name,pID,pos,age,team,season,gp,min,pts,ast,oreb,dreb,treb,stl,blk,tov,pf,fgm,fga,fgp,fg3m,fg3a,fgp3,fg2m,fg2a,fgp2,efgp,ftm,fta,ftp
Mark Acres,acresma01,C,27,ORL,1990,80,1691.0,362,67,154,277,431,36,25,70,248,138,285,0.4842105263157895,3,4,0.75,135,281,0.4804270462633452,0.489,83,120,0.6916666666666667
Michael Adams,adamsmi01,PG,27,DEN,1990,79,2690.0,1221,495,49,176,225,121,3,141,133,398,989,0.4024266936299292,158,432,0.3657407407407407,240,557,0.4308797127468581,0.482,267,314,0.8503184713375797
Mark Aguirre,aguirma01,SF,30,DET,1990,78,2005.0,1099,145,117,188,305,34,19,121,201,438,898,0.487750556792873,31,93,0.3333333333333333,407,805,0.5055900621118012,0.505,192,254,0.7559055118110236
Danny Ainge,aingeda01,PG,30,SAC,1990,75,2727.0,1342,453,69,257,326,113,18,185,238,506,1154,0.438474870017331,108,289,0.3737024221453287,398,865,0.4601156069364162,0.485,222,267,0.8314606741573034
Mark Alarie,alarima01,PF,26,WSB,1990,82,1893.0,860,142,151,223,374,60,39,101,219,371,785,0.4726114649681529,10,49,0.2040816326530612,361,736,0.4904891304347826,0.479,108,133,0.8120300751879699
Steve Alford,alforst01,PG,25,DAL,1990,41,302.0,168,39,2,23,25,15,3,16,22,63,138,0.4565217391304347,7,22,0.3181818181818182,56,116,0.4827586206896552,0.482,35,37,0.945945945945946
Randy Allen,allenra01,SG,25,SAC,1990,63,746.0,235,23,49,89,138,16,19,28,102,106,239,0.4435146443514644,0,7,0.0,106,232,0.4568965517241379,0.444,23,43,0.5348837209302325
Greg Anderson,andergr01,PF,25,MIL,1990,60,1291.0,529,24,112,261,373,32,54,80,176,219,432,0.5069444444444444,0,0,0.0,219,432,0.5069444444444444,0.507,91,170,0.5352941176470588
Nick Anderson,anderni01,SG,22,ORL,1990,81,1785.0,931,124,107,209,316,69,34,138,140,372,753,0.4940239043824701,1,17,0.0588235294117647,371,736,0.5040760869565217,0.495,186,264,0.7045454545454546
Richard Anderson,anderri01,PF,29,CHH,1990,54,604.0,231,55,33,94,127,20,9,26,64,88,211,0.4170616113744075,37,100,0.37,51,111,0.4594594594594595,0.505,18,23,0.782608695652174
Ron Anderson,anderro01,SF,31,PHI,1990,78,2089.0,926,143,81,214,295,72,13,78,143,379,841,0.450653983353151,3,21,0.1428571428571428,376,820,0.4585365853658537,0.452,165,197,0.8375634517766497
Willie Anderson,anderwi01,SG,23,SAS,1990,82,2788.0,1288,364,115,257,372,111,58,198,252,532,1082,0.4916820702402957,7,26,0.2692307692307692,525,1056,0.4971590909090909,0.495,217,290,0.7482758620689656
Michael Ansley,anslemi01,SF,22,ORL,1990,72,1221.0,626,40,187,175,362,24,17,50,152,231,465,0.4967741935483871,0,0,0.0,231,465,0.4967741935483871,0.497,164,227,0.7224669603524229
B.J. Armstrong,armstbj01,PG,22,CHI,1990,81,1291.0,452,199,19,83,102,46,6,83,105,190,392,0.4846938775510204,3,6,0.5,187,386,0.4844559585492228,0.489,69,78,0.8846153846153846
John Bagley,baglejo01,PG,29,BOS,1990,54,1095.0,230,296,26,63,89,40,4,90,77,100,218,0.4587155963302752,1,18,0.0555555555555555,99,200,0.495,0.461,29,39,0.7435897435897436
Thurl Bailey,baileth01,SF,28,UTA,1990,82,2583.0,1162,137,116,294,410,32,100,139,175,470,977,0.481064483111566,0,8,0.0,470,969,0.4850361197110423,0.481,222,285,0.7789473684210526
Ken Bannister,bannike01,PF,29,LAC,1990,52,589.0,206,18,39,73,112,17,7,44,92,77,161,0.4782608695652174,0,1,0.0,77,160,0.48125,0.478,52,110,0.4727272727272727
Charles Barkley,barklch01,SF,26,PHI,1990,79,3085.0,1989,307,361,548,909,148,50,243,250,706,1177,0.5998300764655905,20,92,0.217391304347826,686,1085,0.632258064516129,0.608,557,744,0.7486559139784946
Dana Barros,barroda01,PG,22,SEA,1990,81,1630.0,782,205,35,97,132,53,1,123,97,299,738,0.4051490514905149,95,238,0.3991596638655462,204,500,0.408,0.47,89,110,0.8090909090909091
John Battle,battljo01,SG,27,ATL,1990,60,1477.0,654,154,27,72,99,28,3,89,115,275,544,0.5055147058823529,2,13,0.1538461538461538,273,531,0.5141242937853108,0.507,102,135,0.7555555555555555
Kenny Battle,battlke01,SG,25,PHO,1990,59,729.0,242,38,44,80,124,35,11,32,94,93,170,0.5470588235294118,1,4,0.25,92,166,0.5542168674698795,0.55,55,82,0.6707317073170732
William Bedford,bedfowi01,C,26,DET,1990,42,246.0,118,4,15,43,58,3,17,21,39,54,125,0.432,1,6,0.1666666666666666,53,119,0.4453781512605042,0.436,9,22,0.4090909090909091
Benoit Benjamin,benjabe01,C,25,LAC,1990,71,2313.0,959,159,156,501,657,59,187,187,217,362,688,0.5261627906976745,0,1,0.0,362,687,0.5269286754002911,0.526,235,321,0.7320872274143302
Winston Bennett,bennewi01,SF,24,CLE,1990,55,990.0,338,54,84,104,188,23,10,62,133,137,286,0.479020979020979,0,0,0.0,137,286,0.479020979020979,0.479,64,96,0.6666666666666666
Larry Bird,birdla01,SF,33,BOS,1990,75,2944.0,1820,562,90,622,712,106,61,243,173,718,1517,0.4733025708635465,65,195,0.3333333333333333,653,1322,0.4939485627836611,0.495,319,343,0.9300291545189504
Uwe Blab,blabuw01,C,27,TOT,1990,47,531.0,98,25,29,79,108,1,22,35,102,39,98,0.3979591836734694,0,0,0.0,39,98,0.3979591836734694,0.398,20,37,0.5405405405405406
Rolando Blackman,blackro01,SG,30,DAL,1990,80,2934.0,1552,289,88,192,280,77,21,174,128,626,1256,0.4984076433121019,13,43,0.3023255813953488,613,1213,0.505358615004122,0.504,287,340,0.8441176470588235
Mookie Blaylock,blaylmo01,PG,22,NJN,1990,50,1267.0,505,210,42,98,140,82,14,111,110,212,571,0.3712784588441331,18,80,0.225,194,491,0.395112016293279,0.387,63,81,0.7777777777777778
Muggsy Bogues,boguemu01,PG,25,CHH,1990,81,2743.0,763,867,48,159,207,166,3,146,168,326,664,0.4909638554216867,5,26,0.1923076923076923,321,638,0.5031347962382445,0.495,106,134,0.7910447761194029
Manute Bol,bolma01,C,27,GSW,1990,75,1310.0,146,36,33,243,276,13,238,51,194,56,169,0.3313609467455621,9,48,0.1875,47,121,0.3884297520661157,0.358,25,49,0.5102040816326531
Anthony Bowie,bowiean01,SG,26,HOU,1990,66,918.0,284,96,36,82,118,42,5,59,80,119,293,0.4061433447098976,6,21,0.2857142857142857,113,272,0.4154411764705882,0.416,40,54,0.7407407407407407
Sam Bowie,bowiesa01,C,28,NJN,1990,68,2207.0,998,91,206,484,690,38,121,125,211,347,834,0.4160671462829736,10,31,0.3225806451612903,337,803,0.4196762141967621,0.422,294,379,0.7757255936675461
Adrian Branch,brancad01,SF,26,MIN,1990,11,91.0,65,4,8,12,20,6,0,8,14,25,61,0.4098360655737705,1,1,1.0,24,60,0.4,0.418,14,22,0.6363636363636364
Randy Breuer,breuera01,C,29,TOT,1990,81,1879.0,722,97,154,263,417,42,108,96,196,298,696,0.4281609195402299,0,1,0.0,298,695,0.4287769784172662,0.428,126,193,0.6528497409326425
Frank Brickowski,brickfr01,C,30,SAS,1990,78,1438.0,517,105,89,238,327,66,37,93,226,211,387,0.5452196382428941,0,2,0.0,211,385,0.548051948051948,0.545,95,141,0.6737588652482269
Scott Brooks,brooksc01,PG,24,PHI,1990,72,975.0,319,207,15,49,64,47,0,38,105,119,276,0.4311594202898551,31,79,0.3924050632911392,88,197,0.4467005076142132,0.487,50,57,0.8771929824561403
Chucky Brown,brownch01,SF,21,CLE,1990,75,1339.0,545,50,83,148,231,33,26,69,148,210,447,0.4697986577181208,0,7,0.0,210,440,0.4772727272727273,0.47,125,164,0.7621951219512195
Mike Brown,brownmi01,C,26,UTA,1990,82,1397.0,512,47,111,262,373,32,28,88,187,177,344,0.5145348837209303,1,2,0.5,176,342,0.5146198830409356,0.516,157,199,0.7889447236180904
Raymond Brown,brownra01,PF,24,UTA,1990,16,56.0,16,4,10,5,15,0,0,6,11,8,28,0.2857142857142857,0,0,0.0,8,28,0.2857142857142857,0.286,0,2,0.0
Tony Brown,brownto01,SF,29,MIL,1990,61,635.0,219,41,39,33,72,32,4,51,79,88,206,0.4271844660194174,5,20,0.25,83,186,0.4462365591397849,0.439,38,56,0.6785714285714286
Stanley Brundy,brundst01,SF,22,NJN,1990,16,128.0,37,3,15,11,26,6,5,6,24,15,30,0.5,0,0,0.0,15,30,0.5,0.5,7,18,0.3888888888888889
Mark Bryant,bryanma01,PF,24,POR,1990,58,562.0,168,13,54,92,146,18,9,25,93,70,153,0.457516339869281,0,0,0.0,70,153,0.457516339869281,0.458,28,50,0.56
Torgeir Bryn,brynto01,C,25,LAC,1990,3,10.0,4,0,0,2,2,2,1,1,5,0,2,0.0,0,0,0.0,0,2,0.0,0.0,4,6,0.6666666666666666
Steve Bucknall,bucknst01,SG,23,LAL,1990,18,75.0,23,10,5,2,7,2,1,11,10,9,33,0.2727272727272727,0,1,0.0,9,32,0.28125,0.273,5,6,0.8333333333333334
Greg Butler,butlegr01,C,23,NYK,1990,13,33.0,6,1,3,6,9,0,0,3,8,3,12,0.25,0,0,0.0,3,12,0.25,0.25,0,2,0.0
Michael Cage,cagemi01,C,28,SEA,1990,82,2595.0,798,70,306,515,821,79,45,94,232,325,645,0.5038759689922481,0,0,0.0,325,645,0.5038759689922481,0.504,148,212,0.6981132075471698
Adrian Caldwell,caldwad01,PF,23,HOU,1990,51,331.0,97,7,36,73,109,11,18,32,69,42,76,0.5526315789473685,0,0,0.0,42,76,0.5526315789473685,0.553,13,28,0.4642857142857143
Tony Campbell,campbto01,SG,27,MIN,1990,82,3164.0,1903,213,209,242,451,111,31,251,260,723,1581,0.4573055028462998,9,54,0.1666666666666666,714,1527,0.4675834970530452,0.46,448,569,0.7873462214411248
Rick Carlisle,carliri01,SG,30,NJN,1990,5,21.0,2,5,0,0,0,1,1,4,7,1,7,0.1428571428571428,0,3,0.0,1,4,0.25,0.143,0,0,0.0
Antoine Carr,carran01,PF,28,TOT,1990,77,1727.0,949,119,115,207,322,30,68,125,247,356,721,0.49375866851595,0,7,0.0,356,714,0.4985994397759103,0.494,237,298,0.7953020134228188
Joe Barry Carroll,carrojo01,C,31,TOT,1990,76,1721.0,761,97,133,310,443,47,115,142,192,312,759,0.4110671936758893,0,2,0.0,312,757,0.4121532364597093,0.411,137,177,0.7740112994350282
Bill Cartwright,cartwbi01,C,32,CHI,1990,71,2160.0,811,145,137,328,465,38,34,123,243,292,598,0.4882943143812709,0,0,0.0,292,598,0.4882943143812709,0.488,227,280,0.8107142857142857
Terry Catledge,catlete01,PF,26,ORL,1990,74,2462.0,1435,72,271,292,563,36,17,181,201,546,1152,0.4739583333333333,2,8,0.25,544,1144,0.4755244755244755,0.475,341,486,0.7016460905349794
Tom Chambers,chambto01,PF,30,PHO,1990,81,3046.0,2201,190,121,450,571,88,47,218,260,810,1617,0.5009276437847866,24,86,0.2790697674418604,786,1531,0.5133899412148922,0.508,557,647,0.8608964451313755
Rex Chapman,chapmre01,SG,22,CHH,1990,54,1762.0,945,132,52,127,179,46,6,100,113,377,924,0.408008658008658,47,142,0.3309859154929577,330,782,0.4219948849104859,0.433,144,192,0.75
Maurice Cheeks,cheekma01,PG,33,TOT,1990,81,2519.0,789,453,50,190,240,124,10,121,78,307,609,0.5041050903119869,4,16,0.25,303,593,0.5109612141652614,0.507,171,202,0.8465346534653465
Derrick Chievous,chievde01,SF,22,TOT,1990,55,591.0,293,31,35,55,90,26,5,45,70,105,220,0.4772727272727273,3,9,0.3333333333333333,102,211,0.4834123222748815,0.484,80,111,0.7207207207207207
Ben Coleman,colembe01,PF,28,MIL,1990,22,305.0,126,12,31,56,87,7,7,26,54,46,97,0.4742268041237113,0,1,0.0,46,96,0.4791666666666667,0.474,34,41,0.8292682926829268
Steve Colter,coltest01,PG,27,WSB,1990,73,977.0,361,148,55,121,176,47,10,38,98,142,297,0.4781144781144781,0,5,0.0,142,292,0.4863013698630137,0.478,77,95,0.8105263157894737
Lester Conner,connele01,PG,30,NJN,1990,82,2355.0,648,385,90,175,265,172,8,138,182,237,573,0.4136125654450261,2,13,0.1538461538461538,235,560,0.4196428571428571,0.415,172,214,0.8037383177570093
Michael Cooper,coopemi01,SG,33,LAL,1990,80,1851.0,515,215,59,168,227,67,36,91,206,191,493,0.3874239350912778,50,157,0.3184713375796178,141,336,0.4196428571428571,0.438,83,94,0.8829787234042553
Wayne Cooper,coopewa01,C,33,POR,1990,79,1176.0,301,44,118,221,339,18,95,39,211,138,304,0.4539473684210526,0,3,0.0,138,301,0.4584717607973422,0.454,25,39,0.6410256410256411
Lanard Copeland,copella01,SG,24,PHI,1990,23,110.0,74,9,4,6,10,1,1,19,12,31,68,0.4558823529411764,1,5,0.2,30,63,0.4761904761904761,0.463,11,14,0.7857142857142857
Tyrone Corbin,corbity01,SF,27,MIN,1990,82,3011.0,1203,216,219,385,604,175,41,143,288,521,1083,0.4810710987996306,0,11,0.0,521,1072,0.4860074626865671,0.481,161,209,0.7703349282296651
Dave Corzine,corzida01,C,33,ORL,1990,6,79.0,22,2,7,11,18,2,0,8,7,11,29,0.3793103448275862,0,0,0.0,11,29,0.3793103448275862,0.379,0,2,0.0
Pat Cummings,cummipa01,C,33,MIA,1990,37,391.0,175,13,28,65,93,12,4,32,60,77,159,0.4842767295597484,0,0,0.0,77,159,0.4842767295597484,0.484,21,37,0.5675675675675675
Terry Cummings,cummite01,PF,28,SAS,1990,81,2821.0,1818,219,226,451,677,110,52,202,286,728,1532,0.4751958224543081,19,59,0.3220338983050847,709,1473,0.4813306177868296,0.481,343,440,0.7795454545454545
Dell Curry,curryde01,SG,25,CHH,1990,67,1860.0,1070,159,31,137,168,98,26,100,148,461,990,0.4656565656565656,52,147,0.3537414965986394,409,843,0.4851720047449585,0.492,96,104,0.9230769230769232
Quintin Dailey,dailequ01,SG,29,SEA,1990,30,491.0,247,34,18,33,51,12,0,34,63,97,240,0.4041666666666667,1,5,0.2,96,235,0.4085106382978723,0.406,52,66,0.7878787878787878
Adrian Dantley,dantlad01,SF,34,DAL,1990,45,1300.0,662,80,78,94,172,20,7,75,99,231,484,0.4772727272727273,0,2,0.0,231,482,0.479253112033195,0.477,200,254,0.7874015748031497
Brad Daugherty,daughbr01,C,24,CLE,1990,41,1438.0,690,130,77,296,373,29,22,110,108,244,509,0.4793713163064833,0,2,0.0,244,507,0.4812623274161736,0.479,202,287,0.7038327526132404
Brad Davis,davisbr01,PG,34,DAL,1990,73,1292.0,470,242,12,81,93,47,9,86,151,179,365,0.4904109589041096,35,104,0.3365384615384615,144,261,0.5517241379310345,0.538,77,100,0.77
Charles Davis,davisch02,SF,31,CHI,1990,53,429.0,130,18,25,56,81,10,8,20,52,58,158,0.3670886075949367,7,25,0.28,51,133,0.3834586466165413,0.389,7,8,0.875
Terry Davis,daviste01,PF,22,MIA,1990,63,884.0,298,25,93,136,229,25,28,68,171,122,262,0.465648854961832,0,1,0.0,122,261,0.4674329501915709,0.466,54,87,0.6206896551724138
Walter Davis,daviswa03,SG,35,DEN,1990,69,1635.0,1207,155,46,133,179,59,9,102,160,497,1033,0.4811229428848015,6,46,0.1304347826086956,491,987,0.497467071935157,0.484,207,227,0.9118942731277532
Johnny Dawkins,dawkijo01,PG,26,PHI,1990,81,2865.0,1162,601,48,199,247,121,9,214,159,465,950,0.4894736842105263,22,66,0.3333333333333333,443,884,0.501131221719457,0.501,210,244,0.860655737704918
Vinny Del Negro,delnevi01,SG,23,SAC,1990,76,1858.0,739,250,39,159,198,64,10,111,182,297,643,0.4618973561430793,10,32,0.3125,287,611,0.469721767594108,0.47,135,155,0.8709677419354839
Byron Dinkins,dinkiby01,PG,22,HOU,1990,33,362.0,115,75,13,27,40,19,2,37,30,44,109,0.4036697247706422,1,9,0.1111111111111111,43,100,0.43,0.408,26,30,0.8666666666666667
Vlade Divac,divacvl01,C,21,LAL,1990,82,1611.0,701,75,167,345,512,79,114,110,240,274,549,0.4990892531876138,0,5,0.0,274,544,0.5036764705882353,0.499,153,216,0.7083333333333334
James Donaldson,donalja01,C,32,DAL,1990,73,2265.0,665,57,155,475,630,22,47,119,129,258,479,0.5386221294363257,0,0,0.0,258,479,0.5386221294363257,0.539,149,213,0.6995305164319249
Sherman Douglas,douglsh01,PG,23,MIA,1990,81,2470.0,1155,619,70,136,206,145,10,246,187,463,938,0.4936034115138593,5,31,0.1612903225806451,458,907,0.5049614112458655,0.496,224,326,0.6871165644171779
Terry Dozier,doziete01,SF,23,CHH,1990,9,92.0,22,3,7,8,15,6,2,7,10,9,27,0.3333333333333333,0,1,0.0,9,26,0.3461538461538461,0.333,4,8,0.5
Greg Dreiling,dreilgr01,C,27,IND,1990,49,307.0,65,8,21,66,87,4,14,19,69,20,53,0.3773584905660377,0,0,0.0,20,53,0.3773584905660377,0.377,25,34,0.7352941176470589
Larry Drew,drewla01,PG,31,LAL,1990,80,1333.0,418,217,12,86,98,47,4,95,92,170,383,0.443864229765013,32,81,0.3950617283950617,138,302,0.4569536423841059,0.486,46,60,0.7666666666666667
Clyde Drexler,drexlcl01,SG,27,POR,1990,73,2683.0,1703,432,208,299,507,145,51,191,222,670,1357,0.4937361827560796,30,106,0.2830188679245283,640,1251,0.5115907274180655,0.505,333,430,0.7744186046511627
Kevin Duckworth,duckwke01,C,25,POR,1990,82,2462.0,1327,91,184,325,509,36,34,171,271,548,1146,0.4781849912739965,0,0,0.0,548,1146,0.4781849912739965,0.478,231,312,0.7403846153846154
Chris Dudley,dudlech02,PF,24,TOT,1990,64,1356.0,350,39,174,249,423,41,72,84,164,146,355,0.4112676056338028,0,0,0.0,146,355,0.4112676056338028,0.411,58,182,0.3186813186813186
Joe Dumars,dumarjo01,SG,26,DET,1990,75,2578.0,1335,368,60,152,212,63,2,145,129,508,1058,0.4801512287334593,22,55,0.4,486,1003,0.4845463609172482,0.491,297,330,0.9
Mike Dunleavy,dunlemi01,PG,35,MIL,1990,5,43.0,17,10,0,2,2,1,0,8,7,4,14,0.2857142857142857,2,9,0.2222222222222222,2,5,0.4,0.357,7,8,0.875
T.R. Dunn,dunntr01,SF,34,DEN,1990,65,657.0,114,43,56,82,138,41,4,19,67,44,97,0.4536082474226804,0,2,0.0,44,95,0.4631578947368421,0.454,26,39,0.6666666666666666
Ledell Eackles,eacklle01,SG,23,WSB,1990,78,1696.0,1055,182,74,101,175,50,4,143,157,413,940,0.4393617021276595,19,59,0.3220338983050847,394,881,0.4472190692395005,0.449,210,280,0.75
Mark Eaton,eatonma01,C,33,UTA,1990,82,2281.0,395,39,171,430,601,33,201,75,238,158,300,0.5266666666666666,0,0,0.0,158,300,0.5266666666666666,0.527,79,118,0.6694915254237288
Blue Edwards,edwarbl01,SF,24,UTA,1990,82,1889.0,727,145,69,182,251,76,36,152,280,286,564,0.5070921985815603,9,30,0.3,277,534,0.5187265917602997,0.515,146,203,0.7192118226600985
James Edwards,edwarja01,C,34,DET,1990,82,2283.0,1189,63,112,233,345,23,37,133,295,462,928,0.4978448275862069,0,3,0.0,462,925,0.4994594594594594,0.498,265,354,0.748587570621469
Jay Edwards,edwarja02,SG,21,LAC,1990,4,26.0,7,4,1,1,2,1,0,1,4,3,7,0.4285714285714285,0,2,0.0,3,5,0.6,0.429,1,3,0.3333333333333333
Kevin Edwards,edwarke01,SG,24,MIA,1990,78,2211.0,938,252,77,205,282,125,33,180,149,395,959,0.4118873826903024,9,30,0.3,386,929,0.4155005382131324,0.417,139,183,0.7595628415300546
Craig Ehlo,ehlocr01,SG,28,CLE,1990,81,2894.0,1102,371,147,292,439,126,23,161,226,436,940,0.4638297872340425,104,248,0.4193548387096774,332,692,0.4797687861271676,0.519,126,185,0.6810810810810811
Sean Elliott,elliose01,SF,21,SAS,1990,81,2032.0,810,154,127,170,297,45,14,112,172,311,647,0.4806800618238022,1,9,0.1111111111111111,310,638,0.4858934169278996,0.481,187,216,0.8657407407407407
Dale Ellis,ellisda01,SG,29,SEA,1990,55,2033.0,1293,110,90,148,238,59,7,119,124,502,1011,0.496538081107814,96,256,0.375,406,755,0.5377483443708609,0.544,193,236,0.8177966101694916
Pervis Ellison,ellispe01,C,22,SAC,1990,34,866.0,271,65,64,132,196,16,57,62,132,111,251,0.4422310756972111,0,2,0.0,111,249,0.4457831325301205,0.442,49,78,0.6282051282051282
Alex English,englial01,SF,36,DEN,1990,80,2211.0,1433,225,119,167,286,51,23,93,130,635,1293,0.4911059551430781,2,5,0.4,633,1288,0.4914596273291925,0.492,161,183,0.8797814207650273
Patrick Ewing,ewingpa01,C,27,NYK,1990,82,3165.0,2347,182,235,658,893,78,327,278,325,922,1673,0.5511057979677226,1,4,0.25,921,1669,0.5518274415817855,0.551,502,648,0.7746913580246914
Jim Farmer,farmeji01,SG,25,SEA,1990,38,400.0,243,25,17,26,43,17,1,27,44,89,203,0.438423645320197,8,27,0.2962962962962963,81,176,0.4602272727272727,0.458,57,80,0.7125
Duane Ferrell,ferredu01,SF,24,ATL,1990,14,29.0,12,2,3,4,7,1,0,2,3,5,14,0.3571428571428571,0,1,0.0,5,13,0.3846153846153846,0.357,2,6,0.3333333333333333
Vern Fleming,flemive01,PG,27,IND,1990,82,2876.0,1176,610,118,204,322,92,10,206,213,467,919,0.5081610446137106,12,34,0.3529411764705882,455,885,0.5141242937853108,0.515,230,294,0.782312925170068
Sleepy Floyd,floydsl01,PG,29,HOU,1990,82,2630.0,1000,600,46,152,198,94,11,204,159,362,803,0.4508094645080946,89,234,0.3803418803418803,273,569,0.4797891036906854,0.506,187,232,0.8060344827586207
Tellis Frank,frankte01,PF,24,MIA,1990,77,1762.0,735,85,151,234,385,51,27,134,282,278,607,0.457990115321252,0,0,0.0,278,607,0.457990115321252,0.458,179,234,0.7649572649572649
Corey Gaines,gaineco01,SG,24,PHI,1990,9,81.0,10,26,1,4,5,4,0,10,11,4,12,0.3333333333333333,1,2,0.5,3,10,0.3,0.375,1,4,0.25
Kevin Gamble,gamblke01,SF,24,BOS,1990,71,990.0,362,119,42,70,112,28,8,44,77,137,301,0.4551495016611295,3,18,0.1666666666666666,134,283,0.4734982332155477,0.46,85,107,0.794392523364486
Winston Garland,garlawi01,PG,25,TOT,1990,79,1762.0,574,303,51,163,214,78,10,158,152,230,573,0.4013961605584642,12,36,0.3333333333333333,218,537,0.4059590316573557,0.412,102,122,0.8360655737704918
Tom Garrick,garrito01,SG,23,LAC,1990,73,1721.0,508,289,34,128,162,90,7,117,151,208,421,0.4940617577197149,4,21,0.1904761904761904,204,400,0.51,0.499,88,114,0.7719298245614035
Kenny Gattison,gattike01,PF,25,CHH,1990,63,941.0,372,39,75,122,197,35,31,67,150,148,269,0.550185873605948,1,1,1.0,147,268,0.5485074626865671,0.552,75,110,0.6818181818181818
Derrick Gervin,gervide01,PF,26,NJN,1990,21,339.0,251,8,29,36,65,20,7,12,47,93,197,0.4720812182741117,0,3,0.0,93,194,0.4793814432989691,0.472,65,89,0.7303370786516854
Armen Gilliam,gilliar01,PF,25,TOT,1990,76,2426.0,1271,99,211,388,599,69,51,183,212,484,940,0.5148936170212766,0,2,0.0,484,938,0.5159914712153518,0.515,303,419,0.7231503579952268
Mike Gminski,gminsmi01,C,30,PHI,1990,81,2659.0,1112,128,196,491,687,43,102,98,136,458,1002,0.4570858283433133,3,17,0.1764705882352941,455,985,0.4619289340101523,0.459,193,235,0.8212765957446808
Gary Grant,grantga01,PG,24,LAC,1990,44,1529.0,575,442,59,136,195,108,5,206,120,241,517,0.4661508704061896,5,21,0.238095238095238,236,496,0.4758064516129032,0.471,88,113,0.7787610619469026
Greg Grant,grantgr01,PG,23,PHO,1990,67,678.0,208,168,16,43,59,36,1,77,58,83,216,0.3842592592592592,3,16,0.1875,80,200,0.4,0.391,39,59,0.6610169491525424
Harvey Grant,grantha01,PF,24,WSB,1990,81,1846.0,664,131,138,204,342,52,43,85,194,284,601,0.4725457570715474,0,8,0.0,284,593,0.4789207419898819,0.473,96,137,0.7007299270072993
Horace Grant,grantho01,PF,24,CHI,1990,80,2753.0,1071,227,236,393,629,92,84,110,230,446,853,0.5228604923798359,0,0,0.0,446,853,0.5228604923798359,0.523,179,256,0.69921875
Stuart Gray,grayst01,C,26,TOT,1990,58,560.0,116,19,40,105,145,15,26,24,90,42,99,0.4242424242424242,0,5,0.0,42,94,0.4468085106382978,0.424,32,47,0.6808510638297872
Jeff Grayer,grayeje01,SF,24,MIL,1990,71,1427.0,548,107,94,123,217,48,10,82,125,224,487,0.459958932238193,1,8,0.125,223,479,0.4655532359081419,0.461,99,152,0.6513157894736842
A.C. Green,greenac01,PF,26,LAL,1990,82,2709.0,1061,90,262,450,712,66,50,116,207,385,806,0.477667493796526,13,46,0.2826086956521739,372,760,0.4894736842105263,0.486,278,370,0.7513513513513513
Rickey Green,greenri01,PG,35,IND,1990,69,927.0,244,182,9,45,54,51,1,62,60,100,231,0.4329004329004329,1,11,0.0909090909090909,99,220,0.45,0.435,43,51,0.8431372549019608
Sidney Green,greensi02,C,29,ORL,1990,73,1860.0,761,99,166,422,588,50,26,119,231,312,667,0.4677661169415292,1,3,0.3333333333333333,311,664,0.4683734939759036,0.469,136,209,0.6507177033492823
Dave Greenwood,greenda01,PF,32,DET,1990,37,205.0,60,12,24,54,78,4,9,16,40,22,52,0.4230769230769231,0,0,0.0,22,52,0.4230769230769231,0.423,16,29,0.5517241379310345
Darrell Griffith,griffda01,SG,31,UTA,1990,82,1444.0,733,63,43,123,166,68,19,75,149,301,649,0.4637904468412943,80,215,0.3720930232558139,221,434,0.5092165898617511,0.525,51,78,0.6538461538461539
Scott Haffner,haffnsc01,PG,23,MIA,1990,43,559.0,196,80,7,44,51,13,2,33,53,88,217,0.4055299539170507,3,21,0.1428571428571428,85,196,0.4336734693877551,0.412,17,25,0.68
Jack Haley,haleyja01,PF,26,TOT,1990,67,1084.0,361,26,115,185,300,18,12,72,170,138,347,0.3976945244956772,0,1,0.0,138,346,0.3988439306358382,0.398,85,125,0.68
Tom Hammonds,hammoto01,PF,22,WSB,1990,61,805.0,321,51,61,107,168,11,14,46,98,129,295,0.4372881355932203,0,1,0.0,129,294,0.4387755102040816,0.437,63,98,0.6428571428571429
Bob Hansen,hansebo01,SG,29,UTA,1990,81,2174.0,617,149,66,163,229,52,11,79,194,265,568,0.4665492957746479,54,154,0.3506493506493506,211,414,0.5096618357487923,0.514,33,64,0.515625
Bill Hanzlik,hanzlbi01,PF,32,DEN,1990,81,1605.0,500,186,67,140,207,78,29,87,249,179,396,0.452020202020202,6,31,0.1935483870967742,173,365,0.473972602739726,0.46,136,183,0.7431693989071039
Tim Hardaway,hardati01,PG,23,GSW,1990,79,2663.0,1162,689,57,253,310,165,12,260,232,464,985,0.4710659898477157,23,84,0.2738095238095238,441,901,0.4894561598224195,0.483,211,276,0.7644927536231884
Derek Harper,harpede01,PG,28,DAL,1990,82,3007.0,1473,609,54,190,244,187,26,207,224,567,1161,0.4883720930232558,89,240,0.3708333333333333,478,921,0.5190010857763301,0.527,250,315,0.7936507936507936
Ron Harper,harpero01,SG,26,TOT,1990,35,1367.0,798,182,74,132,206,81,41,100,105,301,637,0.4725274725274725,14,51,0.2745098039215686,287,586,0.4897610921501706,0.484,182,231,0.7878787878787878
Steve Harris,harrist01,SG,26,LAC,1990,15,93.0,31,1,5,5,10,7,1,5,9,14,40,0.35,0,0,0.0,14,40,0.35,0.35,3,4,0.75
Scott Hastings,hastisc01,PF,29,DET,1990,40,166.0,42,8,7,25,32,3,3,7,31,10,33,0.303030303030303,3,12,0.25,7,21,0.3333333333333333,0.348,19,22,0.8636363636363636
Hersey Hawkins,hawkihe01,SG,23,PHI,1990,82,2856.0,1515,261,85,219,304,130,28,185,217,522,1136,0.4595070422535211,84,200,0.42,438,936,0.4679487179487179,0.496,387,436,0.8876146788990825
Gerald Henderson,hendege01,PG,34,TOT,1990,57,464.0,135,74,11,32,43,16,2,24,50,53,109,0.4862385321100917,17,38,0.4473684210526316,36,71,0.5070422535211268,0.564,12,15,0.8
Mike Higgins,higgimi01,SF,22,TOT,1990,11,50.0,14,3,2,2,4,2,2,1,5,3,8,0.375,0,0,0.0,3,8,0.375,0.375,8,10,0.8
Rod Higgins,higgiro01,PF,30,GSW,1990,82,1993.0,909,129,120,302,422,47,53,93,184,304,632,0.4810126582278481,67,193,0.3471502590673575,237,439,0.5398633257403189,0.534,234,285,0.8210526315789474
Roy Hinson,hinsoro01,PF,28,NJN,1990,25,793.0,376,22,61,111,172,14,27,52,87,145,286,0.506993006993007,0,0,0.0,145,286,0.506993006993007,0.507,86,99,0.8686868686868687
Craig Hodges,hodgecr01,SG,29,CHI,1990,63,1055.0,407,110,11,42,53,30,2,30,87,145,331,0.4380664652567976,87,181,0.4806629834254143,58,150,0.3866666666666666,0.569,30,33,0.9090909090909092
Michael Holton,holtomi01,PG,28,CHH,1990,16,109.0,29,16,1,1,2,1,0,13,19,14,26,0.5384615384615384,0,0,0.0,14,26,0.5384615384615384,0.538,1,2,0.5
Dave Hoppen,hoppeda01,C,25,CHH,1990,10,135.0,40,6,19,17,36,2,1,8,26,16,41,0.3902439024390244,0,0,0.0,16,41,0.3902439024390244,0.39,8,10,0.8
Dennis Hopson,hopsode01,SG,24,NJN,1990,79,2551.0,1251,151,113,166,279,100,51,168,183,474,1093,0.4336688014638609,32,101,0.3168316831683168,442,992,0.4455645161290322,0.448,271,342,0.7923976608187134
Tito Horford,horfoti01,C,24,MIL,1990,35,236.0,51,2,19,40,59,5,16,14,33,18,62,0.2903225806451613,0,0,0.0,18,62,0.2903225806451613,0.29,15,24,0.625
Jeff Hornacek,hornaje01,SG,26,PHO,1990,67,2278.0,1179,337,86,227,313,117,14,125,144,483,901,0.5360710321864595,40,98,0.4081632653061224,443,803,0.5516811955168119,0.558,173,202,0.8564356435643564
Ed Horton,hortoed01,PF,22,WSB,1990,45,374.0,202,19,59,49,108,9,5,39,63,80,162,0.4938271604938271,0,4,0.0,80,158,0.5063291139240507,0.494,42,69,0.6086956521739131
Eddie Hughes,hugheed01,PG,29,DEN,1990,60,892.0,209,116,15,55,70,48,1,39,87,83,202,0.4108910891089108,20,49,0.4081632653061224,63,153,0.4117647058823529,0.46,23,34,0.6764705882352942
Jay Humphries,humphja01,PG,27,MIL,1990,81,2818.0,1237,472,80,189,269,156,11,151,253,496,1005,0.4935323383084577,21,70,0.3,475,935,0.5080213903743316,0.504,224,285,0.7859649122807018
Byron Irvin,irvinby01,SG,23,POR,1990,50,488.0,258,47,30,44,74,28,1,39,40,96,203,0.4729064039408867,5,14,0.3571428571428571,91,189,0.4814814814814814,0.485,61,91,0.6703296703296703
Jaren Jackson,jacksja01,SG,22,NJN,1990,28,160.0,67,13,16,8,24,13,1,18,16,25,69,0.3623188405797101,0,3,0.0,25,66,0.3787878787878788,0.362,17,21,0.8095238095238095
Mark Jackson,jacksma01,PG,24,NYK,1990,82,2428.0,809,604,106,212,318,109,4,211,121,327,749,0.4365821094793057,35,131,0.2671755725190839,292,618,0.4724919093851132,0.46,120,165,0.7272727272727273
Michael Jackson,jacksmi02,PG,25,SAC,1990,17,58.0,10,8,2,5,7,5,0,4,3,3,11,0.2727272727272727,1,2,0.5,2,9,0.2222222222222222,0.318,3,6,0.5
Avery Johnson,johnsav01,PG,24,SEA,1990,53,575.0,140,162,21,22,43,26,1,48,55,55,142,0.3873239436619718,1,4,0.25,54,138,0.391304347826087,0.391,29,40,0.725
Buck Johnson,johnsbu01,SF,26,HOU,1990,82,2832.0,1215,252,113,268,381,104,62,167,321,504,1019,0.4946025515210991,2,17,0.1176470588235294,502,1002,0.500998003992016,0.496,205,270,0.7592592592592593
Dennis Johnson,johnsde01,PG,35,BOS,1990,75,2036.0,531,485,48,153,201,81,14,117,179,206,475,0.4336842105263158,1,24,0.0416666666666666,205,451,0.4545454545454545,0.435,118,140,0.8428571428571429
Eddie Johnson,johnsed03,SF,30,PHO,1990,64,1811.0,1080,107,69,177,246,32,10,108,174,411,907,0.4531422271223815,70,184,0.3804347826086957,341,723,0.4716459197786998,0.492,188,205,0.9170731707317074
Eric Johnson,johnser01,PG,23,UTA,1990,48,272.0,54,64,8,20,28,17,2,26,49,20,84,0.238095238095238,1,6,0.1666666666666666,19,78,0.2435897435897435,0.244,13,17,0.7647058823529411
Kevin Johnson,johnske02,PG,23,PHO,1990,74,2782.0,1665,846,42,228,270,95,14,263,143,578,1159,0.4987057808455565,8,41,0.1951219512195122,570,1118,0.5098389982110912,0.502,501,598,0.8377926421404682
Magic Johnson,johnsma02,PG,30,LAL,1990,79,2937.0,1765,907,128,394,522,132,34,289,167,546,1138,0.4797891036906854,106,276,0.3840579710144927,440,862,0.5104408352668214,0.526,567,637,0.8901098901098901
Marques Johnson,johnsma01,SF,33,GSW,1990,10,99.0,40,9,8,9,17,0,1,10,12,12,32,0.375,2,3,0.6666666666666666,10,29,0.3448275862068966,0.406,14,17,0.8235294117647058
Steve Johnson,johnsst03,C,32,TOT,1990,25,259.0,117,17,19,34,53,3,5,31,56,48,92,0.5217391304347826,0,0,0.0,48,92,0.5217391304347826,0.522,21,35,0.6
Vinnie Johnson,johnsvi01,SG,33,DET,1990,82,1972.0,804,255,108,148,256,71,13,123,143,334,775,0.4309677419354839,5,34,0.1470588235294117,329,741,0.4439946018893387,0.434,131,196,0.6683673469387755
Nate Johnston,johnsna01,PF-SF,23,TOT,1990,21,87.0,46,1,13,10,23,3,8,6,11,18,48,0.375,1,4,0.25,17,44,0.3863636363636363,0.385,9,13,0.6923076923076923
Anthony Jones,jonesan01,SG,27,DAL,1990,66,650.0,195,29,33,49,82,32,16,42,77,72,194,0.3711340206185567,4,13,0.3076923076923077,68,181,0.3756906077348066,0.381,47,69,0.6811594202898551
Caldwell Jones,jonesca01,PF,39,SAS,1990,72,885.0,173,20,76,154,230,20,27,48,146,67,144,0.4652777777777778,1,5,0.2,66,139,0.4748201438848921,0.469,38,54,0.7037037037037037
Charles Jones,jonesch01,C,32,WSB,1990,81,2240.0,256,139,145,359,504,50,197,76,296,94,185,0.5081081081081081,0,0,0.0,94,185,0.5081081081081081,0.508,68,105,0.6476190476190476
Michael Jordan,jordami01,SG,26,CHI,1990,82,3197.0,2753,519,143,422,565,227,54,247,241,1034,1964,0.5264765784114053,92,245,0.3755102040816326,942,1719,0.5479930191972077,0.55,593,699,0.8483547925608012
Shawn Kemp,kempsh01,PF,20,SEA,1990,81,1120.0,525,26,146,200,346,47,70,107,204,203,424,0.4787735849056603,2,12,0.1666666666666666,201,412,0.4878640776699029,0.481,117,159,0.7358490566037735
Tim Kempton,kemptti01,PF,26,DEN,1990,71,1061.0,383,118,51,167,218,30,9,80,144,153,312,0.4903846153846153,0,1,0.0,153,311,0.4919614147909968,0.49,77,114,0.6754385964912281
Steve Kerr,kerrst01,PG,24,CLE,1990,78,1664.0,520,248,12,86,98,45,7,74,59,192,432,0.4444444444444444,73,144,0.5069444444444444,119,288,0.4131944444444444,0.529,63,73,0.863013698630137
Jerome Kersey,kerseje01,SF,27,POR,1990,82,2843.0,1310,188,251,439,690,121,63,144,304,519,1085,0.4783410138248848,3,20,0.15,516,1065,0.4845070422535211,0.48,269,390,0.6897435897435897
Randolph Keys,keysra01,SF,23,TOT,1990,80,1615.0,701,88,100,153,253,68,8,84,224,293,678,0.4321533923303834,14,43,0.3255813953488372,279,635,0.4393700787401575,0.442,101,140,0.7214285714285714
Stan Kimbrough,kimbrst01,PG,23,DET,1990,10,50.0,16,5,4,3,7,4,0,4,4,7,16,0.4375,0,0,0.0,7,16,0.4375,0.438,2,2,1.0
Bernard King,kingbe01,SF,33,WSB,1990,82,2687.0,1837,376,129,275,404,51,7,248,230,711,1459,0.4873200822481151,3,23,0.1304347826086956,708,1436,0.4930362116991643,0.488,412,513,0.8031189083820662
Stacey King,kingst01,PF,23,CHI,1990,82,1777.0,728,87,169,215,384,38,58,119,215,267,530,0.5037735849056604,0,1,0.0,267,529,0.504725897920605,0.504,194,267,0.7265917602996255
Greg Kite,kitegr01,C,28,SAC,1990,71,1515.0,230,76,131,246,377,31,51,76,201,101,234,0.4316239316239316,1,1,1.0,100,233,0.4291845493562232,0.434,27,54,0.5
Joe Kleine,kleinjo01,C,28,BOS,1990,81,1365.0,435,46,117,238,355,15,27,64,170,176,367,0.4795640326975476,0,4,0.0,176,363,0.4848484848484848,0.48,83,100,0.83
Jon Koncak,koncajo01,C,26,ATL,1990,54,977.0,198,23,58,168,226,38,34,47,182,78,127,0.6141732283464567,0,1,0.0,78,126,0.6190476190476191,0.614,42,79,0.5316455696202531
Frank Kornet,kornefr01,PF,23,MIL,1990,57,438.0,113,21,25,46,71,14,3,23,54,42,114,0.3684210526315789,5,20,0.25,37,94,0.3936170212765957,0.39,24,39,0.6153846153846154
Larry Krystkowiak,krystla01,PF,25,MIL,1990,16,381.0,112,25,16,60,76,10,2,19,41,43,118,0.3644067796610169,0,2,0.0,43,116,0.3706896551724138,0.364,26,33,0.7878787878787878
Bill Laimbeer,laimbbi01,C,32,DET,1990,81,2675.0,981,171,166,614,780,57,84,98,278,380,785,0.4840764331210191,57,158,0.360759493670886,323,627,0.5151515151515151,0.52,164,192,0.8541666666666666
Jerome Lane,laneje01,PF,23,DEN,1990,67,956.0,334,105,144,217,361,53,17,85,189,145,309,0.4692556634304207,0,5,0.0,145,304,0.4769736842105263,0.469,44,120,0.3666666666666666
Andrew Lang,langan01,C,23,PHO,1990,74,1011.0,258,21,83,188,271,22,133,41,171,97,174,0.5574712643678161,0,0,0.0,97,174,0.5574712643678161,0.557,64,98,0.6530612244897959
Jeff Lebo,leboje01,SG,23,SAS,1990,4,32.0,6,3,2,2,4,2,0,1,7,2,7,0.2857142857142857,0,0,0.0,2,7,0.2857142857142857,0.286,2,2,1.0
Eric Leckner,leckner01,C,23,UTA,1990,77,764.0,331,19,48,144,192,15,23,63,157,125,222,0.5630630630630631,0,0,0.0,125,222,0.5630630630630631,0.563,81,109,0.7431192660550459
Tim Legler,legleti01,SG,23,PHO,1990,11,83.0,28,6,4,4,8,2,0,4,12,11,29,0.3793103448275862,0,1,0.0,11,28,0.3928571428571428,0.379,6,6,1.0
Gary Leonard,leonaga01,C,22,MIN,1990,22,127.0,32,1,10,17,27,3,9,8,26,13,31,0.4193548387096774,0,1,0.0,13,30,0.4333333333333333,0.419,6,14,0.4285714285714285
Jim Les,lesji01,PG,26,TOT,1990,7,92.0,23,21,3,4,7,3,0,10,9,5,14,0.3571428571428571,0,1,0.0,5,13,0.3846153846153846,0.357,13,17,0.7647058823529411
Clifford Lett,lettcl01,PG,24,CHI,1990,4,28.0,4,1,0,0,0,0,0,2,8,2,8,0.25,0,0,0.0,2,8,0.25,0.25,0,0,0.0
Fat Lever,leverfa01,SG,29,DEN,1990,79,2832.0,1443,517,230,504,734,168,13,156,172,568,1283,0.4427123928293063,36,87,0.4137931034482758,532,1196,0.4448160535117056,0.457,271,337,0.8041543026706232
Cliff Levingston,levincl01,PF,29,ATL,1990,75,1706.0,516,80,113,206,319,55,41,49,216,216,424,0.5094339622641509,1,5,0.2,215,419,0.513126491646778,0.511,83,122,0.680327868852459
Ralph Lewis,lewisra01,SG-SF,26,TOT,1990,7,26.0,10,0,4,2,6,1,0,2,3,4,7,0.5714285714285714,0,0,0.0,4,7,0.5714285714285714,0.571,2,2,1.0
Reggie Lewis,lewisre01,SG,24,BOS,1990,79,2522.0,1340,225,109,238,347,88,63,120,216,540,1089,0.4958677685950413,4,15,0.2666666666666666,536,1074,0.4990689013035381,0.498,256,317,0.807570977917981
Todd Lichti,lichtto01,SG,23,DEN,1990,79,1326.0,630,116,49,102,151,55,13,95,145,250,514,0.4863813229571984,0,14,0.0,250,500,0.5,0.486,130,174,0.7471264367816092
Alton Lister,listeal01,C,31,GSW,1990,3,40.0,12,2,5,3,8,1,0,0,8,4,8,0.5,0,1,0.0,4,7,0.5714285714285714,0.5,4,7,0.5714285714285714
Lewis Lloyd,lloydle01,SG,30,TOT,1990,21,123.0,69,11,8,10,18,3,0,20,12,30,53,0.5660377358490566,0,0,0.0,30,53,0.5660377358490566,0.566,9,16,0.5625
Brad Lohaus,lohaubr01,PF,25,TOT,1990,80,1943.0,732,168,98,300,398,58,88,109,211,305,663,0.4600301659125188,47,137,0.3430656934306569,258,526,0.4904942965779467,0.495,75,103,0.7281553398058253
Grant Long,longgr01,PF,23,MIA,1990,81,1856.0,686,96,156,246,402,91,38,139,300,257,532,0.4830827067669173,0,3,0.0,257,529,0.4858223062381852,0.483,172,241,0.7136929460580913
John Long,longjo01,SG,33,ATL,1990,48,1030.0,404,85,26,57,83,45,5,75,66,174,384,0.453125,10,29,0.3448275862068966,164,355,0.4619718309859155,0.466,46,55,0.8363636363636363
Sidney Lowe,lowesi01,PG,30,MIN,1990,80,1744.0,187,337,41,122,163,73,4,63,114,73,229,0.3187772925764192,2,9,0.2222222222222222,71,220,0.3227272727272727,0.323,39,54,0.7222222222222222
John Lucas,lucasjo01,PG,36,HOU,1990,49,938.0,286,238,19,71,90,45,2,85,59,109,291,0.3745704467353952,26,87,0.2988505747126437,83,204,0.4068627450980392,0.419,42,55,0.7636363636363637
Rick Mahorn,mahorri01,PF,31,PHI,1990,75,2271.0,811,98,167,401,568,44,103,104,251,313,630,0.4968253968253968,2,9,0.2222222222222222,311,621,0.500805152979066,0.498,183,256,0.71484375
Dan Majerle,majerda01,SG,24,PHO,1990,73,2244.0,809,188,144,286,430,100,32,82,177,296,698,0.4240687679083094,19,80,0.2375,277,618,0.4482200647249191,0.438,198,260,0.7615384615384615
Jeff Malone,malonje01,SG,28,WSB,1990,75,2567.0,1820,243,54,152,206,48,6,125,116,781,1592,0.4905778894472362,1,6,0.1666666666666666,780,1586,0.4918032786885246,0.491,257,293,0.8771331058020477
Karl Malone,malonka01,PF,26,UTA,1990,82,3122.0,2540,226,232,679,911,121,50,304,259,914,1627,0.5617701290719115,16,43,0.3720930232558139,898,1584,0.5669191919191919,0.567,696,913,0.7623220153340635
Moses Malone,malonmo01,C,34,ATL,1990,81,2735.0,1528,130,364,448,812,47,84,232,158,517,1077,0.4800371402042711,1,9,0.1111111111111111,516,1068,0.4831460674157303,0.481,493,631,0.7812995245641838
Danny Manning,mannida01,PF,23,LAC,1990,71,2269.0,1154,187,142,280,422,91,39,188,261,440,826,0.5326876513317191,0,5,0.0,440,821,0.535931790499391,0.533,274,370,0.7405405405405405
Roy Marble,marblro01,SG,23,ATL,1990,24,162.0,51,11,15,9,24,7,1,14,16,16,58,0.2758620689655172,0,2,0.0,16,56,0.2857142857142857,0.276,19,29,0.6551724137931034
Šarūnas Marčiulionis,marcisa01,SG,25,GSW,1990,75,1695.0,905,121,84,137,221,94,7,137,230,289,557,0.518850987432675,10,39,0.2564102564102564,279,518,0.5386100386100386,0.528,317,403,0.7866004962779156
Jeff Martin,martije01,SG,23,LAC,1990,69,1351.0,433,44,78,81,159,41,16,47,97,170,414,0.4106280193236715,2,15,0.1333333333333333,168,399,0.4210526315789473,0.413,91,129,0.7054263565891473
Anthony Mason,masonan01,PF,23,NJN,1990,21,108.0,37,7,11,23,34,2,2,11,20,14,40,0.35,0,0,0.0,14,40,0.35,0.35,9,15,0.6
Wes Matthews,matthwe01,PG,30,ATL,1990,1,13.0,4,5,0,0,0,0,0,0,0,1,3,0.3333333333333333,0,1,0.0,1,2,0.5,0.333,2,2,1.0
Vernon Maxwell,maxweve01,SG,24,TOT,1990,79,1987.0,714,296,50,178,228,84,10,143,148,275,627,0.4385964912280701,28,105,0.2666666666666666,247,522,0.4731800766283525,0.461,136,211,0.6445497630331753
Bob McCann,mccanbo01,SF,25,DAL,1990,10,62.0,26,6,4,8,12,2,2,6,7,7,21,0.3333333333333333,0,0,0.0,7,21,0.3333333333333333,0.333,12,14,0.8571428571428571
Mel McCants,mccanme01,SF,22,LAL,1990,13,65.0,22,2,1,5,6,3,1,1,11,8,26,0.3076923076923077,0,0,0.0,8,26,0.3076923076923077,0.308,6,8,0.75
George McCloud,mccloge01,SF,22,IND,1990,44,413.0,118,45,12,30,42,19,3,36,56,45,144,0.3125,13,40,0.325,32,104,0.3076923076923077,0.358,15,19,0.7894736842105263
Tim McCormick,mccorti01,C,27,HOU,1990,18,116.0,30,3,8,19,27,3,1,10,24,10,29,0.3448275862068966,0,0,0.0,10,29,0.3448275862068966,0.345,10,19,0.5263157894736842
Rodney McCray,mccraro01,SF,28,SAC,1990,82,3238.0,1358,377,192,477,669,60,70,174,176,537,1043,0.5148609779482263,11,42,0.2619047619047619,526,1001,0.5254745254745254,0.52,273,348,0.7844827586206896
Xavier McDaniel,mcdanxa01,SF,26,SEA,1990,69,2432.0,1471,171,165,282,447,73,36,187,231,611,1233,0.4955393349553934,5,17,0.2941176470588235,606,1216,0.4983552631578947,0.498,244,333,0.7327327327327328
Mike McGee,mcgeemi01,SF,30,PHO,1990,14,280.0,102,16,11,25,36,8,1,14,28,42,87,0.4827586206896552,8,23,0.3478260869565217,34,64,0.53125,0.529,10,21,0.4761904761904761
Kevin McHale,mchalke01,PF,32,BOS,1990,82,2722.0,1712,172,201,476,677,30,157,183,250,648,1181,0.5486875529212532,23,69,0.3333333333333333,625,1112,0.5620503597122302,0.558,393,440,0.8931818181818182
Derrick McKey,mckeyde01,SF,23,SEA,1990,80,2748.0,1254,187,170,319,489,87,81,192,247,468,949,0.4931506849315068,3,23,0.1304347826086956,465,926,0.5021598272138229,0.495,315,403,0.7816377171215881
Carlton McKinney,mckinca01,SG,25,LAC,1990,7,104.0,18,7,4,8,12,6,1,7,15,8,32,0.25,0,1,0.0,8,31,0.2580645161290322,0.25,2,4,0.5
Nate McMillan,mcmilna01,SG,25,SEA,1990,82,2338.0,523,598,127,276,403,140,37,187,289,207,438,0.4726027397260274,11,31,0.3548387096774194,196,407,0.4815724815724815,0.485,98,153,0.6405228758169934
Mark McNamara,mcnamma01,C,30,LAL,1990,33,190.0,102,3,22,41,63,2,1,21,31,38,86,0.4418604651162791,0,0,0.0,38,86,0.4418604651162791,0.442,26,40,0.65
Scott Meents,meentsc01,PF,26,SEA,1990,26,148.0,55,7,7,23,30,4,3,9,12,19,44,0.4318181818181818,0,0,0.0,19,44,0.4318181818181818,0.432,17,23,0.7391304347826086
Reggie Miller,millere01,SG,24,IND,1990,82,3192.0,2016,311,95,200,295,110,18,222,175,661,1287,0.5135975135975136,150,362,0.4143646408839779,511,925,0.5524324324324325,0.572,544,627,0.8676236044657097
Sam Mitchell,mitchsa01,PF,26,MIN,1990,80,2414.0,1012,89,180,282,462,66,54,96,301,372,834,0.4460431654676259,0,9,0.0,372,825,0.4509090909090909,0.446,268,349,0.7679083094555874
Paul Mokeski,mokespa01,C,33,CLE,1990,38,449.0,151,17,27,72,99,8,10,26,76,63,150,0.42,0,1,0.0,63,149,0.4228187919463087,0.42,25,36,0.6944444444444444
Johnny Moore,moorejo01,PG,31,SAS,1990,53,516.0,118,82,16,36,52,32,3,39,55,47,126,0.373015873015873,8,34,0.2352941176470588,39,92,0.4239130434782608,0.405,16,27,0.5925925925925926
Chris Morris,morrich01,SF,24,NJN,1990,80,2449.0,1187,143,194,228,422,130,79,185,219,449,1065,0.4215962441314554,61,193,0.3160621761658031,388,872,0.4449541284403669,0.45,228,316,0.7215189873417721
Mike Morrison,morrimi01,SG,22,PHO,1990,36,153.0,72,11,7,13,20,2,0,23,20,23,68,0.3382352941176471,2,7,0.2857142857142857,21,61,0.3442622950819672,0.353,24,30,0.8
John Morton,mortojo01,SG,22,CLE,1990,37,402.0,146,67,7,25,32,18,4,51,30,48,161,0.2981366459627329,7,30,0.2333333333333333,41,131,0.3129770992366412,0.32,43,62,0.6935483870967742
Chris Mullin,mullich01,SF,26,GSW,1990,78,2830.0,1956,319,130,333,463,123,45,239,142,682,1272,0.5361635220125787,87,234,0.3717948717948718,595,1038,0.5732177263969171,0.57,505,568,0.8890845070422535
Tod Murphy,murphto01,C,26,MIN,1990,82,2493.0,680,106,207,357,564,76,60,61,229,260,552,0.4710144927536231,16,43,0.3720930232558139,244,509,0.4793713163064833,0.486,144,203,0.7093596059113301
Pete Myers,myerspe01,SG,26,TOT,1990,52,751.0,244,135,33,63,96,35,11,76,109,89,225,0.3955555555555555,0,7,0.0,89,218,0.4082568807339449,0.396,66,100,0.66
Larry Nance,nancela01,PF,30,CLE,1990,62,2065.0,1011,161,162,354,516,54,122,110,185,412,807,0.5105328376703842,1,1,1.0,411,806,0.5099255583126551,0.511,186,239,0.7782426778242678
Calvin Natt,nattca01,SF,33,IND,1990,14,164.0,57,9,10,25,35,1,0,5,14,20,31,0.6451612903225806,0,0,0.0,20,31,0.6451612903225806,0.645,17,22,0.7727272727272727
Ed Nealy,nealyed01,PF,29,CHI,1990,46,503.0,104,28,46,92,138,16,4,17,67,37,70,0.5285714285714286,0,2,0.0,37,68,0.5441176470588235,0.529,30,41,0.7317073170731707
Chuck Nevitt,nevitch01,C,30,HOU,1990,3,9.0,4,1,0,3,3,0,1,2,3,2,2,1.0,0,0,0.0,2,2,1.0,1.0,0,0,0.0
Johnny Newman,newmajo01,SF,26,NYK,1990,80,2277.0,1032,180,60,131,191,95,22,143,254,374,786,0.4758269720101781,45,142,0.3169014084507042,329,644,0.5108695652173914,0.504,239,299,0.7993311036789298
Kurt Nimphius,nimphku01,C,31,PHI,1990,38,314.0,90,6,22,39,61,4,18,12,45,38,91,0.4175824175824176,0,1,0.0,38,90,0.4222222222222222,0.418,14,30,0.4666666666666667
Dyron Nix,nixdy01,SF,22,IND,1990,20,109.0,39,5,8,18,26,3,1,7,15,14,39,0.358974358974359,0,0,0.0,14,39,0.358974358974359,0.359,11,16,0.6875
Ken Norman,normake01,SF,25,LAC,1990,70,2334.0,1128,160,143,327,470,78,59,190,196,484,949,0.5100105374077977,7,16,0.4375,477,933,0.5112540192926045,0.514,153,242,0.6322314049586777
Charles Oakley,oaklech01,PF,26,NYK,1990,61,2196.0,889,146,258,469,727,64,16,165,220,336,641,0.5241809672386896,0,3,0.0,336,638,0.5266457680250783,0.524,217,285,0.7614035087719299
Hakeem Olajuwon,olajuha01,C,27,HOU,1990,82,3124.0,1995,234,299,850,1149,174,376,316,314,806,1609,0.5009322560596644,1,6,0.1666666666666666,805,1603,0.5021834061135371,0.501,382,536,0.7126865671641791
Jawann Oldham,oldhaja01,C,32,TOT,1990,6,45.0,9,1,4,12,16,2,3,4,9,3,6,0.5,0,0,0.0,3,6,0.5,0.5,3,7,0.4285714285714285
José Ortiz,ortizjo01,PF,26,UTA,1990,13,64.0,42,7,8,7,15,2,1,5,15,19,42,0.4523809523809524,1,2,0.5,18,40,0.45,0.464,3,5,0.6
Robert Parish,parisro01,C,36,BOS,1990,79,2396.0,1243,103,259,537,796,38,69,169,189,505,871,0.5797933409873708,0,0,0.0,505,871,0.5797933409873708,0.58,233,312,0.7467948717948718
Žarko Paspalj,paspaza01,SF,23,SAS,1990,28,181.0,72,10,15,15,30,3,7,21,37,27,79,0.3417721518987341,0,1,0.0,27,78,0.3461538461538461,0.342,18,22,0.8181818181818182
Jim Paxson,paxsoji02,PG,32,BOS,1990,72,1283.0,460,137,24,53,77,33,5,54,115,191,422,0.45260663507109,5,20,0.25,186,402,0.4626865671641791,0.459,73,90,0.8111111111111111
John Paxson,paxsojo01,PG,29,CHI,1990,82,2365.0,819,335,27,92,119,83,6,85,176,365,708,0.5155367231638418,33,92,0.358695652173913,332,616,0.538961038961039,0.539,56,68,0.8235294117647058
Kenny Payne,payneke01,SF,23,PHI,1990,35,216.0,114,10,11,15,26,7,6,20,37,47,108,0.4351851851851852,4,10,0.4,43,98,0.4387755102040816,0.454,16,18,0.8888888888888888
Will Perdue,perduwi01,C,24,CHI,1990,77,884.0,294,46,88,126,214,19,26,65,150,111,268,0.4141791044776119,0,5,0.0,111,263,0.4220532319391635,0.414,72,104,0.6923076923076923
Sam Perkins,perkisa01,SF,28,DAL,1990,76,2668.0,1206,175,209,363,572,88,64,148,225,435,883,0.4926387315968289,6,28,0.2142857142857142,429,855,0.5017543859649123,0.496,330,424,0.7783018867924528
Tim Perry,perryti01,C,24,PHO,1990,60,612.0,254,17,79,73,152,21,22,47,76,100,195,0.5128205128205128,1,1,1.0,99,194,0.5103092783505154,0.515,53,90,0.5888888888888889
Chuck Person,persoch01,SF,25,IND,1990,77,2714.0,1515,230,126,319,445,53,20,170,217,605,1242,0.4871175523349436,94,253,0.3715415019762846,511,989,0.5166835187057633,0.525,211,270,0.7814814814814814
Jim Petersen,peterji01,C,27,GSW,1990,43,592.0,172,23,49,111,160,17,20,36,103,60,141,0.425531914893617,0,1,0.0,60,140,0.4285714285714285,0.426,52,73,0.7123287671232876
Dražen Petrović,petrodr01,SG,25,POR,1990,77,967.0,583,116,50,61,111,23,2,96,134,207,427,0.4847775175644028,34,74,0.4594594594594595,173,353,0.490084985835694,0.525,135,160,0.84375
Ricky Pierce,piercri01,SG,30,MIL,1990,59,1709.0,1359,133,64,103,167,50,7,129,158,503,987,0.5096251266464032,46,133,0.3458646616541353,457,854,0.5351288056206089,0.533,307,366,0.8387978142076503
Ed Pinckney,pincked01,PF,26,BOS,1990,77,1082.0,362,68,93,132,225,34,42,56,126,135,249,0.5421686746987951,0,1,0.0,135,248,0.5443548387096774,0.542,92,119,0.773109243697479
Scottie Pippen,pippesc01,SF,24,CHI,1990,82,3148.0,1351,444,150,397,547,211,101,278,298,562,1150,0.488695652173913,28,112,0.25,534,1038,0.5144508670520231,0.501,199,295,0.6745762711864407
Olden Polynice,polynol01,C,25,SEA,1990,79,1085.0,360,15,128,172,300,25,21,35,187,156,289,0.5397923875432526,1,2,0.5,155,287,0.5400696864111498,0.542,47,99,0.4747474747474747
Terry Porter,portete01,PG,26,POR,1990,80,2781.0,1406,726,59,213,272,151,4,245,150,448,969,0.4623323013415892,89,238,0.3739495798319328,359,731,0.4911080711354309,0.508,421,472,0.8919491525423728
Paul Pressey,presspa01,SG,31,MIL,1990,57,1400.0,628,244,59,113,172,71,23,109,149,239,506,0.4723320158102767,6,43,0.1395348837209302,233,463,0.5032397408207343,0.478,144,190,0.7578947368421053
Harold Pressley,pressha01,SF,26,SAC,1990,72,1603.0,636,149,94,215,309,58,36,88,148,240,566,0.4240282685512367,46,148,0.3108108108108108,194,418,0.4641148325358851,0.465,110,141,0.7801418439716312
Mark Price,pricema01,PG,25,CLE,1990,73,2706.0,1430,666,66,185,251,114,5,214,89,489,1066,0.4587242026266416,152,374,0.4064171122994652,337,692,0.4869942196531792,0.53,300,338,0.8875739644970414
Brian Quinnett,quinnbr01,SG,23,NYK,1990,31,193.0,40,11,9,19,28,3,4,4,27,19,58,0.3275862068965517,0,2,0.0,19,56,0.3392857142857143,0.328,2,3,0.6666666666666666
Kurt Rambis,rambiku01,PF,31,TOT,1990,74,1904.0,462,135,156,369,525,100,37,104,208,190,373,0.5093833780160858,0,3,0.0,190,370,0.5135135135135135,0.509,82,127,0.6456692913385826
Blair Rasmussen,rasmubl01,C,27,DEN,1990,81,1995.0,1001,82,174,420,594,40,104,75,300,445,895,0.4972067039106145,0,1,0.0,445,894,0.4977628635346756,0.497,111,134,0.8283582089552238
J.R. Reid,reidjr01,C,21,CHH,1990,82,2757.0,908,101,199,492,691,92,54,172,292,358,814,0.4398034398034398,0,5,0.0,358,809,0.4425216316440049,0.44,192,289,0.6643598615916955
Robert Reid,reidro01,SF,34,TOT,1990,72,1202.0,414,90,34,117,151,38,16,45,153,175,447,0.3914988814317673,10,32,0.3125,165,415,0.3975903614457831,0.403,54,86,0.627906976744186
Jerry Reynolds,reynoje01,SF,27,ORL,1990,67,1817.0,858,180,91,232,323,93,64,139,162,309,741,0.4170040485829959,1,14,0.0714285714285714,308,727,0.4236588720770289,0.418,239,322,0.7422360248447205
Glen Rice,ricegl01,SF,22,MIA,1990,77,2311.0,1048,138,100,252,352,67,27,113,198,470,1071,0.4388422035480859,17,69,0.2463768115942029,453,1002,0.4520958083832335,0.447,91,124,0.7338709677419355
Pooh Richardson,richapo01,PG,23,MIN,1990,82,2581.0,938,554,55,162,217,133,25,141,143,426,925,0.4605405405405405,23,83,0.2771084337349397,403,842,0.4786223277909738,0.473,63,107,0.5887850467289719
Mitch Richmond,richmmi01,SG,24,GSW,1990,78,2799.0,1720,223,98,262,360,98,24,201,210,640,1287,0.4972804972804973,34,95,0.3578947368421052,606,1192,0.5083892617449665,0.51,406,469,0.8656716417910447
David Rivers,riverda01,PG,25,LAC,1990,52,724.0,219,155,30,55,85,31,0,88,53,80,197,0.4060913705583756,0,5,0.0,80,192,0.4166666666666667,0.406,59,78,0.7564102564102564
Doc Rivers,riverdo01,PG,28,ATL,1990,48,1526.0,598,264,47,153,200,116,22,98,151,218,480,0.4541666666666666,24,66,0.3636363636363636,194,414,0.4685990338164251,0.479,138,170,0.8117647058823529
Fred Roberts,roberfr01,PF,29,MIL,1990,82,2235.0,857,147,107,204,311,56,25,130,210,330,666,0.4954954954954955,2,11,0.1818181818181818,328,655,0.500763358778626,0.497,195,249,0.7831325301204819
Alvin Robertson,roberal01,SG,27,MIL,1990,81,2599.0,1153,445,230,329,559,207,17,217,280,476,946,0.5031712473572939,4,26,0.1538461538461538,472,920,0.5130434782608696,0.505,197,266,0.7406015037593985
Clifford Robinson,robincl02,PF,23,POR,1990,82,1565.0,746,72,110,198,308,53,53,129,226,298,751,0.3968042609853529,12,44,0.2727272727272727,286,707,0.4045261669024045,0.405,138,251,0.549800796812749
David Robinson,robinda01,C,24,SAS,1990,82,3002.0,1993,164,303,680,983,138,319,257,259,690,1300,0.5307692307692308,0,2,0.0,690,1298,0.5315870570107858,0.531,613,837,0.7323775388291517
Dennis Rodman,rodmade01,SF,28,DET,1990,82,2377.0,719,72,336,456,792,52,60,90,276,288,496,0.5806451612903226,1,9,0.1111111111111111,287,487,0.5893223819301848,0.582,142,217,0.6543778801843319
Tree Rollins,rollitr01,C,34,CLE,1990,48,674.0,125,24,58,95,153,13,53,35,83,57,125,0.456,0,1,0.0,57,124,0.4596774193548387,0.456,11,16,0.6875
Doug Roth,rothdo01,C,22,WSB,1990,42,412.0,81,20,44,76,120,8,13,16,70,37,86,0.4302325581395348,0,1,0.0,37,85,0.4352941176470588,0.43,7,14,0.5
Scott Roth,rothsc01,SF,26,MIN,1990,71,1061.0,486,115,34,78,112,51,6,85,144,159,420,0.3785714285714285,18,52,0.3461538461538461,141,368,0.3831521739130434,0.4,150,201,0.746268656716418
Jim Rowinski,rowinji01,PF,29,MIA,1990,14,112.0,50,5,17,12,29,1,2,10,19,14,32,0.4375,0,0,0.0,14,32,0.4375,0.438,22,26,0.8461538461538461
Brian Rowsom,rowsobr01,PF,24,CHH,1990,44,559.0,225,22,44,87,131,18,11,25,58,78,179,0.435754189944134,1,2,0.5,77,177,0.4350282485875706,0.439,68,83,0.8192771084337349
Donald Royal,royaldo01,SF,23,MIN,1990,66,746.0,387,43,69,68,137,32,8,81,107,117,255,0.4588235294117647,0,1,0.0,117,254,0.4606299212598425,0.459,153,197,0.7766497461928934
Delaney Rudd,ruddde01,PG,27,UTA,1990,77,850.0,273,177,12,43,55,22,1,88,81,111,259,0.4285714285714285,16,56,0.2857142857142857,95,203,0.4679802955665024,0.459,35,53,0.660377358490566
John Salley,sallejo01,PF,25,DET,1990,82,1914.0,593,67,154,285,439,51,153,97,282,209,408,0.5122549019607843,1,4,0.25,208,404,0.5148514851485149,0.513,174,244,0.7131147540983607
Ralph Sampson,sampsra01,C,29,SAC,1990,26,417.0,109,28,11,73,84,14,22,34,66,48,129,0.3720930232558139,1,4,0.25,47,125,0.376,0.376,12,23,0.5217391304347826
Jeff Sanders,sandeje01,PF,24,CHI,1990,31,182.0,28,9,17,22,39,4,4,15,27,13,40,0.325,0,0,0.0,13,40,0.325,0.325,2,4,0.5
Mike Sanders,sandemi01,SF,29,IND,1990,82,1531.0,510,89,78,152,230,43,23,79,220,225,479,0.4697286012526096,5,14,0.3571428571428571,220,465,0.4731182795698925,0.475,55,75,0.7333333333333333
Danny Schayes,schayda01,C,30,DEN,1990,53,1194.0,551,61,117,225,342,41,45,72,200,163,330,0.4939393939393939,0,4,0.0,163,326,0.5,0.494,225,264,0.8522727272727273
Detlef Schrempf,schrede01,PF,27,IND,1990,78,2573.0,1267,247,149,471,620,59,16,180,271,424,822,0.5158150851581509,17,48,0.3541666666666667,407,774,0.5258397932816538,0.526,402,490,0.8204081632653061
Byron Scott,scottby01,SG,28,LAL,1990,77,2593.0,1197,274,51,191,242,77,31,122,180,472,1005,0.4696517412935323,93,220,0.4227272727272727,379,785,0.4828025477707006,0.516,160,209,0.7655502392344498
Rony Seikaly,seikaro01,C,24,MIA,1990,74,2409.0,1228,78,253,513,766,78,124,236,258,486,968,0.5020661157024794,0,1,0.0,486,967,0.5025853154084798,0.502,256,431,0.5939675174013921
Brad Sellers,sellebr01,PF,27,TOT,1990,59,700.0,264,33,39,50,89,17,22,46,74,103,254,0.405511811023622,0,5,0.0,103,249,0.4136546184738955,0.406,58,73,0.7945205479452054
Charles Shackleford,shackch01,C,23,NJN,1990,70,1557.0,573,56,180,299,479,40,35,116,183,247,535,0.4616822429906542,0,1,0.0,247,534,0.4625468164794007,0.462,79,115,0.6869565217391305
John Shasky,shaskjo01,C,25,GSW,1990,14,51.0,10,1,4,9,13,1,2,2,10,4,14,0.2857142857142857,0,0,0.0,4,14,0.2857142857142857,0.286,2,6,0.3333333333333333
Purvis Short,shortpu01,SF,32,NJN,1990,82,2213.0,1072,145,101,147,248,66,20,119,202,432,950,0.4547368421052631,10,35,0.2857142857142857,422,915,0.4612021857923497,0.46,198,237,0.8354430379746836
Dexter Shouse,shousde01,PG,26,PHI,1990,3,18.0,0,2,0,0,0,1,1,2,2,0,4,0.0,0,1,0.0,0,3,0.0,0.0,0,0,0.0
Jerry Sichting,sichtje01,PG,33,TOT,1990,35,496.0,121,94,3,16,19,16,2,22,40,50,125,0.4,3,12,0.25,47,113,0.415929203539823,0.412,18,22,0.8181818181818182
Jack Sikma,sikmaja01,C,34,MIL,1990,71,2250.0,986,229,109,383,492,76,48,139,244,344,827,0.4159613059250302,68,199,0.3417085427135678,276,628,0.4394904458598726,0.457,230,260,0.8846153846153846
Scott Skiles,skilesc01,PG,25,ORL,1990,70,1460.0,536,334,23,136,159,36,4,90,126,190,464,0.4094827586206896,52,132,0.3939393939393939,138,332,0.4156626506024096,0.466,104,119,0.8739495798319328
Charles Smith,smithch01,PF,24,LAC,1990,78,2732.0,1645,114,177,347,524,86,119,162,294,595,1145,0.519650655021834,1,12,0.0833333333333333,594,1133,0.5242718446601942,0.52,454,572,0.7937062937062938
Charles Smith,smithch02,PG,22,BOS,1990,60,519.0,171,103,14,55,69,35,3,36,75,59,133,0.4436090225563909,0,7,0.0,59,126,0.4682539682539682,0.444,53,76,0.6973684210526315
Derek Smith,smithde02,SF,28,PHI,1990,75,1405.0,668,109,62,110,172,35,20,85,198,261,514,0.5077821011673151,16,36,0.4444444444444444,245,478,0.5125523012552301,0.523,130,186,0.6989247311827957
Kenny Smith,smithke01,PG,24,TOT,1990,79,2421.0,943,445,18,139,157,79,8,169,143,378,811,0.4660912453760789,26,83,0.3132530120481928,352,728,0.4835164835164835,0.482,161,196,0.8214285714285714
Larry Smith,smithla01,PF,32,HOU,1990,74,1300.0,222,69,180,272,452,56,28,70,203,101,213,0.4741784037558685,0,2,0.0,101,211,0.4786729857819905,0.474,20,55,0.3636363636363636
Michael Smith,smithmi01,PF,24,BOS,1990,65,620.0,327,79,40,60,100,9,1,54,51,136,286,0.4755244755244755,2,28,0.0714285714285714,134,258,0.5193798449612403,0.479,53,64,0.828125
Otis Smith,smithot01,SF,26,ORL,1990,65,1644.0,875,147,117,183,300,76,57,102,174,348,708,0.4915254237288136,10,40,0.25,338,668,0.5059880239520959,0.499,169,222,0.7612612612612613
Rik Smits,smitsri01,C,23,IND,1990,82,2404.0,1271,142,135,377,512,45,169,143,328,515,967,0.532574974146846,0,1,0.0,515,966,0.5331262939958592,0.533,241,297,0.8114478114478114
Mike Smrek,smrekmi01,C,27,GSW,1990,13,107.0,21,1,11,23,34,4,11,9,18,10,24,0.4166666666666667,0,0,0.0,10,24,0.4166666666666667,0.417,1,6,0.1666666666666666
Rory Sparrow,sparrro01,PG,31,MIA,1990,82,1756.0,487,298,37,101,138,49,4,99,140,210,510,0.4117647058823529,8,40,0.2,202,470,0.4297872340425532,0.42,59,77,0.7662337662337663
John Stockton,stockjo01,PG,27,UTA,1990,78,2915.0,1345,1134,57,149,206,207,18,272,233,472,918,0.514161220043573,47,113,0.415929203539823,425,805,0.5279503105590062,0.54,354,432,0.8194444444444444
Greg Stokes,stokegr01,PF,26,SAC,1990,11,34.0,4,0,2,3,5,0,0,3,8,1,9,0.1111111111111111,0,0,0.0,1,9,0.1111111111111111,0.111,2,2,1.0
Rod Strickland,stricro02,PG,23,TOT,1990,82,2140.0,868,468,90,169,259,127,14,170,160,343,756,0.4537037037037037,8,30,0.2666666666666666,335,726,0.4614325068870523,0.459,174,278,0.6258992805755396
Jon Sundvold,sundvjo01,SG,28,MIA,1990,63,867.0,384,102,15,56,71,25,0,52,69,148,363,0.4077134986225895,44,100,0.44,104,263,0.3954372623574144,0.468,44,52,0.8461538461538461
Roy Tarpley,tarplro01,PF,25,DAL,1990,45,1648.0,758,67,189,400,589,79,70,117,160,314,696,0.4511494252873563,0,6,0.0,314,690,0.4550724637681159,0.451,130,172,0.7558139534883721
Jay Taylor,tayloja01,SG,22,NJN,1990,17,114.0,51,5,5,6,11,5,3,10,9,21,52,0.4038461538461538,3,13,0.2307692307692307,18,39,0.4615384615384615,0.433,6,9,0.6666666666666666
Leonard Taylor,taylole01,PF,23,GSW,1990,10,37.0,11,1,4,8,12,0,0,5,4,0,6,0.0,0,1,0.0,0,5,0.0,0.0,11,16,0.6875
Terry Teagle,teaglte01,SF,29,GSW,1990,82,2376.0,1323,155,114,253,367,91,15,144,231,538,1122,0.4795008912655971,3,14,0.2142857142857142,535,1108,0.4828519855595667,0.481,244,294,0.8299319727891157
Reggie Theus,theusre01,SG,32,ORL,1990,76,2350.0,1438,407,75,146,221,60,12,226,194,517,1178,0.4388794567062818,26,105,0.2476190476190476,491,1073,0.4575955265610438,0.45,378,443,0.8532731376975169
Isiah Thomas,thomais01,PG,28,DET,1990,81,2993.0,1492,765,74,234,308,139,19,322,206,579,1322,0.4379727685325265,42,136,0.3088235294117647,537,1186,0.4527824620573356,0.454,292,377,0.7745358090185677
Billy Thompson,thompbi01,SF,26,MIA,1990,79,2142.0,867,166,238,313,551,54,89,156,237,375,727,0.515818431911967,2,4,0.5,373,723,0.5159059474412172,0.517,115,185,0.6216216216216216
LaSalle Thompson,thompla01,C,28,IND,1990,82,2126.0,554,106,175,455,630,65,71,150,313,223,471,0.4734607218683652,1,5,0.2,222,466,0.4763948497854077,0.475,107,134,0.7985074626865671
Mychal Thompson,thompmy01,C,35,LAL,1990,70,1883.0,706,43,173,304,477,33,73,79,207,281,562,0.5,0,0,0.0,281,562,0.5,0.5,144,204,0.7058823529411765
Bob Thornton,thornbo01,PF,27,PHI,1990,56,592.0,123,17,45,88,133,20,12,35,105,48,112,0.4285714285714285,1,3,0.3333333333333333,47,109,0.4311926605504587,0.433,26,51,0.5098039215686274
Otis Thorpe,thorpot01,PF,27,HOU,1990,82,2947.0,1401,261,258,476,734,66,24,229,270,547,998,0.5480961923847696,0,10,0.0,547,988,0.5536437246963563,0.548,307,446,0.6883408071748879
Sedale Threatt,threase01,PG,28,SEA,1990,65,1481.0,744,216,43,72,115,65,8,77,164,303,599,0.5058430717863105,8,32,0.25,295,567,0.5202821869488536,0.513,130,157,0.8280254777070064
Wayman Tisdale,tisdawa01,PF,25,SAC,1990,79,2937.0,1758,108,185,410,595,54,54,153,251,726,1383,0.5249457700650759,0,6,0.0,726,1377,0.5272331154684096,0.525,306,391,0.782608695652174
Tom Tolbert,tolbeto01,PF,24,GSW,1990,70,1347.0,616,58,122,241,363,23,25,79,191,218,442,0.4932126696832579,5,18,0.2777777777777778,213,424,0.5023584905660378,0.499,175,241,0.7261410788381742
Sedric Toney,toneyse01,PG,27,TOT,1990,64,968.0,264,174,14,46,60,33,0,73,106,87,250,0.348,23,63,0.365079365079365,64,187,0.3422459893048128,0.394,67,83,0.8072289156626506
Kelly Tripucka,tripuke01,SF,30,CHH,1990,79,2404.0,1232,224,82,240,322,75,16,176,220,442,1029,0.4295432458697765,38,104,0.3653846153846153,404,925,0.4367567567567567,0.448,310,351,0.8831908831908832
Trent Tucker,tucketr01,SG,30,NYK,1990,81,1725.0,667,173,57,117,174,74,8,73,159,253,606,0.4174917491749175,95,245,0.3877551020408163,158,361,0.4376731301939058,0.496,66,86,0.7674418604651163
Andre Turner,turnean01,PG,25,TOT,1990,11,115.0,26,23,4,4,8,8,0,12,6,11,38,0.2894736842105263,0,2,0.0,11,36,0.3055555555555556,0.289,4,4,1.0
Henry Turner,turnehe02,PF,23,SAC,1990,36,315.0,156,22,22,28,50,17,7,26,40,58,122,0.4754098360655737,0,3,0.0,58,119,0.4873949579831932,0.475,40,65,0.6153846153846154
Jeff Turner,turneje01,PF,27,ORL,1990,60,1105.0,308,53,52,175,227,23,12,61,161,132,308,0.4285714285714285,2,10,0.2,130,298,0.436241610738255,0.432,42,54,0.7777777777777778
Melvin Turpin,turpime01,C,29,WSB,1990,59,818.0,276,27,88,133,221,15,47,45,135,110,209,0.5263157894736842,0,2,0.0,110,207,0.5314009661835749,0.526,56,71,0.7887323943661971
Kelvin Upshaw,upshake01,SG,27,TOT,1990,40,387.0,160,54,9,32,41,27,1,27,53,64,146,0.4383561643835616,4,15,0.2666666666666666,60,131,0.4580152671755725,0.452,28,37,0.7567567567567568
Kiki Vandeweghe,vandeki01,SF,31,NYK,1990,22,563.0,258,41,15,38,53,15,3,26,28,102,231,0.4415584415584415,10,19,0.5263157894736842,92,212,0.4339622641509434,0.463,44,48,0.9166666666666666
Jay Vincent,vinceja01,SF,30,TOT,1990,41,459.0,214,18,20,42,62,18,5,33,52,86,183,0.4699453551912568,1,2,0.5,85,181,0.4696132596685083,0.473,41,49,0.8367346938775511
Sam Vincent,vincesa01,PG,26,ORL,1990,63,1657.0,705,354,37,157,194,65,20,132,108,258,564,0.4574468085106383,1,14,0.0714285714285714,257,550,0.4672727272727273,0.458,188,214,0.8785046728971962
Gary Voce,vocega01,PF,24,CLE,1990,1,4.0,2,0,2,0,2,0,0,0,0,1,3,0.3333333333333333,0,0,0.0,1,3,0.3333333333333333,0.333,0,0,0.0
Alexander Volkov,volkoal01,C,25,ATL,1990,72,937.0,357,83,52,67,119,36,22,52,166,137,284,0.4823943661971831,13,34,0.3823529411764705,124,250,0.496,0.505,70,120,0.5833333333333334
Mark Wade,wadema01,PG,24,DAL,1990,1,3.0,0,2,0,0,0,0,0,0,0,0,0,0.0,0,0,0.0,0,0,0.0,0.0,0,0,0.0
Darrell Walker,walkeda01,PG,28,WSB,1990,81,2883.0,772,652,173,541,714,139,30,173,220,316,696,0.4540229885057471,2,21,0.0952380952380952,314,675,0.4651851851851852,0.455,138,201,0.6865671641791045
Kenny Walker,walkeke01,PF,25,NYK,1990,68,1595.0,535,49,131,212,343,33,52,60,178,204,384,0.53125,2,5,0.4,202,379,0.5329815303430079,0.534,125,173,0.7225433526011561
Spud Webb,webbsp01,PG,26,ATL,1990,82,2184.0,751,477,38,163,201,105,12,141,185,294,616,0.4772727272727273,1,19,0.0526315789473684,293,597,0.490787269681742,0.478,162,186,0.8709677419354839
Chris Welp,welpch01,C,26,TOT,1990,27,198.0,65,9,18,30,48,6,8,15,58,23,61,0.3770491803278688,0,0,0.0,23,61,0.3770491803278688,0.377,19,25,0.76
Bill Wennington,wennibi01,C,26,DAL,1990,60,814.0,270,41,64,134,198,20,21,50,144,105,234,0.4487179487179487,0,4,0.0,105,230,0.4565217391304347,0.449,60,75,0.8
Doug West,westdo01,SG,22,MIN,1990,52,378.0,135,18,24,46,70,10,6,31,61,53,135,0.3925925925925926,3,11,0.2727272727272727,50,124,0.4032258064516129,0.404,26,32,0.8125
Mark West,westma01,C,29,PHO,1990,82,2399.0,861,45,212,516,728,36,184,126,277,331,530,0.6245283018867924,0,0,0.0,331,530,0.6245283018867924,0.625,199,288,0.6909722222222222
Randy White,whitera01,PF,22,DAL,1990,55,707.0,237,21,78,95,173,24,6,47,124,93,252,0.369047619047619,1,14,0.0714285714285714,92,238,0.3865546218487395,0.371,50,89,0.5617977528089888
Mitchell Wiggins,wiggimi01,SG,30,HOU,1990,66,1852.0,1024,104,133,153,286,85,1,87,165,416,853,0.4876905041031653,0,3,0.0,416,850,0.4894117647058824,0.488,192,237,0.810126582278481
Morlon Wiley,wileymo01,PG,23,ORL,1990,40,638.0,229,114,13,39,52,45,3,63,65,92,208,0.4423076923076923,17,46,0.3695652173913043,75,162,0.4629629629629629,0.483,28,38,0.7368421052631579
Dominique Wilkins,wilkido01,SF,30,ATL,1990,80,2888.0,2138,200,217,304,521,126,47,174,141,810,1672,0.4844497607655502,59,183,0.3224043715846995,751,1489,0.5043653458697113,0.502,459,569,0.8066783831282952
Eddie Lee Wilkins,wilkied01,C,27,NYK,1990,79,972.0,371,16,114,151,265,18,18,73,152,141,310,0.4548387096774193,0,2,0.0,141,308,0.4577922077922078,0.455,89,147,0.6054421768707483
Gerald Wilkins,wilkige01,SG,26,NYK,1990,82,2609.0,1191,330,133,238,371,95,21,194,188,472,1032,0.4573643410852713,39,125,0.312,433,907,0.4773980154355016,0.476,208,259,0.803088803088803
Buck Williams,willibu01,PF,29,POR,1990,82,2801.0,1114,116,250,550,800,69,39,168,285,413,754,0.5477453580901857,0,1,0.0,413,753,0.548472775564409,0.548,288,408,0.7058823529411765
Herb Williams,willihe01,C,31,DAL,1990,81,2199.0,700,119,76,315,391,51,106,106,243,295,665,0.4436090225563909,2,9,0.2222222222222222,293,656,0.4466463414634146,0.445,108,159,0.6792452830188679
Hot Rod Williams,williho01,PF,27,CLE,1990,82,2776.0,1381,168,220,443,663,86,167,143,214,528,1070,0.4934579439252336,0,0,0.0,528,1070,0.4934579439252336,0.493,325,440,0.7386363636363636
John Williams,willijo02,SF,23,WSB,1990,18,632.0,327,84,27,109,136,21,9,43,33,130,274,0.4744525547445255,2,18,0.1111111111111111,128,256,0.5,0.478,65,84,0.7738095238095238
Micheal Williams,willimi02,PG,23,TOT,1990,28,329.0,156,81,12,20,32,22,1,33,39,60,119,0.5042016806722689,0,3,0.0,60,116,0.5172413793103449,0.504,36,46,0.782608695652174
Mike Williams,willimi03,PF-SF,26,TOT,1990,21,102.0,15,2,5,18,23,3,7,3,30,6,18,0.3333333333333333,0,1,0.0,6,17,0.3529411764705882,0.333,3,6,0.5
Reggie Williams,willire01,SF,25,TOT,1990,47,743.0,320,53,28,55,83,32,14,45,102,131,338,0.3875739644970414,6,37,0.1621621621621621,125,301,0.4152823920265781,0.396,52,68,0.7647058823529411
Kevin Willis,willike02,PF,27,ATL,1990,81,2273.0,1006,57,253,392,645,63,47,144,259,418,805,0.5192546583850932,2,7,0.2857142857142857,416,798,0.5213032581453634,0.52,168,246,0.6829268292682927
David Wingate,wingada01,SG,26,SAS,1990,78,1856.0,527,208,62,133,195,89,18,127,154,220,491,0.4480651731160896,0,13,0.0,220,478,0.4602510460251046,0.448,87,112,0.7767857142857143
Randy Wittman,wittmra01,SF,30,IND,1990,61,544.0,130,39,4,26,30,7,4,23,21,62,122,0.5081967213114754,1,2,0.5,61,120,0.5083333333333333,0.512,5,6,0.8333333333333334
Joe Wolf,wolfjo01,C,25,LAC,1990,77,1325.0,370,62,63,169,232,30,24,77,129,155,392,0.3954081632653061,5,25,0.2,150,367,0.4087193460490463,0.402,55,71,0.7746478873239436
Leon Wood,woodle01,SG,27,NJN,1990,28,200.0,50,47,1,11,12,6,0,8,16,16,49,0.3265306122448979,4,21,0.1904761904761904,12,28,0.4285714285714285,0.367,14,16,0.875
Mike Woodson,woodsmi01,SG,31,HOU,1990,61,972.0,394,66,25,63,88,42,11,49,100,160,405,0.3950617283950617,12,41,0.2926829268292683,148,364,0.4065934065934066,0.41,62,86,0.7209302325581395
Orlando Woolridge,woolror01,SF,30,LAL,1990,62,1421.0,788,96,49,136,185,39,46,73,160,306,550,0.5563636363636364,0,5,0.0,306,545,0.5614678899082569,0.556,176,240,0.7333333333333333
Haywoode Workman,workmha01,PG,24,ATL,1990,6,16.0,6,2,0,3,3,3,0,0,3,2,3,0.6666666666666666,0,0,0.0,2,3,0.6666666666666666,0.667,2,2,1.0
James Worthy,worthja01,SF,28,LAL,1990,80,2960.0,1685,288,160,318,478,99,49,160,190,711,1298,0.5477657935285054,15,49,0.3061224489795918,696,1249,0.5572457966373099,0.554,248,317,0.7823343848580442
Danny Young,youngda01,PG,27,POR,1990,82,1393.0,383,231,29,93,122,82,4,80,84,138,328,0.4207317073170731,16,59,0.2711864406779661,122,269,0.4535315985130111,0.445,91,112,0.8125
Michael Young,youngmi01,SF,29,LAC,1990,45,459.0,219,24,36,50,86,25,3,15,47,92,194,0.4742268041237113,8,26,0.3076923076923077,84,168,0.5,0.495,27,38,0.7105263157894737
Alaa Abdelnaby,abdelal01,PF,22,POR,1991,43,290.0,135,12,27,62,89,4,12,22,39,55,116,0.4741379310344827,0,0,0.0,55,116,0.4741379310344827,0.474,25,44,0.5681818181818182
Mahmoud Abdul-Rauf,abdulma02,PG,21,DEN,1991,67,1505.0,942,206,34,87,121,55,4,110,149,417,1009,0.4132804757185332,24,100,0.24,393,909,0.4323432343234323,0.425,84,98,0.8571428571428571
Mark Acres,acresma01,C,28,ORL,1991,68,1313.0,285,25,140,219,359,25,25,42,218,109,214,0.5093457943925234,1,3,0.3333333333333333,108,211,0.5118483412322274,0.512,66,101,0.6534653465346535
Michael Adams,adamsmi01,PG,28,DEN,1991,66,2346.0,1752,693,58,198,256,147,6,240,162,560,1421,0.3940886699507389,167,564,0.2960992907801418,393,857,0.4585764294049008,0.453,465,529,0.8790170132325141
Mark Aguirre,aguirma01,SF,31,DET,1991,78,2006.0,1104,139,134,240,374,47,20,128,209,420,909,0.462046204620462,24,78,0.3076923076923077,396,831,0.4765342960288808,0.475,240,317,0.7570977917981072
Danny Ainge,aingeda01,SG,31,POR,1991,80,1710.0,890,285,45,160,205,63,13,100,195,337,714,0.4719887955182072,102,251,0.4063745019920319,235,463,0.5075593952483801,0.543,114,138,0.8260869565217391
Mark Alarie,alarima01,PF,27,WSB,1991,42,587.0,244,45,41,76,117,15,8,40,88,99,225,0.44,5,21,0.238095238095238,94,204,0.4607843137254901,0.451,41,48,0.8541666666666666
Steve Alford,alforst01,PG,26,DAL,1991,34,236.0,151,22,10,14,24,8,1,16,11,59,117,0.5042735042735043,7,23,0.3043478260869565,52,94,0.5531914893617021,0.534,26,31,0.8387096774193549
Greg Anderson,andergr01,PF,26,TOT,1991,68,924.0,292,16,97,221,318,35,45,84,140,116,270,0.4296296296296296,0,1,0.0,116,269,0.4312267657992565,0.43,60,115,0.5217391304347826
Nick Anderson,anderni01,SG,23,ORL,1991,70,1971.0,990,106,92,294,386,74,44,113,145,400,857,0.4667444574095682,17,58,0.293103448275862,383,799,0.4793491864831039,0.477,173,259,0.667953667953668
Ron Anderson,anderro01,SF,32,PHI,1991,82,2340.0,1198,115,103,264,367,65,13,100,163,512,1055,0.4853080568720379,9,43,0.2093023255813953,503,1012,0.4970355731225296,0.49,165,198,0.8333333333333334
Willie Anderson,anderwi01,SG,24,SAS,1991,75,2592.0,1083,358,68,283,351,79,46,167,226,453,991,0.4571140262361251,7,35,0.2,446,956,0.4665271966527197,0.461,170,213,0.7981220657276995
Michael Ansley,anslemi01,SF,23,ORL,1991,67,877.0,379,25,122,131,253,27,7,32,125,144,263,0.5475285171102662,0,0,0.0,144,263,0.5475285171102662,0.548,91,127,0.7165354330708661
B.J. Armstrong,armstbj01,PG,23,CHI,1991,82,1731.0,720,301,25,124,149,70,4,107,118,304,632,0.4810126582278481,15,30,0.5,289,602,0.4800664451827242,0.493,97,111,0.8738738738738738
Vincent Askew,askewvi01,SG,24,GSW,1991,7,85.0,33,13,7,4,11,2,0,6,21,12,25,0.48,0,0,0.0,12,25,0.48,0.48,9,11,0.8181818181818182
Keith Askins,askinke01,SF,23,MIA,1991,39,266.0,86,19,30,38,68,16,13,11,46,34,81,0.419753086419753,6,25,0.24,28,56,0.5,0.457,12,25,0.48
Miloš Babić,babicmi01,PF,22,CLE,1991,12,52.0,19,4,6,3,9,1,1,5,7,6,19,0.3157894736842105,0,0,0.0,6,19,0.3157894736842105,0.316,7,12,0.5833333333333334
Thurl Bailey,baileth01,PF,29,UTA,1991,82,2486.0,1017,124,101,306,407,53,91,130,160,399,872,0.4575688073394495,0,3,0.0,399,869,0.4591484464902186,0.458,219,271,0.8081180811808119
Cedric Ball,ballce01,PF,22,LAC,1991,7,26.0,8,0,5,6,11,0,2,2,5,3,8,0.375,0,0,0.0,3,8,0.375,0.375,2,2,1.0
Ken Bannister,bannike01,PF,30,LAC,1991,47,339.0,111,9,34,62,96,5,7,25,73,43,81,0.5308641975308642,0,1,0.0,43,80,0.5375,0.531,25,65,0.3846153846153846
Charles Barkley,barklch01,SF,27,PHI,1991,67,2498.0,1849,284,258,422,680,110,33,210,173,665,1167,0.5698371893744645,44,155,0.2838709677419355,621,1012,0.6136363636363636,0.589,475,658,0.7218844984802432
Dana Barros,barroda01,PG,23,SEA,1991,66,750.0,418,111,17,54,71,23,1,54,40,154,311,0.495176848874598,32,81,0.3950617283950617,122,230,0.5304347826086957,0.547,78,85,0.9176470588235294
John Battle,battljo01,SG,28,ATL,1991,79,1863.0,1078,217,34,125,159,45,6,113,145,397,862,0.4605568445475638,14,49,0.2857142857142857,383,813,0.4710947109471095,0.469,270,316,0.8544303797468354
Kenny Battle,battlke01,SG,26,TOT,1991,56,945.0,339,62,83,93,176,60,18,53,108,133,282,0.4716312056737589,3,24,0.125,130,258,0.5038759689922481,0.477,70,93,0.7526881720430108
William Bedford,bedfowi01,C,27,DET,1991,60,562.0,272,32,55,76,131,2,36,32,76,106,242,0.4380165289256198,5,13,0.3846153846153846,101,229,0.4410480349344978,0.448,55,78,0.7051282051282052
Benoit Benjamin,benjabe01,C,26,TOT,1991,70,2236.0,982,119,157,566,723,54,145,235,184,386,778,0.4961439588688946,0,0,0.0,386,778,0.4961439588688946,0.496,210,295,0.711864406779661
Winston Bennett,bennewi01,SF,25,CLE,1991,27,334.0,115,28,30,34,64,8,2,20,50,40,107,0.3738317757009345,0,0,0.0,40,107,0.3738317757009345,0.374,35,47,0.7446808510638298
Larry Bird,birdla01,SF,34,BOS,1991,60,2277.0,1164,431,53,456,509,108,58,187,118,462,1017,0.4542772861356932,77,198,0.3888888888888889,385,819,0.4700854700854701,0.492,163,183,0.8907103825136612
Rolando Blackman,blackro01,SG,31,DAL,1991,80,2965.0,1590,301,63,193,256,69,19,159,153,634,1316,0.4817629179331307,40,114,0.3508771929824561,594,1202,0.4941763727121464,0.497,282,326,0.8650306748466258
Lance Blanks,blankla01,SG,24,DET,1991,38,214.0,64,26,4,16,20,9,2,18,35,26,61,0.4262295081967213,2,16,0.125,24,45,0.5333333333333333,0.443,10,14,0.7142857142857143
Mookie Blaylock,blaylmo01,PG,23,NJN,1991,72,2585.0,1017,441,67,182,249,169,40,207,180,432,1039,0.4157844080846968,14,91,0.1538461538461538,418,948,0.4409282700421941,0.423,139,176,0.7897727272727273
Muggsy Bogues,boguemu01,PG,26,CHH,1991,81,2299.0,568,669,58,158,216,137,3,120,160,241,524,0.4599236641221374,0,12,0.0,241,512,0.470703125,0.46,86,108,0.7962962962962963
Manute Bol,bolma01,C,28,PHI,1991,82,1522.0,155,20,66,284,350,16,247,63,184,65,164,0.3963414634146341,1,14,0.0714285714285714,64,150,0.4266666666666667,0.399,24,41,0.5853658536585366
Anthony Bonner,bonnean01,PF,22,SAC,1991,34,750.0,250,49,59,102,161,39,5,41,62,103,230,0.4478260869565217,0,0,0.0,103,230,0.4478260869565217,0.448,44,76,0.5789473684210527
Sam Bowie,bowiesa01,C,29,NJN,1991,62,1916.0,801,147,176,304,480,43,90,141,175,314,723,0.4343015214384509,4,22,0.1818181818181818,310,701,0.442225392296719,0.437,169,231,0.7316017316017316
Randy Breuer,breuera01,C,30,MIN,1991,73,1505.0,429,73,114,231,345,35,80,69,132,197,435,0.4528735632183908,0,0,0.0,197,435,0.4528735632183908,0.453,35,79,0.4430379746835443
Frank Brickowski,brickfr01,PF,31,MIL,1991,75,1912.0,942,131,129,297,426,86,43,160,255,372,706,0.5269121813031161,0,2,0.0,372,704,0.5284090909090909,0.527,198,248,0.7983870967741935
Scott Brooks,brooksc01,PG,25,MIN,1991,80,980.0,424,204,28,44,72,53,5,51,122,159,370,0.4297297297297297,45,135,0.3333333333333333,114,235,0.4851063829787234,0.491,61,72,0.8472222222222222
Chucky Brown,brownch01,SF,22,CLE,1991,74,1485.0,627,80,78,135,213,26,24,94,130,263,502,0.5239043824701195,0,4,0.0,263,498,0.5281124497991968,0.524,101,144,0.7013888888888888
Dee Brown,brownde01,PG,22,BOS,1991,82,1945.0,712,344,41,141,182,83,14,137,161,284,612,0.4640522875816993,7,34,0.2058823529411764,277,578,0.4792387543252595,0.47,137,157,0.8726114649681529
Mike Brown,brownmi01,C,27,UTA,1991,82,1391.0,390,49,109,228,337,29,24,82,166,129,284,0.454225352112676,0,0,0.0,129,284,0.454225352112676,0.454,132,178,0.7415730337078652
Tony Brown,brownto01,SG-SF,30,TOT,1991,30,294.0,83,16,24,19,43,4,0,16,47,30,80,0.375,3,12,0.25,27,68,0.3970588235294117,0.394,20,23,0.8695652173913043
Mark Bryant,bryanma01,PF,25,POR,1991,53,781.0,272,27,65,125,190,15,12,33,120,99,203,0.4876847290640394,0,1,0.0,99,202,0.4900990099009901,0.488,74,101,0.7326732673267327
Jud Buechler,buechju01,SF,22,NJN,1991,74,859.0,232,51,61,80,141,33,15,26,79,94,226,0.415929203539823,1,4,0.25,93,222,0.4189189189189189,0.418,43,66,0.6515151515151515
Matt Bullard,bullama01,PF,23,HOU,1991,18,63.0,39,2,6,8,14,3,0,3,10,14,31,0.4516129032258064,0,3,0.0,14,28,0.5,0.452,11,17,0.6470588235294118
Willie Burton,burtowi01,SF,22,MIA,1991,76,1928.0,915,107,111,151,262,72,24,144,275,341,773,0.4411384217335058,4,30,0.1333333333333333,337,743,0.4535666218034993,0.444,229,293,0.7815699658703071
Greg Butler,butlegr01,C,24,LAC,1991,9,37.0,14,1,8,8,16,0,0,4,9,5,19,0.2631578947368421,0,0,0.0,5,19,0.2631578947368421,0.263,4,6,0.6666666666666666
Michael Cage,cagemi01,C,29,SEA,1991,82,2141.0,522,89,177,381,558,85,58,83,194,226,445,0.5078651685393258,0,3,0.0,226,442,0.5113122171945701,0.508,70,112,0.625
Adrian Caldwell,caldwad01,PF,24,HOU,1991,42,343.0,77,8,43,57,100,19,10,30,35,35,83,0.4216867469879518,0,1,0.0,35,82,0.4268292682926829,0.422,7,17,0.4117647058823529
Rick Calloway,callori01,SG,24,SAC,1991,64,678.0,205,61,25,53,78,22,7,51,98,75,192,0.390625,0,2,0.0,75,190,0.3947368421052631,0.391,55,79,0.6962025316455697
Elden Campbell,campbel01,PF,22,LAL,1991,52,380.0,144,10,40,56,96,11,38,16,71,56,123,0.4552845528455284,0,0,0.0,56,123,0.4552845528455284,0.455,32,49,0.6530612244897959
Tony Campbell,campbto01,SG,28,MIN,1991,77,2893.0,1678,214,161,185,346,121,48,190,204,652,1502,0.4340878828229028,16,61,0.2622950819672131,636,1441,0.4413601665510062,0.439,358,446,0.8026905829596412
Antoine Carr,carran01,PF,29,SAC,1991,77,2527.0,1551,191,163,257,420,45,101,171,315,628,1228,0.511400651465798,0,3,0.0,628,1225,0.5126530612244898,0.511,295,389,0.7583547557840618
Joe Barry Carroll,carrojo01,C,32,PHO,1991,11,96.0,37,11,3,21,24,1,8,12,18,13,36,0.3611111111111111,0,0,0.0,13,36,0.3611111111111111,0.361,11,12,0.9166666666666666
Bill Cartwright,cartwbi01,C,33,CHI,1991,79,2273.0,760,126,167,319,486,32,15,113,167,318,649,0.4899845916795069,0,0,0.0,318,649,0.4899845916795069,0.49,124,178,0.6966292134831461
Terry Catledge,catlete01,PF,27,ORL,1991,51,1459.0,745,58,168,187,355,34,9,107,113,292,632,0.4620253164556962,0,5,0.0,292,627,0.4657097288676236,0.462,161,258,0.624031007751938
Duane Causwell,causwdu01,C,22,SAC,1991,76,1719.0,525,69,141,250,391,49,148,96,225,210,413,0.5084745762711864,0,0,0.0,210,413,0.5084745762711864,0.508,105,165,0.6363636363636364
Cedric Ceballos,cebalce01,SF,21,PHO,1991,63,730.0,519,35,77,73,150,22,5,69,70,204,419,0.4868735083532219,1,6,0.1666666666666666,203,413,0.4915254237288136,0.488,110,166,0.6626506024096386
Tom Chambers,chambto01,PF,31,PHO,1991,76,2475.0,1511,194,104,386,490,65,52,177,235,556,1271,0.4374508261211644,20,73,0.273972602739726,536,1198,0.4474123539232053,0.445,379,459,0.8257080610021786
Rex Chapman,chapmre01,PG,23,CHH,1991,70,2100.0,1102,250,45,146,191,73,16,131,167,410,922,0.4446854663774403,48,148,0.3243243243243243,362,774,0.4677002583979328,0.471,234,282,0.8297872340425532
Maurice Cheeks,cheekma01,PG,34,NYK,1991,76,2147.0,592,435,22,151,173,128,10,108,138,241,483,0.4989648033126294,5,20,0.25,236,463,0.509719222462203,0.504,105,129,0.813953488372093
Derrick Chievous,chievde01,SF,23,CLE,1991,18,110.0,43,2,11,7,18,3,1,6,16,17,46,0.3695652173913043,0,0,0.0,17,46,0.3695652173913043,0.37,9,16,0.5625
Richard Coffey,cofferi01,SF,25,MIN,1991,52,320.0,68,3,42,37,79,6,4,5,45,28,75,0.3733333333333333,0,1,0.0,28,74,0.3783783783783784,0.373,12,22,0.5454545454545454
Derrick Coleman,colemde01,PF,23,NJN,1991,74,2602.0,1364,163,269,490,759,71,99,217,217,514,1100,0.4672727272727273,13,38,0.3421052631578947,501,1062,0.4717514124293785,0.473,323,442,0.7307692307692307
Bimbo Coles,colesbi01,PG,22,MIA,1991,82,1355.0,401,232,56,97,153,65,12,98,149,162,393,0.4122137404580153,6,34,0.1764705882352941,156,359,0.4345403899721448,0.42,71,95,0.7473684210526316
Steve Colter,coltest01,PG,28,SAC,1991,19,251.0,58,37,5,21,26,11,1,11,27,23,56,0.4107142857142857,5,14,0.3571428571428571,18,42,0.4285714285714285,0.455,7,10,0.7
Lester Conner,connele01,PG,31,TOT,1991,74,1008.0,260,165,21,91,112,85,2,58,75,96,207,0.463768115942029,0,5,0.0,96,202,0.4752475247524752,0.464,68,94,0.723404255319149
Anthony Cook,cookan01,PF,23,DEN,1991,58,1121.0,307,26,134,192,326,35,72,50,100,118,283,0.4169611307420495,0,3,0.0,118,280,0.4214285714285714,0.417,71,129,0.5503875968992248
Wayne Cooper,coopewa01,C,34,POR,1991,67,746.0,147,22,54,134,188,7,61,22,120,57,145,0.3931034482758621,0,1,0.0,57,144,0.3958333333333333,0.393,33,42,0.7857142857142857
Tyrone Corbin,corbity01,SF,28,MIN,1991,82,3196.0,1472,347,185,404,589,162,53,209,257,587,1311,0.4477498093058734,2,10,0.2,585,1301,0.4496541122213682,0.449,296,371,0.7978436657681941
Dave Corzine,corzida01,C,34,SEA,1991,28,147.0,47,4,10,23,33,5,5,2,18,17,38,0.4473684210526316,0,0,0.0,17,38,0.4473684210526316,0.447,13,22,0.5909090909090909
Pat Cummings,cummipa01,PF,34,UTA,1991,4,26.0,15,0,3,2,5,0,0,2,8,4,6,0.6666666666666666,0,0,0.0,4,6,0.6666666666666666,0.667,7,10,0.7
Terry Cummings,cummite01,PF,29,SAS,1991,67,2195.0,1177,157,194,327,521,61,30,131,225,503,1039,0.4841193455245428,7,33,0.2121212121212121,496,1006,0.4930417495029821,0.487,164,240,0.6833333333333333
Earl Cureton,curetea01,PF,33,CHH,1991,9,159.0,17,3,6,30,36,0,3,6,16,8,24,0.3333333333333333,0,1,0.0,8,23,0.3478260869565217,0.333,1,3,0.3333333333333333
Dell Curry,curryde01,SG,26,CHH,1991,76,1515.0,802,166,47,152,199,75,25,80,125,337,715,0.4713286713286713,32,86,0.3720930232558139,305,629,0.4848966613672496,0.494,96,114,0.8421052631578947
Quintin Dailey,dailequ01,SG,30,SEA,1991,30,299.0,184,16,11,21,32,7,1,19,25,73,155,0.4709677419354838,0,1,0.0,73,154,0.474025974025974,0.471,38,62,0.6129032258064516
Adrian Dantley,dantlad01,SF,35,MIL,1991,10,126.0,57,9,8,5,13,5,0,6,8,19,50,0.38,1,3,0.3333333333333333,18,47,0.3829787234042553,0.39,18,26,0.6923076923076923
Brad Daugherty,daughbr01,C,25,CLE,1991,76,2946.0,1645,253,177,653,830,74,46,211,191,605,1155,0.5238095238095238,0,3,0.0,605,1152,0.5251736111111112,0.524,435,579,0.7512953367875648
Brad Davis,davisbr01,PG,35,DAL,1991,80,1426.0,431,230,13,105,118,45,17,77,212,159,373,0.4262734584450402,22,85,0.2588235294117647,137,288,0.4756944444444444,0.456,91,118,0.7711864406779662
Terry Davis,daviste01,PF,23,MIA,1991,55,996.0,300,39,107,159,266,18,28,36,129,115,236,0.4872881355932203,1,2,0.5,114,234,0.4871794871794871,0.489,69,124,0.5564516129032258
Walter Davis,daviswa03,SG,36,TOT,1991,71,1483.0,924,125,71,110,181,80,3,88,150,403,862,0.4675174013921113,11,36,0.3055555555555556,392,826,0.4745762711864407,0.474,107,117,0.9145299145299144
Johnny Dawkins,dawkijo01,PG,27,PHI,1991,4,124.0,63,28,0,16,16,3,0,8,4,26,41,0.6341463414634146,1,4,0.25,25,37,0.6756756756756757,0.646,10,11,0.9090909090909092
Tony Dawson,dawsoto01,SF,23,SAC,1991,4,17.0,9,0,2,0,2,0,0,1,0,4,7,0.5714285714285714,1,1,1.0,3,6,0.5,0.643,0,0,0.0
Byron Dinkins,dinkiby01,PG,23,TOT,1991,12,149.0,36,19,0,12,12,2,0,13,15,14,34,0.4117647058823529,0,0,0.0,14,34,0.4117647058823529,0.412,8,9,0.8888888888888888
Vlade Divac,divacvl01,C,22,LAL,1991,82,2310.0,921,92,205,461,666,106,127,146,247,360,637,0.565149136577708,5,14,0.3571428571428571,355,623,0.5698234349919743,0.569,196,279,0.7025089605734767
James Donaldson,donalja01,C,33,DAL,1991,82,2800.0,819,69,201,526,727,34,93,146,181,327,615,0.5317073170731708,0,0,0.0,327,615,0.5317073170731708,0.532,165,229,0.7205240174672489
Sherman Douglas,douglsh01,PG,24,MIA,1991,73,2562.0,1352,624,78,131,209,121,5,270,178,532,1055,0.5042654028436019,4,31,0.1290322580645161,528,1024,0.515625,0.506,284,414,0.6859903381642513
Greg Dreiling,dreilgr01,C,28,IND,1991,73,1031.0,259,51,66,189,255,24,29,57,178,98,194,0.5051546391752577,0,2,0.0,98,192,0.5104166666666666,0.505,63,105,0.6
Larry Drew,drewla01,PG,32,LAL,1991,48,496.0,139,118,5,29,34,15,1,49,40,54,125,0.432,14,33,0.4242424242424242,40,92,0.4347826086956521,0.488,17,22,0.7727272727272727
Clyde Drexler,drexlcl01,SG,28,POR,1991,82,2852.0,1767,493,212,334,546,144,60,232,226,645,1338,0.4820627802690583,61,191,0.3193717277486911,584,1147,0.5091543156059285,0.505,416,524,0.7938931297709924
Kevin Duckworth,duckwke01,C,26,POR,1991,81,2511.0,1282,89,177,354,531,33,34,186,251,521,1084,0.4806273062730627,0,2,0.0,521,1082,0.4815157116451016,0.481,240,311,0.7717041800643086
Chris Dudley,dudlech02,C,25,NJN,1991,61,1560.0,434,37,229,282,511,39,153,80,217,170,417,0.407673860911271,0,0,0.0,170,417,0.407673860911271,0.408,94,176,0.5340909090909091
Joe Dumars,dumarjo01,SG,27,DET,1991,80,3046.0,1629,443,62,125,187,89,7,189,135,622,1292,0.4814241486068111,14,45,0.3111111111111111,608,1247,0.48757016840417,0.487,371,417,0.8896882494004796
T.R. Dunn,dunntr01,SG,35,DEN,1991,17,217.0,52,24,20,22,42,12,1,7,30,21,47,0.4468085106382978,1,4,0.25,20,43,0.4651162790697674,0.457,9,10,0.9
Ledell Eackles,eacklle01,SG,24,WSB,1991,67,1616.0,868,136,47,81,128,47,10,115,121,345,762,0.452755905511811,14,59,0.2372881355932203,331,703,0.4708392603129445,0.462,164,222,0.7387387387387387
Mark Eaton,eatonma01,C,34,UTA,1991,80,2580.0,409,51,182,485,667,39,188,99,298,169,292,0.5787671232876712,0,0,0.0,169,292,0.5787671232876712,0.579,71,112,0.6339285714285714
Blue Edwards,edwarbl01,SF,25,UTA,1991,62,1611.0,576,108,51,150,201,57,29,105,203,244,464,0.5258620689655172,6,24,0.25,238,440,0.5409090909090909,0.532,82,117,0.7008547008547008
James Edwards,edwarja01,C,35,DET,1991,72,1903.0,982,65,91,186,277,12,30,126,249,383,792,0.4835858585858585,1,2,0.5,382,790,0.4835443037974684,0.484,215,295,0.7288135593220338
Kevin Edwards,edwarke01,SG,25,MIA,1991,79,2000.0,955,240,80,125,205,129,46,163,151,380,927,0.4099244875943905,24,84,0.2857142857142857,356,843,0.4223013048635824,0.423,171,213,0.8028169014084507
Craig Ehlo,ehlocr01,SG,29,CLE,1991,82,2766.0,832,376,142,246,388,121,34,160,209,344,773,0.445019404915912,49,149,0.3288590604026846,295,624,0.4727564102564102,0.477,95,140,0.6785714285714286
Mario Elie,eliema01,SF-SG,27,TOT,1991,33,644.0,237,45,46,64,110,19,10,30,85,79,159,0.4968553459119497,4,10,0.4,75,149,0.5033557046979866,0.509,75,89,0.8426966292134831
Sean Elliott,elliose01,SF,22,SAS,1991,82,3044.0,1301,238,142,314,456,69,33,147,190,478,976,0.4897540983606557,20,64,0.3125,458,912,0.5021929824561403,0.5,325,402,0.8084577114427861
Dale Ellis,ellisda01,SG,30,TOT,1991,51,1424.0,857,95,66,107,173,49,8,81,112,340,718,0.4735376044568245,57,157,0.3630573248407643,283,561,0.5044563279857398,0.513,120,166,0.7228915662650602
Pervis Ellison,ellispe01,C,23,WSB,1991,76,1942.0,791,102,224,361,585,49,157,146,268,326,636,0.5125786163522013,0,6,0.0,326,630,0.5174603174603175,0.513,139,214,0.6495327102803738
A.J. English,engliaj01,SG,23,WSB,1991,70,1443.0,616,177,66,81,147,25,15,114,127,251,572,0.4388111888111888,3,31,0.0967741935483871,248,541,0.4584103512014787,0.441,111,157,0.7070063694267515
Alex English,englial01,SF,37,DAL,1991,79,1748.0,763,105,108,146,254,40,25,101,141,322,734,0.438692098092643,0,1,0.0,322,733,0.4392905866302865,0.439,119,140,0.85
Patrick Ewing,ewingpa01,C,28,NYK,1991,81,3104.0,2154,244,194,711,905,80,258,291,287,845,1645,0.513677811550152,0,6,0.0,845,1639,0.5155582672361196,0.514,464,623,0.7447833065810594
Jim Farmer,farmeji01,SG,26,TOT,1991,27,456.0,255,38,29,39,68,13,2,38,58,101,223,0.452914798206278,5,23,0.217391304347826,96,200,0.48,0.464,48,65,0.7384615384615385
Dave Feitl,feitlda01,C,28,HOU,1991,52,372.0,137,8,29,71,100,3,12,25,52,52,140,0.3714285714285714,0,3,0.0,52,137,0.3795620437956204,0.371,33,44,0.75
Duane Ferrell,ferredu01,SF,25,ATL,1991,78,1165.0,475,55,97,82,179,33,27,78,151,174,356,0.4887640449438202,2,3,0.6666666666666666,172,353,0.4872521246458923,0.492,125,156,0.8012820512820513
Danny Ferry,ferryda01,PF,24,CLE,1991,81,1661.0,697,142,99,187,286,43,25,120,230,275,643,0.4276827371695179,23,77,0.2987012987012987,252,566,0.4452296819787986,0.446,124,152,0.8157894736842105
Vern Fleming,flemive01,PG,28,IND,1991,69,1929.0,877,369,83,131,214,76,13,137,116,356,671,0.5305514157973175,4,18,0.2222222222222222,352,653,0.5390505359877489,0.534,161,221,0.7285067873303167
Sleepy Floyd,floydsl01,PG,30,HOU,1991,82,1850.0,1005,317,52,107,159,95,17,140,122,386,939,0.4110756123535676,48,176,0.2727272727272727,338,763,0.4429882044560944,0.437,185,246,0.7520325203252033
Greg Foster,fostegr01,PF,22,WSB,1991,54,606.0,236,37,52,99,151,12,22,45,112,97,211,0.4597156398104265,0,5,0.0,97,206,0.470873786407767,0.46,42,61,0.6885245901639344
Anthony Frederick,fredean01,SF,26,SAC,1991,35,475.0,177,44,36,48,84,22,13,40,50,67,168,0.3988095238095238,0,0,0.0,67,168,0.3988095238095238,0.399,43,60,0.7166666666666667
Corey Gaines,gaineco01,SG,25,DEN,1991,10,226.0,83,91,4,10,14,10,2,23,25,28,70,0.4,5,21,0.238095238095238,23,49,0.4693877551020408,0.436,22,26,0.8461538461538461
Kevin Gamble,gamblke01,SF,25,BOS,1991,82,2706.0,1281,256,85,182,267,100,34,148,237,548,933,0.587352625937835,0,7,0.0,548,926,0.591792656587473,0.587,185,227,0.8149779735682819
Winston Garland,garlawi01,PG,26,LAC,1991,69,1702.0,564,317,46,152,198,97,10,116,189,221,519,0.4258188824662813,4,26,0.1538461538461538,217,493,0.4401622718052738,0.43,118,157,0.7515923566878981
Tom Garrick,garrito01,SG,24,LAC,1991,67,949.0,260,223,40,87,127,62,2,66,101,100,236,0.423728813559322,0,22,0.0,100,214,0.4672897196261682,0.424,60,79,0.759493670886076
Kenny Gattison,gattike01,PF,26,CHH,1991,72,1552.0,650,44,136,243,379,48,67,102,211,243,457,0.5317286652078774,0,2,0.0,243,455,0.5340659340659341,0.532,164,248,0.6612903225806451
Tate George,georgta01,PG,22,NJN,1991,56,594.0,192,104,19,28,47,25,5,42,58,80,193,0.4145077720207253,0,2,0.0,80,191,0.418848167539267,0.415,32,40,0.8
Derrick Gervin,gervide01,PF,27,NJN,1991,56,743.0,425,30,40,70,110,19,19,45,88,164,394,0.416243654822335,7,28,0.25,157,366,0.4289617486338797,0.425,90,114,0.7894736842105263
Kendall Gill,gillke01,SG,22,CHH,1991,82,1944.0,906,303,105,158,263,104,39,163,186,376,836,0.4497607655502392,2,14,0.1428571428571428,374,822,0.4549878345498783,0.451,152,182,0.8351648351648352
Armen Gilliam,gilliar01,PF,26,TOT,1991,75,2644.0,1242,105,220,378,598,69,53,174,185,487,1001,0.4865134865134865,0,2,0.0,487,999,0.4874874874874875,0.487,268,329,0.8145896656534954
Gerald Glass,glassge01,SF,23,MIN,1991,51,606.0,352,42,54,48,102,28,9,41,76,149,340,0.438235294117647,2,17,0.1176470588235294,147,323,0.4551083591331269,0.441,52,76,0.6842105263157895
Mike Gminski,gminsmi01,C,31,TOT,1991,80,2196.0,844,93,186,396,582,40,56,85,99,357,808,0.4418316831683168,2,14,0.1428571428571428,355,794,0.4471032745591939,0.443,128,158,0.810126582278481
Dan Godfread,godfrda01,C,23,MIN,1991,10,20.0,13,0,0,2,2,1,4,0,5,5,12,0.4166666666666667,0,1,0.0,5,11,0.4545454545454545,0.417,3,4,0.75
Jim Grandholm,grandji01,PF,30,DAL,1991,26,168.0,79,8,20,30,50,2,8,11,33,30,58,0.5172413793103449,9,17,0.5294117647058824,21,41,0.5121951219512195,0.595,10,21,0.4761904761904761
Gary Grant,grantga01,PG,25,LAC,1991,68,2105.0,590,587,69,140,209,103,12,210,192,265,587,0.4514480408858603,9,39,0.2307692307692307,256,548,0.4671532846715328,0.459,51,74,0.6891891891891891
Greg Grant,grantgr01,PG,24,NYK,1991,22,107.0,26,20,1,9,10,9,0,10,12,10,27,0.3703703703703703,1,3,0.3333333333333333,9,24,0.375,0.389,5,6,0.8333333333333334
Harvey Grant,grantha01,PF,25,WSB,1991,77,2842.0,1405,204,179,378,557,91,61,125,232,609,1224,0.4975490196078431,2,15,0.1333333333333333,607,1209,0.5020678246484698,0.498,185,249,0.7429718875502008
Horace Grant,grantho01,PF,25,CHI,1991,78,2641.0,1000,178,266,393,659,95,69,92,203,401,733,0.5470668485675307,1,6,0.1666666666666666,400,727,0.5502063273727648,0.548,197,277,0.7111913357400722
Stuart Gray,grayst01,C,27,NYK,1991,8,37.0,11,0,2,8,10,0,1,2,6,4,12,0.3333333333333333,0,0,0.0,4,12,0.3333333333333333,0.333,3,3,1.0
Jeff Grayer,grayeje01,SG,25,MIL,1991,82,1422.0,521,123,111,135,246,48,9,86,98,210,485,0.4329896907216495,0,3,0.0,210,482,0.4356846473029045,0.433,101,147,0.6870748299319728
A.C. Green,greenac01,PF,27,LAL,1991,82,2164.0,750,71,201,315,516,59,23,99,117,258,542,0.4760147601476014,11,55,0.2,247,487,0.5071868583162218,0.486,223,302,0.7384105960264901
Rickey Green,greenri01,PG,36,PHI,1991,79,2248.0,793,413,33,104,137,57,6,108,130,334,722,0.4626038781163435,8,36,0.2222222222222222,326,686,0.4752186588921283,0.468,117,141,0.8297872340425532
Sidney Green,greensi02,PF,30,SAS,1991,66,1099.0,443,52,98,215,313,32,13,89,172,177,384,0.4609375,0,3,0.0,177,381,0.4645669291338583,0.461,89,105,0.8476190476190476
Dave Greenwood,greenda01,PF,33,SAS,1991,63,1018.0,239,52,61,160,221,29,25,71,172,85,169,0.5029585798816568,0,2,0.0,85,167,0.5089820359281437,0.503,69,94,0.7340425531914894
Darrell Griffith,griffda01,SG,32,UTA,1991,75,1005.0,430,37,17,73,90,42,7,48,100,174,445,0.3910112359550561,48,138,0.3478260869565217,126,307,0.4104234527687296,0.445,34,45,0.7555555555555555
Scott Haffner,haffnsc01,PG,24,CHH,1991,7,50.0,17,9,2,2,4,3,1,4,4,8,21,0.3809523809523809,0,2,0.0,8,19,0.4210526315789473,0.381,1,2,0.5
Jack Haley,haleyja01,PF,27,NJN,1991,78,1178.0,434,31,140,216,356,20,21,63,199,161,343,0.4693877551020408,0,0,0.0,161,343,0.4693877551020408,0.469,112,181,0.6187845303867403
Tom Hammonds,hammoto01,PF,23,WSB,1991,70,1023.0,367,43,58,148,206,15,7,54,108,155,336,0.4613095238095238,0,4,0.0,155,332,0.466867469879518,0.461,57,79,0.7215189873417721
Bob Hansen,hansebo01,SG,30,SAC,1991,36,811.0,229,90,33,63,96,20,5,34,72,96,256,0.375,19,69,0.2753623188405797,77,187,0.4117647058823529,0.412,18,36,0.5
Tim Hardaway,hardati01,PG,24,GSW,1991,82,3215.0,1881,793,87,245,332,214,12,270,228,739,1551,0.4764667956157318,97,252,0.3849206349206349,642,1299,0.4942263279445728,0.508,306,381,0.8031496062992126
Derek Harper,harpede01,PG,29,DAL,1991,77,2879.0,1519,548,59,174,233,147,14,177,222,572,1226,0.466557911908646,89,246,0.3617886178861789,483,980,0.4928571428571429,0.503,286,391,0.731457800511509
Ron Harper,harpero01,SG,27,LAC,1991,39,1383.0,763,209,58,130,188,66,35,129,111,285,729,0.3909465020576131,48,148,0.3243243243243243,237,581,0.4079173838209983,0.424,145,217,0.6682027649769585
Tony Harris,harrito01,SG,23,PHI,1991,6,41.0,10,0,0,1,1,1,0,3,5,4,16,0.25,0,2,0.0,4,14,0.2857142857142857,0.25,2,4,0.5
Scott Hastings,hastisc01,PF,30,DET,1991,27,113.0,48,7,14,14,28,0,0,7,23,16,28,0.5714285714285714,3,4,0.75,13,24,0.5416666666666666,0.625,13,13,1.0
Hersey Hawkins,hawkihe01,SG,24,PHI,1991,80,3110.0,1767,299,48,262,310,178,39,213,182,590,1251,0.4716227018385291,108,270,0.4,482,981,0.491335372069317,0.515,479,550,0.8709090909090909
Gerald Henderson,hendege01,PG,35,DET,1991,23,392.0,123,62,8,29,37,12,2,28,43,50,117,0.4273504273504273,7,21,0.3333333333333333,43,96,0.4479166666666667,0.457,16,21,0.7619047619047619
Steve Henson,hensost01,PG,22,MIL,1991,68,690.0,214,131,14,37,51,32,0,43,83,79,189,0.4179894179894179,18,54,0.3333333333333333,61,135,0.4518518518518518,0.466,38,42,0.9047619047619048
Mike Higgins,higgimi01,SF,23,SAC,1991,7,61.0,16,2,4,1,5,0,2,4,16,6,10,0.6,0,0,0.0,6,10,0.6,0.6,4,7,0.5714285714285714
Rod Higgins,higgiro01,SF,31,GSW,1991,82,2024.0,776,113,109,245,354,52,37,65,198,259,559,0.4633273703041144,73,220,0.3318181818181818,186,339,0.5486725663716814,0.529,185,226,0.8185840707964602
Sean Higgins,higgise01,SF,22,SAS,1991,50,464.0,225,35,18,45,63,8,1,49,53,97,212,0.4575471698113207,3,19,0.1578947368421052,94,193,0.4870466321243523,0.465,28,33,0.8484848484848485
Tyrone Hill,hillty01,PF,22,GSW,1991,74,1192.0,390,19,157,226,383,33,30,72,264,147,299,0.4916387959866221,0,0,0.0,147,299,0.4916387959866221,0.492,96,152,0.631578947368421
Roy Hinson,hinsoro01,PF,29,NJN,1991,9,91.0,41,4,6,13,19,0,3,6,14,20,39,0.5128205128205128,0,0,0.0,20,39,0.5128205128205128,0.513,1,3,0.3333333333333333
Craig Hodges,hodgecr01,SG,30,CHI,1991,73,843.0,362,97,10,32,42,34,2,35,74,146,344,0.4244186046511627,44,115,0.3826086956521739,102,229,0.445414847161572,0.488,26,27,0.9629629629629628
Dave Hoppen,hoppeda01,C,26,TOT,1991,30,155.0,64,3,18,21,39,3,1,13,29,24,44,0.5454545454545454,0,2,0.0,24,42,0.5714285714285714,0.545,16,22,0.7272727272727273
Dennis Hopson,hopsode01,SF,25,CHI,1991,61,728.0,264,65,49,60,109,25,14,59,79,104,244,0.4262295081967213,1,5,0.2,103,239,0.4309623430962343,0.428,55,83,0.6626506024096386
Jeff Hornacek,hornaje01,SG,27,PHO,1991,80,2733.0,1350,409,74,247,321,111,16,130,185,544,1051,0.5176022835394862,61,146,0.4178082191780822,483,905,0.5337016574585636,0.547,201,224,0.8973214285714286
Jay Humphries,humphja01,PG,28,MIL,1991,80,2726.0,1215,538,57,163,220,129,7,151,237,482,960,0.5020833333333333,60,161,0.3726708074534161,422,799,0.5281602002503129,0.533,191,239,0.799163179916318
Byron Irvin,irvinby01,SG,24,WSB,1991,33,316.0,171,24,24,21,45,15,2,16,32,60,129,0.4651162790697674,1,5,0.2,59,124,0.4758064516129032,0.469,50,61,0.819672131147541
Mark Jackson,jacksma01,PG,25,NYK,1991,72,1595.0,630,452,62,135,197,60,9,135,81,250,508,0.4921259842519685,13,51,0.2549019607843137,237,457,0.5185995623632386,0.505,117,160,0.73125
Dave Jamerson,jamerda01,SG,23,HOU,1991,37,202.0,113,27,9,21,30,6,1,20,24,43,113,0.3805309734513274,5,19,0.2631578947368421,38,94,0.4042553191489361,0.403,22,27,0.8148148148148148
Henry James,jameshe01,PF,25,CLE,1991,37,505.0,300,32,26,53,79,15,5,37,59,112,254,0.4409448818897638,24,60,0.4,88,194,0.4536082474226804,0.488,52,72,0.7222222222222222
Les Jepsen,jepsele01,C,23,GSW,1991,21,105.0,28,1,17,20,37,1,3,3,16,11,36,0.3055555555555556,0,1,0.0,11,35,0.3142857142857143,0.306,6,9,0.6666666666666666
Avery Johnson,johnsav01,PG,25,TOT,1991,68,959.0,320,230,22,55,77,47,4,74,62,130,277,0.4693140794223827,1,9,0.1111111111111111,129,268,0.4813432835820895,0.471,59,87,0.6781609195402298
Buck Johnson,johnsbu01,SF,27,HOU,1991,73,2279.0,991,142,108,222,330,81,47,122,240,416,873,0.4765177548682703,2,15,0.1333333333333333,414,858,0.4825174825174825,0.478,157,216,0.7268518518518519
Eddie Johnson,johnsed03,SG,31,TOT,1991,81,2085.0,1354,111,107,164,271,58,9,122,181,543,1122,0.4839572192513369,39,120,0.325,504,1002,0.5029940119760479,0.501,229,257,0.8910505836575876
Kevin Johnson,johnske02,PG,24,PHO,1991,77,2772.0,1710,781,54,217,271,163,11,269,174,591,1145,0.5161572052401747,9,44,0.2045454545454545,582,1101,0.5286103542234333,0.52,519,616,0.8425324675324676
Magic Johnson,johnsma02,PG,31,LAL,1991,79,2933.0,1531,989,105,446,551,102,17,314,150,466,976,0.4774590163934426,80,250,0.32,386,726,0.5316804407713499,0.518,519,573,0.9057591623036648
Steve Johnson,johnsst03,C,33,GSW,1991,24,228.0,90,17,18,39,57,4,4,25,50,34,63,0.5396825396825397,0,0,0.0,34,63,0.5396825396825397,0.54,22,37,0.5945945945945946
Vinnie Johnson,johnsvi01,SG,34,DET,1991,82,2390.0,958,271,110,170,280,75,15,118,166,406,936,0.4337606837606838,11,34,0.3235294117647059,395,902,0.4379157427937916,0.44,135,209,0.645933014354067
Charles Jones,jonesch01,C,33,WSB,1991,62,1499.0,163,48,119,240,359,51,124,46,199,67,124,0.5403225806451613,0,0,0.0,67,124,0.5403225806451613,0.54,29,50,0.58
Michael Jordan,jordami01,SG,27,CHI,1991,82,3034.0,2580,453,118,374,492,223,83,202,229,990,1837,0.5389221556886228,29,93,0.3118279569892473,961,1744,0.5510321100917431,0.547,571,671,0.8509687034277198
Shawn Kemp,kempsh01,PF,21,SEA,1991,81,2442.0,1214,144,267,412,679,77,123,202,319,462,909,0.5082508250825083,2,12,0.1666666666666666,460,897,0.5128205128205128,0.509,288,436,0.6605504587155964
Steve Kerr,kerrst01,PG,25,CLE,1991,57,905.0,271,131,5,32,37,29,4,40,52,99,223,0.4439461883408072,28,62,0.4516129032258064,71,161,0.4409937888198758,0.507,45,53,0.8490566037735849
Jerome Kersey,kerseje01,SF,28,POR,1991,73,2359.0,1084,227,169,312,481,101,76,149,251,424,887,0.4780157835400225,4,13,0.3076923076923077,420,874,0.4805491990846682,0.48,232,327,0.709480122324159
Alec Kessler,kesslal01,C,24,MIA,1991,78,1259.0,486,31,115,221,336,17,26,108,189,199,468,0.4252136752136752,0,4,0.0,199,464,0.4288793103448275,0.425,88,131,0.6717557251908397
Randolph Keys,keysra01,SF,24,CHH,1991,44,473.0,140,18,40,60,100,22,15,35,93,59,145,0.4068965517241379,3,14,0.2142857142857142,56,131,0.4274809160305343,0.417,19,33,0.5757575757575758
Bo Kimble,kimblbo01,SG,24,LAC,1991,62,1004.0,429,76,42,77,119,30,8,77,158,159,418,0.3803827751196172,19,65,0.2923076923076923,140,353,0.3966005665722379,0.403,92,119,0.773109243697479
Bernard King,kingbe01,SF,34,WSB,1991,64,2401.0,1817,292,114,205,319,56,16,255,187,713,1511,0.471872931833223,8,37,0.2162162162162162,705,1474,0.4782903663500678,0.475,383,485,0.7896907216494845
Stacey King,kingst01,PF,24,CHI,1991,76,1198.0,419,65,72,136,208,24,42,91,134,156,334,0.467065868263473,0,2,0.0,156,332,0.4698795180722891,0.467,107,152,0.7039473684210527
Greg Kite,kitegr01,C,29,ORL,1991,82,2225.0,395,59,189,399,588,25,81,102,298,166,338,0.4911242603550296,0,0,0.0,166,338,0.4911242603550296,0.491,63,123,0.5121951219512195
Joe Kleine,kleinjo01,C,29,BOS,1991,72,850.0,258,21,71,173,244,15,14,53,108,102,218,0.4678899082568807,0,2,0.0,102,216,0.4722222222222222,0.468,54,69,0.782608695652174
Negele Knight,knighne01,PG,23,PHO,1991,64,792.0,339,191,20,51,71,20,7,76,83,131,308,0.4253246753246753,6,25,0.24,125,283,0.4416961130742049,0.435,71,118,0.6016949152542372
Bart Kofoed,kofoeba01,SG,26,GSW,1991,5,21.0,3,4,2,1,3,0,0,2,4,0,3,0.0,0,0,0.0,0,3,0.0,0.0,3,6,0.5
Jon Koncak,koncajo01,C,27,ATL,1991,77,1931.0,313,124,101,274,375,74,76,50,265,140,321,0.4361370716510903,1,8,0.125,139,313,0.4440894568690096,0.438,32,54,0.5925925925925926
Frank Kornet,kornefr01,PF,24,MIL,1991,32,157.0,58,9,10,14,24,5,1,11,28,23,62,0.3709677419354839,5,18,0.2777777777777778,18,44,0.4090909090909091,0.411,7,13,0.5384615384615384
Bill Laimbeer,laimbbi01,C,33,DET,1991,82,2668.0,904,157,173,564,737,38,56,98,242,372,778,0.4781491002570694,37,125,0.296,335,653,0.5130168453292496,0.502,123,147,0.8367346938775511
Jerome Lane,laneje01,PF,24,DEN,1991,62,1383.0,463,123,280,298,578,51,14,105,192,202,461,0.4381778741865509,1,4,0.25,201,457,0.4398249452954048,0.439,58,141,0.4113475177304964
Andrew Lang,langan01,C,24,PHO,1991,63,1152.0,311,27,113,190,303,17,127,45,168,109,189,0.5767195767195767,0,1,0.0,109,188,0.5797872340425532,0.577,93,130,0.7153846153846154
Eric Leckner,leckner01,C,24,TOT,1991,72,1122.0,324,39,82,213,295,14,22,69,192,131,294,0.445578231292517,0,0,0.0,131,294,0.445578231292517,0.446,62,111,0.5585585585585585
Kurk Lee,leeku01,PG,23,NJN,1991,48,265.0,66,34,7,23,30,11,2,20,39,19,71,0.2676056338028169,3,15,0.2,16,56,0.2857142857142857,0.289,25,28,0.8928571428571429
Tim Legler,legleti01,SG,24,DEN,1991,10,148.0,58,12,8,10,18,2,0,4,20,25,72,0.3472222222222222,3,12,0.25,22,60,0.3666666666666666,0.368,5,6,0.8333333333333334
Gary Leonard,leonaga01,C,23,ATL,1991,4,9.0,2,0,0,2,2,0,1,0,2,0,0,0.0,0,0,0.0,0,0,0.0,0.0,2,4,0.5
Jim Les,lesji01,PG,27,SAC,1991,55,1399.0,395,299,18,93,111,57,4,75,141,119,268,0.4440298507462686,71,154,0.461038961038961,48,114,0.4210526315789473,0.576,86,103,0.8349514563106796
Clifford Lett,lettcl01,PG,25,SAS,1991,7,99.0,34,7,1,6,7,2,1,8,9,14,29,0.4827586206896552,0,1,0.0,14,28,0.5,0.483,6,9,0.6666666666666666
Fat Lever,leverfa01,SG,30,DAL,1991,4,86.0,29,12,3,12,15,6,3,10,5,9,23,0.391304347826087,0,3,0.0,9,20,0.45,0.391,11,14,0.7857142857142857
Cliff Levingston,levincl01,PF,30,CHI,1991,78,1013.0,314,56,99,126,225,29,43,50,143,127,282,0.450354609929078,1,4,0.25,126,278,0.4532374100719424,0.452,59,91,0.6483516483516484
Reggie Lewis,lewisre01,SG,25,BOS,1991,79,2878.0,1478,201,119,291,410,98,85,147,234,598,1219,0.490566037735849,1,13,0.0769230769230769,597,1206,0.4950248756218905,0.491,281,340,0.8264705882352941
Marcus Liberty,liberma01,SF,22,DEN,1991,76,1171.0,507,64,117,104,221,48,19,71,153,216,513,0.4210526315789473,17,57,0.2982456140350877,199,456,0.4364035087719298,0.438,58,92,0.6304347826086957
Todd Lichti,lichtto01,SG,24,DEN,1991,29,860.0,405,72,49,63,112,46,8,33,65,166,378,0.4391534391534391,14,47,0.2978723404255319,152,331,0.459214501510574,0.458,59,69,0.855072463768116
Alton Lister,listeal01,C,32,GSW,1991,77,1552.0,491,93,121,362,483,20,90,106,282,188,393,0.4783715012722646,0,1,0.0,188,392,0.4795918367346938,0.478,115,202,0.5693069306930693
Ian Lockhart,lockhia01,SF,23,PHO,1991,1,2.0,4,0,0,0,0,0,0,0,0,1,1,1.0,0,0,0.0,1,1,1.0,1.0,2,2,1.0
Brad Lohaus,lohaubr01,PF,26,MIL,1991,81,1219.0,428,75,59,158,217,50,74,60,170,179,415,0.4313253012048192,33,119,0.2773109243697479,146,296,0.4932432432432432,0.471,37,54,0.6851851851851852
Grant Long,longgr01,PF,24,MIA,1991,80,2514.0,734,176,225,343,568,119,43,156,295,276,561,0.4919786096256685,1,6,0.1666666666666666,275,555,0.4954954954954955,0.493,181,230,0.7869565217391304
John Long,longjo01,SG,34,DET,1991,25,256.0,96,18,9,23,32,9,2,14,17,35,85,0.4117647058823529,2,6,0.3333333333333333,33,79,0.4177215189873418,0.424,24,25,0.96
Rick Mahorn,mahorri01,C,32,PHI,1991,80,2439.0,711,118,151,470,621,79,56,127,276,261,559,0.4669051878354204,0,9,0.0,261,550,0.4745454545454545,0.467,189,240,0.7875
Dan Majerle,majerda01,SF,25,PHO,1991,77,2281.0,1051,216,168,250,418,106,40,114,162,397,821,0.4835566382460414,30,86,0.3488372093023256,367,735,0.4993197278911565,0.502,227,298,0.761744966442953
Jeff Malone,malonje01,SG,29,UTA,1991,69,2466.0,1282,143,36,170,206,50,6,108,128,525,1034,0.5077369439071566,1,6,0.1666666666666666,524,1028,0.5097276264591439,0.508,231,252,0.9166666666666666
Karl Malone,malonka01,PF,27,UTA,1991,82,3302.0,2382,270,236,731,967,89,79,244,268,847,1608,0.5267412935323383,4,14,0.2857142857142857,843,1594,0.5288582183186951,0.528,684,888,0.7702702702702703
Moses Malone,malonmo01,C,35,ATL,1991,82,1912.0,869,68,271,396,667,30,74,137,134,280,598,0.4682274247491639,0,7,0.0,280,591,0.4737732656514382,0.468,309,372,0.8306451612903226
Danny Manning,mannida01,PF,24,LAC,1991,73,2197.0,1159,196,169,257,426,117,62,188,281,470,905,0.5193370165745856,0,3,0.0,470,902,0.5210643015521065,0.519,219,306,0.7156862745098039
Šarūnas Marčiulionis,marcisa01,SG,26,GSW,1991,50,987.0,545,85,51,67,118,62,4,75,136,183,365,0.5013698630136987,1,6,0.1666666666666666,182,359,0.5069637883008357,0.503,178,246,0.7235772357723578
Jeff Martin,martije01,PG,24,LAC,1991,74,1334.0,523,65,53,78,131,37,31,49,104,214,507,0.4220907297830374,27,88,0.3068181818181818,187,419,0.4463007159904534,0.449,68,100,0.68
Anthony Mason,masonan01,PF,24,DEN,1991,3,21.0,10,0,3,2,5,1,0,0,6,2,4,0.5,0,0,0.0,2,4,0.5,0.5,6,8,0.75
Tony Massenburg,masseto01,PF,23,SAS,1991,35,161.0,82,4,23,35,58,4,9,13,26,27,60,0.45,0,0,0.0,27,60,0.45,0.45,28,45,0.6222222222222222
Vernon Maxwell,maxweve01,SG,25,HOU,1991,82,2870.0,1397,303,41,197,238,127,15,171,179,504,1247,0.4041700080192462,172,510,0.3372549019607843,332,737,0.4504748982360922,0.473,217,296,0.7331081081081081
Travis Mays,maystr01,PG,22,SAC,1991,64,2145.0,915,253,54,124,178,81,11,159,169,294,724,0.4060773480662983,72,197,0.365482233502538,222,527,0.4212523719165085,0.456,255,331,0.770392749244713
George McCloud,mccloge01,SF,23,IND,1991,74,1070.0,343,150,35,83,118,40,11,91,141,131,351,0.3732193732193732,43,124,0.3467741935483871,88,227,0.3876651982378855,0.434,38,49,0.7755102040816326
Tim McCormick,mccorti01,C,28,ATL,1991,56,689.0,252,32,56,109,165,11,14,45,91,93,187,0.4973262032085561,0,3,0.0,93,184,0.5054347826086957,0.497,66,90,0.7333333333333333
Rodney McCray,mccraro01,PF,29,DAL,1991,74,2561.0,844,259,153,407,560,70,51,129,203,336,679,0.4948453608247423,13,39,0.3333333333333333,323,640,0.5046875,0.504,159,198,0.803030303030303
Xavier McDaniel,mcdanxa01,SF,27,TOT,1991,81,2634.0,1373,187,173,384,557,76,46,184,264,590,1186,0.4974704890387858,0,8,0.0,590,1178,0.5008488964346349,0.497,193,267,0.7228464419475655
Kevin McHale,mchalke01,PF,33,BOS,1991,68,2067.0,1251,126,145,335,480,25,146,140,194,504,912,0.5526315789473685,15,37,0.4054054054054054,489,875,0.5588571428571428,0.561,228,275,0.8290909090909091
Derrick McKey,mckeyde01,SF,24,SEA,1991,73,2503.0,1115,169,172,251,423,91,56,158,220,438,847,0.5171192443919717,4,19,0.2105263157894736,434,828,0.5241545893719807,0.519,235,278,0.8453237410071942
Nate McMillan,mcmilna01,SG,26,SEA,1991,78,1434.0,338,371,71,180,251,104,20,122,211,132,305,0.4327868852459016,17,48,0.3541666666666667,115,257,0.4474708171206226,0.461,57,93,0.6129032258064516
Mark McNamara,mcnamma01,C,31,ORL,1991,2,13.0,0,0,0,4,4,0,0,0,1,0,1,0.0,0,0,0.0,0,1,0.0,0.0,0,0,0.0
Scott Meents,meentsc01,PF,27,SEA,1991,13,53.0,17,8,3,7,10,7,4,6,5,7,28,0.25,1,1,1.0,6,27,0.2222222222222222,0.268,2,4,0.5
Reggie Miller,millere01,SG,25,IND,1991,82,2972.0,1855,331,81,200,281,109,13,163,165,596,1164,0.5120274914089347,112,322,0.3478260869565217,484,842,0.5748218527315915,0.56,551,600,0.9183333333333332
Terry Mills,millste01,PF,23,TOT,1991,55,819.0,315,33,82,147,229,35,29,43,100,134,288,0.4652777777777778,0,4,0.0,134,284,0.4718309859154929,0.465,47,66,0.7121212121212122
Sam Mitchell,mitchsa01,PF,27,MIN,1991,82,3121.0,1197,133,188,332,520,66,57,104,338,445,1010,0.4405940594059406,0,9,0.0,445,1001,0.4445554445554445,0.441,307,396,0.7752525252525253
Paul Mokeski,mokespa01,C,34,GSW,1991,36,257.0,57,9,20,47,67,8,3,7,58,21,59,0.3559322033898305,3,9,0.3333333333333333,18,50,0.36,0.381,12,15,0.8
Sidney Moncrief,moncrsi01,SG,33,ATL,1991,72,1096.0,337,104,31,97,128,50,9,66,112,117,240,0.4875,21,64,0.328125,96,176,0.5454545454545454,0.531,82,105,0.780952380952381
Chris Morris,morrich01,SF,25,NJN,1991,79,2553.0,1042,220,210,311,521,138,96,167,248,409,962,0.4251559251559251,45,179,0.2513966480446927,364,783,0.4648786717752235,0.449,179,244,0.7336065573770492
John Morton,mortojo01,SF,23,CLE,1991,66,1207.0,357,243,41,62,103,61,18,107,112,120,274,0.437956204379562,4,12,0.3333333333333333,116,262,0.4427480916030534,0.445,113,139,0.8129496402877698
Chris Mullin,mullich01,SF,27,GSW,1991,82,3315.0,2107,329,141,302,443,173,63,245,176,777,1449,0.5362318840579711,40,133,0.3007518796992481,737,1316,0.5600303951367781,0.55,513,580,0.8844827586206897
Chris Munk,munkch01,PF,23,UTA,1991,11,29.0,13,1,5,9,14,1,2,5,5,3,7,0.4285714285714285,0,0,0.0,3,7,0.4285714285714285,0.429,7,12,0.5833333333333334
Tod Murphy,murphto01,PF,27,MIN,1991,52,1063.0,251,60,92,163,255,25,20,32,101,90,227,0.3964757709251101,1,17,0.0588235294117647,89,210,0.4238095238095238,0.399,70,105,0.6666666666666666
Jerrod Mustaf,mustaje01,PF,21,NYK,1991,62,825.0,268,36,51,118,169,15,14,61,109,106,228,0.4649122807017544,0,1,0.0,106,227,0.4669603524229075,0.465,56,87,0.6436781609195402
Pete Myers,myerspe01,SG,27,SAS,1991,8,103.0,29,14,2,16,18,3,3,14,14,10,23,0.4347826086956521,0,1,0.0,10,22,0.4545454545454545,0.435,9,11,0.8181818181818182
Larry Nance,nancela01,PF,31,CLE,1991,80,2927.0,1537,237,201,485,686,66,200,131,219,635,1211,0.5243600330305532,2,8,0.25,633,1203,0.5261845386533666,0.525,265,330,0.803030303030303
Craig Neal,nealcr01,PG,26,DEN,1991,10,125.0,44,37,2,14,16,4,0,19,26,14,35,0.4,3,9,0.3333333333333333,11,26,0.4230769230769231,0.443,13,22,0.5909090909090909
Ed Nealy,nealyed01,PF,30,PHO,1991,55,573.0,123,36,44,107,151,24,4,19,46,45,97,0.4639175257731959,5,16,0.3125,40,81,0.4938271604938271,0.49,28,38,0.7368421052631579
Johnny Newman,newmajo01,SF,27,CHH,1991,81,2477.0,1371,188,94,160,254,100,17,189,278,478,1017,0.4700098328416912,30,84,0.3571428571428571,448,933,0.480171489817792,0.485,385,476,0.8088235294117647
Ken Norman,normake01,SF,26,LAC,1991,70,2309.0,1219,159,177,320,497,63,63,139,192,520,1037,0.5014464802314368,6,32,0.1875,514,1005,0.5114427860696518,0.504,173,275,0.6290909090909091
Dan O'Sullivan,osullda01,C,22,UTA,1991,21,85.0,21,4,5,12,17,1,1,4,18,7,16,0.4375,0,0,0.0,7,16,0.4375,0.438,7,11,0.6363636363636364
Charles Oakley,oaklech01,PF,27,NYK,1991,76,2739.0,853,204,305,615,920,62,17,215,288,307,595,0.5159663865546219,0,2,0.0,307,593,0.5177065767284992,0.516,239,305,0.7836065573770492
Alan Ogg,oggal01,C,23,MIA,1991,31,261.0,54,2,15,34,49,6,27,8,53,24,55,0.4363636363636363,0,2,0.0,24,53,0.4528301886792453,0.436,6,10,0.6
Hakeem Olajuwon,olajuha01,C,28,HOU,1991,56,2062.0,1187,131,219,551,770,121,221,174,221,487,959,0.5078206465067779,0,4,0.0,487,955,0.5099476439790576,0.508,213,277,0.7689530685920578
Jawann Oldham,oldhaja01,C,33,IND,1991,4,19.0,6,0,0,3,3,0,0,0,1,3,6,0.5,0,0,0.0,3,6,0.5,0.5,0,0,0.0
Brian Oliver,olivebr01,SG,22,PHI,1991,73,800.0,279,88,18,62,80,34,4,50,76,111,272,0.4080882352941176,5,18,0.2777777777777778,106,254,0.4173228346456692,0.417,52,71,0.7323943661971831
Gerald Paddio,paddige01,SF,25,CLE,1991,70,1181.0,504,90,38,80,118,20,6,71,71,212,506,0.4189723320158103,6,24,0.25,206,482,0.4273858921161825,0.425,74,93,0.7956989247311828
Walter Palmer,palmewa01,C,22,UTA,1991,28,85.0,40,6,6,15,21,3,4,6,20,15,45,0.3333333333333333,0,1,0.0,15,44,0.3409090909090909,0.333,10,15,0.6666666666666666
Robert Parish,parisro01,C,37,BOS,1991,81,2441.0,1207,66,271,585,856,66,103,153,197,485,811,0.5980271270036991,0,1,0.0,485,810,0.5987654320987654,0.598,237,309,0.7669902912621359
John Paxson,paxsojo01,PG,30,CHI,1991,82,1971.0,710,297,15,76,91,62,3,69,136,317,578,0.5484429065743944,42,96,0.4375,275,482,0.5705394190871369,0.585,34,41,0.8292682926829268
Kenny Payne,payneke01,SF,24,PHI,1991,47,444.0,166,16,17,49,66,10,6,21,43,68,189,0.3597883597883597,4,18,0.2222222222222222,64,171,0.3742690058479532,0.37,26,29,0.896551724137931
Gary Payton,paytoga01,PG,22,SEA,1991,82,2244.0,588,528,108,135,243,165,15,180,249,259,575,0.4504347826086956,1,13,0.0769230769230769,258,562,0.4590747330960854,0.451,69,97,0.711340206185567
Will Perdue,perduwi01,C,25,CHI,1991,74,972.0,307,47,122,214,336,23,57,75,147,116,235,0.4936170212765957,0,3,0.0,116,232,0.5,0.494,75,112,0.6696428571428571
Sam Perkins,perkisa01,PF,29,LAL,1991,73,2504.0,983,108,167,371,538,64,78,103,247,368,744,0.4946236559139785,18,64,0.28125,350,680,0.5147058823529411,0.507,229,279,0.8207885304659498
Tim Perry,perryti01,C,25,PHO,1991,46,587.0,193,27,53,73,126,23,43,32,60,75,144,0.5208333333333334,0,5,0.0,75,139,0.539568345323741,0.521,43,70,0.6142857142857143
Chuck Person,persoch01,SF,26,IND,1991,80,2566.0,1474,238,121,296,417,56,17,184,221,620,1231,0.503655564581641,69,203,0.3399014778325123,551,1028,0.5359922178988327,0.532,165,229,0.7205240174672489
Jim Petersen,peterji01,C,28,GSW,1991,62,834.0,279,27,69,131,200,13,41,48,153,114,236,0.4830508474576271,1,4,0.25,113,232,0.4870689655172414,0.485,50,76,0.6578947368421053
Dražen Petrović,petrodr01,SG,26,TOT,1991,61,1015.0,623,86,51,59,110,43,1,81,132,243,493,0.4929006085192697,23,65,0.3538461538461538,220,428,0.514018691588785,0.516,114,137,0.8321167883211679
Ricky Pierce,piercri01,SG,31,TOT,1991,78,2167.0,1598,168,67,124,191,60,13,147,170,561,1156,0.4852941176470588,46,116,0.396551724137931,515,1040,0.4951923076923077,0.505,430,471,0.9129511677282378
Ed Pinckney,pincked01,PF,27,BOS,1991,70,1165.0,366,45,155,186,341,61,43,45,147,131,243,0.5390946502057613,0,1,0.0,131,242,0.5413223140495868,0.539,104,116,0.896551724137931
Scottie Pippen,pippesc01,SF,25,CHI,1991,82,3014.0,1461,511,163,432,595,193,93,232,270,600,1153,0.5203816131830009,21,68,0.3088235294117647,579,1085,0.5336405529953917,0.529,240,340,0.7058823529411765
Olden Polynice,polynol01,C,26,TOT,1991,79,2092.0,778,42,220,333,553,43,32,88,192,316,564,0.5602836879432624,0,1,0.0,316,563,0.5612788632326821,0.56,146,252,0.5793650793650794
Dave Popson,popsoda01,PF,26,BOS,1991,19,64.0,35,2,7,7,14,1,2,6,12,13,32,0.40625,0,0,0.0,13,32,0.40625,0.406,9,10,0.9
Terry Porter,portete01,PG,27,POR,1991,81,2665.0,1381,649,52,230,282,158,12,189,151,486,944,0.5148305084745762,130,313,0.4153354632587859,356,631,0.5641838351822503,0.584,279,339,0.8230088495575221
Paul Pressey,presspa01,SG,32,SAS,1991,70,1683.0,528,271,50,126,176,63,32,130,174,201,426,0.4718309859154929,16,57,0.2807017543859649,185,369,0.5013550135501355,0.491,110,133,0.8270676691729323
Mark Price,pricema01,PG,26,CLE,1991,16,571.0,271,166,8,37,45,42,2,56,23,97,195,0.4974358974358974,18,53,0.3396226415094339,79,142,0.5563380281690141,0.544,59,62,0.9516129032258064
Kevin Pritchard,pritcke01,PG,23,GSW,1991,62,773.0,243,81,16,49,65,30,8,59,104,88,229,0.3842794759825327,5,31,0.1612903225806451,83,198,0.4191919191919191,0.395,62,77,0.8051948051948052
Brian Quinnett,quinnbr01,SG,24,NYK,1991,68,1011.0,319,53,65,80,145,22,13,52,100,139,303,0.4587458745874587,15,43,0.3488372093023256,124,260,0.4769230769230769,0.483,26,36,0.7222222222222222
Kurt Rambis,rambiku01,PF,32,PHO,1991,62,900.0,226,64,77,189,266,25,11,45,107,83,167,0.497005988023952,0,2,0.0,83,165,0.503030303030303,0.497,60,85,0.7058823529411765
Blair Rasmussen,rasmubl01,C,28,DEN,1991,70,2325.0,875,70,170,508,678,52,132,81,307,405,885,0.4576271186440678,2,5,0.4,403,880,0.4579545454545454,0.459,63,93,0.6774193548387096
J.R. Reid,reidjr01,C,22,CHH,1991,80,2467.0,902,89,154,348,502,87,47,153,286,360,773,0.4657179818887451,0,2,0.0,360,771,0.4669260700389105,0.466,182,259,0.7027027027027027
Robert Reid,reidro01,SF,35,PHI,1991,3,37.0,4,4,2,7,9,1,3,3,3,2,14,0.1428571428571428,0,0,0.0,2,14,0.1428571428571428,0.143,0,0,0.0
Jerry Reynolds,reynoje01,SG,28,ORL,1991,80,1843.0,1034,203,88,211,299,95,56,172,123,344,793,0.4337957124842371,10,34,0.2941176470588235,334,759,0.4400527009222661,0.44,336,419,0.801909307875895
Glen Rice,ricegl01,SF,23,MIA,1991,77,2646.0,1342,189,85,296,381,101,26,166,216,550,1193,0.4610226320201173,71,184,0.3858695652173913,479,1009,0.4747274529236868,0.491,171,209,0.8181818181818182
Pooh Richardson,richapo01,PG,24,MIN,1991,82,3154.0,1401,734,82,204,286,131,13,174,114,635,1350,0.4703703703703704,42,128,0.328125,593,1222,0.4852700490998363,0.486,89,165,0.5393939393939394
Mitch Richmond,richmmi01,SG,25,GSW,1991,77,3027.0,1840,238,147,305,452,126,34,230,207,703,1424,0.4936797752808989,40,115,0.3478260869565217,663,1309,0.5064935064935064,0.508,394,465,0.8473118279569892
Doc Rivers,riverdo01,PG,29,ATL,1991,79,2586.0,1197,340,47,206,253,148,47,125,216,444,1020,0.4352941176470588,88,262,0.3358778625954198,356,758,0.4696569920844327,0.478,221,262,0.8435114503816794
Fred Roberts,roberfr01,PF,30,MIL,1991,82,2114.0,888,135,107,174,281,63,29,135,190,357,670,0.5328358208955224,4,25,0.16,353,645,0.5472868217054263,0.536,170,209,0.8133971291866029
Alvin Robertson,roberal01,SG,28,MIL,1991,81,2598.0,1098,444,191,268,459,246,16,212,273,438,904,0.4845132743362831,23,63,0.365079365079365,415,841,0.4934601664684899,0.497,199,263,0.7566539923954373
Clifford Robinson,robincl02,PF,24,POR,1991,82,1940.0,957,151,123,226,349,78,76,133,263,373,806,0.4627791563275434,6,19,0.3157894736842105,367,787,0.4663278271918678,0.467,205,314,0.6528662420382165
David Robinson,robinda01,C,25,SAS,1991,82,3095.0,2101,208,335,728,1063,127,320,270,264,754,1366,0.5519765739385066,1,7,0.1428571428571428,753,1359,0.5540838852097131,0.552,592,777,0.7619047619047619
Larry Robinson,robinla01,SG,23,TOT,1991,36,425.0,139,35,29,22,51,16,1,27,49,62,150,0.4133333333333333,0,1,0.0,62,149,0.4161073825503356,0.413,15,27,0.5555555555555556
Rumeal Robinson,robinru01,PG,24,ATL,1991,47,674.0,265,132,20,51,71,32,8,76,65,108,242,0.4462809917355372,2,11,0.1818181818181818,106,231,0.4588744588744589,0.45,47,80,0.5875
Dennis Rodman,rodmade01,SF,29,DET,1991,82,2747.0,669,85,361,665,1026,65,55,94,281,276,560,0.4928571428571429,6,30,0.2,270,530,0.5094339622641509,0.498,111,176,0.6306818181818182
Tree Rollins,rollitr01,C,35,DET,1991,37,202.0,36,4,13,29,42,2,20,15,35,14,33,0.4242424242424242,0,0,0.0,14,33,0.4242424242424242,0.424,8,14,0.5714285714285714
Delaney Rudd,ruddde01,PG,28,UTA,1991,82,874.0,324,216,14,52,66,36,2,102,92,124,285,0.4350877192982456,17,61,0.2786885245901639,107,224,0.4776785714285714,0.465,59,71,0.8309859154929577
John Salley,sallejo01,PF,26,DET,1991,74,1649.0,544,70,137,190,327,52,112,91,240,179,377,0.4748010610079575,0,1,0.0,179,376,0.476063829787234,0.475,186,256,0.7265625
Ralph Sampson,sampsra01,C,30,SAC,1991,25,348.0,74,17,41,70,111,11,17,27,54,34,93,0.3655913978494624,1,5,0.2,33,88,0.375,0.371,5,19,0.2631578947368421
Jeff Sanders,sandeje01,PF,25,CHH,1991,3,43.0,13,1,3,6,9,1,1,1,6,6,14,0.4285714285714285,0,0,0.0,6,14,0.4285714285714285,0.429,1,2,0.5
Mike Sanders,sandemi01,SF,30,IND,1991,80,1357.0,463,106,73,112,185,37,26,65,198,206,494,0.4170040485829959,4,20,0.2,202,474,0.4261603375527426,0.421,47,57,0.8245614035087719
Danny Schayes,schayda01,C,31,MIL,1991,82,2228.0,870,98,174,361,535,55,61,106,264,298,597,0.4991624790619765,0,5,0.0,298,592,0.5033783783783784,0.499,274,328,0.8353658536585366
Steve Scheffler,schefst01,C,23,CHH,1991,39,227.0,59,9,21,24,45,6,2,4,20,20,39,0.5128205128205128,0,0,0.0,20,39,0.5128205128205128,0.513,19,21,0.9047619047619048
Dwayne Schintzius,schindw01,C,22,SAS,1991,42,398.0,158,17,28,93,121,2,29,34,64,68,155,0.4387096774193548,0,2,0.0,68,153,0.4444444444444444,0.439,22,40,0.55
Detlef Schrempf,schrede01,PF,28,IND,1991,82,2632.0,1320,301,178,482,660,58,22,175,262,432,831,0.51985559566787,15,40,0.375,417,791,0.527180783817952,0.529,441,539,0.8181818181818182
Byron Scott,scottby01,SG,29,LAL,1991,82,2630.0,1191,177,54,192,246,95,21,85,146,501,1051,0.4766888677450047,71,219,0.3242009132420091,430,832,0.5168269230769231,0.51,118,148,0.7972972972972973
Dennis Scott,scottde01,SG,22,ORL,1991,82,2336.0,1284,134,62,173,235,62,25,127,203,503,1183,0.4251901944209637,125,334,0.374251497005988,378,849,0.4452296819787986,0.478,153,204,0.75
Rony Seikaly,seikaro01,C,25,MIA,1991,64,2171.0,1050,95,207,502,709,51,86,205,213,395,822,0.4805352798053528,2,6,0.3333333333333333,393,816,0.4816176470588235,0.482,258,417,0.6187050359712231
John Shasky,shaskjo01,C,26,DAL,1991,57,510.0,150,11,58,76,134,14,20,27,75,51,116,0.4396551724137931,0,0,0.0,51,116,0.4396551724137931,0.44,48,79,0.6075949367088608
Brian Shaw,shawbr01,PG,24,BOS,1991,79,2772.0,1091,602,104,266,370,105,34,223,206,442,942,0.4692144373673036,3,27,0.1111111111111111,439,915,0.4797814207650273,0.471,204,249,0.8192771084337349
Jack Sikma,sikmaja01,C,35,MIL,1991,77,1940.0,802,143,108,333,441,65,64,130,218,295,691,0.426917510853835,46,135,0.3407407407407407,249,556,0.447841726618705,0.46,166,197,0.8426395939086294
Lionel Simmons,simmoli01,SF,22,SAC,1991,79,2978.0,1421,315,193,504,697,113,85,230,249,549,1301,0.4219830899308224,3,11,0.2727272727272727,546,1290,0.4232558139534884,0.423,320,435,0.735632183908046
Scott Skiles,skilesc01,PG,26,ORL,1991,79,2714.0,1357,660,57,213,270,89,4,252,192,462,1039,0.4446583253128007,93,228,0.4078947368421052,369,811,0.4549938347718865,0.489,340,377,0.9018567639257294
Charles Smith,smithch01,SF,25,LAC,1991,74,2703.0,1480,134,216,392,608,81,145,165,267,548,1168,0.4691780821917808,0,7,0.0,548,1161,0.4720068906115418,0.469,384,484,0.7933884297520661
Charles Smith,smithch02,PG,23,BOS,1991,5,30.0,9,6,0,2,2,1,0,3,7,3,7,0.4285714285714285,0,0,0.0,3,7,0.4285714285714285,0.429,3,5,0.6
Clinton Smith,smithcl01,SG,27,WSB,1991,5,45.0,7,4,2,2,4,1,0,1,3,2,4,0.5,0,0,0.0,2,4,0.5,0.5,3,6,0.5
Derek Smith,smithde02,SF,29,BOS,1991,2,16.0,5,5,0,0,0,1,1,1,3,1,4,0.25,0,1,0.0,1,3,0.3333333333333333,0.25,3,4,0.75
Kenny Smith,smithke01,PG,25,HOU,1991,78,2699.0,1380,554,36,127,163,106,11,237,131,522,1003,0.5204386839481555,49,135,0.362962962962963,473,868,0.5449308755760369,0.545,287,340,0.8441176470588235
Larry Smith,smithla01,PF,33,HOU,1991,81,1923.0,268,88,302,407,709,83,22,93,265,128,263,0.4866920152091255,0,0,0.0,128,263,0.4866920152091255,0.487,12,50,0.24
Michael Smith,smithmi01,PF,25,BOS,1991,47,389.0,218,43,21,35,56,6,2,37,27,95,200,0.475,6,24,0.25,89,176,0.5056818181818182,0.49,22,27,0.8148148148148148
Otis Smith,smithot01,SF,27,ORL,1991,75,1885.0,1044,169,176,213,389,85,35,140,190,407,902,0.4512195121951219,9,46,0.1956521739130435,398,856,0.4649532710280374,0.456,221,301,0.7342192691029901
Tony Smith,smithto02,SG,22,LAL,1991,64,695.0,234,135,24,47,71,28,12,69,80,97,220,0.4409090909090909,0,7,0.0,97,213,0.4553990610328638,0.441,40,57,0.7017543859649122
Rik Smits,smitsri01,C,24,IND,1991,76,1690.0,828,84,116,241,357,24,111,86,246,342,705,0.4851063829787234,0,0,0.0,342,705,0.4851063829787234,0.485,144,189,0.7619047619047619
Mike Smrek,smrekmi01,C,28,TOT,1991,15,95.0,24,4,7,19,26,3,3,3,27,9,27,0.3333333333333333,0,0,0.0,9,27,0.3333333333333333,0.333,6,12,0.5
Rory Sparrow,sparrro01,PG,32,SAC,1991,80,2375.0,831,362,45,141,186,83,16,126,189,371,756,0.4907407407407407,31,78,0.3974358974358974,340,678,0.5014749262536873,0.511,58,83,0.6987951807228916
Felton Spencer,spencfe01,C,23,MIN,1991,81,2099.0,572,25,272,369,641,48,121,77,337,195,381,0.5118110236220472,0,1,0.0,195,380,0.5131578947368421,0.512,182,252,0.7222222222222222
John Starks,starkjo01,SG,25,NYK,1991,61,1173.0,466,204,30,101,131,59,17,74,137,180,410,0.4390243902439024,27,93,0.2903225806451613,153,317,0.4826498422712933,0.472,79,105,0.7523809523809524
Everette Stephens,stephev01,PG,24,MIL,1991,3,6.0,6,2,0,0,0,0,0,0,0,2,3,0.6666666666666666,0,0,0.0,2,3,0.6666666666666666,0.667,2,2,1.0
John Stockton,stockjo01,PG,28,UTA,1991,82,3103.0,1413,1164,46,191,237,234,16,298,233,496,978,0.5071574642126789,58,168,0.3452380952380952,438,810,0.5407407407407407,0.537,363,434,0.836405529953917
Rod Strickland,stricro02,PG,24,SAS,1991,58,2076.0,800,463,57,162,219,117,11,156,125,314,651,0.4823348694316436,11,33,0.3333333333333333,303,618,0.4902912621359223,0.491,161,211,0.7630331753554502
Jon Sundvold,sundvjo01,SG,29,MIA,1991,24,225.0,112,24,3,6,9,7,0,16,11,43,107,0.4018691588785046,15,35,0.4285714285714285,28,72,0.3888888888888889,0.472,11,11,1.0
Roy Tarpley,tarplro01,C,26,DAL,1991,5,171.0,102,12,16,39,55,6,9,13,20,43,79,0.5443037974683544,0,1,0.0,43,78,0.5512820512820513,0.544,16,18,0.8888888888888888
Terry Teagle,teaglte01,SG,30,LAL,1991,82,1498.0,815,82,82,99,181,31,8,83,165,335,757,0.4425363276089828,0,9,0.0,335,748,0.4478609625668449,0.443,145,177,0.8192090395480226
Reggie Theus,theusre01,SG,33,NJN,1991,81,2955.0,1510,378,69,160,229,85,35,252,231,583,1247,0.4675220529270248,52,144,0.3611111111111111,531,1103,0.4814143245693563,0.488,292,343,0.8513119533527697
Irving Thomas,thomair01,PF,25,LAL,1991,26,108.0,46,10,14,17,31,4,1,13,24,17,50,0.34,0,0,0.0,17,50,0.34,0.34,12,21,0.5714285714285714
Isiah Thomas,thomais01,PG,29,DET,1991,48,1657.0,776,446,35,125,160,75,10,185,118,289,665,0.4345864661654135,19,65,0.2923076923076923,270,600,0.45,0.449,179,229,0.7816593886462883
Jim Thomas,thomaji01,SG,30,MIN,1991,3,14.0,2,1,0,0,0,1,0,1,0,1,4,0.25,0,0,0.0,1,4,0.25,0.25,0,0,0.0
Billy Thompson,thompbi01,SF,27,MIA,1991,73,1481.0,499,111,120,192,312,32,48,117,161,205,411,0.4987834549878345,0,4,0.0,205,407,0.5036855036855037,0.499,89,124,0.717741935483871
LaSalle Thompson,thompla01,C,29,IND,1991,82,1946.0,625,147,154,409,563,63,63,168,265,276,565,0.4884955752212389,1,5,0.2,275,560,0.4910714285714285,0.489,72,104,0.6923076923076923
Mychal Thompson,thompmy01,C,36,LAL,1991,72,1077.0,288,21,74,154,228,23,23,47,112,113,228,0.4956140350877193,0,2,0.0,113,226,0.5,0.496,62,88,0.7045454545454546
Bob Thornton,thornbo01,PF,28,MIN,1991,12,110.0,16,1,1,14,15,0,3,9,18,4,13,0.3076923076923077,0,0,0.0,4,13,0.3076923076923077,0.308,8,10,0.8
Otis Thorpe,thorpot01,PF,28,HOU,1991,82,3039.0,1435,197,287,559,846,73,20,217,278,549,988,0.555668016194332,3,7,0.4285714285714285,546,981,0.5565749235474006,0.557,334,480,0.6958333333333333
Sedale Threatt,threase01,PG,29,SEA,1991,80,2066.0,1013,273,25,74,99,113,8,138,191,433,835,0.518562874251497,10,35,0.2857142857142857,423,800,0.52875,0.525,137,173,0.791907514450867
Wayman Tisdale,tisdawa01,PF,26,SAC,1991,33,1116.0,660,66,75,178,253,23,28,82,99,262,542,0.4833948339483395,0,1,0.0,262,541,0.4842883548983364,0.483,136,170,0.8
Tom Tolbert,tolbeto01,PF,25,GSW,1991,62,1371.0,500,76,87,188,275,35,38,80,195,183,433,0.4226327944572748,7,21,0.3333333333333333,176,412,0.4271844660194174,0.431,127,172,0.7383720930232558
Andy Toolson,toolsan01,SF,25,UTA,1991,47,470.0,137,31,32,35,67,14,2,24,58,50,124,0.4032258064516129,12,32,0.375,38,92,0.4130434782608695,0.452,25,33,0.7575757575757576
Kelly Tripucka,tripuke01,SF,31,CHH,1991,77,1289.0,541,159,46,130,176,33,13,92,130,187,412,0.4538834951456311,15,45,0.3333333333333333,172,367,0.4686648501362397,0.472,152,167,0.9101796407185628
Trent Tucker,tucketr01,SG,31,NYK,1991,65,1194.0,463,111,33,72,105,44,9,46,120,191,434,0.4400921658986175,64,153,0.4183006535947712,127,281,0.4519572953736654,0.514,17,27,0.6296296296296297
Andre Turner,turnean01,PG,26,PHI,1991,70,1407.0,412,311,36,116,152,63,0,95,124,168,383,0.4386422976501306,12,33,0.3636363636363636,156,350,0.4457142857142857,0.454,64,87,0.735632183908046
Jeff Turner,turneje01,PF,28,ORL,1991,71,1683.0,609,97,108,255,363,29,10,126,234,259,532,0.4868421052631579,6,15,0.4,253,517,0.4893617021276595,0.492,85,112,0.7589285714285714
Kelvin Upshaw,upshake01,SG,28,DAL,1991,48,514.0,270,86,20,35,55,28,5,39,77,104,231,0.4502164502164502,7,29,0.2413793103448276,97,202,0.4801980198019802,0.465,55,64,0.859375
Darnell Valentine,valenda01,PG,31,CLE,1991,65,1841.0,609,351,37,135,172,98,12,126,170,230,496,0.4637096774193548,6,25,0.24,224,471,0.4755838641188959,0.47,143,172,0.8313953488372093
Kiki Vandeweghe,vandeki01,SF,32,NYK,1991,75,2420.0,1226,110,78,102,180,42,10,108,122,458,927,0.4940668824163969,51,141,0.3617021276595745,407,786,0.5178117048346056,0.522,259,288,0.8993055555555556
Loy Vaught,vaughlo01,PF,22,LAC,1991,73,1178.0,399,40,124,225,349,20,23,49,135,175,359,0.4874651810584958,0,2,0.0,175,357,0.4901960784313725,0.487,49,74,0.6621621621621622
Sam Vincent,vincesa01,PG,27,ORL,1991,49,975.0,406,197,17,90,107,30,5,91,74,152,353,0.4305949008498583,3,19,0.1578947368421052,149,334,0.4461077844311377,0.435,99,120,0.825
Stojko Vranković,vrankst01,C,27,BOS,1991,31,166.0,58,4,15,36,51,1,29,24,43,24,52,0.4615384615384615,0,0,0.0,24,52,0.4615384615384615,0.462,10,18,0.5555555555555556
Milt Wagner,wagnemi01,SG,27,MIA,1991,13,116.0,63,15,0,7,7,2,3,12,14,24,57,0.4210526315789473,6,17,0.3529411764705882,18,40,0.45,0.474,9,11,0.8181818181818182
Darrell Walker,walkeda01,PG,29,WSB,1991,71,2305.0,553,459,140,358,498,78,33,154,199,230,535,0.4299065420560747,0,9,0.0,230,526,0.4372623574144487,0.43,93,154,0.6038961038961039
Kenny Walker,walkeke01,SF,26,NYK,1991,54,771.0,230,13,63,94,157,18,30,30,92,83,191,0.4345549738219895,0,1,0.0,83,190,0.4368421052631579,0.435,64,82,0.7804878048780488
Spud Webb,webbsp01,PG,27,ATL,1991,75,2197.0,1003,417,41,133,174,118,6,146,180,359,803,0.4470734744707347,54,168,0.3214285714285714,305,635,0.4803149606299212,0.481,231,266,0.868421052631579
Bill Wennington,wennibi01,C,27,SAC,1991,77,1455.0,437,69,101,239,340,46,59,51,230,181,415,0.436144578313253,1,5,0.2,180,410,0.4390243902439024,0.437,74,94,0.7872340425531915
Doug West,westdo01,SG,23,MIN,1991,75,824.0,294,48,56,80,136,35,23,41,115,118,246,0.4796747967479675,0,1,0.0,118,245,0.4816326530612245,0.48,58,84,0.6904761904761905
Mark West,westma01,C,30,PHO,1991,82,1957.0,629,37,171,393,564,32,161,86,266,247,382,0.6465968586387435,0,0,0.0,247,382,0.6465968586387435,0.647,135,206,0.6553398058252428
Randy White,whitera01,PF,23,DAL,1991,79,1901.0,695,63,173,331,504,81,44,131,308,265,665,0.3984962406015037,6,37,0.1621621621621621,259,628,0.4124203821656051,0.403,159,225,0.7066666666666667
Morlon Wiley,wileymo01,PG,24,ORL,1991,34,350.0,113,73,4,13,17,24,0,34,37,45,108,0.4166666666666667,6,12,0.5,39,96,0.40625,0.444,17,25,0.68
Dominique Wilkins,wilkido01,SF,31,ATL,1991,81,3078.0,2101,265,261,471,732,123,65,201,156,770,1640,0.4695121951219512,85,249,0.3413654618473896,685,1391,0.4924514737598849,0.495,476,574,0.8292682926829268
Eddie Lee Wilkins,wilkied01,C,28,NYK,1991,68,668.0,279,15,69,111,180,17,7,50,91,114,255,0.4470588235294118,0,1,0.0,114,254,0.4488188976377952,0.447,51,90,0.5666666666666667
Gerald Wilkins,wilkige01,SG,27,NYK,1991,68,2164.0,938,275,78,129,207,82,23,161,181,380,804,0.472636815920398,9,43,0.2093023255813953,371,761,0.4875164257555847,0.478,169,206,0.8203883495145631
Buck Williams,willibu01,PF,30,POR,1991,80,2582.0,933,97,227,524,751,47,47,137,247,358,595,0.6016806722689075,0,0,0.0,358,595,0.6016806722689075,0.602,217,308,0.7045454545454546
Herb Williams,willihe01,C,32,DAL,1991,60,1832.0,747,95,86,271,357,30,88,113,197,332,655,0.5068702290076336,0,4,0.0,332,651,0.5099846390168971,0.507,83,130,0.6384615384615384
Hot Rod Williams,williho01,C,28,CLE,1991,43,1293.0,505,100,111,179,290,36,69,63,126,199,430,0.4627906976744186,0,1,0.0,199,429,0.4638694638694638,0.463,107,164,0.6524390243902439
Jayson Williams,willija01,PF,22,PHI,1991,52,508.0,182,16,41,70,111,9,6,40,92,72,161,0.4472049689440994,1,2,0.5,71,159,0.4465408805031446,0.45,37,56,0.6607142857142857
John Williams,willijo02,SF,24,WSB,1991,33,941.0,411,133,42,135,177,39,6,68,63,164,393,0.4173027989821883,10,41,0.2439024390243902,154,352,0.4375,0.43,73,97,0.7525773195876289
Kenny Williams,willike03,PF,21,IND,1991,75,527.0,220,31,56,75,131,11,31,41,81,93,179,0.5195530726256983,0,3,0.0,93,176,0.5284090909090909,0.52,34,50,0.68
Micheal Williams,willimi02,PG,24,IND,1991,73,1706.0,813,348,49,127,176,150,17,150,202,261,523,0.4990439770554493,1,7,0.1428571428571428,260,516,0.5038759689922481,0.5,290,330,0.8787878787878788
Reggie Williams,willire01,SF,26,TOT,1991,73,1896.0,991,133,133,173,306,113,41,112,253,384,855,0.4491228070175438,57,157,0.3630573248407643,327,698,0.4684813753581662,0.482,166,197,0.8426395939086294
Scott Williams,willisc01,PF,22,CHI,1991,51,337.0,127,16,42,56,98,12,13,23,51,53,104,0.5096153846153846,1,2,0.5,52,102,0.5098039215686274,0.514,20,28,0.7142857142857143
Kevin Willis,willike02,PF,28,ATL,1991,80,2373.0,1051,99,259,445,704,60,40,153,235,444,881,0.5039727582292849,4,10,0.4,440,871,0.505166475315729,0.506,159,238,0.6680672268907563
Trevor Wilson,wilsotr01,PF,22,ATL,1991,25,162.0,55,11,16,24,40,5,1,17,13,21,70,0.3,0,2,0.0,21,68,0.3088235294117647,0.3,13,26,0.5
Kennard Winchester,winchke01,SF,24,HOU,1991,64,607.0,239,25,34,33,67,16,13,30,70,98,245,0.4,8,20,0.4,90,225,0.4,0.416,35,45,0.7777777777777778
David Wingate,wingada01,SG,27,SAS,1991,25,563.0,136,46,24,51,75,19,5,42,66,53,138,0.3840579710144927,1,9,0.1111111111111111,52,129,0.4031007751937984,0.388,29,41,0.7073170731707317
Randy Wittman,wittmra01,SF,31,IND,1991,41,355.0,74,25,6,27,33,10,4,10,9,35,79,0.4430379746835443,0,5,0.0,35,74,0.4729729729729729,0.443,4,6,0.6666666666666666
Joe Wolf,wolfjo01,C,26,DEN,1991,74,1593.0,539,107,136,264,400,60,31,95,244,234,519,0.4508670520231214,2,15,0.1333333333333333,232,504,0.4603174603174603,0.453,69,83,0.8313253012048193
David Wood,woodda01,SF,26,HOU,1991,82,1421.0,432,94,107,139,246,58,16,89,236,148,349,0.4240687679083094,28,90,0.3111111111111111,120,259,0.4633204633204633,0.464,108,133,0.8120300751879699
Leon Wood,woodle01,SG,28,SAC,1991,12,222.0,81,49,5,14,19,5,0,12,10,25,63,0.3968253968253968,12,38,0.3157894736842105,13,25,0.52,0.492,19,21,0.9047619047619048
Mike Woodson,woodsmi01,SG,32,TOT,1991,15,171.0,64,15,3,10,13,5,5,12,18,26,77,0.3376623376623376,1,7,0.1428571428571428,25,70,0.3571428571428571,0.344,11,13,0.8461538461538461
Orlando Woolridge,woolror01,SF,31,DEN,1991,53,1823.0,1330,119,141,220,361,69,23,152,145,490,983,0.4984740590030518,0,4,0.0,490,979,0.5005107252298263,0.498,350,439,0.7972665148063781
Haywoode Workman,workmha01,PG,25,WSB,1991,73,2034.0,581,353,51,191,242,87,7,135,162,234,515,0.4543689320388349,12,50,0.24,222,465,0.4774193548387097,0.466,101,133,0.7593984962406015
James Worthy,worthja01,SF,29,LAL,1991,78,3008.0,1670,275,107,249,356,104,35,127,117,716,1455,0.4920962199312714,26,90,0.2888888888888888,690,1365,0.5054945054945055,0.501,212,266,0.7969924812030075
Howard Wright,wrighho02,PF,23,TOT,1991,15,164.0,54,3,12,33,45,4,5,11,28,19,47,0.4042553191489361,0,1,0.0,19,46,0.4130434782608695,0.404,16,24,0.6666666666666666
A.J. Wynder,wyndeaj01,PG,26,BOS,1991,6,39.0,12,8,1,2,3,1,0,4,1,3,12,0.25,0,1,0.0,3,11,0.2727272727272727,0.25,6,8,0.75
Danny Young,youngda01,PG,28,POR,1991,75,897.0,283,141,22,53,75,50,7,50,49,103,271,0.3800738007380074,36,104,0.3461538461538461,67,167,0.4011976047904191,0.446,41,45,0.9111111111111112
Alaa Abdelnaby,abdelal01,PF,23,POR,1992,71,934.0,432,30,81,179,260,25,16,66,132,178,361,0.4930747922437673,0,0,0.0,178,361,0.4930747922437673,0.493,76,101,0.7524752475247525
Mahmoud Abdul-Rauf,abdulma02,PG,22,DEN,1992,81,1538.0,837,192,22,92,114,44,4,117,130,356,845,0.421301775147929,31,94,0.3297872340425531,325,751,0.4327563249001331,0.44,94,108,0.8703703703703703
Mark Acres,acresma01,C,29,ORL,1992,68,926.0,208,22,97,155,252,25,15,33,140,78,151,0.5165562913907285,1,3,0.3333333333333333,77,148,0.5202702702702703,0.52,51,67,0.7611940298507462
Michael Adams,adamsmi01,PG,29,WSB,1992,78,2795.0,1408,594,58,252,310,145,9,212,162,485,1233,0.3933495539334955,125,386,0.3238341968911917,360,847,0.4250295159386068,0.444,313,360,0.8694444444444445
Rafael Addison,addisra01,SF,27,NJN,1992,76,1175.0,444,68,65,100,165,28,28,46,109,187,432,0.4328703703703703,14,49,0.2857142857142857,173,383,0.4516971279373368,0.449,56,76,0.7368421052631579
Mark Aguirre,aguirma01,SF,32,DET,1992,75,1582.0,851,126,67,169,236,51,11,105,171,339,787,0.4307496823379924,15,71,0.2112676056338028,324,716,0.4525139664804469,0.44,158,230,0.6869565217391305
Danny Ainge,aingeda01,SG,32,POR,1992,81,1595.0,784,202,40,108,148,73,13,70,148,299,676,0.4423076923076923,78,230,0.3391304347826087,221,446,0.4955156950672645,0.5,108,131,0.8244274809160306
Victor Alexander,alexavi01,C,22,GSW,1992,80,1350.0,589,32,106,230,336,45,62,91,176,243,459,0.5294117647058824,0,1,0.0,243,458,0.5305676855895196,0.529,103,149,0.6912751677852349
Greg Anderson,andergr01,PF,27,DEN,1992,82,2793.0,945,78,337,604,941,88,65,201,263,389,854,0.455503512880562,0,4,0.0,389,850,0.4576470588235294,0.456,167,268,0.6231343283582089
Kenny Anderson,anderke01,PG,21,NJN,1992,64,1086.0,450,203,38,89,127,67,9,97,68,187,480,0.3895833333333333,3,13,0.2307692307692307,184,467,0.3940042826552462,0.393,73,98,0.7448979591836735
Nick Anderson,anderni01,SG,24,ORL,1992,60,2203.0,1196,163,98,286,384,97,33,126,132,482,1042,0.4625719769673704,30,85,0.3529411764705882,452,957,0.4723092998955068,0.477,202,303,0.6666666666666666
Ron Anderson,anderro01,SF,33,PHI,1992,82,2432.0,1123,135,96,182,278,86,11,109,128,469,1008,0.4652777777777778,42,127,0.3307086614173228,427,881,0.4846765039727582,0.486,143,163,0.8773006134969326
Willie Anderson,anderwi01,SG,25,SAS,1992,57,1889.0,744,302,62,238,300,54,51,140,151,312,685,0.4554744525547445,13,56,0.2321428571428571,299,629,0.4753577106518283,0.465,107,138,0.7753623188405797
Michael Ansley,anslemi01,SF,24,TOT,1992,10,45.0,21,2,2,4,6,0,0,3,7,8,18,0.4444444444444444,0,0,0.0,8,18,0.4444444444444444,0.444,5,6,0.8333333333333334
Greg Anthony,anthogr01,PG,24,NYK,1992,82,1510.0,447,314,33,103,136,59,9,98,170,161,435,0.3701149425287356,8,55,0.1454545454545454,153,380,0.4026315789473684,0.379,117,158,0.740506329113924
B.J. Armstrong,armstbj01,PG,24,CHI,1992,82,1875.0,809,266,19,126,145,46,5,94,88,335,697,0.4806312769010043,35,87,0.4022988505747126,300,610,0.4918032786885246,0.506,104,129,0.8062015503875969
Vincent Askew,askewvi01,SG,25,GSW,1992,80,1496.0,498,188,89,144,233,47,23,84,128,193,379,0.5092348284960422,1,10,0.1,192,369,0.5203252032520326,0.511,111,160,0.69375
Keith Askins,askinke01,SF,24,MIA,1992,59,843.0,219,38,65,77,142,40,15,47,109,84,205,0.4097560975609756,25,73,0.3424657534246575,59,132,0.4469696969696969,0.471,26,37,0.7027027027027027
Stacey Augmon,augmost01,SG,23,ATL,1992,82,2505.0,1094,201,191,229,420,124,27,181,161,440,899,0.489432703003337,1,6,0.1666666666666666,439,893,0.4916013437849944,0.49,213,320,0.665625
Isaac Austin,austiis01,C,22,UTA,1992,31,112.0,61,5,11,24,35,2,2,8,20,21,46,0.4565217391304347,0,0,0.0,21,46,0.4565217391304347,0.457,19,30,0.6333333333333333
Miloš Babić,babicmi01,C,23,MIA,1992,9,35.0,18,6,2,9,11,1,0,5,0,6,13,0.4615384615384615,0,0,0.0,6,13,0.4615384615384615,0.462,6,8,0.75
John Bagley,baglejo01,PG,31,BOS,1992,73,1742.0,524,480,38,123,161,57,4,148,123,223,506,0.4407114624505929,10,42,0.238095238095238,213,464,0.459051724137931,0.451,68,95,0.7157894736842105
Thurl Bailey,baileth01,PF,30,TOT,1992,84,2104.0,951,78,122,363,485,35,117,108,160,368,836,0.4401913875598086,0,2,0.0,368,834,0.4412470023980815,0.44,215,270,0.7962962962962963
Steve Bardo,bardost01,SG,23,SAS,1992,1,1.0,0,0,1,0,1,0,0,0,0,0,0,0.0,0,0,0.0,0,0,0.0,0.0,0,0,0.0
Charles Barkley,barklch01,SF,28,PHI,1992,75,2881.0,1730,308,271,559,830,136,44,235,196,622,1126,0.5523978685612788,32,137,0.2335766423357664,590,989,0.596562184024267,0.567,454,653,0.6952526799387443
Dana Barros,barroda01,PG,24,SEA,1992,75,1331.0,619,125,17,64,81,51,4,56,84,238,493,0.4827586206896552,83,186,0.4462365591397849,155,307,0.504885993485342,0.567,60,79,0.759493670886076
John Battle,battljo01,SG,29,CLE,1992,76,1637.0,779,159,19,93,112,36,5,91,116,316,659,0.4795144157814871,2,17,0.1176470588235294,314,642,0.4890965732087227,0.481,145,171,0.847953216374269
Kenny Battle,battlke01,SG,27,TOT,1992,16,92.0,32,4,4,12,16,2,2,4,10,11,17,0.6470588235294118,0,1,0.0,11,16,0.6875,0.647,10,12,0.8333333333333334
William Bedford,bedfowi01,C,28,DET,1992,32,363.0,114,12,24,39,63,6,18,15,56,50,121,0.4132231404958678,0,1,0.0,50,120,0.4166666666666667,0.413,14,22,0.6363636363636364
Benoit Benjamin,benjabe01,C,27,SEA,1992,63,1941.0,879,76,130,383,513,39,118,175,185,354,740,0.4783783783783784,0,2,0.0,354,738,0.4796747967479675,0.478,171,249,0.6867469879518072
Winston Bennett,bennewi01,SF,26,TOT,1992,54,833.0,195,38,63,99,162,19,9,33,122,80,211,0.3791469194312796,0,1,0.0,80,210,0.3809523809523809,0.379,35,50,0.7
David Benoit,benoida01,SF,23,UTA,1992,77,1161.0,434,34,105,191,296,19,44,71,124,175,375,0.4666666666666667,3,14,0.2142857142857142,172,361,0.4764542936288088,0.471,81,100,0.81
Larry Bird,birdla01,SF,35,BOS,1992,45,1662.0,908,306,46,388,434,42,33,125,82,353,758,0.4656992084432718,52,128,0.40625,301,630,0.4777777777777778,0.5,150,162,0.925925925925926
Rolando Blackman,blackro01,SG,32,DAL,1992,75,2527.0,1374,204,78,161,239,50,22,153,134,535,1161,0.4608096468561585,65,169,0.3846153846153846,470,992,0.4737903225806452,0.489,239,266,0.8984962406015038
Lance Blanks,blankla01,SG,25,DET,1992,43,189.0,64,19,9,13,22,14,1,14,26,25,55,0.4545454545454545,6,16,0.375,19,39,0.4871794871794871,0.509,8,11,0.7272727272727273
Mookie Blaylock,blaylmo01,PG,24,NJN,1992,72,2548.0,996,492,101,168,269,170,40,152,182,429,993,0.43202416918429,12,54,0.2222222222222222,417,939,0.4440894568690096,0.438,126,177,0.711864406779661
Muggsy Bogues,boguemu01,PG,27,CHH,1992,82,2790.0,730,743,58,177,235,170,6,156,156,317,671,0.4724292101341281,2,27,0.074074074074074,315,644,0.4891304347826087,0.474,94,120,0.7833333333333333
Manute Bol,bolma01,C,29,PHI,1992,71,1267.0,110,22,54,168,222,11,205,41,139,49,128,0.3828125,0,9,0.0,49,119,0.4117647058823529,0.383,12,26,0.4615384615384615
Anthony Bonner,bonnean01,PF,23,SAC,1992,79,2287.0,740,125,192,293,485,94,26,133,194,294,658,0.4468085106382978,1,4,0.25,293,654,0.4480122324159021,0.448,151,241,0.6265560165975104
Anthony Bowie,bowiean01,SG,28,ORL,1992,52,1721.0,758,163,70,175,245,55,38,107,101,312,633,0.4928909952606635,17,44,0.3863636363636363,295,589,0.5008488964346349,0.506,117,136,0.8602941176470589
Sam Bowie,bowiesa01,C,30,NJN,1992,71,2179.0,1062,186,203,375,578,41,120,150,212,421,947,0.4445617740232312,8,25,0.32,413,922,0.447939262472885,0.449,212,280,0.7571428571428571
Terrell Brandon,brandte01,PG,21,CLE,1992,82,1605.0,605,316,49,113,162,81,22,136,107,252,601,0.4193011647254576,1,23,0.0434782608695652,251,578,0.4342560553633218,0.42,100,124,0.8064516129032258
Randy Breuer,breuera01,C,31,MIN,1992,67,1176.0,363,89,98,183,281,27,99,41,117,161,344,0.4680232558139535,0,1,0.0,161,343,0.4693877551020408,0.468,41,77,0.5324675324675324
Frank Brickowski,brickfr01,SF,32,MIL,1992,65,1556.0,740,122,97,247,344,60,23,112,223,306,584,0.523972602739726,3,6,0.5,303,578,0.5242214532871973,0.527,125,163,0.7668711656441718
Kevin Brooks,brookke01,SF,22,DEN,1992,37,270.0,105,11,13,26,39,8,2,18,19,43,97,0.4432989690721649,2,11,0.1818181818181818,41,86,0.4767441860465116,0.454,17,21,0.8095238095238095
Scott Brooks,brooksc01,PG,26,MIN,1992,82,1082.0,417,205,27,72,99,66,7,51,82,167,374,0.446524064171123,32,90,0.3555555555555555,135,284,0.4753521126760563,0.489,51,63,0.8095238095238095
Chucky Brown,brownch01,SF,23,TOT,1992,42,431.0,150,26,31,51,82,12,7,29,48,60,128,0.46875,0,3,0.0,60,125,0.48,0.469,30,49,0.6122448979591837
Dee Brown,brownde01,PG,23,BOS,1992,31,883.0,363,164,15,64,79,33,7,59,74,149,350,0.4257142857142857,5,22,0.2272727272727272,144,328,0.4390243902439024,0.433,60,78,0.7692307692307693
Mike Brown,brownmi01,C,28,UTA,1992,82,1783.0,632,81,187,289,476,42,34,105,196,221,488,0.4528688524590163,0,1,0.0,221,487,0.4537987679671458,0.453,190,285,0.6666666666666666
Myron Brown,brownmy01,PG,22,MIN,1992,4,23.0,9,6,0,3,3,1,0,4,2,4,6,0.6666666666666666,1,3,0.3333333333333333,3,3,1.0,0.75,0,0,0.0
Randy Brown,brownra02,PG,23,SAC,1992,56,535.0,192,59,26,43,69,35,12,42,68,77,169,0.4556213017751479,0,6,0.0,77,163,0.4723926380368098,0.456,38,58,0.6551724137931034
Tony Brown,brownto01,SF,31,TOT,1992,57,655.0,271,48,32,52,84,30,5,35,82,102,249,0.4096385542168674,19,63,0.3015873015873015,83,186,0.4462365591397849,0.448,48,66,0.7272727272727273
Mark Bryant,bryanma01,PF,26,POR,1992,56,800.0,230,41,87,114,201,26,8,30,105,95,198,0.4797979797979798,0,3,0.0,95,195,0.4871794871794871,0.48,40,60,0.6666666666666666
Jud Buechler,buechju01,SF,23,TOT,1992,28,290.0,70,23,18,34,52,19,7,13,31,29,71,0.4084507042253521,0,1,0.0,29,70,0.4142857142857143,0.408,12,21,0.5714285714285714
Matt Bullard,bullama01,PF,24,HOU,1992,80,1278.0,512,75,73,150,223,26,21,56,129,205,447,0.4586129753914988,64,166,0.3855421686746988,141,281,0.501779359430605,0.53,38,50,0.76
Willie Burton,burtowi01,SF,23,MIA,1992,68,1585.0,762,123,76,168,244,46,37,119,186,280,622,0.45016077170418,6,15,0.4,274,607,0.4514003294892916,0.455,196,245,0.8
Steve Burtt,burttst01,SG,29,PHO,1992,31,356.0,187,59,10,24,34,16,4,33,58,74,160,0.4625,1,6,0.1666666666666666,73,154,0.474025974025974,0.466,38,54,0.7037037037037037
Michael Cage,cagemi01,PF,30,SEA,1992,82,2461.0,720,92,266,462,728,99,55,78,237,307,542,0.566420664206642,0,5,0.0,307,537,0.5716945996275605,0.566,106,171,0.6198830409356725
Demetrius Calip,calipde01,PG,22,LAL,1992,7,58.0,11,12,1,4,5,1,0,5,8,4,18,0.2222222222222222,1,5,0.2,3,13,0.2307692307692307,0.25,2,3,0.6666666666666666
Elden Campbell,campbel01,C,23,LAL,1992,81,1876.0,578,59,155,268,423,53,159,73,203,220,491,0.4480651731160896,0,2,0.0,220,489,0.4498977505112474,0.448,138,223,0.6188340807174888
Tony Campbell,campbto01,SF,29,MIN,1992,78,2441.0,1307,229,141,145,286,84,31,165,206,527,1137,0.4635004397537379,13,37,0.3513513513513513,514,1100,0.4672727272727273,0.469,240,299,0.802675585284281
Antoine Carr,carran01,PF,30,SAS,1992,81,1867.0,881,63,128,218,346,32,96,114,264,359,732,0.4904371584699453,1,5,0.2,358,727,0.4924346629986245,0.491,162,212,0.7641509433962265
Bill Cartwright,cartwbi01,C,34,CHI,1992,64,1471.0,512,87,93,231,324,22,14,75,131,208,445,0.4674157303370786,0,0,0.0,208,445,0.4674157303370786,0.467,96,159,0.6037735849056604
Terry Catledge,catlete01,PF,28,ORL,1992,78,2430.0,1154,109,257,292,549,58,16,138,196,457,922,0.4956616052060738,0,4,0.0,457,918,0.4978213507625272,0.496,240,346,0.6936416184971098
Duane Causwell,causwdu01,C,23,SAC,1992,80,2291.0,636,59,196,384,580,47,215,124,281,250,455,0.5494505494505495,0,1,0.0,250,454,0.5506607929515418,0.549,136,222,0.6126126126126126
Cedric Ceballos,cebalce01,SF,22,PHO,1992,64,725.0,462,50,60,92,152,16,11,71,52,176,365,0.4821917808219178,1,6,0.1666666666666666,175,359,0.4874651810584958,0.484,109,148,0.7364864864864865
Tom Chambers,chambto01,PF,32,PHO,1992,69,1948.0,1128,142,86,315,401,57,37,103,196,426,989,0.4307381193124368,18,49,0.3673469387755102,408,940,0.4340425531914894,0.44,258,311,0.8295819935691319
Rex Chapman,chapmre01,PG-SG,24,TOT,1992,22,567.0,270,89,10,48,58,15,8,45,51,113,252,0.4484126984126984,8,29,0.2758620689655172,105,223,0.4708520179372197,0.464,36,53,0.6792452830188679
Maurice Cheeks,cheekma01,PG,35,ATL,1992,56,1086.0,259,185,29,66,95,83,0,36,73,115,249,0.4618473895582329,3,6,0.5,112,243,0.4609053497942387,0.468,26,43,0.6046511627906976
Pete Chilcutt,chilcpe01,PF,23,SAC,1992,69,817.0,251,38,78,109,187,32,17,41,70,113,250,0.452,2,2,1.0,111,248,0.4475806451612903,0.456,23,28,0.8214285714285714
Derrick Coleman,colemde01,PF,24,NJN,1992,65,2207.0,1289,205,203,415,618,54,98,248,168,483,958,0.5041753653444676,23,76,0.3026315789473684,460,882,0.5215419501133787,0.516,300,393,0.7633587786259542
Bimbo Coles,colesbi01,PG,23,MIA,1992,81,1976.0,816,366,69,120,189,73,13,167,151,295,649,0.4545454545454545,10,52,0.1923076923076923,285,597,0.4773869346733668,0.462,216,262,0.8244274809160306
Marty Conlon,conloma01,C,24,SEA,1992,45,381.0,120,12,33,36,69,9,7,27,40,48,101,0.4752475247524752,0,0,0.0,48,101,0.4752475247524752,0.475,24,32,0.75
Lester Conner,connele01,PG,32,MIL,1992,81,1420.0,287,294,63,121,184,97,10,79,86,103,239,0.4309623430962343,0,7,0.0,103,232,0.4439655172413793,0.431,81,115,0.7043478260869566
Anthony Cook,cookan01,PF,24,DEN,1992,22,115.0,34,2,13,21,34,5,4,3,10,15,25,0.6,0,0,0.0,15,25,0.6,0.6,4,6,0.6666666666666666
Wayne Cooper,coopewa01,C,35,POR,1992,35,344.0,77,21,38,63,101,4,27,15,57,35,82,0.4268292682926829,0,0,0.0,35,82,0.4268292682926829,0.427,7,11,0.6363636363636364
Tom Copa,copato01,C,27,SAS,1992,33,132.0,48,3,14,22,36,2,6,8,29,22,40,0.55,0,0,0.0,22,40,0.55,0.55,4,13,0.3076923076923077
Lanard Copeland,copella01,SG,26,LAC,1992,10,48.0,16,5,1,6,7,2,0,4,5,7,23,0.3043478260869565,0,2,0.0,7,21,0.3333333333333333,0.304,2,2,1.0
Tyrone Corbin,corbity01,SF,29,TOT,1992,80,2207.0,780,140,163,309,472,82,20,97,193,303,630,0.4809523809523809,0,4,0.0,303,626,0.4840255591054313,0.481,174,201,0.8656716417910447
Chris Corchiani,corchch01,PG,23,ORL,1992,51,741.0,255,141,18,60,78,45,2,74,94,77,193,0.3989637305699481,10,37,0.2702702702702703,67,156,0.4294871794871794,0.425,91,104,0.875
Corey Crowder,crowdco01,SF,22,UTA,1992,51,328.0,114,17,16,25,41,7,2,13,35,43,112,0.3839285714285714,13,30,0.4333333333333333,30,82,0.3658536585365853,0.442,15,18,0.8333333333333334
Terry Cummings,cummite01,PF,30,SAS,1992,70,2149.0,1210,102,247,384,631,58,34,115,210,514,1053,0.4881291547958215,5,13,0.3846153846153846,509,1040,0.4894230769230769,0.491,177,249,0.7108433734939759
Dell Curry,curryde01,SG,27,CHH,1992,77,2020.0,1209,177,57,202,259,93,20,134,156,504,1038,0.4855491329479768,74,183,0.4043715846994535,430,855,0.5029239766081871,0.521,127,152,0.8355263157894737
Quintin Dailey,dailequ01,SG,31,SEA,1992,11,98.0,31,4,2,10,12,5,1,10,6,9,37,0.2432432432432432,0,1,0.0,9,36,0.25,0.243,13,16,0.8125
Brad Daugherty,daughbr01,C,26,CLE,1992,73,2643.0,1566,262,191,569,760,65,78,185,190,576,1010,0.5702970297029702,0,2,0.0,576,1008,0.5714285714285714,0.57,414,533,0.776735459662289
Brad Davis,davisbr01,PG,36,DAL,1992,33,429.0,92,66,4,29,33,11,3,27,57,38,86,0.4418604651162791,5,18,0.2777777777777778,33,68,0.4852941176470588,0.471,11,15,0.7333333333333333
Dale Davis,davisda01,PF,22,IND,1992,64,1301.0,395,30,158,252,410,27,74,49,191,154,279,0.5519713261648745,0,1,0.0,154,278,0.5539568345323741,0.552,87,152,0.5723684210526315
Terry Davis,daviste01,PF,24,DAL,1992,68,2149.0,693,57,228,444,672,26,29,117,202,256,531,0.4821092278719397,0,5,0.0,256,526,0.4866920152091255,0.482,181,285,0.6350877192982456
Walter Davis,daviswa03,SF,37,DEN,1992,46,741.0,457,68,20,50,70,29,1,45,69,185,403,0.4590570719602977,5,16,0.3125,180,387,0.4651162790697674,0.465,82,94,0.8723404255319149
Johnny Dawkins,dawkijo01,PG,28,PHI,1992,82,2815.0,988,567,42,185,227,89,5,183,158,394,902,0.4368070953436807,36,101,0.3564356435643564,358,801,0.4469413233458177,0.457,164,186,0.8817204301075269
Bison Dele,delebi01,PF,22,ORL,1992,48,905.0,437,33,115,157,272,41,53,86,139,171,324,0.5277777777777778,0,0,0.0,171,324,0.5277777777777778,0.528,95,142,0.6690140845070423
Vlade Divac,divacvl01,C,23,LAL,1992,36,979.0,405,60,87,160,247,55,35,88,114,157,317,0.4952681388012618,5,19,0.2631578947368421,152,298,0.5100671140939598,0.503,86,112,0.7678571428571429
James Donaldson,donalja01,C,34,TOT,1992,58,1075.0,285,33,99,190,289,8,49,48,103,112,245,0.4571428571428571,0,0,0.0,112,245,0.4571428571428571,0.457,61,86,0.7093023255813954
Sherman Douglas,douglsh01,PG,25,TOT,1992,42,752.0,308,172,13,50,63,25,9,68,78,117,253,0.4624505928853755,1,10,0.1,116,243,0.4773662551440329,0.464,73,107,0.6822429906542056
Greg Dreiling,dreilgr01,C,29,IND,1992,60,509.0,117,25,22,74,96,10,16,31,123,43,87,0.4942528735632184,1,1,1.0,42,86,0.4883720930232558,0.5,30,40,0.75
Clyde Drexler,drexlcl01,SG,29,POR,1992,76,2751.0,1903,512,166,334,500,138,70,240,229,694,1476,0.470189701897019,114,338,0.3372781065088757,580,1138,0.5096660808435852,0.509,401,505,0.7940594059405941
Kevin Duckworth,duckwke01,C,27,POR,1992,82,2222.0,880,99,151,346,497,38,37,143,264,362,786,0.460559796437659,0,3,0.0,362,783,0.4623243933588761,0.461,156,226,0.6902654867256637
Chris Dudley,dudlech02,C,26,NJN,1992,82,1902.0,460,58,343,396,739,38,179,79,275,190,472,0.4025423728813559,0,0,0.0,190,472,0.4025423728813559,0.403,80,171,0.4678362573099415
Joe Dumars,dumarjo01,SG,28,DET,1992,82,3192.0,1635,375,82,106,188,71,12,193,145,587,1311,0.4477498093058734,49,120,0.4083333333333333,538,1191,0.4517212426532326,0.466,412,475,0.8673684210526316
Ledell Eackles,eacklle01,SG,25,WSB,1992,65,1463.0,856,125,39,139,178,47,7,75,145,355,759,0.4677206851119894,7,35,0.2,348,724,0.4806629834254143,0.472,139,187,0.7433155080213903
Mark Eaton,eatonma01,C,35,UTA,1992,81,2023.0,266,40,150,341,491,36,205,60,239,107,240,0.4458333333333333,0,0,0.0,107,240,0.4458333333333333,0.446,52,87,0.5977011494252874
Patrick Eddie,eddiepa01,C,24,NYK,1992,4,13.0,4,0,0,1,1,0,0,0,3,2,9,0.2222222222222222,0,0,0.0,2,9,0.2222222222222222,0.222,0,0,0.0
Blue Edwards,edwarbl01,SF,26,UTA,1992,81,2283.0,1018,137,86,212,298,81,46,122,236,433,830,0.5216867469879518,39,103,0.3786407766990291,394,727,0.5419532324621733,0.545,113,146,0.773972602739726
James Edwards,edwarja01,C,36,LAC,1992,72,1437.0,698,53,55,147,202,24,33,72,236,250,538,0.4646840148698885,0,1,0.0,250,537,0.4655493482309125,0.465,198,271,0.7306273062730627
Kevin Edwards,edwarke01,PG,26,MIA,1992,81,1840.0,819,170,56,155,211,99,20,120,138,325,716,0.4539106145251396,7,32,0.21875,318,684,0.4649122807017544,0.459,162,191,0.8481675392670157
Craig Ehlo,ehlocr01,SG,30,CLE,1992,63,2016.0,776,238,94,213,307,78,22,104,150,310,684,0.4532163742690058,69,167,0.4131736526946107,241,517,0.4661508704061896,0.504,87,123,0.7073170731707317
Mario Elie,eliema01,SG,28,GSW,1992,79,1677.0,620,174,69,158,227,68,15,83,159,221,424,0.5212264150943396,23,70,0.3285714285714285,198,354,0.559322033898305,0.548,155,182,0.8516483516483516
Sean Elliott,elliose01,SF,23,SAS,1992,82,3120.0,1338,214,143,296,439,84,29,152,149,514,1040,0.4942307692307692,25,82,0.3048780487804878,489,958,0.5104384133611691,0.506,285,331,0.8610271903323263
Dale Ellis,ellisda01,SF,31,MIL,1992,81,2191.0,1272,104,92,161,253,57,18,119,151,485,1034,0.4690522243713733,138,329,0.4194528875379939,347,705,0.4921985815602837,0.536,164,212,0.7735849056603774
LeRon Ellis,ellisle02,C,22,LAC,1992,29,103.0,43,1,12,12,24,6,9,11,11,17,50,0.34,0,0,0.0,17,50,0.34,0.34,9,19,0.4736842105263157
Pervis Ellison,ellispe01,C,24,WSB,1992,66,2511.0,1322,190,217,523,740,62,177,196,222,547,1014,0.539447731755424,1,3,0.3333333333333333,546,1011,0.5400593471810089,0.54,227,312,0.7275641025641025
A.J. English,engliaj01,SG,24,WSB,1992,81,1665.0,886,143,74,94,168,32,9,89,160,366,846,0.4326241134751773,6,34,0.1764705882352941,360,812,0.4433497536945813,0.436,148,176,0.8409090909090909
Patrick Ewing,ewingpa01,C,29,NYK,1992,82,3150.0,1970,156,228,693,921,88,245,209,277,796,1525,0.5219672131147541,1,6,0.1666666666666666,795,1519,0.5233706385780118,0.522,377,511,0.7377690802348337
Dave Feitl,feitlda01,C,29,NJN,1992,34,175.0,82,6,21,40,61,2,3,19,22,33,77,0.4285714285714285,0,0,0.0,33,77,0.4285714285714285,0.429,16,19,0.8421052631578947
Duane Ferrell,ferredu01,SF,26,ATL,1992,66,1598.0,839,92,105,105,210,49,17,99,134,331,632,0.5237341772151899,11,33,0.3333333333333333,320,599,0.5342237061769616,0.532,166,218,0.7614678899082569
Danny Ferry,ferryda01,PF,25,CLE,1992,68,937.0,346,75,53,160,213,22,15,46,135,134,328,0.4085365853658536,17,48,0.3541666666666667,117,280,0.4178571428571428,0.434,61,73,0.8356164383561644
Vern Fleming,flemive01,PG,29,IND,1992,82,1737.0,726,266,69,140,209,56,7,140,134,294,610,0.4819672131147541,6,27,0.2222222222222222,288,583,0.4939965694682676,0.487,132,179,0.7374301675977654
Sleepy Floyd,floydsl01,PG,31,HOU,1992,82,1662.0,744,239,34,116,150,57,21,128,128,286,704,0.40625,37,123,0.3008130081300813,249,581,0.4285714285714285,0.433,135,170,0.7941176470588235
Greg Foster,fostegr01,PF,23,WSB,1992,49,548.0,213,35,43,102,145,6,12,36,83,89,193,0.4611398963730569,0,1,0.0,89,192,0.4635416666666667,0.461,35,49,0.7142857142857143
Rick Fox,foxri01,SF,22,BOS,1992,81,1535.0,644,126,73,147,220,78,30,123,230,241,525,0.459047619047619,23,70,0.3285714285714285,218,455,0.4791208791208791,0.481,139,184,0.7554347826086957
Tellis Frank,frankte01,PF,26,MIN,1992,10,140.0,46,8,8,18,26,5,4,5,24,18,33,0.5454545454545454,0,0,0.0,18,33,0.5454545454545454,0.545,10,15,0.6666666666666666
Anthony Frederick,fredean01,SF,27,CHH,1992,66,852.0,389,71,75,69,144,40,26,58,91,161,370,0.4351351351351351,4,17,0.2352941176470588,157,353,0.4447592067988669,0.441,63,92,0.6847826086956522
Kevin Gamble,gamblke01,SF,26,BOS,1992,82,2496.0,1108,219,80,206,286,75,37,97,200,480,908,0.5286343612334802,9,31,0.2903225806451613,471,877,0.5370581527936146,0.534,139,157,0.8853503184713376
Winston Garland,garlawi01,PG,27,DEN,1992,78,2209.0,846,411,67,123,190,98,22,175,206,333,750,0.444,9,28,0.3214285714285714,324,722,0.4487534626038781,0.45,171,199,0.8592964824120602
Tom Garrick,garrito01,SG,25,TOT,1992,40,549.0,137,98,12,44,56,36,4,44,54,59,143,0.4125874125874126,1,4,0.25,58,139,0.4172661870503597,0.416,18,26,0.6923076923076923
Chris Gatling,gatlich01,PF,24,GSW,1992,54,612.0,306,16,75,107,182,31,36,44,101,117,206,0.5679611650485437,0,4,0.0,117,202,0.5792079207920792,0.568,72,109,0.6605504587155964
Kenny Gattison,gattike01,PF,27,CHH,1992,82,2223.0,1042,131,177,403,580,59,69,140,273,423,799,0.5294117647058824,0,2,0.0,423,797,0.5307402760351317,0.529,196,285,0.6877192982456141
Tate George,georgta01,SG,23,NJN,1992,70,1037.0,418,162,36,69,105,41,3,82,98,165,386,0.4274611398963731,1,6,0.1666666666666666,164,380,0.431578947368421,0.429,87,106,0.8207547169811321
Kendall Gill,gillke01,SG,23,CHH,1992,79,2906.0,1622,329,165,237,402,154,46,180,237,666,1427,0.4667133847231955,6,25,0.24,660,1402,0.470756062767475,0.469,284,381,0.7454068241469817
Armen Gilliam,gilliar01,PF,27,PHI,1992,81,2771.0,1367,118,234,426,660,51,85,166,176,512,1001,0.5114885114885115,0,2,0.0,512,999,0.5125125125125125,0.511,343,425,0.8070588235294117
Gerald Glass,glassge01,SF,24,MIN,1992,75,1822.0,859,175,107,153,260,66,30,103,171,383,871,0.4397244546498278,16,54,0.2962962962962963,367,817,0.449204406364749,0.449,77,125,0.616
Mike Gminski,gminsmi01,C,32,CHH,1992,35,499.0,202,31,37,81,118,11,16,20,37,90,199,0.4522613065326633,1,3,0.3333333333333333,89,196,0.4540816326530612,0.455,21,28,0.75
Dan Godfread,godfrda01,C,24,HOU,1992,1,2.0,0,0,0,0,0,0,0,0,0,0,0,0.0,0,0,0.0,0,0,0.0,0.0,0,0,0.0
Paul Graham,grahapa01,SG,24,ATL,1992,78,1718.0,791,175,72,159,231,96,21,91,193,305,682,0.4472140762463343,55,141,0.3900709219858156,250,541,0.4621072088724584,0.488,126,170,0.7411764705882353
Ron Grandison,grandro01,PF,27,CHH,1992,3,25.0,10,1,3,8,11,1,1,3,4,2,4,0.5,0,0,0.0,2,4,0.5,0.5,6,10,0.6
Gary Grant,grantga01,PG,26,LAC,1992,78,2049.0,609,538,34,150,184,138,14,187,181,275,595,0.4621848739495798,15,51,0.2941176470588235,260,544,0.4779411764705882,0.475,44,54,0.8148148148148148
Greg Grant,grantgr01,PG,25,TOT,1992,68,891.0,225,217,14,55,69,45,2,46,76,99,225,0.44,7,18,0.3888888888888889,92,207,0.4444444444444444,0.456,20,24,0.8333333333333334
Harvey Grant,grantha01,SF,26,WSB,1992,64,2388.0,1155,170,157,275,432,74,27,109,178,489,1022,0.4784735812133072,1,8,0.125,488,1014,0.4812623274161736,0.479,176,220,0.8
Horace Grant,grantho01,PF,26,CHI,1992,81,2859.0,1149,217,344,463,807,100,131,98,196,457,790,0.5784810126582278,0,2,0.0,457,788,0.5799492385786802,0.578,235,317,0.7413249211356467
Jeff Grayer,grayeje01,SG,26,MIL,1992,82,1659.0,739,150,129,128,257,64,13,105,142,309,689,0.4484760522496371,19,66,0.2878787878787879,290,623,0.4654895666131621,0.462,102,153,0.6666666666666666
A.C. Green,greenac01,PF,28,LAL,1992,82,2902.0,1116,117,306,456,762,91,36,111,141,382,803,0.4757160647571606,12,56,0.2142857142857142,370,747,0.4953145917001338,0.483,340,457,0.7439824945295405
Rickey Green,greenri01,PG,37,BOS,1992,26,367.0,106,68,3,21,24,17,1,18,28,46,103,0.4466019417475728,1,4,0.25,45,99,0.4545454545454545,0.451,13,18,0.7222222222222222
Sean Green,greense01,SG,21,IND,1992,35,256.0,141,22,22,20,42,13,6,27,31,62,158,0.3924050632911392,2,10,0.2,60,148,0.4054054054054054,0.399,15,28,0.5357142857142857
Sidney Green,greensi02,PF,31,SAS,1992,80,1127.0,367,36,92,250,342,29,11,62,148,147,344,0.4273255813953488,0,0,0.0,147,344,0.4273255813953488,0.427,73,89,0.8202247191011236
Jack Haley,haleyja01,C,28,LAL,1992,49,394.0,76,7,31,64,95,7,8,25,75,31,84,0.369047619047619,0,0,0.0,31,84,0.369047619047619,0.369,14,29,0.4827586206896552
Tom Hammonds,hammoto01,PF,24,WSB,1992,37,984.0,440,36,49,136,185,22,13,58,118,195,400,0.4875,0,1,0.0,195,399,0.4887218045112781,0.488,50,82,0.6097560975609756
Bob Hansen,hansebo01,SG,31,TOT,1992,68,809.0,173,69,17,60,77,27,3,28,134,79,178,0.4438202247191011,7,27,0.2592592592592592,72,151,0.4768211920529801,0.463,8,22,0.3636363636363636
Tim Hardaway,hardati01,PG,25,GSW,1992,81,3332.0,1893,807,81,229,310,164,13,267,208,734,1592,0.4610552763819096,127,376,0.3377659574468085,607,1216,0.4991776315789473,0.501,298,389,0.7660668380462725
Derek Harper,harpede01,PG,30,DAL,1992,65,2252.0,1152,373,49,121,170,101,17,154,150,448,1011,0.4431256181998022,58,186,0.3118279569892473,390,825,0.4727272727272727,0.472,198,261,0.7586206896551724
Ron Harper,harpero01,SG,28,LAC,1992,82,3144.0,1495,417,120,327,447,152,72,252,199,569,1292,0.4404024767801857,64,211,0.3033175355450237,505,1081,0.4671600370027752,0.465,293,398,0.7361809045226131
Scott Hastings,hastisc01,C,31,DEN,1992,40,421.0,58,26,30,68,98,10,15,22,56,17,50,0.34,0,9,0.0,17,41,0.4146341463414634,0.34,24,28,0.8571428571428571
Hersey Hawkins,hawkihe01,SG,25,PHI,1992,81,3013.0,1536,248,53,218,271,157,43,189,174,521,1127,0.4622892635314996,91,229,0.3973799126637554,430,898,0.4788418708240534,0.503,403,461,0.8741865509761388
Gerald Henderson,hendege01,PG,36,TOT,1992,16,96.0,36,10,1,7,8,3,0,8,12,12,32,0.375,3,8,0.375,9,24,0.375,0.422,9,11,0.8181818181818182
Steve Henson,hensost01,PG,23,MIL,1992,50,386.0,150,82,17,24,41,15,1,40,50,52,144,0.3611111111111111,23,48,0.4791666666666667,29,96,0.3020833333333333,0.441,23,29,0.7931034482758621
Carl Herrera,herreca01,PF,25,HOU,1992,43,566.0,191,27,33,66,99,16,25,37,60,83,161,0.515527950310559,0,1,0.0,83,160,0.51875,0.516,25,44,0.5681818181818182
Rod Higgins,higgiro01,SF,32,GSW,1992,25,535.0,255,22,30,55,85,15,13,15,75,87,211,0.4123222748815165,33,95,0.3473684210526316,54,116,0.4655172413793103,0.491,48,59,0.8135593220338984
Sean Higgins,higgise01,PF-SF,23,TOT,1992,38,616.0,291,41,29,73,102,16,6,41,58,127,277,0.4584837545126354,6,25,0.24,121,252,0.4801587301587302,0.469,31,36,0.8611111111111112
Tyrone Hill,hillty01,C,23,GSW,1992,82,1886.0,671,47,182,411,593,73,43,106,315,254,487,0.5215605749486653,0,1,0.0,254,486,0.522633744855967,0.522,163,235,0.6936170212765957
Donald Hodge,hodgedo01,PF,22,DAL,1992,51,1058.0,426,39,118,157,275,25,23,75,128,163,328,0.4969512195121951,0,0,0.0,163,328,0.4969512195121951,0.497,100,150,0.6666666666666666
Craig Hodges,hodgecr01,SG,31,CHI,1992,56,555.0,238,54,7,17,24,14,1,22,33,93,242,0.384297520661157,36,96,0.375,57,146,0.3904109589041096,0.459,16,17,0.9411764705882352
Dave Hoppen,hoppeda01,C,27,PHI,1992,11,40.0,9,2,1,9,10,0,0,3,6,2,7,0.2857142857142857,0,0,0.0,2,7,0.2857142857142857,0.286,5,10,0.5
Dennis Hopson,hopsode01,SG,26,TOT,1992,71,1314.0,743,102,105,101,206,67,39,100,115,276,593,0.4654300168634064,12,47,0.2553191489361702,264,546,0.4835164835164835,0.476,179,253,0.7075098814229249
Jeff Hornacek,hornaje01,SG,28,PHO,1992,81,3078.0,1632,411,106,301,407,158,31,170,218,635,1240,0.5120967741935484,83,189,0.4391534391534391,552,1051,0.5252140818268316,0.546,279,315,0.8857142857142857
Brian Howard,howarbr01,SF,24,DAL,1992,27,318.0,131,14,17,34,51,11,8,15,55,54,104,0.5192307692307693,1,2,0.5,53,102,0.5196078431372549,0.524,22,31,0.7096774193548387
Jay Humphries,humphja01,PG,29,MIL,1992,71,2261.0,991,466,44,140,184,119,13,148,210,377,803,0.4694894146948941,42,144,0.2916666666666667,335,659,0.5083459787556904,0.496,195,249,0.7831325301204819
Cedric Hunter,huntece01,PG,27,CHH,1992,1,1.0,0,0,0,0,0,0,0,0,0,0,0,0.0,0,0,0.0,0,0,0.0,0.0,0,0,0.0
Mike Iuzzolino,iuzzomi01,PG,24,DAL,1992,52,1280.0,486,194,27,71,98,33,1,92,79,160,355,0.4507042253521127,59,136,0.4338235294117647,101,219,0.4611872146118721,0.534,107,128,0.8359375
Jaren Jackson,jacksja01,SG,24,GSW,1992,5,54.0,26,3,5,5,10,2,0,4,7,11,23,0.4782608695652174,0,0,0.0,11,23,0.4782608695652174,0.478,4,6,0.6666666666666666
Mark Jackson,jacksma01,PG,26,NYK,1992,81,2461.0,916,694,95,210,305,112,13,211,153,367,747,0.4912985274431057,11,43,0.2558139534883721,356,704,0.5056818181818182,0.499,171,222,0.7702702702702703
Dave Jamerson,jamerda01,SG,24,HOU,1992,48,378.0,191,33,22,21,43,17,0,24,39,79,191,0.4136125654450261,8,28,0.2857142857142857,71,163,0.4355828220858895,0.435,25,27,0.925925925925926
Henry James,jameshe01,SF,26,CLE,1992,65,866.0,418,25,35,77,112,16,11,43,94,164,403,0.4069478908188585,29,90,0.3222222222222222,135,313,0.4313099041533546,0.443,61,76,0.8026315789473685
Les Jepsen,jepsele01,C,24,SAC,1992,31,87.0,25,1,12,18,30,1,5,3,17,9,24,0.375,0,1,0.0,9,23,0.391304347826087,0.375,7,11,0.6363636363636364
Avery Johnson,johnsav01,PG,26,TOT,1992,69,1235.0,386,266,13,67,80,61,9,110,89,158,330,0.4787878787878787,4,15,0.2666666666666666,154,315,0.4888888888888889,0.485,66,101,0.6534653465346535
Buck Johnson,johnsbu01,SF,28,HOU,1992,80,2202.0,685,158,95,217,312,72,49,104,234,290,633,0.4581358609794628,1,9,0.1111111111111111,289,624,0.4631410256410256,0.459,104,143,0.7272727272727273
Eddie Johnson,johnsed03,SF,32,SEA,1992,81,2366.0,1386,161,118,174,292,55,11,130,199,534,1164,0.4587628865979381,27,107,0.2523364485981308,507,1057,0.4796594134342479,0.47,291,338,0.8609467455621301
Kevin Johnson,johnske02,PG,25,PHO,1992,78,2899.0,1536,836,61,231,292,116,23,272,180,539,1125,0.4791111111111111,10,46,0.217391304347826,529,1079,0.4902687673772011,0.484,448,555,0.8072072072072072
Larry Johnson,johnsla02,PF,22,CHH,1992,82,3047.0,1576,292,323,576,899,81,51,160,225,616,1258,0.4896661367249602,5,22,0.2272727272727272,611,1236,0.494336569579288,0.492,339,409,0.8288508557457213
Vinnie Johnson,johnsvi01,SG,35,SAS,1992,60,1350.0,478,145,67,115,182,41,14,74,93,202,499,0.4048096192384769,19,60,0.3166666666666666,183,439,0.4168564920273349,0.424,55,85,0.6470588235294118
Charles Jones,jonesch01,C,34,WSB,1992,75,1365.0,86,62,105,212,317,43,92,39,214,33,90,0.3666666666666666,0,0,0.0,33,90,0.3666666666666666,0.367,20,40,0.5
Michael Jordan,jordami01,SG,28,CHI,1992,80,3102.0,2404,489,91,420,511,182,75,200,201,943,1818,0.5187018701870187,27,100,0.27,916,1718,0.5331781140861467,0.526,491,590,0.8322033898305085
Shawn Kemp,kempsh01,PF,22,SEA,1992,64,1808.0,994,86,264,401,665,70,124,156,261,362,718,0.5041782729805014,0,3,0.0,362,715,0.5062937062937063,0.504,270,361,0.7479224376731302
Steve Kerr,kerrst01,PG,26,CLE,1992,48,847.0,319,110,14,64,78,27,10,31,29,121,237,0.510548523206751,32,74,0.4324324324324324,89,163,0.5460122699386503,0.578,45,54,0.8333333333333334
Jerome Kersey,kerseje01,SF,29,POR,1992,77,2553.0,971,243,241,392,633,114,71,151,254,398,852,0.4671361502347418,1,8,0.125,397,844,0.4703791469194313,0.468,174,262,0.6641221374045801
Alec Kessler,kesslal01,PF,25,MIA,1992,77,1197.0,410,34,114,200,314,17,32,58,185,158,383,0.412532637075718,0,0,0.0,158,383,0.412532637075718,0.413,94,115,0.8173913043478261
Bo Kimble,kimblbo01,SG,25,LAC,1992,34,277.0,112,17,13,19,32,10,6,15,37,44,111,0.3963963963963964,4,13,0.3076923076923077,40,98,0.4081632653061224,0.414,20,31,0.6451612903225806
Albert King,kingal01,SF,32,WSB,1992,6,59.0,31,5,1,10,11,3,0,2,7,11,30,0.3666666666666666,2,7,0.2857142857142857,9,23,0.391304347826087,0.4,7,8,0.875
Rich King,kingri01,C,22,SEA,1992,40,213.0,88,12,20,29,49,4,5,18,42,27,71,0.380281690140845,0,1,0.0,27,70,0.3857142857142857,0.38,34,45,0.7555555555555555
Stacey King,kingst01,PF,25,CHI,1992,79,1268.0,551,77,87,118,205,21,25,76,129,215,425,0.5058823529411764,2,5,0.4,213,420,0.5071428571428571,0.508,119,158,0.7531645569620253
Greg Kite,kitegr01,C,30,ORL,1992,72,1479.0,228,44,156,246,402,30,57,61,212,94,215,0.4372093023255814,0,1,0.0,94,214,0.4392523364485981,0.437,40,68,0.5882352941176471
Joe Kleine,kleinjo01,C,30,BOS,1992,70,991.0,326,32,94,202,296,23,14,27,99,144,293,0.4914675767918088,4,8,0.5,140,285,0.4912280701754385,0.498,34,48,0.7083333333333334
Negele Knight,knighne01,PG,24,PHO,1992,42,631.0,243,112,16,30,46,24,3,58,58,103,217,0.4746543778801843,4,13,0.3076923076923077,99,204,0.4852941176470588,0.484,33,48,0.6875
Bart Kofoed,kofoeba01,SG,27,SEA,1992,44,239.0,66,51,6,20,26,2,2,20,26,25,53,0.4716981132075472,1,7,0.1428571428571428,24,46,0.5217391304347826,0.481,15,26,0.5769230769230769
Jon Koncak,koncajo01,C,28,ATL,1992,77,1489.0,241,132,62,199,261,50,67,54,207,111,284,0.3908450704225352,0,12,0.0,111,272,0.4080882352941176,0.391,19,29,0.6551724137931034
Larry Krystkowiak,krystla01,PF,27,MIL,1992,79,1848.0,714,114,131,298,429,54,12,115,218,293,660,0.4439393939393939,0,5,0.0,293,655,0.4473282442748091,0.444,128,169,0.757396449704142
Bill Laimbeer,laimbbi01,C,34,DET,1992,81,2234.0,783,160,104,347,451,51,54,102,225,342,727,0.4704264099037138,32,85,0.3764705882352941,310,642,0.4828660436137071,0.492,67,75,0.8933333333333333
Jerome Lane,laneje01,PF,25,TOT,1992,14,177.0,37,17,32,34,66,2,1,14,28,14,46,0.3043478260869565,0,0,0.0,14,46,0.3043478260869565,0.304,9,27,0.3333333333333333
Andrew Lang,langan01,C,25,PHO,1992,81,1965.0,622,43,170,376,546,48,201,87,306,248,475,0.5221052631578947,0,1,0.0,248,474,0.5232067510548524,0.522,126,164,0.7682926829268293
Eric Leckner,leckner01,C,25,CHH,1992,59,716.0,196,31,49,157,206,9,18,39,114,79,154,0.512987012987013,0,1,0.0,79,153,0.5163398692810458,0.513,38,51,0.7450980392156863
Doug Lee,leedo01,SG,27,NJN,1992,46,307.0,120,22,17,18,35,11,1,12,39,50,116,0.4310344827586206,10,37,0.2702702702702703,40,79,0.5063291139240507,0.474,10,19,0.5263157894736842
Gary Leonard,leonaga01,C,24,ATL,1992,5,13.0,10,1,3,2,5,1,0,1,3,4,6,0.6666666666666666,0,0,0.0,4,6,0.6666666666666666,0.667,2,2,1.0
Jim Les,lesji01,PG,28,SAC,1992,62,712.0,231,143,11,52,63,31,3,42,58,74,192,0.3854166666666667,45,131,0.3435114503816794,29,61,0.4754098360655737,0.503,38,47,0.8085106382978723
Fat Lever,leverfa01,SG,31,DAL,1992,31,884.0,347,107,56,105,161,46,12,36,73,135,349,0.3868194842406877,17,52,0.3269230769230769,118,297,0.3973063973063973,0.411,60,80,0.75
Cliff Levingston,levincl01,PF,31,CHI,1992,79,1020.0,311,66,109,118,227,27,45,42,134,125,251,0.49800796812749,1,6,0.1666666666666666,124,245,0.5061224489795918,0.5,60,96,0.625
Reggie Lewis,lewisre01,SG,26,BOS,1992,82,3070.0,1703,185,117,277,394,125,105,136,258,703,1397,0.5032211882605584,5,21,0.238095238095238,698,1376,0.5072674418604651,0.505,292,343,0.8513119533527697
Marcus Liberty,liberma01,SF,23,DEN,1992,75,1527.0,698,58,144,164,308,66,29,90,165,275,621,0.4428341384863124,17,50,0.34,258,571,0.4518388791593695,0.457,131,180,0.7277777777777777
Todd Lichti,lichtto01,SG,25,DEN,1992,68,1176.0,446,74,36,82,118,43,12,72,131,173,376,0.4601063829787234,1,9,0.1111111111111111,172,367,0.4686648501362397,0.461,99,118,0.8389830508474576
Alton Lister,listeal01,C,33,GSW,1992,26,293.0,102,14,21,71,92,5,16,20,61,44,79,0.5569620253164557,0,0,0.0,44,79,0.5569620253164557,0.557,14,33,0.4242424242424242
Brad Lohaus,lohaubr01,PF,27,MIL,1992,70,1081.0,408,74,65,184,249,40,71,46,144,162,360,0.45,57,144,0.3958333333333333,105,216,0.4861111111111111,0.529,27,41,0.6585365853658537
Grant Long,longgr01,PF,25,MIA,1992,82,3063.0,1212,225,259,432,691,139,40,185,248,440,890,0.4943820224719101,6,22,0.2727272727272727,434,868,0.5,0.498,326,404,0.806930693069307
Luc Longley,longllu01,C,23,MIN,1992,66,991.0,281,53,67,190,257,35,64,83,157,114,249,0.4578313253012048,0,0,0.0,114,249,0.4578313253012048,0.458,53,80,0.6625
Kevin Lynch,lynchke01,SG,23,CHH,1992,55,819.0,224,83,30,55,85,37,9,44,107,93,223,0.4170403587443946,3,8,0.375,90,215,0.4186046511627907,0.424,35,46,0.7608695652173914
Mark Macon,maconma01,SG,22,DEN,1992,76,2304.0,805,168,80,140,220,154,14,155,242,333,889,0.374578177727784,4,30,0.1333333333333333,329,859,0.3830034924330617,0.377,135,185,0.7297297297297297
Dan Majerle,majerda01,SF,26,PHO,1992,82,2853.0,1418,274,148,335,483,131,43,102,158,551,1153,0.4778837814397225,87,228,0.3815789473684211,464,925,0.5016216216216216,0.516,229,303,0.7557755775577558
Jeff Malone,malonje01,SG,30,UTA,1992,81,2922.0,1639,180,49,184,233,56,5,140,126,691,1353,0.5107169253510717,1,12,0.0833333333333333,690,1341,0.5145413870246085,0.511,256,285,0.8982456140350877
Karl Malone,malonka01,PF,28,UTA,1992,81,3054.0,2272,241,225,684,909,108,51,248,226,798,1516,0.5263852242744064,3,17,0.1764705882352941,795,1499,0.5303535690460307,0.527,673,865,0.7780346820809249
Moses Malone,malonmo01,C,36,MIL,1992,82,2511.0,1279,93,320,424,744,74,64,150,136,440,929,0.4736275565123789,3,8,0.375,437,921,0.4744842562432139,0.475,396,504,0.7857142857142857
Danny Manning,mannida01,PF,25,LAC,1992,82,2904.0,1579,285,229,335,564,135,122,210,293,650,1199,0.5421184320266889,0,5,0.0,650,1194,0.5443886097152428,0.542,279,385,0.7246753246753247
Šarūnas Marčiulionis,marcisa01,SG,27,GSW,1992,72,2117.0,1361,243,68,140,208,116,10,193,237,491,912,0.5383771929824561,3,10,0.3,488,902,0.541019955654102,0.54,376,477,0.7882599580712788
Anthony Mason,masonan01,PF,25,NYK,1992,82,2198.0,573,106,216,357,573,46,20,101,229,203,399,0.5087719298245614,0,0,0.0,203,399,0.5087719298245614,0.509,167,260,0.6423076923076924
Tony Massenburg,masseto01,PF,24,TOT,1992,18,90.0,29,0,7,18,25,1,1,9,21,10,25,0.4,0,0,0.0,10,25,0.4,0.4,9,15,0.6
Vernon Maxwell,maxweve01,SG,26,HOU,1992,80,2700.0,1372,326,37,206,243,104,28,178,200,502,1216,0.4128289473684211,162,473,0.3424947145877378,340,743,0.4576043068640646,0.479,206,267,0.7715355805243446
Tharon Mayes,mayesth01,SG,23,TOT,1992,24,255.0,99,35,3,13,16,16,2,31,41,30,99,0.303030303030303,15,41,0.3658536585365853,15,58,0.2586206896551724,0.379,24,36,0.6666666666666666
Travis Mays,maystr01,PG,23,ATL,1992,2,32.0,17,1,1,1,2,0,0,3,4,6,14,0.4285714285714285,3,6,0.5,3,8,0.375,0.536,2,2,1.0
Bob McCann,mccanbo01,SF,27,DET,1992,26,129.0,30,6,12,18,30,6,4,7,23,13,33,0.3939393939393939,0,1,0.0,13,32,0.40625,0.394,4,13,0.3076923076923077
George McCloud,mccloge01,SF,24,IND,1992,51,892.0,338,116,45,87,132,26,11,62,95,128,313,0.4089456869009584,32,94,0.3404255319148936,96,219,0.4383561643835616,0.46,50,64,0.78125
Tim McCormick,mccorti01,C,29,NYK,1992,22,108.0,42,9,14,20,34,2,0,8,18,14,33,0.4242424242424242,0,0,0.0,14,33,0.4242424242424242,0.424,14,21,0.6666666666666666
Rodney McCray,mccraro01,SF,30,DAL,1992,75,2106.0,677,219,149,319,468,48,30,115,180,271,622,0.4356913183279742,25,85,0.2941176470588235,246,537,0.4581005586592179,0.456,110,153,0.7189542483660131
Xavier McDaniel,mcdanxa01,SF,28,NYK,1992,82,2344.0,1125,149,176,284,460,57,24,147,241,488,1021,0.4779627815866797,12,39,0.3076923076923077,476,982,0.4847250509164969,0.484,137,192,0.7135416666666666
Kevin McHale,mchalke01,PF,34,BOS,1992,56,1398.0,780,82,119,211,330,11,59,82,112,323,634,0.5094637223974764,0,13,0.0,323,621,0.5201288244766505,0.509,134,163,0.8220858895705522
Derrick McKey,mckeyde01,SF,25,SEA,1992,52,1757.0,777,120,95,173,268,61,47,114,142,285,604,0.4718543046357616,19,50,0.38,266,554,0.4801444043321299,0.488,188,222,0.8468468468468469
Carlton McKinney,mckinca01,SG,27,NYK,1992,2,9.0,4,0,0,1,1,0,0,0,1,2,9,0.2222222222222222,0,0,0.0,2,9,0.2222222222222222,0.222,0,0,0.0
Nate McMillan,mcmilna01,PG,27,SEA,1992,72,1652.0,435,359,92,160,252,129,29,112,218,177,405,0.437037037037037,27,98,0.2755102040816326,150,307,0.4885993485342019,0.47,54,84,0.6428571428571429
Reggie Miller,millere01,SG,26,IND,1992,82,3120.0,1695,314,82,236,318,105,26,157,210,562,1121,0.5013380909901873,129,341,0.3782991202346041,433,780,0.5551282051282052,0.559,442,515,0.858252427184466
Terry Mills,millste01,PF,24,NJN,1992,82,1714.0,742,84,187,266,453,48,41,82,200,310,670,0.4626865671641791,8,23,0.3478260869565217,302,647,0.4667697063369397,0.469,114,152,0.75
Sam Mitchell,mitchsa01,PF,28,MIN,1992,82,2151.0,825,94,158,315,473,53,39,97,230,307,725,0.4234482758620689,2,11,0.1818181818181818,305,714,0.4271708683473389,0.425,209,266,0.7857142857142857
Rodney Monroe,monroro01,SG,23,ATL,1992,38,313.0,131,27,12,21,33,12,2,23,19,53,144,0.3680555555555556,6,27,0.2222222222222222,47,117,0.4017094017094017,0.389,19,23,0.8260869565217391
Tracy Moore,mooretr01,SF,26,DAL,1992,42,782.0,355,48,31,51,82,32,4,44,97,130,325,0.4,30,84,0.3571428571428571,100,241,0.4149377593360996,0.446,65,78,0.8333333333333334
Chris Morris,morrich01,SF,26,NJN,1992,77,2394.0,879,197,199,295,494,129,81,171,211,346,726,0.4765840220385675,22,110,0.2,324,616,0.525974025974026,0.492,165,231,0.7142857142857143
John Morton,mortojo01,SF-SG,24,TOT,1992,25,270.0,106,32,6,20,26,13,1,28,23,36,93,0.3870967741935484,2,16,0.125,34,77,0.4415584415584415,0.398,32,38,0.8421052631578947
Chris Mullin,mullich01,SF,28,GSW,1992,81,3346.0,2074,286,127,323,450,173,62,202,171,830,1584,0.523989898989899,64,175,0.3657142857142857,766,1409,0.5436479772888574,0.544,350,420,0.8333333333333334
Eric Murdock,murdoer01,PG,23,UTA,1992,50,478.0,203,92,21,33,54,30,7,50,52,76,183,0.4153005464480874,5,26,0.1923076923076923,71,157,0.4522292993630573,0.429,46,61,0.7540983606557377
Tod Murphy,murphto01,PF,28,MIN,1992,47,429.0,98,11,36,74,110,9,8,18,40,39,80,0.4875,1,2,0.5,38,78,0.4871794871794871,0.494,19,34,0.5588235294117647
Jerrod Mustaf,mustaje01,PF,22,PHO,1992,52,545.0,233,45,45,100,145,21,16,51,59,92,193,0.4766839378238341,0,0,0.0,92,193,0.4766839378238341,0.477,49,71,0.6901408450704225
Dikembe Mutombo,mutomdi01,C,25,DEN,1992,71,2716.0,1177,156,316,554,870,43,210,252,273,428,869,0.4925201380897583,0,0,0.0,428,869,0.4925201380897583,0.493,321,500,0.642
Larry Nance,nancela01,PF,32,CLE,1992,81,2880.0,1375,232,213,457,670,80,243,87,200,556,1032,0.5387596899224806,0,6,0.0,556,1026,0.5419103313840156,0.539,263,320,0.821875
Ed Nealy,nealyed01,PF,31,PHO,1992,52,505.0,160,37,25,86,111,16,2,17,45,62,121,0.512396694214876,20,50,0.4,42,71,0.5915492957746479,0.595,16,24,0.6666666666666666
Chuck Nevitt,nevitch01,C,32,CHI,1992,4,9.0,2,1,0,1,1,0,0,3,2,1,3,0.3333333333333333,0,0,0.0,1,3,0.3333333333333333,0.333,0,0,0.0
Johnny Newman,newmajo01,SF,28,CHH,1992,55,1651.0,839,146,71,108,179,70,14,129,181,295,618,0.4773462783171521,13,46,0.2826086956521739,282,572,0.493006993006993,0.488,236,308,0.7662337662337663
Ken Norman,normake01,SF,27,LAC,1992,77,2009.0,929,125,158,290,448,53,66,100,145,402,821,0.489646772228989,4,28,0.1428571428571428,398,793,0.501891551071879,0.492,121,226,0.5353982300884956
Charles Oakley,oaklech01,PF,28,NYK,1992,82,2309.0,506,133,256,444,700,67,15,123,258,210,402,0.5223880597014925,0,3,0.0,210,399,0.5263157894736842,0.522,86,117,0.7350427350427351
Alan Ogg,oggal01,C,24,MIA,1992,43,367.0,108,7,30,44,74,5,28,19,73,46,84,0.5476190476190477,0,0,0.0,46,84,0.5476190476190477,0.548,16,30,0.5333333333333333
Hakeem Olajuwon,olajuha01,C,29,HOU,1992,70,2636.0,1510,157,246,599,845,127,304,187,263,591,1177,0.5021240441801189,0,1,0.0,591,1176,0.5025510204081632,0.502,328,428,0.7663551401869159
Brian Oliver,olivebr01,SG,23,PHI,1992,34,279.0,81,20,10,20,30,10,2,24,33,33,100,0.33,0,4,0.0,33,96,0.34375,0.33,15,22,0.6818181818181818
Jimmy Oliver,oliveji01,SG,22,CLE,1992,27,252.0,96,20,9,18,27,9,2,9,22,39,98,0.3979591836734694,1,9,0.1111111111111111,38,89,0.4269662921348314,0.403,17,22,0.7727272727272727
Billy Owens,owensbi01,PF,22,GSW,1992,80,2510.0,1141,188,243,396,639,90,65,179,276,468,891,0.5252525252525253,1,9,0.1111111111111111,467,882,0.5294784580498866,0.526,204,312,0.6538461538461539
Keith Owens,owenske01,SF,22,LAL,1992,20,80.0,26,3,8,7,15,5,4,2,11,9,32,0.28125,0,0,0.0,9,32,0.28125,0.281,8,10,0.8
Robert Pack,packro01,PG,22,POR,1992,72,894.0,332,140,32,65,97,40,4,92,101,115,272,0.4227941176470588,0,10,0.0,115,262,0.4389312977099237,0.423,102,127,0.8031496062992126
Robert Parish,parisro01,C,38,BOS,1992,79,2285.0,1115,70,219,486,705,68,97,131,172,468,874,0.5354691075514875,0,0,0.0,468,874,0.5354691075514875,0.535,179,232,0.771551724137931
John Paxson,paxsojo01,PG,31,CHI,1992,79,1946.0,555,241,21,75,96,49,9,44,142,257,487,0.5277207392197125,12,44,0.2727272727272727,245,443,0.5530474040632054,0.54,29,37,0.7837837837837838
Kenny Payne,payneke01,SF,25,PHI,1992,49,353.0,144,17,13,41,54,16,8,19,34,65,145,0.4482758620689655,5,12,0.4166666666666667,60,133,0.4511278195488721,0.466,9,13,0.6923076923076923
Gary Payton,paytoga01,PG,23,SEA,1992,81,2549.0,764,506,123,172,295,147,21,174,248,331,734,0.4509536784741144,3,23,0.1304347826086956,328,711,0.4613220815752461,0.453,99,148,0.668918918918919
Will Perdue,perduwi01,C,26,CHI,1992,77,1007.0,350,80,108,204,312,16,43,72,133,152,278,0.5467625899280576,1,2,0.5,151,276,0.5471014492753623,0.549,45,91,0.4945054945054945
Sam Perkins,perkisa01,PF,30,LAL,1992,63,2332.0,1041,141,192,364,556,64,62,83,192,361,803,0.4495641344956413,15,69,0.217391304347826,346,734,0.4713896457765668,0.459,304,372,0.8172043010752689
Elliot Perry,perryel01,PG,22,TOT,1992,50,437.0,126,78,14,25,39,34,3,50,36,49,129,0.3798449612403101,1,7,0.1428571428571428,48,122,0.3934426229508196,0.384,27,41,0.6585365853658537
Tim Perry,perryti01,PF,26,PHO,1992,80,2483.0,982,134,204,347,551,44,116,141,237,413,789,0.523447401774398,3,8,0.375,410,781,0.5249679897567221,0.525,153,215,0.7116279069767442
Chuck Person,persoch01,SF,27,IND,1992,81,2923.0,1497,382,114,312,426,68,18,216,247,616,1284,0.4797507788161994,132,354,0.3728813559322034,484,930,0.5204301075268817,0.531,133,197,0.6751269035532995
Jim Petersen,peterji01,PF,29,GSW,1992,27,169.0,43,9,12,33,45,5,6,5,35,18,40,0.45,0,2,0.0,18,38,0.4736842105263157,0.45,7,10,0.7
Dražen Petrović,petrodr01,SG,27,NJN,1992,82,3027.0,1691,252,97,161,258,105,11,215,248,668,1315,0.5079847908745247,123,277,0.4440433212996389,545,1038,0.5250481695568401,0.555,232,287,0.8083623693379791
Bobby Phills,phillbo01,SG,22,CLE,1992,10,65.0,31,4,4,4,8,3,1,8,3,12,28,0.4285714285714285,0,2,0.0,12,26,0.4615384615384615,0.429,7,11,0.6363636363636364
Ricky Pierce,piercri01,SG,32,SEA,1992,78,2658.0,1690,241,93,140,233,86,20,189,213,620,1306,0.4747320061255742,33,123,0.2682926829268293,587,1183,0.4961961115807269,0.487,417,455,0.9164835164835164
Ed Pinckney,pincked01,PF,28,BOS,1992,81,1917.0,613,62,252,312,564,70,56,73,158,203,378,0.5370370370370371,0,1,0.0,203,377,0.5384615384615384,0.537,207,255,0.8117647058823529
Scottie Pippen,pippesc01,SF,26,CHI,1992,82,3164.0,1720,572,185,445,630,155,93,253,242,687,1359,0.5055187637969095,16,80,0.2,671,1279,0.524628616106333,0.511,330,434,0.7603686635944701
Olden Polynice,polynol01,C,27,LAC,1992,76,1834.0,613,46,195,341,536,45,20,83,165,244,470,0.5191489361702127,0,1,0.0,244,469,0.5202558635394456,0.519,125,201,0.6218905472636815
Dave Popson,popsoda01,PF,27,MIL,1992,5,26.0,7,3,2,3,5,2,1,4,5,3,7,0.4285714285714285,0,1,0.0,3,6,0.5,0.429,1,2,0.5
Terry Porter,portete01,PG,28,POR,1992,82,2784.0,1485,477,51,204,255,127,12,188,155,521,1129,0.4614703277236492,128,324,0.3950617283950617,393,805,0.4881987577639751,0.518,315,368,0.8559782608695652
Paul Pressey,presspa01,SG,33,SAS,1992,56,759.0,151,142,22,73,95,29,19,64,86,60,161,0.3726708074534161,3,21,0.1428571428571428,57,140,0.4071428571428571,0.382,28,41,0.6829268292682927
Mark Price,pricema01,PG,27,CLE,1992,72,2138.0,1247,535,38,135,173,94,12,159,113,438,897,0.4882943143812709,101,261,0.3869731800766283,337,636,0.529874213836478,0.545,270,285,0.9473684210526316
Kevin Pritchard,pritcke01,PG,24,BOS,1992,11,136.0,46,30,1,10,11,3,4,11,17,16,34,0.4705882352941176,0,3,0.0,16,31,0.5161290322580645,0.471,14,18,0.7777777777777778
Brian Quinnett,quinnbr01,SG,25,TOT,1992,39,326.0,115,12,16,35,51,16,8,16,32,43,124,0.3467741935483871,13,41,0.3170731707317073,30,83,0.3614457831325301,0.399,16,26,0.6153846153846154
Kurt Rambis,rambiku01,PF,33,PHO,1992,28,381.0,90,37,23,83,106,12,14,25,46,38,82,0.4634146341463415,0,0,0.0,38,82,0.4634146341463415,0.463,14,18,0.7777777777777778
Mark Randall,randama01,PF,24,TOT,1992,54,441.0,171,33,39,32,71,12,3,25,39,68,149,0.4563758389261745,3,16,0.1875,65,133,0.4887218045112781,0.466,32,43,0.7441860465116279
Blair Rasmussen,rasmubl01,C,29,ATL,1992,81,1968.0,729,107,94,299,393,35,48,51,233,347,726,0.477961432506887,5,23,0.217391304347826,342,703,0.4864864864864865,0.481,30,40,0.75
J.R. Reid,reidjr01,C,23,CHH,1992,51,1257.0,560,81,96,221,317,49,23,84,159,213,435,0.4896551724137931,0,3,0.0,213,432,0.4930555555555556,0.49,134,190,0.7052631578947368
Jerry Reynolds,reynoje01,SG,29,ORL,1992,46,1159.0,555,151,47,102,149,63,17,96,69,197,518,0.3803088803088803,3,24,0.125,194,494,0.3927125506072874,0.383,158,189,0.8359788359788359
Glen Rice,ricegl01,SF,24,MIA,1992,79,3007.0,1765,184,84,310,394,90,35,145,170,672,1432,0.4692737430167598,155,396,0.3914141414141414,517,1036,0.499034749034749,0.523,266,318,0.8364779874213837
Pooh Richardson,richapo01,PG,25,MIN,1992,82,2922.0,1350,685,91,210,301,119,25,204,152,587,1261,0.4655035685963521,53,155,0.3419354838709677,534,1106,0.4828209764918625,0.487,123,178,0.6910112359550562
Mitch Richmond,richmmi01,SG,26,SAC,1992,80,3095.0,1803,411,62,257,319,92,34,247,231,685,1465,0.4675767918088737,103,268,0.3843283582089552,582,1197,0.4862155388471177,0.503,330,406,0.812807881773399
David Rivers,riverda01,PG,27,LAC,1992,15,122.0,30,21,10,9,19,7,1,17,14,10,30,0.3333333333333333,0,1,0.0,10,29,0.3448275862068966,0.333,10,11,0.9090909090909092
Doc Rivers,riverdo01,PG,30,LAC,1992,59,1657.0,641,233,23,124,147,111,19,92,166,226,533,0.424015009380863,26,92,0.2826086956521739,200,441,0.4535147392290249,0.448,163,196,0.8316326530612245
Fred Roberts,roberfr01,PF,31,MIL,1992,80,1746.0,769,122,103,154,257,52,40,122,177,311,645,0.4821705426356589,19,37,0.5135135135135135,292,608,0.4802631578947368,0.497,128,171,0.7485380116959064
Stanley Roberts,roberst01,C,21,ORL,1992,55,1118.0,573,39,113,223,336,22,83,78,221,236,446,0.5291479820627802,0,1,0.0,236,445,0.5303370786516854,0.529,101,196,0.5153061224489796
Alvin Robertson,roberal01,SG,29,MIL,1992,82,2463.0,1010,360,175,175,350,210,32,223,263,396,922,0.4295010845986984,67,210,0.319047619047619,329,712,0.4620786516853932,0.466,151,198,0.7626262626262627
Cliff Robinson,robincl01,PF,31,LAL,1992,9,78.0,29,9,7,12,19,5,0,7,4,11,27,0.4074074074074074,0,1,0.0,11,26,0.4230769230769231,0.407,7,8,0.875
Clifford Robinson,robincl02,SF,25,POR,1992,82,2124.0,1016,137,140,276,416,85,107,154,274,398,854,0.4660421545667447,1,11,0.0909090909090909,397,843,0.4709371293001186,0.467,219,330,0.6636363636363637
David Robinson,robinda01,C,26,SAS,1992,68,2564.0,1578,181,261,568,829,158,305,182,219,592,1074,0.5512104283054003,1,8,0.125,591,1066,0.5544090056285178,0.552,393,561,0.7005347593582888
Larry Robinson,robinla01,SG,24,BOS,1992,1,6.0,2,1,2,0,2,0,0,1,3,1,5,0.2,0,0,0.0,1,5,0.2,0.2,0,0,0.0
Rumeal Robinson,robinru01,PG,25,ATL,1992,81,2220.0,1055,446,64,155,219,105,24,206,178,423,928,0.4558189655172414,34,104,0.3269230769230769,389,824,0.4720873786407767,0.474,175,275,0.6363636363636364
Dennis Rodman,rodmade01,PF,30,DET,1992,82,3301.0,800,191,523,1007,1530,68,70,140,248,342,635,0.5385826771653544,32,101,0.3168316831683168,310,534,0.5805243445692884,0.564,84,140,0.6
Tree Rollins,rollitr01,C,36,HOU,1992,59,697.0,118,15,61,110,171,14,62,18,85,46,86,0.5348837209302325,0,0,0.0,46,86,0.5348837209302325,0.535,26,30,0.8666666666666667
Donald Royal,royaldo01,SF,25,SAS,1992,60,718.0,252,34,65,59,124,25,7,39,73,80,178,0.449438202247191,0,0,0.0,80,178,0.449438202247191,0.449,92,133,0.6917293233082706
Delaney Rudd,ruddde01,SG,29,UTA,1992,65,538.0,193,109,15,39,54,15,1,49,64,75,188,0.3989361702127659,11,47,0.2340425531914893,64,141,0.4539007092198581,0.428,32,42,0.7619047619047619
Jeff Ruland,rulanje01,C,33,PHI,1992,13,209.0,51,5,16,31,47,7,4,20,45,20,38,0.5263157894736842,0,0,0.0,20,38,0.5263157894736842,0.526,11,16,0.6875
John Salley,sallejo01,PF,27,DET,1992,72,1774.0,684,116,106,190,296,49,110,102,222,249,486,0.5123456790123457,0,3,0.0,249,483,0.515527950310559,0.512,186,260,0.7153846153846154
Ralph Sampson,sampsra01,C,31,WSB,1992,10,108.0,22,4,11,19,30,3,8,10,14,9,29,0.3103448275862069,0,2,0.0,9,27,0.3333333333333333,0.31,4,6,0.6666666666666666
Jeff Sanders,sandeje01,SF,26,ATL,1992,12,117.0,47,9,9,17,26,5,3,5,15,20,45,0.4444444444444444,0,0,0.0,20,45,0.4444444444444444,0.444,7,9,0.7777777777777778
Mike Sanders,sandemi01,SF,31,TOT,1992,31,633.0,221,53,27,69,96,24,10,22,83,92,161,0.5714285714285714,1,3,0.3333333333333333,91,158,0.5759493670886076,0.575,36,47,0.7659574468085106
Danny Schayes,schayda01,C,32,MIL,1992,43,726.0,240,34,58,110,168,19,19,41,98,83,199,0.4170854271356783,0,0,0.0,83,199,0.4170854271356783,0.417,74,96,0.7708333333333334
Steve Scheffler,schefst01,C,24,TOT,1992,11,61.0,21,0,10,4,14,3,1,1,10,6,9,0.6666666666666666,0,0,0.0,6,9,0.6666666666666666,0.667,9,12,0.75
Dwayne Schintzius,schindw01,C,23,SAC,1992,33,400.0,110,20,43,75,118,6,28,19,67,50,117,0.4273504273504273,0,4,0.0,50,113,0.4424778761061947,0.427,10,12,0.8333333333333334
Detlef Schrempf,schrede01,PF,29,IND,1992,80,2605.0,1380,312,202,568,770,62,37,191,286,496,925,0.5362162162162162,23,71,0.323943661971831,473,854,0.5538641686182669,0.549,365,441,0.8276643990929705
Byron Scott,scottby01,SG,30,LAL,1992,82,2679.0,1218,226,74,236,310,105,28,119,140,460,1005,0.4577114427860697,54,157,0.3439490445859872,406,848,0.4787735849056603,0.485,244,291,0.8384879725085911
Dennis Scott,scottde01,SF,23,ORL,1992,18,608.0,359,35,14,52,66,20,9,31,49,133,331,0.4018126888217522,29,89,0.3258426966292135,104,242,0.4297520661157025,0.446,64,71,0.9014084507042254
Rony Seikaly,seikaro01,C,26,MIA,1992,79,2800.0,1296,109,307,627,934,40,121,216,278,463,947,0.4889123548046462,0,3,0.0,463,944,0.4904661016949153,0.489,370,505,0.7326732673267327
Brad Sellers,sellebr01,PF,29,DET,1992,43,226.0,102,14,15,27,42,1,10,15,20,41,88,0.4659090909090909,0,1,0.0,41,87,0.4712643678160919,0.466,20,26,0.7692307692307693
Charles Shackleford,shackch01,C,25,PHI,1992,72,1399.0,473,46,145,270,415,38,51,62,205,205,422,0.485781990521327,0,1,0.0,205,421,0.4869358669833729,0.486,63,95,0.6631578947368421
Brian Shaw,shawbr01,PG,25,TOT,1992,63,1423.0,495,250,50,154,204,57,22,99,115,209,513,0.4074074074074074,5,23,0.217391304347826,204,490,0.4163265306122449,0.412,72,91,0.7912087912087912
Lionel Simmons,simmoli01,SF,23,SAC,1992,78,2895.0,1336,337,149,485,634,135,132,218,205,527,1162,0.4535283993115318,1,5,0.2,526,1157,0.4546240276577355,0.454,281,365,0.7698630136986301
Scott Skiles,skilesc01,PG,27,ORL,1992,75,2377.0,1057,544,36,166,202,74,5,233,188,359,868,0.4135944700460829,91,250,0.364,268,618,0.4336569579288026,0.466,248,277,0.8953068592057761
Charles Smith,smithch01,SF,26,LAC,1992,49,1310.0,714,56,95,206,301,41,98,69,159,251,539,0.4656771799628942,0,6,0.0,251,533,0.4709193245778612,0.466,212,270,0.7851851851851852
Doug Smith,smithdo03,PF,22,DAL,1992,76,1707.0,671,129,129,262,391,62,34,97,259,291,702,0.4145299145299145,0,11,0.0,291,691,0.4211287988422576,0.415,89,121,0.7355371900826446
Kenny Smith,smithke01,PG,26,HOU,1992,81,2735.0,1137,562,34,143,177,104,7,227,112,432,910,0.4747252747252747,54,137,0.3941605839416058,378,773,0.4890038809831824,0.504,219,253,0.8656126482213439
LaBradford Smith,smithla02,SG,22,WSB,1992,48,708.0,247,99,30,51,81,44,1,63,98,100,246,0.4065040650406504,2,21,0.0952380952380952,98,225,0.4355555555555555,0.411,45,56,0.8035714285714286
Larry Smith,smithla01,PF,34,HOU,1992,45,800.0,104,33,107,149,256,21,7,44,121,50,92,0.5434782608695652,0,1,0.0,50,91,0.5494505494505495,0.543,4,11,0.3636363636363636
Otis Smith,smithot01,SG,28,ORL,1992,55,877.0,310,57,40,76,116,36,13,62,85,116,318,0.3647798742138364,8,21,0.3809523809523809,108,297,0.3636363636363636,0.377,70,91,0.7692307692307693
Steve Smith,smithst01,SG,22,MIA,1992,61,1806.0,729,278,81,107,188,59,19,152,162,297,654,0.4541284403669725,40,125,0.32,257,529,0.4858223062381852,0.485,95,127,0.7480314960629921
Tony Smith,smithto02,PG,23,LAL,1992,63,820.0,275,109,31,45,76,39,8,50,91,113,283,0.3992932862190813,0,11,0.0,113,272,0.4154411764705882,0.399,49,75,0.6533333333333333
Rik Smits,smitsri01,C,25,IND,1992,74,1772.0,1024,116,124,293,417,29,100,130,231,436,855,0.5099415204678363,0,2,0.0,436,853,0.511137162954279,0.51,152,193,0.7875647668393783
Mike Smrek,smrekmi01,C,29,GSW,1992,2,3.0,0,0,0,1,1,0,0,0,0,0,0,0.0,0,0,0.0,0,0,0.0,0.0,0,0,0.0
Rory Sparrow,sparrro01,PG,33,TOT,1992,46,489.0,127,83,3,25,28,12,5,33,57,58,151,0.3841059602649007,3,15,0.2,55,136,0.4044117647058823,0.394,8,13,0.6153846153846154
Felton Spencer,spencfe01,C,24,MIN,1992,61,1481.0,405,53,167,268,435,27,79,70,241,141,331,0.4259818731117825,0,0,0.0,141,331,0.4259818731117825,0.426,123,178,0.6910112359550562
John Starks,starkjo01,SG,26,NYK,1992,82,2118.0,1139,276,45,146,191,103,18,150,231,405,902,0.4490022172949002,94,270,0.3481481481481481,311,632,0.4920886075949367,0.501,235,302,0.7781456953642384
Larry Stewart,stewala01,PF,23,WSB,1992,76,2229.0,794,120,186,263,449,51,44,112,225,303,590,0.5135593220338983,0,3,0.0,303,587,0.5161839863713799,0.514,188,233,0.8068669527896996
John Stockton,stockjo01,PG,29,UTA,1992,82,3002.0,1297,1126,68,202,270,244,22,286,234,453,939,0.4824281150159744,83,204,0.4068627450980392,370,735,0.5034013605442177,0.527,308,366,0.8415300546448088
Rod Strickland,stricro02,PG,25,SAS,1992,57,2053.0,787,491,92,173,265,118,17,160,122,300,659,0.4552352048558422,5,15,0.3333333333333333,295,644,0.4580745341614907,0.459,182,265,0.6867924528301886
Derek Strong,stronde01,PF,23,WSB,1992,1,12.0,3,1,1,4,5,0,0,1,1,0,4,0.0,0,0,0.0,0,4,0.0,0.0,3,4,0.75
Lamont Strothers,strotla01,SG,23,POR,1992,4,17.0,10,1,1,0,1,1,1,2,2,4,12,0.3333333333333333,0,2,0.0,4,10,0.4,0.333,2,4,0.5
Jon Sundvold,sundvjo01,PG,30,MIA,1992,3,8.0,3,2,0,0,0,0,0,0,2,1,3,0.3333333333333333,1,1,1.0,0,2,0.0,0.5,0,0,0.0
Greg Sutton,suttogr01,PG,24,SAS,1992,67,601.0,246,91,6,41,47,26,9,70,111,93,240,0.3875,26,89,0.2921348314606741,67,151,0.4437086092715231,0.442,34,45,0.7555555555555555
Terry Teagle,teaglte01,SG,31,LAL,1992,82,1602.0,880,113,91,92,183,66,9,114,148,364,805,0.4521739130434782,1,4,0.25,363,801,0.4531835205992509,0.453,151,197,0.766497461928934
Carl Thomas,thomaca01,SG,22,SAC,1992,1,31.0,12,1,0,0,0,1,0,1,3,5,12,0.4166666666666667,1,2,0.5,4,10,0.4,0.458,1,2,0.5
Charles Thomas,thomach01,SG,22,DET,1992,36,156.0,48,22,6,16,22,4,1,17,20,18,51,0.3529411764705882,2,17,0.1176470588235294,16,34,0.4705882352941176,0.373,10,15,0.6666666666666666
Isiah Thomas,thomais01,PG,30,DET,1992,78,2918.0,1445,560,68,179,247,118,15,252,194,564,1264,0.4462025316455696,25,86,0.2906976744186046,539,1178,0.4575551782682512,0.456,292,378,0.7724867724867724
Billy Thompson,thompbi01,SF,28,GSW,1992,1,1.0,0,0,0,0,0,0,0,0,0,0,0,0.0,0,0,0.0,0,0,0.0,0.0,0,0,0.0
LaSalle Thompson,thompla01,C,30,IND,1992,80,1299.0,394,102,98,283,381,52,34,98,207,168,359,0.467966573816156,0,2,0.0,168,357,0.4705882352941176,0.468,58,71,0.8169014084507042
Stephen Thompson,thompst01,SG,23,TOT,1992,19,91.0,31,8,11,8,19,6,3,5,9,14,37,0.3783783783783784,0,1,0.0,14,36,0.3888888888888889,0.378,3,8,0.375
Bob Thornton,thornbo01,PF,29,UTA,1992,2,6.0,4,0,2,0,2,0,0,0,1,1,7,0.1428571428571428,0,0,0.0,1,7,0.1428571428571428,0.143,2,2,1.0
Otis Thorpe,thorpot01,PF,29,HOU,1992,82,3056.0,1420,250,285,577,862,52,37,237,307,558,943,0.591728525980912,0,7,0.0,558,936,0.5961538461538461,0.592,304,463,0.6565874730021598
Sedale Threatt,threase01,PG,30,LAL,1992,82,3070.0,1240,593,43,210,253,168,16,182,231,509,1041,0.48895292987512,20,62,0.3225806451612903,489,979,0.4994892747701736,0.499,202,243,0.831275720164609
Wayman Tisdale,tisdawa01,PF,27,SAC,1992,72,2521.0,1195,106,135,334,469,55,79,124,248,522,1043,0.5004793863854267,0,2,0.0,522,1041,0.5014409221902018,0.5,151,198,0.7626262626262627
Tom Tolbert,tolbeto01,PF,26,GSW,1992,35,310.0,90,21,14,41,55,10,6,20,73,33,86,0.3837209302325581,2,8,0.25,31,78,0.3974358974358974,0.395,22,40,0.55
Trent Tucker,tucketr01,SG,32,SAS,1992,24,415.0,155,27,8,29,37,21,3,14,39,60,129,0.4651162790697674,19,48,0.3958333333333333,41,81,0.5061728395061729,0.539,16,20,0.8
Andre Turner,turnean01,PG,27,WSB,1992,70,871.0,284,177,17,73,90,57,2,84,59,111,261,0.425287356321839,1,16,0.0625,110,245,0.4489795918367347,0.427,61,77,0.7922077922077922
Jeff Turner,turneje01,SF,29,ORL,1992,75,1591.0,530,92,62,184,246,24,16,106,229,225,499,0.4509018036072144,1,8,0.125,224,491,0.4562118126272912,0.452,79,114,0.6929824561403509
John Turner,turnejo01,SF,24,HOU,1992,42,345.0,117,12,38,40,78,6,4,32,40,43,98,0.4387755102040816,0,0,0.0,43,98,0.4387755102040816,0.439,31,59,0.5254237288135594
Kiki Vandeweghe,vandeki01,SF,33,NYK,1992,67,956.0,467,57,31,57,88,15,8,27,87,188,383,0.4908616187989556,26,66,0.3939393939393939,162,317,0.5110410094637224,0.525,65,81,0.8024691358024691
Loy Vaught,vaughlo01,PF,23,LAC,1992,79,1687.0,601,71,160,352,512,37,31,66,165,271,551,0.4918330308529945,4,5,0.8,267,546,0.489010989010989,0.495,55,69,0.7971014492753623
João Vianna,viannjo01,SF,25,DAL,1992,1,9.0,2,2,0,0,0,0,0,1,3,1,2,0.5,0,0,0.0,1,2,0.5,0.5,0,0,0.0
Sam Vincent,vincesa01,PG,28,ORL,1992,39,885.0,411,148,19,82,101,35,4,72,55,150,349,0.4297994269340974,1,13,0.0769230769230769,149,336,0.4434523809523809,0.431,110,130,0.8461538461538461
Alexander Volkov,volkoal01,C,27,ATL,1992,77,1516.0,662,250,103,162,265,66,30,102,178,251,569,0.4411247803163444,35,110,0.3181818181818182,216,459,0.4705882352941176,0.472,125,198,0.6313131313131313
Stojko Vranković,vrankst01,C,28,BOS,1992,19,110.0,37,5,8,20,28,0,17,10,22,15,32,0.46875,0,0,0.0,15,32,0.46875,0.469,7,12,0.5833333333333334
Darrell Walker,walkeda01,SG,30,DET,1992,74,1541.0,387,205,85,153,238,63,18,79,134,161,381,0.4225721784776903,0,10,0.0,161,371,0.4339622641509434,0.423,65,105,0.6190476190476191
Spud Webb,webbsp01,PG,28,SAC,1992,77,2724.0,1231,547,30,193,223,125,24,229,193,448,1006,0.4453280318091451,73,199,0.3668341708542713,375,807,0.4646840148698885,0.482,262,305,0.8590163934426229
Doug West,westdo01,SG,24,MIN,1992,80,2540.0,1116,281,107,150,257,66,26,120,239,463,894,0.5178970917225951,4,23,0.1739130434782608,459,871,0.5269804822043628,0.52,186,231,0.8051948051948052
Mark West,westma01,C,31,PHO,1992,82,1436.0,501,22,134,238,372,14,81,82,239,196,310,0.632258064516129,0,0,0.0,196,310,0.632258064516129,0.632,109,171,0.6374269005847953
Ennis Whatley,whatlen01,PG,29,POR,1992,23,209.0,69,34,6,15,21,14,3,14,12,21,51,0.4117647058823529,0,4,0.0,21,47,0.4468085106382978,0.412,27,31,0.8709677419354839
Randy White,whitera01,PF,24,DAL,1992,65,1021.0,418,31,96,140,236,31,22,68,157,145,382,0.3795811518324607,4,27,0.1481481481481481,141,355,0.3971830985915493,0.385,124,162,0.7654320987654321
Mitchell Wiggins,wiggimi01,SG,32,PHI,1992,49,569.0,211,22,43,51,94,20,1,25,67,88,229,0.3842794759825327,0,1,0.0,88,228,0.3859649122807017,0.384,35,51,0.6862745098039216
Morlon Wiley,wileymo01,PG,25,TOT,1992,53,870.0,204,180,24,57,81,47,3,60,89,83,193,0.4300518134715025,14,42,0.3333333333333333,69,151,0.4569536423841059,0.466,24,35,0.6857142857142857
Dominique Wilkins,wilkido01,SF,32,ATL,1992,42,1601.0,1179,158,103,192,295,52,24,122,77,424,914,0.4638949671772429,37,128,0.2890625,387,786,0.4923664122137404,0.484,294,352,0.8352272727272727
Gerald Wilkins,wilkige01,SG,28,NYK,1992,82,2344.0,1016,219,74,132,206,76,17,113,195,431,964,0.4470954356846473,38,108,0.3518518518518518,393,856,0.4591121495327103,0.467,116,159,0.7295597484276729
Buck Williams,willibu01,PF,31,POR,1992,80,2519.0,901,108,260,444,704,62,41,130,244,340,563,0.6039076376554174,0,1,0.0,340,562,0.604982206405694,0.604,221,293,0.7542662116040956
Herb Williams,willihe01,C,33,DAL,1992,75,2040.0,859,94,106,348,454,35,98,114,189,367,851,0.4312573443008226,1,6,0.1666666666666666,366,845,0.4331360946745562,0.432,124,171,0.7251461988304093
Hot Rod Williams,williho01,C,29,CLE,1992,80,2432.0,952,196,228,379,607,60,182,83,191,341,678,0.5029498525073747,0,4,0.0,341,674,0.5059347181008902,0.503,270,359,0.7520891364902507
Jayson Williams,willija01,PF,23,PHI,1992,50,646.0,206,12,62,83,145,20,20,44,110,75,206,0.3640776699029126,0,0,0.0,75,206,0.3640776699029126,0.364,56,88,0.6363636363636364
Kenny Williams,willike03,SF,22,IND,1992,60,565.0,252,40,64,65,129,20,41,22,99,113,218,0.518348623853211,0,4,0.0,113,214,0.5280373831775701,0.518,26,43,0.6046511627906976
Micheal Williams,willimi02,PG,25,IND,1992,79,2750.0,1188,647,73,209,282,233,22,240,262,404,824,0.4902912621359223,8,33,0.2424242424242424,396,791,0.5006321112515802,0.495,372,427,0.8711943793911007
Reggie Williams,willire01,SF,27,DEN,1992,81,2623.0,1474,235,145,260,405,148,68,173,270,601,1277,0.4706342991386061,56,156,0.358974358974359,545,1121,0.4861730597680642,0.493,216,269,0.8029739776951673
Scott Williams,willisc01,PF,23,CHI,1992,63,690.0,214,50,90,157,247,13,36,35,122,83,172,0.4825581395348837,0,3,0.0,83,169,0.4911242603550296,0.483,48,74,0.6486486486486487
Kevin Willis,willike02,PF,29,ATL,1992,81,2962.0,1480,173,418,840,1258,72,54,197,223,591,1224,0.4828431372549019,6,37,0.1621621621621621,585,1187,0.4928390901432182,0.485,292,363,0.8044077134986226
Kennard Winchester,winchke01,SF-SG,25,TOT,1992,19,81.0,35,8,6,9,15,2,2,2,5,13,30,0.4333333333333333,1,2,0.5,12,28,0.4285714285714285,0.45,8,10,0.8
David Wingate,wingada01,SG,28,WSB,1992,81,2127.0,638,247,80,189,269,123,21,124,162,266,572,0.465034965034965,1,18,0.0555555555555555,265,554,0.4783393501805054,0.466,105,146,0.7191780821917808
Randy Wittman,wittmra01,SG,32,IND,1992,24,115.0,17,11,1,8,9,2,0,3,4,8,19,0.4210526315789473,0,0,0.0,8,19,0.4210526315789473,0.421,1,2,0.5
Joe Wolf,wolfjo01,C,27,DEN,1992,67,1160.0,254,61,97,143,240,32,14,60,124,100,277,0.3610108303249097,1,11,0.0909090909090909,99,266,0.3721804511278195,0.363,53,66,0.803030303030303
Orlando Woolridge,woolror01,SF,32,DET,1992,82,2113.0,1146,88,109,151,260,41,33,133,154,452,907,0.4983461962513781,1,9,0.1111111111111111,451,898,0.5022271714922049,0.499,241,353,0.6827195467422096
James Worthy,worthja01,SF,30,LAL,1992,54,2108.0,1075,252,98,207,305,76,23,127,89,450,1007,0.4468718967229394,9,43,0.2093023255813953,441,964,0.4574688796680498,0.451,166,204,0.8137254901960784
Danny Young,youngda01,PG,29,TOT,1992,62,1023.0,280,172,16,59,75,46,4,47,53,100,255,0.392156862745098,23,70,0.3285714285714285,77,185,0.4162162162162162,0.437,57,67,0.8507462686567164
Alaa Abdelnaby,abdelal01,PF,24,TOT,1993,75,1311.0,578,27,126,211,337,25,26,97,189,245,473,0.5179704016913319,0,1,0.0,245,472,0.5190677966101694,0.518,88,116,0.7586206896551724
Mahmoud Abdul-Rauf,abdulma02,PG,23,DEN,1993,81,2710.0,1553,344,51,174,225,84,8,187,179,633,1407,0.4498933901918976,70,197,0.3553299492385787,563,1210,0.4652892561983471,0.475,217,232,0.9353448275862069
Mark Acres,acresma01,C,30,TOT,1993,18,269.0,64,5,26,41,67,3,6,13,34,26,49,0.5306122448979592,1,2,0.5,25,47,0.5319148936170213,0.541,11,16,0.6875
Michael Adams,adamsmi01,PG,30,WSB,1993,70,2499.0,1035,526,52,188,240,100,4,175,146,365,831,0.4392298435619735,68,212,0.320754716981132,297,619,0.4798061389337641,0.48,237,277,0.855595667870036
Rafael Addison,addisra01,SF,28,NJN,1993,68,1164.0,428,53,45,87,132,23,11,64,125,182,411,0.4428223844282238,7,34,0.2058823529411764,175,377,0.4641909814323607,0.451,57,70,0.8142857142857143
Mark Aguirre,aguirma01,SF,33,DET,1993,51,1056.0,503,105,43,109,152,16,7,68,101,187,422,0.4431279620853081,30,83,0.3614457831325301,157,339,0.4631268436578171,0.479,99,129,0.7674418604651163
Danny Ainge,aingeda01,SG,33,PHO,1993,80,2163.0,947,260,49,165,214,69,8,113,175,337,730,0.4616438356164383,150,372,0.4032258064516129,187,358,0.5223463687150838,0.564,123,145,0.8482758620689655
Victor Alexander,alexavi01,C,23,GSW,1993,72,1753.0,809,93,132,288,420,34,53,120,218,344,667,0.5157421289355323,10,22,0.4545454545454545,334,645,0.517829457364341,0.523,111,162,0.6851851851851852
Eric Anderson,anderer01,PF,22,NYK,1993,16,44.0,21,3,6,8,14,3,1,5,14,5,18,0.2777777777777778,0,0,0.0,5,18,0.2777777777777778,0.278,11,13,0.8461538461538461
Kenny Anderson,anderke01,PG,22,NJN,1993,55,2010.0,927,449,51,175,226,96,11,153,140,370,850,0.4352941176470588,7,25,0.28,363,825,0.44,0.439,180,232,0.7758620689655172
Nick Anderson,anderni01,SG,25,ORL,1993,79,2920.0,1574,265,122,355,477,128,56,164,200,594,1324,0.4486404833836858,88,249,0.3534136546184739,506,1075,0.4706976744186046,0.482,298,402,0.7412935323383084
Ron Anderson,anderro01,SF,34,PHI,1993,69,1263.0,561,93,62,122,184,31,5,63,75,225,544,0.4136029411764705,39,120,0.325,186,424,0.4386792452830189,0.449,72,89,0.8089887640449438
Willie Anderson,anderwi01,SG,26,SAS,1993,38,560.0,183,79,7,50,57,14,6,44,52,80,186,0.4301075268817204,1,8,0.125,79,178,0.4438202247191011,0.433,22,28,0.7857142857142857
Greg Anthony,anthogr01,PG,25,NYK,1993,70,1699.0,459,398,42,128,170,113,12,104,141,174,419,0.4152744630071599,4,30,0.1333333333333333,170,389,0.4370179948586118,0.42,107,159,0.6729559748427673
B.J. Armstrong,armstbj01,PG,25,CHI,1993,82,2492.0,1009,330,27,122,149,66,6,83,169,408,818,0.4987775061124694,63,139,0.4532374100719424,345,679,0.508100147275405,0.537,130,151,0.8609271523178808
Vincent Askew,askewvi01,SG,26,TOT,1993,73,1129.0,411,122,62,99,161,40,19,69,135,152,309,0.4919093851132686,2,6,0.3333333333333333,150,303,0.495049504950495,0.495,105,149,0.7046979865771812
Keith Askins,askinke01,SF,25,MIA,1993,69,935.0,227,31,74,124,198,31,29,37,141,88,213,0.4131455399061033,22,65,0.3384615384615385,66,148,0.4459459459459459,0.465,29,40,0.725
Stacey Augmon,augmost01,SG,24,ATL,1993,73,2112.0,1021,170,141,146,287,91,18,157,141,397,792,0.5012626262626263,0,4,0.0,397,788,0.5038071065989848,0.501,227,307,0.739413680781759
Isaac Austin,austiis01,C,23,UTA,1993,46,306.0,129,6,38,41,79,8,14,23,60,50,112,0.4464285714285714,0,1,0.0,50,111,0.4504504504504504,0.446,29,44,0.6590909090909091
Anthony Avent,aventan01,PF,23,MIL,1993,82,2285.0,806,91,180,332,512,57,73,140,237,347,802,0.4326683291770573,0,2,0.0,347,800,0.43375,0.433,112,172,0.6511627906976745
John Bagley,baglejo01,PG,32,BOS,1993,10,97.0,23,20,1,6,7,2,0,17,11,9,25,0.36,0,1,0.0,9,24,0.375,0.36,5,6,0.8333333333333334
Thurl Bailey,baileth01,PF,31,MIN,1993,70,1276.0,525,61,53,162,215,20,47,60,88,203,446,0.4551569506726457,0,0,0.0,203,446,0.4551569506726457,0.455,119,142,0.8380281690140845
Steve Bardo,bardost01,SG,24,DAL,1993,23,175.0,51,29,10,27,37,8,3,17,28,19,62,0.3064516129032258,1,6,0.1666666666666666,18,56,0.3214285714285714,0.315,12,17,0.7058823529411765
Charles Barkley,barklch01,PF,29,PHO,1993,76,2859.0,1944,385,237,691,928,119,74,233,196,716,1376,0.5203488372093024,67,220,0.3045454545454545,649,1156,0.5614186851211073,0.545,445,582,0.7646048109965635
Dana Barros,barroda01,PG,25,SEA,1993,69,1243.0,541,151,18,89,107,63,3,58,78,214,474,0.4514767932489451,64,169,0.378698224852071,150,305,0.4918032786885246,0.519,49,59,0.8305084745762712
Jon Barry,barryjo01,SG,23,MIL,1993,47,552.0,206,68,10,33,43,35,3,42,57,76,206,0.3689320388349514,21,63,0.3333333333333333,55,143,0.3846153846153846,0.42,33,49,0.673469387755102
John Battle,battljo01,SG,30,CLE,1993,41,497.0,223,54,4,25,29,9,5,22,39,83,200,0.415,1,6,0.1666666666666666,82,194,0.422680412371134,0.418,56,72,0.7777777777777778
Kenny Battle,battlke01,SG,28,BOS,1993,3,29.0,14,2,7,4,11,1,0,2,2,6,13,0.4615384615384615,0,1,0.0,6,12,0.5,0.462,2,2,1.0
William Bedford,bedfowi01,C,29,SAS,1993,16,66.0,25,0,1,9,10,0,1,1,15,9,27,0.3333333333333333,1,1,1.0,8,26,0.3076923076923077,0.352,6,12,0.5
Benoit Benjamin,benjabe01,C,28,TOT,1993,59,754.0,335,22,51,158,209,31,48,78,134,133,271,0.4907749077490775,0,0,0.0,133,271,0.4907749077490775,0.491,69,104,0.6634615384615384
Tony Bennett,benneto01,PG,23,CHH,1993,75,857.0,276,136,12,51,63,30,0,50,110,110,260,0.4230769230769231,26,80,0.325,84,180,0.4666666666666667,0.473,30,41,0.7317073170731707
David Benoit,benoida01,SF,24,UTA,1993,82,1712.0,664,43,116,276,392,45,43,90,201,258,592,0.4358108108108108,34,98,0.3469387755102041,224,494,0.4534412955465587,0.465,114,152,0.75
Rolando Blackman,blackro01,SG,33,NYK,1993,60,1434.0,580,157,23,79,102,22,10,65,129,239,539,0.4434137291280148,31,73,0.4246575342465753,208,466,0.4463519313304721,0.472,71,90,0.7888888888888889
Alex Blackwell,blackal01,SF,22,LAL,1993,27,109.0,34,7,10,13,23,4,2,5,14,14,42,0.3333333333333333,0,3,0.0,14,39,0.358974358974359,0.333,6,8,0.75
Lance Blanks,blankla01,SG,26,MIN,1993,61,642.0,161,72,18,50,68,16,5,31,61,65,150,0.4333333333333333,11,43,0.2558139534883721,54,107,0.5046728971962616,0.47,20,32,0.625
Ricky Blanton,blantri01,SF,26,CHI,1993,2,13.0,6,1,2,1,3,2,0,1,1,3,7,0.4285714285714285,0,0,0.0,3,7,0.4285714285714285,0.429,0,0,0.0
Mookie Blaylock,blaylmo01,PG,25,ATL,1993,80,2820.0,1069,671,89,191,280,203,23,187,156,414,964,0.429460580912863,118,315,0.3746031746031746,296,649,0.4560862865947612,0.491,123,169,0.727810650887574
Muggsy Bogues,boguemu01,PG,28,CHH,1993,81,2833.0,808,711,51,247,298,161,5,154,179,331,730,0.4534246575342466,6,26,0.2307692307692307,325,704,0.4616477272727273,0.458,140,168,0.8333333333333334
Manute Bol,bolma01,C,30,PHI,1993,58,855.0,126,18,44,149,193,14,119,50,87,52,127,0.4094488188976378,10,32,0.3125,42,95,0.4421052631578947,0.449,12,19,0.631578947368421
Walter Bond,bondwa01,SG,23,DAL,1993,74,1578.0,590,122,52,144,196,75,18,112,223,227,565,0.4017699115044247,7,42,0.1666666666666666,220,523,0.4206500956022944,0.408,129,167,0.7724550898203593
Anthony Bonner,bonnean01,PF,24,SAC,1993,70,1764.0,601,96,188,267,455,86,17,105,183,229,497,0.4607645875251509,0,7,0.0,229,490,0.4673469387755102,0.461,143,241,0.5933609958506224
Anthony Bowie,bowiean01,SG,29,ORL,1993,77,1761.0,618,175,36,158,194,54,14,84,131,268,569,0.4710017574692443,15,48,0.3125,253,521,0.4856046065259117,0.484,67,84,0.7976190476190477
Sam Bowie,bowiesa01,C,31,NJN,1993,79,2092.0,717,127,158,398,556,32,128,120,226,287,638,0.4498432601880878,2,6,0.3333333333333333,285,632,0.4509493670886076,0.451,141,181,0.7790055248618785
Terrell Brandon,brandte01,PG,22,CLE,1993,82,1622.0,725,302,37,142,179,79,27,107,122,297,621,0.4782608695652174,13,42,0.3095238095238095,284,579,0.4905008635578584,0.489,118,143,0.8251748251748252
Randy Breuer,breuera01,C,32,ATL,1993,12,107.0,32,6,10,18,28,2,3,5,12,15,31,0.4838709677419355,0,0,0.0,15,31,0.4838709677419355,0.484,2,5,0.4
Frank Brickowski,brickfr01,C,33,MIL,1993,66,2075.0,1115,196,120,285,405,80,44,202,235,456,836,0.5454545454545454,8,26,0.3076923076923077,448,810,0.5530864197530864,0.55,195,268,0.7276119402985075
Kevin Brooks,brookke01,SF,23,DEN,1993,55,571.0,227,34,22,59,81,10,2,39,46,93,233,0.3991416309012875,6,26,0.2307692307692307,87,207,0.4202898550724637,0.412,35,40,0.875
Scott Brooks,brooksc01,PG,27,HOU,1993,82,1516.0,519,243,22,77,99,79,3,72,136,183,385,0.4753246753246753,41,99,0.4141414141414141,142,286,0.4965034965034965,0.529,112,135,0.8296296296296296
Chucky Brown,brownch01,SF,24,NJN,1993,77,1186.0,391,51,88,144,232,20,24,56,112,160,331,0.4833836858006042,0,5,0.0,160,326,0.4907975460122699,0.483,71,98,0.7244897959183674
Dee Brown,brownde01,PG,24,BOS,1993,80,2254.0,874,461,45,201,246,138,32,136,203,328,701,0.4679029957203994,26,82,0.3170731707317073,302,619,0.4878836833602585,0.486,192,242,0.7933884297520661
Mike Brown,brownmi01,C,29,UTA,1993,82,1551.0,465,64,147,244,391,32,23,95,190,176,409,0.4303178484107579,0,1,0.0,176,408,0.4313725490196078,0.43,113,164,0.6890243902439024
Randy Brown,brownra02,PG,24,SAC,1993,75,1726.0,567,196,75,137,212,108,34,120,206,225,486,0.4629629629629629,2,6,0.3333333333333333,223,480,0.4645833333333333,0.465,115,157,0.732484076433121
Mark Bryant,bryanma01,C,27,POR,1993,80,1396.0,476,41,132,192,324,37,23,65,226,186,370,0.5027027027027027,0,1,0.0,186,369,0.5040650406504065,0.503,104,148,0.7027027027027027
Jud Buechler,buechju01,SF,24,GSW,1993,70,1287.0,437,94,81,114,195,47,19,55,98,176,403,0.4367245657568238,20,59,0.3389830508474576,156,344,0.4534883720930232,0.462,65,87,0.7471264367816092
Matt Bullard,bullama01,PF,25,HOU,1993,79,1356.0,575,110,66,156,222,30,11,57,129,213,494,0.4311740890688259,91,243,0.3744855967078189,122,251,0.4860557768924303,0.523,58,74,0.7837837837837838
Willie Burton,burtowi01,SF,24,MIA,1993,26,451.0,204,16,22,48,70,13,16,50,58,54,141,0.3829787234042553,5,15,0.3333333333333333,49,126,0.3888888888888889,0.401,91,127,0.7165354330708661
Steve Burtt,burttst01,SG,30,WSB,1993,4,35.0,29,6,2,1,3,2,0,4,5,10,26,0.3846153846153846,1,3,0.3333333333333333,9,23,0.391304347826087,0.404,8,10,0.8
Michael Cage,cagemi01,C,31,SEA,1993,82,2156.0,499,69,268,391,659,76,46,59,183,219,416,0.5264423076923077,0,1,0.0,219,415,0.5277108433734939,0.526,61,130,0.4692307692307692
Dexter Cambridge,cambrde01,SF,23,DAL,1993,53,885.0,370,58,88,79,167,24,6,63,128,151,312,0.483974358974359,0,4,0.0,151,308,0.4902597402597403,0.484,68,99,0.6868686868686869
Elden Campbell,campbel01,PF,24,LAL,1993,79,1551.0,606,48,127,205,332,59,100,69,165,238,520,0.4576923076923077,0,3,0.0,238,517,0.460348162475822,0.458,130,204,0.6372549019607843
Tony Campbell,campbto01,SF,30,NYK,1993,58,1062.0,449,62,59,96,155,34,5,51,150,194,396,0.4898989898989899,2,5,0.4,192,391,0.4910485933503836,0.492,59,87,0.6781609195402298
Antoine Carr,carran01,PF,31,SAS,1993,71,1947.0,932,97,107,281,388,35,87,96,264,379,705,0.5375886524822695,0,5,0.0,379,700,0.5414285714285715,0.538,174,224,0.7767857142857143
Bill Cartwright,cartwbi01,C,35,CHI,1993,63,1253.0,354,83,83,150,233,20,10,62,154,141,343,0.4110787172011662,0,0,0.0,141,343,0.4110787172011662,0.411,72,98,0.7346938775510204
Terry Catledge,catlete01,PF,29,ORL,1993,21,262.0,99,5,18,28,46,4,1,25,31,36,73,0.4931506849315068,0,0,0.0,36,73,0.4931506849315068,0.493,27,34,0.7941176470588235
Duane Causwell,causwdu01,C,24,SAC,1993,55,1211.0,453,35,112,191,303,32,87,58,192,175,321,0.5451713395638629,0,1,0.0,175,320,0.546875,0.545,103,165,0.6242424242424243
Cedric Ceballos,cebalce01,SF,23,PHO,1993,74,1607.0,949,77,172,236,408,54,28,106,103,381,662,0.5755287009063444,0,2,0.0,381,660,0.5772727272727273,0.576,187,258,0.7248062015503876
Tom Chambers,chambto01,PF,33,PHO,1993,73,1723.0,892,101,96,249,345,43,23,92,212,320,716,0.4469273743016759,11,28,0.3928571428571428,309,688,0.4491279069767442,0.455,241,288,0.8368055555555556
Rex Chapman,chapmre01,SG,25,WSB,1993,60,1300.0,749,116,19,69,88,38,10,79,119,287,602,0.4767441860465116,43,116,0.3706896551724138,244,486,0.5020576131687243,0.512,132,163,0.8098159509202454
Maurice Cheeks,cheekma01,PG,36,NJN,1993,35,510.0,126,107,5,37,42,33,2,33,35,51,93,0.5483870967741935,0,2,0.0,51,91,0.5604395604395604,0.548,24,27,0.8888888888888888
Pete Chilcutt,chilcpe01,PF,24,SAC,1993,59,834.0,362,64,80,114,194,22,21,54,102,165,340,0.4852941176470588,0,0,0.0,165,340,0.4852941176470588,0.485,32,46,0.6956521739130435
Doug Christie,chrisdo01,SG,22,LAL,1993,23,332.0,142,53,24,27,51,22,5,50,53,45,106,0.4245283018867924,2,12,0.1666666666666666,43,94,0.4574468085106383,0.434,50,66,0.7575757575757576
Derrick Coleman,colemde01,PF,25,NJN,1993,76,2759.0,1572,276,247,605,852,92,126,243,210,564,1226,0.4600326264274062,23,99,0.2323232323232323,541,1127,0.4800354924578527,0.469,421,521,0.8080614203454894
Bimbo Coles,colesbi01,PG,24,MIA,1993,81,2232.0,855,373,58,108,166,80,11,108,199,318,686,0.4635568513119533,42,137,0.3065693430656934,276,549,0.5027322404371585,0.494,177,220,0.8045454545454546
Marty Conlon,conloma01,C,25,SAC,1993,46,467.0,219,37,48,75,123,13,5,28,43,81,171,0.4736842105263157,0,4,0.0,81,167,0.4850299401197604,0.474,57,81,0.7037037037037037
Lester Conner,connele01,PG,33,LAC,1993,31,422.0,74,65,16,33,49,34,4,21,39,28,62,0.4516129032258064,0,0,0.0,28,62,0.4516129032258064,0.452,18,19,0.9473684210526316
Duane Cooper,coopedu01,PG,23,LAL,1993,65,645.0,156,150,13,37,50,18,2,69,66,62,158,0.3924050632911392,7,30,0.2333333333333333,55,128,0.4296875,0.415,25,35,0.7142857142857143
Tyrone Corbin,corbity01,SF,30,UTA,1993,82,2555.0,950,173,194,325,519,108,32,108,252,385,766,0.5026109660574413,0,5,0.0,385,761,0.5059132720105125,0.503,180,218,0.8256880733944955
Chris Corchiani,corchch01,PG,24,TOT,1993,10,105.0,44,16,1,6,7,6,0,8,18,14,24,0.5833333333333334,0,3,0.0,14,21,0.6666666666666666,0.583,16,21,0.7619047619047619
Joe Courtney,courtjo01,PF,23,TOT,1993,12,104.0,33,3,4,15,19,5,5,6,17,13,32,0.40625,0,0,0.0,13,32,0.40625,0.406,7,9,0.7777777777777778
John Crotty,crottjo01,PG,23,UTA,1993,40,243.0,102,55,4,13,17,11,0,30,29,37,72,0.5138888888888888,2,14,0.1428571428571428,35,58,0.603448275862069,0.528,26,38,0.6842105263157895
Terry Cummings,cummite01,PF,31,SAS,1993,8,76.0,27,4,6,13,19,1,1,2,17,11,29,0.3793103448275862,0,0,0.0,11,29,0.3793103448275862,0.379,5,10,0.5
Radisav Ćurčić,curcira01,C,27,DAL,1993,20,166.0,58,12,17,32,49,7,2,8,30,16,41,0.3902439024390244,0,0,0.0,16,41,0.3902439024390244,0.39,26,36,0.7222222222222222
Dell Curry,curryde01,SG,28,CHH,1993,80,2094.0,1227,180,51,235,286,87,23,129,150,498,1102,0.4519056261343013,95,237,0.4008438818565401,403,865,0.4658959537572254,0.495,136,157,0.8662420382165605
Lloyd Daniels,daniell01,SG,25,SAS,1993,77,1573.0,701,148,86,130,216,38,30,102,144,285,644,0.4425465838509316,59,177,0.3333333333333333,226,467,0.4839400428265524,0.488,72,99,0.7272727272727273
Brad Daugherty,daughbr01,C,27,CLE,1993,71,2691.0,1432,312,164,562,726,53,56,150,174,520,911,0.570801317233809,1,2,0.5,519,909,0.570957095709571,0.571,391,492,0.7947154471544715
Dale Davis,davisda01,PF,23,IND,1993,82,2264.0,727,69,291,432,723,63,148,79,274,304,535,0.5682242990654206,0,0,0.0,304,535,0.5682242990654206,0.568,119,225,0.5288888888888889
Hubert Davis,davishu01,SG,22,NYK,1993,50,815.0,269,83,13,43,56,22,4,45,71,110,251,0.4382470119521912,6,19,0.3157894736842105,104,232,0.4482758620689655,0.45,43,54,0.7962962962962963
Terry Davis,daviste01,PF,25,DAL,1993,75,2462.0,955,68,259,442,701,36,28,160,199,393,863,0.455388180764774,2,8,0.25,391,855,0.4573099415204678,0.457,167,281,0.594306049822064
Johnny Dawkins,dawkijo01,PG,29,PHI,1993,74,1598.0,655,339,33,103,136,80,4,121,91,258,590,0.4372881355932203,26,84,0.3095238095238095,232,506,0.458498023715415,0.459,113,142,0.795774647887324
Todd Day,dayto01,SG,23,MIL,1993,71,1931.0,983,117,144,147,291,75,48,118,222,358,828,0.4323671497584541,54,184,0.2934782608695652,304,644,0.4720496894409938,0.465,213,297,0.7171717171717171
Vinny Del Negro,delnevi01,PG,26,SAS,1993,73,1526.0,543,291,19,144,163,44,1,92,146,218,430,0.5069767441860465,6,24,0.25,212,406,0.5221674876847291,0.514,101,117,0.8632478632478633
Bison Dele,delebi01,PF,23,ORL,1993,21,240.0,96,5,24,32,56,14,17,25,48,40,78,0.5128205128205128,0,1,0.0,40,77,0.5194805194805194,0.513,16,20,0.8
Vlade Divac,divacvl01,C,24,LAL,1993,82,2525.0,1050,232,220,509,729,128,140,214,311,397,819,0.4847374847374847,21,75,0.28,376,744,0.5053763440860215,0.498,235,341,0.6891495601173021
James Donaldson,donalja01,C,35,UTA,1993,6,94.0,21,1,6,23,29,1,7,4,13,8,14,0.5714285714285714,0,0,0.0,8,14,0.5714285714285714,0.571,5,9,0.5555555555555556
Sherman Douglas,douglsh01,PG,26,BOS,1993,79,1932.0,618,508,65,97,162,49,10,161,166,264,530,0.4981132075471698,6,29,0.2068965517241379,258,501,0.5149700598802395,0.504,84,150,0.56
Greg Dreiling,dreilgr01,C,30,IND,1993,43,239.0,46,8,26,40,66,5,8,9,60,19,58,0.3275862068965517,0,4,0.0,19,54,0.3518518518518518,0.328,8,15,0.5333333333333333
Clyde Drexler,drexlcl01,SG,30,POR,1993,49,1671.0,976,278,126,183,309,95,37,115,159,350,816,0.4289215686274509,31,133,0.2330827067669172,319,683,0.4670571010248902,0.448,245,292,0.839041095890411
Kevin Duckworth,duckwke01,C,28,POR,1993,74,1762.0,729,70,118,269,387,45,39,87,222,301,688,0.4375,0,2,0.0,301,686,0.4387755102040816,0.438,127,174,0.7298850574712644
Chris Dudley,dudlech02,C,27,NJN,1993,71,1398.0,245,16,215,298,513,17,103,54,195,94,266,0.3533834586466165,0,0,0.0,94,266,0.3533834586466165,0.353,57,110,0.5181818181818182
Joe Dumars,dumarjo01,SG,29,DET,1993,77,3094.0,1809,308,63,85,148,78,7,138,141,677,1454,0.4656121045392022,112,299,0.3745819397993311,565,1155,0.4891774891774891,0.504,343,397,0.8639798488664987
Richard Dumas,dumasri02,SF,23,PHO,1993,48,1320.0,757,60,100,123,223,85,39,92,127,302,576,0.5243055555555556,1,3,0.3333333333333333,301,573,0.525305410122164,0.525,152,215,0.7069767441860465
Pat Durham,durhapa01,SF,25,GSW,1993,5,78.0,21,4,5,9,14,1,1,7,6,6,25,0.24,0,0,0.0,6,25,0.24,0.24,9,12,0.75
Mark Eaton,eatonma01,C,36,UTA,1993,64,1104.0,177,17,73,191,264,18,79,43,143,71,130,0.5461538461538461,0,0,0.0,71,130,0.5461538461538461,0.546,35,50,0.7
Blue Edwards,edwarbl01,SF,27,MIL,1993,82,2729.0,1382,214,123,259,382,129,45,175,242,554,1083,0.5115420129270545,37,106,0.3490566037735849,517,977,0.5291709314227226,0.529,237,300,0.79
James Edwards,edwarja01,C,37,LAL,1993,52,617.0,328,41,30,70,100,10,7,51,122,122,270,0.4518518518518518,0,0,0.0,122,270,0.4518518518518518,0.452,84,118,0.711864406779661
Kevin Edwards,edwarke01,SG,27,MIA,1993,40,1134.0,556,120,48,73,121,68,12,75,69,216,462,0.4675324675324675,5,17,0.2941176470588235,211,445,0.4741573033707865,0.473,119,141,0.8439716312056738
Craig Ehlo,ehlocr01,SG,31,CLE,1993,82,2559.0,949,254,113,290,403,104,22,124,170,385,785,0.4904458598726114,93,244,0.3811475409836065,292,541,0.5397412199630314,0.55,86,120,0.7166666666666667
Mario Elie,eliema01,SF,29,POR,1993,82,1757.0,708,177,59,157,216,74,20,89,145,240,524,0.4580152671755725,45,129,0.3488372093023256,195,395,0.4936708860759494,0.501,183,214,0.8551401869158879
Sean Elliott,elliose01,SF,24,SAS,1993,70,2604.0,1207,265,85,237,322,68,28,152,132,451,918,0.4912854030501089,37,104,0.3557692307692308,414,814,0.5085995085995086,0.511,268,337,0.7952522255192879
Dale Ellis,ellisda01,SG,32,SAS,1993,82,2731.0,1366,107,81,231,312,78,18,111,179,545,1092,0.4990842490842491,119,297,0.4006734006734007,426,795,0.5358490566037736,0.554,157,197,0.7969543147208121
LaPhonso Ellis,ellisla01,PF,22,DEN,1993,82,2749.0,1205,151,274,470,744,72,111,153,293,483,958,0.5041753653444676,2,13,0.1538461538461538,481,945,0.508994708994709,0.505,237,317,0.7476340694006309
Pervis Ellison,ellispe01,C,25,WSB,1993,49,1701.0,852,117,138,295,433,45,108,110,154,341,655,0.5206106870229008,0,4,0.0,341,651,0.5238095238095238,0.521,170,242,0.7024793388429752
Jo Jo English,englijo01,SG,22,CHI,1993,6,31.0,6,1,2,4,6,3,2,4,5,3,10,0.3,0,3,0.0,3,7,0.4285714285714285,0.3,0,2,0.0
Patrick Ewing,ewingpa01,C,30,NYK,1993,81,3003.0,1959,151,191,789,980,74,161,265,286,779,1550,0.5025806451612903,1,7,0.1428571428571428,778,1543,0.5042125729099157,0.503,400,556,0.7194244604316546
Duane Ferrell,ferredu01,SF,27,ATL,1993,82,1736.0,839,132,97,94,191,59,17,103,160,327,696,0.4698275862068966,9,36,0.25,318,660,0.4818181818181818,0.476,176,226,0.7787610619469026
Danny Ferry,ferryda01,PF,26,CLE,1993,76,1461.0,573,137,81,198,279,29,49,83,171,220,459,0.4793028322440087,34,82,0.4146341463414634,186,377,0.493368700265252,0.516,99,113,0.8761061946902655
Vern Fleming,flemive01,PG,30,IND,1993,75,1503.0,710,224,63,106,169,63,9,121,126,280,554,0.5054151624548736,7,36,0.1944444444444444,273,518,0.527027027027027,0.512,143,197,0.7258883248730964
Sleepy Floyd,floydsl01,PG,32,HOU,1993,52,867.0,345,132,14,72,86,32,6,68,59,124,305,0.4065573770491803,16,56,0.2857142857142857,108,249,0.4337349397590361,0.433,81,102,0.7941176470588235
Greg Foster,fostegr01,PF,24,TOT,1993,43,298.0,125,21,32,51,83,3,14,25,58,55,120,0.4583333333333333,0,4,0.0,55,116,0.4741379310344827,0.458,15,21,0.7142857142857143
Rick Fox,foxri01,SF,23,BOS,1993,71,1082.0,453,113,55,104,159,61,21,77,133,184,380,0.4842105263157895,4,23,0.1739130434782608,180,357,0.5042016806722689,0.489,81,101,0.801980198019802
Kevin Gamble,gamblke01,SF,27,BOS,1993,82,2541.0,1093,226,46,200,246,86,37,81,185,459,906,0.5066225165562914,52,139,0.3741007194244604,407,767,0.530638852672751,0.535,123,149,0.825503355704698
Winston Garland,garlawi01,PG,28,HOU,1993,66,1004.0,391,138,32,76,108,39,4,67,116,152,343,0.4431486880466472,6,13,0.4615384615384615,146,330,0.4424242424242424,0.452,81,89,0.9101123595505618
Chris Gatling,gatlich01,PF,25,GSW,1993,70,1248.0,648,40,129,191,320,44,53,102,197,249,462,0.538961038961039,0,6,0.0,249,456,0.5460526315789473,0.539,150,207,0.7246376811594203
Kenny Gattison,gattike01,PF,28,CHH,1993,75,1475.0,508,68,108,245,353,48,55,64,237,203,384,0.5286458333333334,0,3,0.0,203,381,0.5328083989501312,0.529,102,169,0.6035502958579881
Matt Geiger,geigema01,C,23,MIA,1993,48,554.0,214,14,46,74,120,15,18,36,123,76,145,0.5241379310344828,0,4,0.0,76,141,0.5390070921985816,0.524,62,92,0.6739130434782609
Tate George,georgta01,PG,24,NJN,1993,48,380.0,122,59,9,18,27,10,3,31,25,51,135,0.3777777777777777,0,5,0.0,51,130,0.3923076923076923,0.378,20,24,0.8333333333333334
Kendall Gill,gillke01,SG,24,CHH,1993,69,2430.0,1167,268,120,220,340,98,36,174,191,463,1032,0.4486434108527132,17,62,0.2741935483870967,446,970,0.4597938144329896,0.457,224,290,0.7724137931034483
Armen Gilliam,gilliar01,PF,28,PHI,1993,80,1742.0,992,116,136,336,472,37,54,157,123,359,774,0.4638242894056847,0,1,0.0,359,773,0.4644243208279431,0.464,274,325,0.8430769230769231
Gerald Glass,glassge01,SF,25,TOT,1993,60,848.0,316,77,61,81,142,33,18,35,104,142,339,0.4188790560471976,7,33,0.2121212121212121,135,306,0.4411764705882353,0.429,25,39,0.6410256410256411
Mike Gminski,gminsmi01,C,33,CHH,1993,34,251.0,93,7,34,51,85,1,9,11,28,42,83,0.5060240963855421,0,0,0.0,42,83,0.5060240963855421,0.506,9,10,0.9
Paul Graham,grahapa01,SG,25,ATL,1993,80,1508.0,650,164,61,129,190,86,6,120,185,256,560,0.4571428571428571,42,141,0.2978723404255319,214,419,0.5107398568019093,0.495,96,131,0.732824427480916
Gary Grant,grantga01,PG,27,LAC,1993,74,1624.0,486,353,27,112,139,106,9,129,168,210,476,0.4411764705882353,11,42,0.2619047619047619,199,434,0.4585253456221198,0.453,55,74,0.7432432432432432
Greg Grant,grantgr01,PG,26,PHI,1993,72,996.0,194,206,24,43,67,43,1,54,73,77,220,0.35,20,68,0.2941176470588235,57,152,0.375,0.395,20,31,0.6451612903225806
Harvey Grant,grantha01,SF,27,WSB,1993,72,2667.0,1339,205,133,279,412,72,44,90,168,560,1149,0.4873803307223672,1,10,0.1,559,1139,0.4907813871817383,0.488,218,300,0.7266666666666667
Horace Grant,grantho01,PF,27,CHI,1993,77,2745.0,1017,201,341,388,729,89,96,110,218,421,829,0.5078407720144753,1,5,0.2,420,824,0.5097087378640777,0.508,174,281,0.6192170818505338
Jeff Grayer,grayeje01,SG,27,GSW,1993,48,1025.0,423,70,71,86,157,31,8,54,120,165,353,0.4674220963172804,2,14,0.1428571428571428,163,339,0.4808259587020649,0.47,91,136,0.6691176470588235
A.C. Green,greenac01,PF,29,LAL,1993,82,2819.0,1051,116,287,424,711,88,39,116,149,379,706,0.5368271954674221,16,46,0.3478260869565217,363,660,0.55,0.548,277,375,0.7386666666666667
Litterial Green,greenli01,PG,22,ORL,1993,52,626.0,235,116,11,23,34,23,4,42,70,87,198,0.4393939393939394,1,10,0.1,86,188,0.4574468085106383,0.442,60,96,0.625
Sean Green,greense01,SG,22,IND,1993,13,81.0,62,7,4,5,9,2,1,9,11,28,55,0.509090909090909,3,10,0.3,25,45,0.5555555555555556,0.536,3,4,0.75
Sidney Green,greensi02,PF,32,TOT,1993,39,329.0,93,24,32,86,118,6,5,20,37,34,89,0.3820224719101123,0,2,0.0,34,87,0.3908045977011494,0.382,25,31,0.8064516129032258
Tom Gugliotta,guglito01,PF,23,WSB,1993,81,2795.0,1187,306,219,562,781,134,35,230,195,484,1135,0.426431718061674,38,135,0.2814814814814815,446,1000,0.446,0.443,181,281,0.6441281138790036
Jay Guidinger,guidija01,C,23,CLE,1993,32,215.0,51,17,26,38,64,9,10,10,48,19,55,0.3454545454545454,0,0,0.0,19,55,0.3454545454545454,0.345,13,25,0.52
Tom Hammonds,hammoto01,PF,25,TOT,1993,54,713.0,248,24,38,89,127,18,12,34,77,105,221,0.4751131221719457,0,1,0.0,105,220,0.4772727272727273,0.475,38,62,0.6129032258064516
Tim Hardaway,hardati01,PG,26,GSW,1993,66,2609.0,1419,699,60,203,263,116,12,220,152,522,1168,0.4469178082191781,102,309,0.3300970873786408,420,859,0.4889406286379511,0.491,273,367,0.7438692098092643
Derek Harper,harpede01,SG,31,DAL,1993,62,2108.0,1126,334,42,81,123,80,16,136,145,393,939,0.4185303514376997,101,257,0.3929961089494163,292,682,0.4281524926686217,0.472,239,316,0.7563291139240507
Ron Harper,harpero01,SG,29,LAC,1993,80,2970.0,1443,360,117,308,425,177,73,222,212,542,1203,0.4505403158769742,52,186,0.2795698924731182,490,1017,0.4818092428711897,0.472,307,399,0.7694235588972431
Scott Hastings,hastisc01,C,32,DEN,1993,76,670.0,156,34,44,93,137,12,8,29,115,57,112,0.5089285714285714,2,8,0.25,55,104,0.5288461538461539,0.518,40,55,0.7272727272727273
Hersey Hawkins,hawkihe01,SG,26,PHI,1993,81,2977.0,1643,317,91,255,346,137,30,180,189,551,1172,0.470136518771331,122,307,0.3973941368078176,429,865,0.4959537572254335,0.522,419,487,0.8603696098562629
Steve Henson,hensost01,PG,24,ATL,1993,53,719.0,213,155,12,43,55,30,1,52,85,71,182,0.3901098901098901,37,80,0.4625,34,102,0.3333333333333333,0.492,34,40,0.85
Carl Herrera,herreca01,PF,26,HOU,1993,81,1800.0,605,61,148,306,454,47,35,92,190,240,444,0.5405405405405406,0,2,0.0,240,442,0.5429864253393665,0.541,125,176,0.7102272727272727
Rod Higgins,higgiro01,SF,33,SAC,1993,69,1425.0,571,119,66,127,193,51,29,63,141,199,483,0.4120082815734989,43,133,0.3233082706766917,156,350,0.4457142857142857,0.457,130,151,0.8609271523178808
Sean Higgins,higgise01,SF,24,GSW,1993,29,591.0,240,66,23,45,68,13,5,64,54,96,215,0.4465116279069767,13,37,0.3513513513513513,83,178,0.4662921348314606,0.477,35,47,0.7446808510638298
Tyrone Hill,hillty01,C,24,GSW,1993,74,2070.0,640,68,255,499,754,41,40,92,320,251,494,0.5080971659919028,0,4,0.0,251,490,0.5122448979591837,0.508,138,221,0.6244343891402715
Donald Hodge,hodgedo01,C,23,DAL,1993,79,1267.0,393,75,93,201,294,33,37,90,204,161,400,0.4025,0,0,0.0,161,400,0.4025,0.403,71,104,0.6826923076923077
Dave Hoppen,hoppeda01,C,28,NJN,1993,2,10.0,2,0,1,3,4,0,0,0,2,1,1,1.0,0,0,0.0,1,1,1.0,1.0,0,2,0.0
Jeff Hornacek,hornaje01,PG,29,PHI,1993,79,2860.0,1511,548,84,258,342,131,21,222,203,582,1239,0.4697336561743341,97,249,0.3895582329317269,485,990,0.4898989898989899,0.509,250,289,0.8650519031141869
Robert Horry,horryro01,SF,22,HOU,1993,79,2330.0,801,191,113,279,392,80,83,156,210,323,682,0.4736070381231672,12,47,0.2553191489361702,311,635,0.489763779527559,0.482,143,200,0.715
Byron Houston,houstby01,PF,23,GSW,1993,79,1274.0,421,69,119,196,315,44,43,87,253,145,325,0.4461538461538462,2,7,0.2857142857142857,143,318,0.449685534591195,0.449,129,194,0.6649484536082474
Brian Howard,howarbr01,SF,25,DAL,1993,68,1295.0,439,67,66,146,212,55,34,68,217,183,414,0.4420289855072464,1,7,0.1428571428571428,182,407,0.4471744471744471,0.443,72,94,0.7659574468085106
Stephen Howard,howarst01,SF,22,UTA,1993,49,260.0,104,10,26,34,60,15,12,23,58,35,93,0.3763440860215054,0,0,0.0,35,93,0.3763440860215054,0.376,34,53,0.6415094339622641
Jay Humphries,humphja01,SG,30,UTA,1993,78,2034.0,690,317,40,103,143,101,11,132,236,287,659,0.4355083459787557,15,75,0.2,272,584,0.4657534246575342,0.447,101,130,0.7769230769230769
Byron Irvin,irvinby01,SG,26,WSB,1993,4,45.0,22,2,2,2,4,1,0,4,5,9,18,0.5,1,1,1.0,8,17,0.4705882352941176,0.528,3,6,0.5
Mike Iuzzolino,iuzzomi01,PG,25,DAL,1993,70,1769.0,610,328,31,109,140,49,6,129,101,221,478,0.4623430962343096,54,144,0.375,167,334,0.5,0.519,114,149,0.7651006711409396
Jaren Jackson,jacksja01,SG,25,LAC,1993,34,350.0,131,35,19,20,39,19,5,17,45,53,128,0.4140625,2,5,0.4,51,123,0.4146341463414634,0.422,23,27,0.8518518518518519
Jim Jackson,jacksji01,SF,22,DAL,1993,28,938.0,457,131,42,80,122,40,11,115,80,184,466,0.3948497854077253,21,73,0.2876712328767123,163,393,0.4147582697201017,0.417,68,92,0.7391304347826086
Mark Jackson,jacksma01,PG,27,LAC,1993,82,3117.0,1181,724,129,259,388,136,12,220,158,459,945,0.4857142857142857,22,82,0.2682926829268293,437,863,0.5063731170336037,0.497,241,300,0.8033333333333333
Henry James,jameshe01,PF,27,TOT,1993,10,88.0,67,1,7,4,11,3,0,7,9,21,51,0.4117647058823529,3,13,0.2307692307692307,18,38,0.4736842105263157,0.441,22,26,0.8461538461538461
Keith Jennings,jennike01,PG,24,GSW,1993,8,136.0,69,23,2,9,11,4,0,7,18,25,42,0.5952380952380952,5,9,0.5555555555555556,20,33,0.6060606060606061,0.655,14,18,0.7777777777777778
Avery Johnson,johnsav01,PG,27,SAS,1993,75,2030.0,656,561,20,126,146,85,16,145,141,256,510,0.5019607843137255,0,8,0.0,256,502,0.5099601593625498,0.502,144,182,0.7912087912087912
Buck Johnson,johnsbu01,SF,29,WSB,1993,73,1287.0,478,89,78,117,195,36,18,70,187,193,403,0.4789081885856079,0,3,0.0,193,400,0.4825,0.479,92,126,0.7301587301587301
Dave Johnson,johnsda01,SG,22,POR,1993,42,356.0,157,13,18,30,48,8,1,28,23,57,149,0.3825503355704698,3,14,0.2142857142857142,54,135,0.4,0.393,40,59,0.6779661016949152
Eddie Johnson,johnsed03,SF,33,SEA,1993,82,1869.0,1177,135,124,148,272,36,4,134,173,463,991,0.467204843592331,17,56,0.3035714285714285,446,935,0.4770053475935829,0.476,234,257,0.9105058365758756
Frank Johnson,johnsfr01,PG,34,PHO,1993,77,1122.0,332,186,41,72,113,60,8,80,112,136,312,0.4358974358974359,1,12,0.0833333333333333,135,300,0.45,0.438,59,76,0.7763157894736842
Kevin Johnson,johnske02,PG,26,PHO,1993,49,1643.0,791,384,30,74,104,85,19,151,100,282,565,0.4991150442477876,1,8,0.125,281,557,0.5044883303411131,0.5,226,276,0.8188405797101449
Larry Johnson,johnsla02,PF,23,CHH,1993,82,3323.0,1810,353,281,583,864,53,27,227,187,728,1385,0.5256317689530686,18,71,0.2535211267605634,710,1314,0.5403348554033486,0.532,336,438,0.7671232876712328
Charles Jones,jonesch01,C,35,WSB,1993,67,1206.0,88,42,87,190,277,38,77,38,144,33,63,0.5238095238095238,0,1,0.0,33,62,0.532258064516129,0.524,22,38,0.5789473684210527
Michael Jordan,jordami01,SG,29,CHI,1993,78,3067.0,2541,428,135,387,522,221,61,207,188,992,2003,0.4952571143285072,81,230,0.3521739130434783,911,1773,0.5138183869148336,0.515,476,569,0.836555360281195
Thomas Jordan,jordath01,PF,24,PHI,1993,4,106.0,44,3,5,14,19,3,5,12,14,18,41,0.4390243902439024,0,0,0.0,18,41,0.4390243902439024,0.439,8,17,0.4705882352941176
Adam Keefe,keefead01,PF,22,ATL,1993,82,1549.0,542,80,171,261,432,57,16,100,195,188,376,0.5,0,1,0.0,188,375,0.5013333333333333,0.5,166,237,0.70042194092827
Shawn Kemp,kempsh01,PF,23,SEA,1993,78,2582.0,1388,155,287,546,833,119,146,217,327,515,1047,0.4918815663801337,0,4,0.0,515,1043,0.4937679769894535,0.492,358,503,0.7117296222664016
Tim Kempton,kemptti01,PF,29,PHO,1993,30,167.0,56,19,12,27,39,4,4,16,30,19,48,0.3958333333333333,0,0,0.0,19,48,0.3958333333333333,0.396,18,31,0.5806451612903226
Steve Kerr,kerrst01,SG-PG,27,TOT,1993,52,481.0,134,70,5,40,45,10,1,27,36,53,122,0.4344262295081967,6,26,0.2307692307692307,47,96,0.4895833333333333,0.459,22,24,0.9166666666666666
Jerome Kersey,kerseje01,SF,30,POR,1993,65,1719.0,686,121,126,280,406,80,41,84,181,281,642,0.4376947040498442,8,28,0.2857142857142857,273,614,0.4446254071661237,0.444,116,183,0.6338797814207651
Alec Kessler,kesslal01,PF,26,MIA,1993,40,415.0,155,14,25,66,91,4,12,21,63,57,122,0.4672131147540984,5,11,0.4545454545454545,52,111,0.4684684684684684,0.488,36,47,0.7659574468085106
Bo Kimble,kimblbo01,SG,26,NYK,1993,9,55.0,33,5,3,8,11,1,0,6,10,14,33,0.4242424242424242,2,8,0.25,12,25,0.48,0.455,3,8,0.375
Stan Kimbrough,kimbrst01,PG,26,SAC,1993,3,15.0,5,1,0,0,0,1,0,0,1,2,6,0.3333333333333333,1,2,0.5,1,4,0.25,0.417,0,0,0.0
Bernard King,kingbe01,SF,36,NJN,1993,32,430.0,223,18,35,41,76,11,3,21,53,91,177,0.5141242937853108,2,7,0.2857142857142857,89,170,0.5235294117647059,0.52,39,57,0.6842105263157895
Rich King,kingri01,C,23,SEA,1993,3,12.0,6,1,1,4,5,0,0,3,1,2,5,0.4,0,0,0.0,2,5,0.4,0.4,2,2,1.0
Stacey King,kingst01,C,26,CHI,1993,76,1059.0,408,71,105,102,207,26,20,70,128,160,340,0.4705882352941176,2,6,0.3333333333333333,158,334,0.4730538922155688,0.474,86,122,0.7049180327868853
Greg Kite,kitegr01,C,31,ORL,1993,64,640.0,89,10,66,127,193,13,12,35,133,38,84,0.4523809523809524,0,1,0.0,38,83,0.4578313253012048,0.452,13,24,0.5416666666666666
Joe Kleine,kleinjo01,C,31,BOS,1993,78,1129.0,257,39,113,233,346,17,17,37,123,108,267,0.4044943820224719,0,6,0.0,108,261,0.4137931034482758,0.404,41,58,0.7068965517241379
Negele Knight,knighne01,PG,25,PHO,1993,52,888.0,315,145,28,36,64,23,4,73,66,124,317,0.3911671924290221,0,7,0.0,124,310,0.4,0.391,67,86,0.7790697674418605
Bart Kofoed,kofoeba01,SG,28,BOS,1993,7,41.0,17,10,0,1,1,2,1,3,1,3,13,0.2307692307692307,0,1,0.0,3,12,0.25,0.231,11,14,0.7857142857142857
Jon Koncak,koncajo01,C,29,ATL,1993,78,1975.0,275,140,100,327,427,75,100,52,264,124,267,0.4644194756554307,3,8,0.375,121,259,0.4671814671814672,0.47,24,50,0.48
Larry Krystkowiak,krystla01,PF,28,UTA,1993,71,1362.0,513,68,74,205,279,42,13,62,181,198,425,0.4658823529411764,0,1,0.0,198,424,0.4669811320754717,0.466,117,147,0.7959183673469388
Christian Laettner,laettch01,PF,23,MIN,1993,81,2823.0,1472,223,171,537,708,105,83,275,290,503,1061,0.4740810556079171,4,40,0.1,499,1021,0.4887365328109696,0.476,462,553,0.8354430379746836
Bill Laimbeer,laimbbi01,C,35,DET,1993,79,1933.0,687,127,110,309,419,46,40,59,212,292,574,0.5087108013937283,10,27,0.3703703703703703,282,547,0.5155393053016454,0.517,93,104,0.8942307692307693
Jerome Lane,laneje01,PF,26,CLE,1993,21,149.0,59,17,24,29,53,12,3,7,32,27,54,0.5,0,0,0.0,27,54,0.5,0.5,5,20,0.25
Andrew Lang,langan01,C,26,PHI,1993,73,1861.0,386,79,136,300,436,46,141,89,261,149,351,0.4245014245014245,1,5,0.2,148,346,0.4277456647398844,0.426,87,114,0.7631578947368421
Doug Lee,leedo01,SG,28,NJN,1993,5,33.0,5,5,0,2,2,0,1,3,7,2,7,0.2857142857142857,1,3,0.3333333333333333,1,4,0.25,0.357,0,0,0.0
Tim Legler,legleti01,SG,26,TOT,1993,33,635.0,289,46,25,34,59,24,6,28,63,105,241,0.4356846473029045,22,65,0.3384615384615385,83,176,0.4715909090909091,0.481,57,71,0.8028169014084507
Jim Les,lesji01,PG,29,SAC,1993,73,881.0,328,169,20,69,89,40,7,48,81,110,259,0.4247104247104247,66,154,0.4285714285714285,44,105,0.419047619047619,0.552,42,50,0.84
Reggie Lewis,lewisre01,SG,27,BOS,1993,80,3144.0,1666,298,88,259,347,118,77,133,248,663,1410,0.4702127659574468,14,60,0.2333333333333333,649,1350,0.4807407407407407,0.475,326,376,0.8670212765957447
Marcus Liberty,liberma01,SF,24,DEN,1993,78,1585.0,628,105,131,204,335,64,21,79,143,252,620,0.4064516129032258,22,59,0.3728813559322034,230,561,0.409982174688057,0.424,102,156,0.6538461538461539
Todd Lichti,lichtto01,SG,26,DEN,1993,48,752.0,331,52,35,67,102,28,11,49,60,124,276,0.4492753623188406,2,6,0.3333333333333333,122,270,0.4518518518518518,0.453,81,102,0.7941176470588235
Alton Lister,listeal01,C,34,GSW,1993,20,174.0,45,5,15,29,44,0,9,18,40,19,42,0.4523809523809524,0,0,0.0,19,42,0.4523809523809524,0.452,7,13,0.5384615384615384
Brad Lohaus,lohaubr01,PF,28,MIL,1993,80,1766.0,724,127,59,217,276,47,74,93,178,283,614,0.4609120521172638,85,230,0.3695652173913043,198,384,0.515625,0.53,73,101,0.7227722772277227
Grant Long,longgr01,PF,26,MIA,1993,76,2728.0,1061,182,197,371,568,104,31,133,264,397,847,0.4687131050767414,6,26,0.2307692307692307,391,821,0.4762484774665043,0.472,261,341,0.7653958944281525
Luc Longley,longllu01,C,24,MIN,1993,55,1045.0,319,51,71,169,240,47,77,88,169,133,292,0.4554794520547945,0,0,0.0,133,292,0.4554794520547945,0.455,53,74,0.7162162162162162
Kevin Lynch,lynchke01,SG,24,CHH,1993,40,324.0,86,25,12,23,35,11,6,24,44,30,59,0.5084745762711864,0,1,0.0,30,58,0.5172413793103449,0.508,26,38,0.6842105263157895
Sam Mack,macksa01,SF,22,SAS,1993,40,267.0,142,15,18,30,48,14,5,22,44,47,118,0.3983050847457627,3,22,0.1363636363636363,44,96,0.4583333333333333,0.411,45,58,0.7758620689655172
Don MacLean,macledo01,PF,23,WSB,1993,62,674.0,407,39,33,89,122,11,4,42,82,157,361,0.4349030470914127,3,6,0.5,154,355,0.4338028169014084,0.439,90,111,0.8108108108108109
Mark Macon,maconma01,PG,23,DEN,1993,48,1141.0,358,126,33,70,103,69,3,72,135,158,381,0.4146981627296588,0,6,0.0,158,375,0.4213333333333333,0.415,42,60,0.7
Rick Mahorn,mahorri01,PF,34,NJN,1993,74,1077.0,291,33,93,186,279,19,31,58,156,101,214,0.4719626168224299,1,3,0.3333333333333333,100,211,0.4739336492890995,0.474,88,110,0.8
Dan Majerle,majerda01,SG,27,PHO,1993,82,3199.0,1388,311,120,263,383,138,33,133,180,509,1096,0.4644160583941605,167,438,0.3812785388127854,342,658,0.5197568389057751,0.541,203,261,0.7777777777777778
Jeff Malone,malonje01,SG,31,UTA,1993,79,2558.0,1429,128,31,142,173,42,4,125,117,595,1205,0.4937759336099585,3,9,0.3333333333333333,592,1196,0.4949832775919732,0.495,236,277,0.851985559566787
Karl Malone,malonka01,PF,29,UTA,1993,82,3099.0,2217,308,227,692,919,124,85,240,261,797,1443,0.5523215523215523,4,20,0.2,793,1423,0.5572733661278988,0.554,619,836,0.7404306220095693
Moses Malone,malonmo01,C,37,MIL,1993,11,104.0,50,7,22,24,46,1,8,10,6,13,42,0.3095238095238095,0,0,0.0,13,42,0.3095238095238095,0.31,24,31,0.7741935483870968
Danny Manning,mannida01,PF,26,LAC,1993,79,2761.0,1800,207,198,322,520,108,101,230,323,702,1379,0.5090645395213923,8,30,0.2666666666666666,694,1349,0.514455151964418,0.512,388,484,0.8016528925619835
Šarūnas Marčiulionis,marcisa01,SF,28,GSW,1993,30,836.0,521,105,40,57,97,51,2,76,92,178,328,0.5426829268292683,3,15,0.2,175,313,0.5591054313099042,0.547,162,213,0.7605633802816901
Anthony Mason,masonan01,PF,26,NYK,1993,81,2482.0,831,170,231,409,640,43,19,137,240,316,629,0.5023847376788553,0,0,0.0,316,629,0.5023847376788553,0.502,199,292,0.6815068493150684
Marlon Maxey,maxeyma01,PF,23,MIN,1993,43,520.0,231,12,66,98,164,11,18,38,75,93,169,0.5502958579881657,0,1,0.0,93,168,0.5535714285714286,0.55,45,70,0.6428571428571429
Vernon Maxwell,maxweve01,SG,27,HOU,1993,71,2251.0,982,297,29,192,221,86,8,140,124,349,858,0.4067599067599067,120,361,0.3324099722991689,229,497,0.4607645875251509,0.477,164,228,0.7192982456140351
Lee Mayberry,maybele01,PG,22,MIL,1993,82,1503.0,424,273,26,92,118,59,7,85,148,171,375,0.456,43,110,0.3909090909090909,128,265,0.4830188679245283,0.513,39,68,0.5735294117647058
Travis Mays,maystr01,PG,24,ATL,1993,49,787.0,341,72,20,33,53,21,3,51,59,129,309,0.4174757281553398,29,84,0.3452380952380952,100,225,0.4444444444444444,0.464,54,82,0.6585365853658537
Bob McCann,mccanbo01,SF,28,MIN,1993,79,1536.0,495,68,92,190,282,51,58,79,202,200,410,0.4878048780487805,0,2,0.0,200,408,0.4901960784313725,0.488,95,152,0.625
George McCloud,mccloge01,SF,25,IND,1993,78,1500.0,565,192,60,145,205,53,11,107,165,216,525,0.4114285714285714,58,181,0.3204419889502762,158,344,0.4593023255813953,0.467,75,102,0.7352941176470589
Rodney McCray,mccraro01,SF,31,CHI,1993,64,1019.0,222,81,53,105,158,12,15,53,99,92,204,0.4509803921568627,2,5,0.4,90,199,0.4522613065326633,0.456,36,52,0.6923076923076923
Xavier McDaniel,mcdanxa01,PF,29,BOS,1993,82,2215.0,1111,163,168,321,489,72,51,171,249,457,924,0.4945887445887446,6,22,0.2727272727272727,451,902,0.5,0.498,191,241,0.7925311203319502
Kevin McHale,mchalke01,PF,35,BOS,1993,71,1656.0,762,73,95,263,358,16,59,92,126,298,649,0.4591679506933744,2,18,0.1111111111111111,296,631,0.4690966719492868,0.461,164,195,0.841025641025641
Derrick McKey,mckeyde01,SF,26,SEA,1993,77,2439.0,1034,197,121,206,327,105,58,152,208,387,780,0.4961538461538461,40,112,0.3571428571428571,347,668,0.5194610778443114,0.522,220,297,0.7407407407407407
Nate McMillan,mcmilna01,PG,28,SEA,1993,73,1977.0,546,384,84,222,306,173,33,139,240,213,459,0.4640522875816993,25,65,0.3846153846153846,188,394,0.4771573604060913,0.491,95,134,0.7089552238805971
Oliver Miller,milleol01,C,22,PHO,1993,56,1069.0,313,118,70,205,275,38,100,108,145,121,255,0.4745098039215686,0,3,0.0,121,252,0.4801587301587302,0.475,71,100,0.71
Reggie Miller,millere01,SG,27,IND,1993,82,2954.0,1736,262,67,191,258,120,26,145,182,571,1193,0.4786253143336127,167,419,0.3985680190930787,404,774,0.5219638242894057,0.549,427,485,0.8804123711340206
Terry Mills,millste01,PF,25,DET,1993,81,2183.0,1199,111,176,296,472,44,50,142,282,494,1072,0.4608208955223881,10,36,0.2777777777777778,484,1036,0.4671814671814672,0.465,201,254,0.7913385826771654
Harold Miner,minerha01,SG,21,MIA,1993,73,1383.0,750,73,74,73,147,34,8,92,130,292,615,0.4747967479674796,3,9,0.3333333333333333,289,606,0.4768976897689769,0.477,163,214,0.7616822429906542
Sam Mitchell,mitchsa01,SF,29,IND,1993,81,1402.0,584,76,93,155,248,23,10,51,207,215,483,0.4451345755693582,4,23,0.1739130434782608,211,460,0.458695652173913,0.449,150,185,0.8108108108108109
Tracy Moore,mooretr01,SG,27,DAL,1993,39,510.0,282,47,23,29,52,21,4,32,54,103,249,0.4136546184738955,23,67,0.3432835820895522,80,182,0.4395604395604395,0.46,53,61,0.8688524590163934
Chris Morris,morrich01,SF,27,NJN,1993,77,2302.0,1086,106,227,227,454,144,52,119,171,436,907,0.4807056229327453,17,76,0.2236842105263158,419,831,0.5042117930204573,0.49,197,248,0.7943548387096774
Isaiah Morris,morriis01,SF,23,DET,1993,25,102.0,55,4,6,6,12,3,1,8,14,26,57,0.4561403508771929,0,0,0.0,26,57,0.4561403508771929,0.456,3,4,0.75
Alonzo Mourning,mournal01,C,22,CHH,1993,78,2644.0,1639,76,263,542,805,27,271,236,286,572,1119,0.5111706881143878,0,3,0.0,572,1116,0.5125448028673835,0.511,495,634,0.7807570977917981
Chris Mullin,mullich01,SF,29,GSW,1993,46,1902.0,1191,166,42,190,232,68,41,139,76,474,930,0.5096774193548387,60,133,0.4511278195488721,414,797,0.5194479297365119,0.542,183,226,0.8097345132743363
Eric Murdock,murdoer01,PG,24,MIL,1993,79,2437.0,1138,603,95,189,284,174,7,207,177,438,936,0.4679487179487179,31,119,0.2605042016806723,407,817,0.4981640146878825,0.485,231,296,0.7804054054054054
Tracy Murray,murratr01,SF,21,POR,1993,48,495.0,272,11,40,43,83,8,5,31,59,108,260,0.4153846153846154,21,70,0.3,87,190,0.4578947368421052,0.456,35,40,0.875
Jerrod Mustaf,mustaje01,PF,23,PHO,1993,32,336.0,147,10,29,54,83,14,11,22,40,57,130,0.4384615384615384,0,1,0.0,57,129,0.4418604651162791,0.438,33,53,0.6226415094339622
Dikembe Mutombo,mutomdi01,C,26,DEN,1993,82,3029.0,1131,147,344,726,1070,43,287,216,284,398,781,0.5096030729833547,0,0,0.0,398,781,0.5096030729833547,0.51,335,492,0.6808943089430894
Larry Nance,nancela01,PF,33,CLE,1993,77,2753.0,1268,223,184,484,668,54,198,107,223,533,971,0.548918640576725,0,4,0.0,533,967,0.5511892450879007,0.549,202,247,0.8178137651821862
Ed Nealy,nealyed01,PF,32,TOT,1993,41,308.0,69,15,12,52,64,12,2,7,41,26,69,0.3768115942028985,8,27,0.2962962962962963,18,42,0.4285714285714285,0.435,9,12,0.75
Melvin Newbern,newbeme01,SG,25,DET,1993,33,311.0,119,57,19,18,37,23,1,32,42,42,113,0.3716814159292035,1,8,0.125,41,105,0.3904761904761905,0.376,34,60,0.5666666666666667
Johnny Newman,newmajo01,SF,29,CHH,1993,64,1471.0,764,117,72,71,143,45,19,90,154,279,534,0.5224719101123596,12,45,0.2666666666666666,267,489,0.5460122699386503,0.534,194,240,0.8083333333333333
Ken Norman,normake01,SF,28,LAC,1993,76,2477.0,1137,165,209,362,571,59,58,125,156,498,975,0.5107692307692308,10,38,0.2631578947368421,488,937,0.5208110992529349,0.516,131,220,0.5954545454545455
Shaquille O'Neal,onealsh01,C,20,ORL,1993,81,3071.0,1893,152,342,780,1122,60,286,307,321,733,1304,0.5621165644171779,0,2,0.0,733,1302,0.5629800307219662,0.562,427,721,0.5922330097087378
Dan O'Sullivan,osullda01,C,24,TOT,1993,6,17.0,9,1,2,4,6,1,0,0,4,3,5,0.6,0,0,0.0,3,5,0.6,0.6,3,4,0.75
Charles Oakley,oaklech01,PF,29,NYK,1993,82,2230.0,565,126,288,420,708,85,15,124,289,219,431,0.5081206496519721,0,1,0.0,219,430,0.5093023255813953,0.508,127,176,0.7215909090909091
Alan Ogg,oggal01,C,25,TOT,1993,6,29.0,13,4,3,7,10,1,3,3,6,5,13,0.3846153846153846,0,0,0.0,5,13,0.3846153846153846,0.385,3,4,0.75
Hakeem Olajuwon,olajuha01,C,30,HOU,1993,82,3242.0,2140,291,283,785,1068,150,342,262,305,848,1603,0.529008109794136,0,8,0.0,848,1595,0.5316614420062696,0.529,444,570,0.7789473684210526
Matt Othick,othicma01,PG,23,SAS,1993,4,39.0,8,7,1,1,2,1,0,4,7,3,5,0.6,2,4,0.5,1,1,1.0,0.8,0,2,0.0
Doug Overton,overtdo01,PG,23,WSB,1993,45,990.0,366,157,25,81,106,31,6,72,81,152,323,0.4705882352941176,3,13,0.2307692307692307,149,310,0.4806451612903226,0.475,59,81,0.7283950617283951
Billy Owens,owensbi01,PF,23,GSW,1993,37,1201.0,612,144,108,156,264,35,28,106,105,247,493,0.5010141987829615,1,11,0.0909090909090909,246,482,0.5103734439834025,0.502,117,183,0.639344262295082
Robert Pack,packro01,PG,23,DEN,1993,77,1579.0,810,335,52,108,160,81,10,185,182,285,606,0.4702970297029702,1,8,0.125,284,598,0.4749163879598662,0.471,239,311,0.7684887459807074
Gerald Paddio,paddige01,SF,27,SEA,1993,41,307.0,158,33,17,33,50,14,6,16,24,71,159,0.4465408805031446,2,8,0.25,69,151,0.4569536423841059,0.453,14,21,0.6666666666666666
Walter Palmer,palmewa01,C,24,DAL,1993,20,124.0,60,5,12,32,44,1,5,10,29,27,57,0.4736842105263157,0,0,0.0,27,57,0.4736842105263157,0.474,6,9,0.6666666666666666
Robert Parish,parisro01,C,39,BOS,1993,79,2146.0,994,61,246,494,740,57,107,120,201,416,777,0.5353925353925354,0,0,0.0,416,777,0.5353925353925354,0.535,162,235,0.6893617021276596
John Paxson,paxsojo01,PG,32,CHI,1993,59,1030.0,246,136,9,39,48,38,2,31,99,105,233,0.4506437768240343,19,41,0.4634146341463415,86,192,0.4479166666666667,0.491,17,20,0.85
Kenny Payne,payneke01,SF,26,PHI,1993,13,154.0,84,18,4,20,24,5,2,7,15,38,90,0.4222222222222222,4,18,0.2222222222222222,34,72,0.4722222222222222,0.444,4,4,1.0
Gary Payton,paytoga01,PG,24,SEA,1993,82,2548.0,1110,399,95,186,281,177,21,148,250,476,963,0.494288681204569,7,34,0.2058823529411764,469,929,0.5048439181916039,0.498,151,196,0.7704081632653061
Anthony Peeler,peelean01,SG,23,LAL,1993,77,1656.0,802,166,64,115,179,60,14,123,193,297,634,0.4684542586750788,46,118,0.3898305084745763,251,516,0.4864341085271317,0.505,162,206,0.7864077669902912
Will Perdue,perduwi01,C,27,CHI,1993,72,998.0,341,74,103,184,287,22,47,74,139,137,246,0.556910569105691,0,1,0.0,137,245,0.5591836734693878,0.557,67,111,0.6036036036036037
Sam Perkins,perkisa01,PF,31,TOT,1993,79,2351.0,1036,156,163,361,524,60,82,108,225,381,799,0.4768460575719649,24,71,0.3380281690140845,357,728,0.4903846153846153,0.492,250,305,0.819672131147541
Tim Perry,perryti01,PF,27,PHI,1993,81,2104.0,731,126,154,255,409,40,91,123,159,287,613,0.4681892332789559,10,49,0.2040816326530612,277,564,0.4911347517730496,0.476,147,207,0.7101449275362319
Chuck Person,persoch01,SF,28,MIN,1993,78,2985.0,1309,343,98,335,433,67,30,219,198,541,1248,0.4334935897435897,118,332,0.3554216867469879,423,916,0.4617903930131004,0.481,109,168,0.6488095238095238
Dražen Petrović,petrodr01,SG,28,NJN,1993,70,2660.0,1564,247,42,148,190,94,13,204,237,587,1134,0.517636684303351,75,167,0.4491017964071856,512,967,0.5294725956566702,0.551,315,362,0.8701657458563536
Bobby Phills,phillbo01,SG,23,CLE,1993,31,139.0,93,10,6,11,17,10,2,18,19,38,82,0.4634146341463415,2,5,0.4,36,77,0.4675324675324675,0.476,15,25,0.6
Ricky Pierce,piercri01,SG,33,SEA,1993,77,2218.0,1403,220,58,134,192,100,7,160,167,524,1071,0.4892623716153128,42,113,0.3716814159292035,482,958,0.5031315240083507,0.509,313,352,0.8892045454545454
Ed Pinckney,pincked01,PF,29,BOS,1993,7,151.0,32,1,14,29,43,4,7,8,13,10,24,0.4166666666666667,0,0,0.0,10,24,0.4166666666666667,0.417,12,13,0.9230769230769232
Scottie Pippen,pippesc01,SF,27,CHI,1993,81,3123.0,1510,507,203,418,621,173,73,246,219,628,1327,0.4732479276563677,22,93,0.2365591397849462,606,1234,0.4910858995137763,0.482,232,350,0.6628571428571428
Gary Plummer,plummga01,PF,30,DEN,1993,60,737.0,281,40,53,120,173,14,11,78,141,106,228,0.4649122807017544,0,3,0.0,106,225,0.4711111111111111,0.465,69,95,0.7263157894736842
Olden Polynice,polynol01,C,28,DET,1993,67,1299.0,486,29,181,237,418,31,21,54,126,210,429,0.4895104895104895,0,1,0.0,210,428,0.4906542056074766,0.49,66,142,0.4647887323943662
Terry Porter,portete01,PG,29,POR,1993,81,2883.0,1476,419,58,258,316,101,10,199,122,503,1108,0.453971119133574,143,345,0.4144927536231884,360,763,0.4718217562254259,0.519,327,388,0.8427835051546392
Paul Pressey,presspa01,SG,34,GSW,1993,18,268.0,79,30,8,23,31,11,5,23,36,29,66,0.4393939393939394,0,4,0.0,29,62,0.4677419354838709,0.439,21,27,0.7777777777777778
Brent Price,pricebr01,PG,24,WSB,1993,68,859.0,262,154,28,75,103,56,3,85,90,100,279,0.3584229390681003,8,48,0.1666666666666666,92,231,0.3982683982683982,0.373,54,68,0.7941176470588235
Mark Price,pricema01,PG,28,CLE,1993,75,2380.0,1365,602,37,164,201,89,11,196,105,477,986,0.4837728194726166,122,293,0.4163822525597269,355,693,0.5122655122655123,0.546,289,305,0.9475409836065574
Anthony Pullard,pullaan01,PF,26,MIL,1993,8,37.0,17,2,2,6,8,2,2,5,5,8,18,0.4444444444444444,0,0,0.0,8,18,0.4444444444444444,0.444,1,3,0.3333333333333333
Kurt Rambis,rambiku01,PF,34,TOT,1993,72,822.0,177,53,77,150,227,43,18,42,122,67,129,0.5193798449612403,0,2,0.0,67,127,0.5275590551181102,0.519,43,65,0.6615384615384615
Mark Randall,randama01,PF,25,TOT,1993,37,248.0,97,11,27,28,55,4,2,17,33,40,80,0.5,1,8,0.125,39,72,0.5416666666666666,0.506,16,26,0.6153846153846154
Blair Rasmussen,rasmubl01,C,30,ATL,1993,22,283.0,71,5,20,35,55,5,10,12,61,30,80,0.375,2,6,0.3333333333333333,28,74,0.3783783783783784,0.388,9,13,0.6923076923076923
J.R. Reid,reidjr01,PF,24,TOT,1993,83,1887.0,780,80,120,336,456,47,31,125,266,283,595,0.4756302521008403,0,5,0.0,283,590,0.4796610169491525,0.476,214,280,0.7642857142857142
Glen Rice,ricegl01,SF,25,MIA,1993,82,3082.0,1554,180,92,332,424,92,25,157,201,582,1324,0.4395770392749245,148,386,0.3834196891191709,434,938,0.4626865671641791,0.495,242,295,0.8203389830508474
Pooh Richardson,richapo01,PG,26,IND,1993,74,2396.0,769,573,63,204,267,94,12,167,132,337,703,0.4793741109530583,3,29,0.1034482758620689,334,674,0.4955489614243323,0.482,92,124,0.7419354838709677
Mitch Richmond,richmmi01,SG,27,SAC,1993,45,1728.0,987,221,18,136,154,53,9,130,137,371,782,0.4744245524296675,48,130,0.3692307692307692,323,652,0.495398773006135,0.505,197,233,0.8454935622317596
Doc Rivers,riverdo01,PG,31,NYK,1993,77,1886.0,604,405,26,166,192,123,9,114,215,216,494,0.437246963562753,39,123,0.3170731707317073,177,371,0.477088948787062,0.477,133,162,0.8209876543209876
Fred Roberts,roberfr01,C,32,MIL,1993,79,1488.0,599,118,91,146,237,57,27,67,138,226,428,0.5280373831775701,12,29,0.4137931034482758,214,399,0.5363408521303258,0.542,135,169,0.7988165680473372
Stanley Roberts,roberst01,C,22,LAC,1993,77,1816.0,870,59,181,297,478,34,141,121,332,375,711,0.5274261603375527,0,0,0.0,375,711,0.5274261603375527,0.527,120,246,0.4878048780487805
Alvin Robertson,roberal01,SG,30,TOT,1993,69,2006.0,618,263,107,162,269,155,18,133,218,247,539,0.4582560296846011,40,122,0.3278688524590163,207,417,0.4964028776978417,0.495,84,128,0.65625
Clifford Robinson,robincl02,PF,26,POR,1993,82,2575.0,1570,182,165,377,542,98,163,173,287,632,1336,0.4730538922155688,19,77,0.2467532467532467,613,1259,0.4868943606036537,0.48,287,416,0.6899038461538461
David Robinson,robinda01,C,27,SAS,1993,82,3211.0,1916,301,229,727,956,127,264,241,239,676,1348,0.5014836795252225,3,17,0.1764705882352941,673,1331,0.5056348610067618,0.503,561,766,0.7323759791122716
Larry Robinson,robinla01,SG,25,WSB,1993,4,33.0,15,3,1,2,3,1,1,1,0,6,16,0.375,0,1,0.0,6,15,0.4,0.375,3,5,0.6
Rumeal Robinson,robinru01,PG,26,NJN,1993,80,1585.0,672,323,49,110,159,96,12,140,169,270,638,0.4231974921630094,20,56,0.3571428571428571,250,582,0.4295532646048109,0.439,112,195,0.5743589743589743
Dennis Rodman,rodmade01,PF,31,DET,1993,62,2410.0,468,102,367,765,1132,48,45,103,201,183,429,0.4265734265734265,15,73,0.2054794520547945,168,356,0.4719101123595505,0.444,87,163,0.5337423312883436
Tree Rollins,rollitr01,C,37,HOU,1993,42,247.0,31,10,12,48,60,6,15,9,43,11,41,0.2682926829268293,0,2,0.0,11,39,0.282051282051282,0.268,9,12,0.75
Sean Rooks,rooksse01,C,23,DAL,1993,72,2087.0,970,95,196,340,536,38,81,160,204,368,747,0.4926372155287818,0,2,0.0,368,745,0.4939597315436241,0.493,234,389,0.6015424164524421
Donald Royal,royaldo01,SF,26,ORL,1993,77,1636.0,706,80,116,179,295,36,25,113,179,194,391,0.4961636828644501,0,3,0.0,194,388,0.5,0.496,318,390,0.8153846153846154
Delaney Rudd,ruddde01,PG,30,POR,1993,15,95.0,26,17,4,5,9,1,0,11,7,7,36,0.1944444444444444,1,11,0.0909090909090909,6,25,0.24,0.208,11,14,0.7857142857142857
Jeff Ruland,rulanje01,C,34,DET,1993,11,55.0,12,2,9,9,18,2,0,6,16,5,11,0.4545454545454545,0,0,0.0,5,11,0.4545454545454545,0.455,2,4,0.5
John Salley,sallejo01,PF,28,MIA,1993,51,1422.0,423,83,113,200,313,32,70,101,192,154,307,0.501628664495114,0,0,0.0,154,307,0.501628664495114,0.502,115,144,0.7986111111111112
Jeff Sanders,sandeje01,PF,27,ATL,1993,9,120.0,24,6,12,17,29,8,1,11,16,10,25,0.4,0,0,0.0,10,25,0.4,0.4,4,8,0.5
Mike Sanders,sandemi01,SF,32,CLE,1993,53,1189.0,454,75,52,118,170,39,30,57,150,197,396,0.4974747474747474,1,4,0.25,196,392,0.5,0.499,59,78,0.7564102564102564
Danny Schayes,schayda01,C,33,MIL,1993,70,1124.0,322,78,72,177,249,36,36,65,148,105,263,0.3992395437262357,0,3,0.0,105,260,0.4038461538461538,0.399,112,137,0.8175182481751825
Steve Scheffler,schefst01,C,25,SEA,1993,29,166.0,66,5,15,21,36,6,1,5,37,25,48,0.5208333333333334,0,0,0.0,25,48,0.5208333333333334,0.521,16,24,0.6666666666666666
Dwayne Schintzius,schindw01,C,24,NJN,1993,5,35.0,7,2,2,6,8,2,2,0,4,2,7,0.2857142857142857,0,0,0.0,2,7,0.2857142857142857,0.286,3,3,1.0
Detlef Schrempf,schrede01,PF,30,IND,1993,82,3098.0,1567,493,210,570,780,79,27,243,305,517,1085,0.4764976958525345,8,52,0.1538461538461538,509,1033,0.4927395934172314,0.48,525,653,0.8039816232771823
Byron Scott,scottby01,SG,31,LAL,1993,58,1677.0,792,157,27,107,134,55,13,70,98,296,659,0.4491654021244309,44,135,0.3259259259259259,252,524,0.4809160305343511,0.483,156,184,0.8478260869565217
Dennis Scott,scottde01,SF,24,ORL,1993,54,1759.0,858,136,38,148,186,57,18,104,131,329,763,0.4311926605504587,108,268,0.4029850746268656,221,495,0.4464646464646464,0.502,92,117,0.7863247863247863
Malik Sealy,sealyma01,SF,22,IND,1993,58,672.0,330,47,60,52,112,36,7,58,74,136,319,0.4263322884012539,7,31,0.2258064516129032,129,288,0.4479166666666667,0.437,51,74,0.6891891891891891
Rony Seikaly,seikaro01,C,27,MIA,1993,72,2456.0,1232,100,259,587,846,38,83,203,260,417,868,0.4804147465437788,1,8,0.125,416,860,0.4837209302325581,0.481,397,540,0.7351851851851852
Brad Sellers,sellebr01,PF,30,MIN,1993,54,533.0,135,46,27,56,83,6,11,27,40,49,130,0.3769230769230769,0,1,0.0,49,129,0.3798449612403101,0.377,37,39,0.9487179487179488
Charles Shackleford,shackch01,C,26,PHI,1993,48,568.0,191,26,65,140,205,13,25,36,92,80,164,0.4878048780487805,0,2,0.0,80,162,0.4938271604938271,0.488,31,49,0.6326530612244898
Brian Shaw,shawbr01,PG,26,MIA,1993,68,1603.0,498,235,70,187,257,48,19,96,163,197,501,0.3932135728542914,43,130,0.3307692307692307,154,371,0.4150943396226415,0.436,61,78,0.782051282051282
Lionel Simmons,simmoli01,SF,24,SAC,1993,69,2502.0,1235,312,156,339,495,95,38,196,197,468,1055,0.4436018957345971,1,11,0.0909090909090909,467,1044,0.4473180076628352,0.444,298,364,0.8186813186813187
Scott Skiles,skilesc01,PG,28,ORL,1993,78,3086.0,1201,735,52,238,290,86,2,267,244,416,891,0.4668911335578002,80,235,0.3404255319148936,336,656,0.5121951219512195,0.512,289,324,0.8919753086419753
Charles Smith,smithch01,SF,27,NYK,1993,81,2172.0,1003,142,170,262,432,48,96,155,254,358,764,0.468586387434555,0,2,0.0,358,762,0.4698162729658792,0.469,287,367,0.782016348773842
Chris Smith,smithch03,SG,22,MIN,1993,80,1266.0,347,196,32,64,96,48,16,68,96,125,289,0.4325259515570934,2,14,0.1428571428571428,123,275,0.4472727272727272,0.436,95,120,0.7916666666666666
Doug Smith,smithdo03,PF,23,DAL,1993,61,1524.0,634,104,96,232,328,48,52,115,280,289,666,0.4339339339339339,0,4,0.0,289,662,0.4365558912386706,0.434,56,74,0.7567567567567568
Kenny Smith,smithke01,PG,27,HOU,1993,82,2422.0,1065,446,28,132,160,80,7,163,110,387,744,0.5201612903225806,96,219,0.4383561643835616,291,525,0.5542857142857143,0.585,195,222,0.8783783783783784
LaBradford Smith,smithla02,SG,23,WSB,1993,69,1546.0,639,186,26,80,106,58,9,103,178,261,570,0.4578947368421052,8,23,0.3478260869565217,253,547,0.4625228519195612,0.465,109,127,0.8582677165354331
Larry Smith,smithla01,PF,35,SAS,1993,66,833.0,85,28,103,165,268,23,16,39,133,38,87,0.4367816091954023,0,0,0.0,38,87,0.4367816091954023,0.437,9,22,0.4090909090909091
Reggie Smith,smithre01,C,22,POR,1993,23,68.0,23,1,15,6,21,4,1,4,16,10,27,0.3703703703703703,0,1,0.0,10,26,0.3846153846153846,0.37,3,14,0.2142857142857142
Steve Smith,smithst01,SG,23,MIA,1993,48,1610.0,766,267,56,141,197,50,16,129,148,279,619,0.4507269789983845,53,132,0.4015151515151515,226,487,0.4640657084188911,0.494,155,197,0.7868020304568528
Tony Smith,smithto02,SG,24,LAL,1993,55,752.0,330,63,46,41,87,50,7,40,72,133,275,0.4836363636363636,2,11,0.1818181818181818,131,264,0.4962121212121212,0.487,62,82,0.7560975609756098
Rik Smits,smitsri01,C,26,IND,1993,81,2072.0,1155,121,126,306,432,27,75,147,285,494,1017,0.4857423795476893,0,0,0.0,494,1017,0.4857423795476893,0.486,167,228,0.7324561403508771
Andre Spencer,spencan01,SF,28,TOT,1993,20,422.0,187,24,38,43,81,17,7,26,64,73,163,0.4478527607361963,0,2,0.0,73,161,0.453416149068323,0.448,41,54,0.7592592592592593
Elmore Spencer,spencel01,C,23,LAC,1993,44,280.0,104,8,17,45,62,8,18,26,54,44,82,0.5365853658536586,0,0,0.0,44,82,0.5365853658536586,0.537,16,32,0.5
Felton Spencer,spencfe01,C,25,MIN,1993,71,1296.0,293,17,134,190,324,23,66,70,243,105,226,0.4646017699115044,0,0,0.0,105,226,0.4646017699115044,0.465,83,127,0.6535433070866141
Latrell Sprewell,sprewla01,SG,22,GSW,1993,77,2741.0,1182,295,79,192,271,126,52,203,166,449,968,0.4638429752066115,73,198,0.3686868686868687,376,770,0.4883116883116883,0.502,211,283,0.7455830388692579
John Starks,starkjo01,SG,27,NYK,1993,80,2477.0,1397,404,54,150,204,91,12,173,234,513,1199,0.4278565471226022,108,336,0.3214285714285714,405,863,0.4692931633835457,0.473,263,331,0.7945619335347432
Barry Stevens,steveba01,SF,30,GSW,1993,2,6.0,2,0,2,0,2,0,0,0,1,1,2,0.5,0,0,0.0,1,2,0.5,0.5,0,0,0.0
Larry Stewart,stewala01,SF,24,WSB,1993,81,1823.0,796,146,154,229,383,47,29,153,191,306,564,0.5425531914893617,0,2,0.0,306,562,0.5444839857651246,0.543,184,253,0.7272727272727273
Bryant Stith,stithbr01,SG,22,DEN,1993,39,865.0,347,49,39,85,124,24,5,44,82,124,278,0.4460431654676259,0,4,0.0,124,274,0.4525547445255474,0.446,99,119,0.8319327731092437
Alex Stivrins,stivral01,PF-SF,30,TOT,1993,19,76.0,41,3,7,12,19,2,2,7,11,19,39,0.4871794871794871,0,2,0.0,19,37,0.5135135135135135,0.487,3,4,0.75
John Stockton,stockjo01,PG,30,UTA,1993,82,2863.0,1239,987,64,173,237,199,21,266,224,437,899,0.4860956618464961,72,187,0.3850267379679144,365,712,0.5126404494382022,0.526,293,367,0.7983651226158038
Rod Strickland,stricro02,SG,26,POR,1993,78,2474.0,1069,559,120,217,337,131,24,199,153,396,816,0.4852941176470588,4,30,0.1333333333333333,392,786,0.4987277353689567,0.488,273,381,0.7165354330708661
Derek Strong,stronde01,PF,24,MIL,1993,23,339.0,156,14,40,75,115,11,1,13,20,42,92,0.4565217391304347,4,8,0.5,38,84,0.4523809523809524,0.478,68,85,0.8
Lamont Strothers,strotla01,SG,24,DAL,1993,9,138.0,50,13,8,6,14,8,0,15,13,20,61,0.3278688524590163,2,13,0.1538461538461538,18,48,0.375,0.344,8,10,0.8
Terry Teagle,teaglte01,SG,32,HOU,1993,2,25.0,5,2,0,3,3,0,0,1,1,2,7,0.2857142857142857,0,0,0.0,2,7,0.2857142857142857,0.286,1,2,0.5
Isiah Thomas,thomais01,PG,31,DET,1993,79,2922.0,1391,671,71,161,232,123,18,284,222,526,1258,0.4181240063593004,61,198,0.308080808080808,465,1060,0.4386792452830189,0.442,278,377,0.7374005305039788
LaSalle Thompson,thompla01,C,31,IND,1993,63,730.0,237,34,55,123,178,29,24,47,137,104,213,0.488262910798122,0,1,0.0,104,212,0.490566037735849,0.488,29,39,0.7435897435897436
Otis Thorpe,thorpot01,PF,30,HOU,1993,72,2357.0,923,181,219,370,589,43,19,151,234,385,690,0.5579710144927537,0,2,0.0,385,688,0.559593023255814,0.558,153,256,0.59765625
Sedale Threatt,threase01,PG,31,LAL,1993,82,2893.0,1235,564,47,226,273,142,11,173,248,522,1028,0.5077821011673151,14,53,0.2641509433962264,508,975,0.521025641025641,0.515,177,215,0.8232558139534883
Wayman Tisdale,tisdawa01,PF,28,SAC,1993,76,2283.0,1263,108,127,373,500,52,47,117,277,544,1068,0.5093632958801498,0,2,0.0,544,1066,0.5103189493433395,0.509,175,231,0.7575757575757576
Tom Tolbert,tolbeto01,PF,27,ORL,1993,72,1838.0,583,91,133,279,412,33,21,124,192,226,454,0.4977973568281938,9,28,0.3214285714285714,217,426,0.5093896713615024,0.508,122,168,0.7261904761904762
Trent Tucker,tucketr01,SG,33,CHI,1993,69,909.0,356,82,16,55,71,24,6,18,65,143,295,0.4847457627118644,52,131,0.3969465648854962,91,164,0.5548780487804879,0.573,18,22,0.8181818181818182
Jeff Turner,turneje01,PF,30,ORL,1993,75,1479.0,528,107,74,178,252,19,9,66,192,231,437,0.528604118993135,10,17,0.5882352941176471,221,420,0.5261904761904762,0.54,56,70,0.8
Kiki Vandeweghe,vandeki01,SF,34,LAC,1993,41,494.0,254,25,12,36,48,13,7,20,45,92,203,0.4532019704433497,12,37,0.3243243243243243,80,166,0.4819277108433735,0.483,58,66,0.8787878787878788
Loy Vaught,vaughlo01,PF,24,LAC,1993,79,1653.0,743,54,164,328,492,55,39,83,172,313,616,0.5081168831168831,1,4,0.25,312,612,0.5098039215686274,0.509,116,155,0.7483870967741936
Gundars Vētra,vetragu01,SF,25,MIN,1993,13,89.0,45,6,4,4,8,2,0,2,12,19,40,0.475,3,3,1.0,16,37,0.4324324324324324,0.513,4,6,0.6666666666666666
Darrell Walker,walkeda01,PG-SG,31,TOT,1993,37,511.0,80,53,22,36,58,33,2,25,63,34,96,0.3541666666666667,0,1,0.0,34,95,0.3578947368421052,0.354,12,26,0.4615384615384615
Duane Washington,washidu01,SG,28,LAC,1993,4,28.0,0,5,0,2,2,1,0,2,2,0,5,0.0,0,0,0.0,0,5,0.0,0.0,0,0,0.0
Clarence Weatherspoon,weathcl01,SF,22,PHI,1993,82,2654.0,1280,147,179,410,589,85,67,176,188,494,1053,0.4691358024691358,1,4,0.25,493,1049,0.4699714013346044,0.47,291,408,0.7132352941176471
Marcus Webb,webbma01,PF,22,BOS,1993,9,51.0,39,2,5,5,10,1,2,5,11,13,25,0.52,0,1,0.0,13,24,0.5416666666666666,0.52,13,21,0.6190476190476191
Spud Webb,webbsp01,PG,29,SAC,1993,69,2335.0,1000,481,44,149,193,104,6,194,177,342,789,0.4334600760456273,37,135,0.2740740740740741,305,654,0.4663608562691131,0.457,279,328,0.850609756097561
Robert Werdann,werdaro01,C,22,DEN,1993,28,149.0,53,7,23,29,52,6,4,12,38,18,59,0.3050847457627119,0,1,0.0,18,58,0.3103448275862069,0.305,17,31,0.5483870967741935
Doug West,westdo01,SG,25,MIN,1993,80,3104.0,1543,235,89,158,247,85,21,165,279,646,1249,0.5172137710168134,2,23,0.0869565217391304,644,1226,0.5252854812398042,0.518,249,296,0.8412162162162162
Mark West,westma01,C,32,PHO,1993,82,1558.0,436,29,153,305,458,16,103,93,243,175,285,0.6140350877192983,0,0,0.0,175,285,0.6140350877192983,0.614,86,166,0.5180722891566265
Randy White,whitera01,PF,25,DAL,1993,64,1433.0,618,49,154,216,370,63,45,108,226,235,540,0.4351851851851852,10,42,0.238095238095238,225,498,0.4518072289156626,0.444,138,184,0.75
Morlon Wiley,wileymo01,PG,26,TOT,1993,58,995.0,263,181,29,62,91,65,3,80,127,96,254,0.3779527559055118,54,154,0.3506493506493506,42,100,0.42,0.484,17,26,0.6538461538461539
Dominique Wilkins,wilkido01,SF,33,ATL,1993,71,2647.0,2121,227,187,295,482,70,27,184,116,741,1584,0.4678030303030303,120,316,0.379746835443038,621,1268,0.4897476340694006,0.506,519,627,0.8277511961722488
Eddie Lee Wilkins,wilkied01,PF,30,PHI,1993,26,192.0,158,2,14,26,40,7,1,17,34,55,97,0.5670103092783505,0,2,0.0,55,95,0.5789473684210527,0.567,48,78,0.6153846153846154
Gerald Wilkins,wilkige01,SF,29,CLE,1993,80,2079.0,890,183,74,140,214,78,18,94,154,361,797,0.452948557089084,16,58,0.2758620689655172,345,739,0.4668470906630582,0.463,152,181,0.8397790055248618
Buck Williams,willibu01,PF,32,POR,1993,82,2498.0,678,75,232,458,690,81,61,101,270,270,528,0.5113636363636364,0,1,0.0,270,527,0.5123339658444023,0.511,138,214,0.6448598130841121
Corey Williams,willico01,PG,22,CHI,1993,35,242.0,81,23,19,12,31,4,2,11,24,31,85,0.3647058823529411,1,3,0.3333333333333333,30,82,0.3658536585365853,0.371,18,22,0.8181818181818182
Herb Williams,willihe01,C,34,NYK,1993,55,571.0,158,19,44,102,146,21,28,22,78,72,175,0.4114285714285714,0,0,0.0,72,175,0.4114285714285714,0.411,14,21,0.6666666666666666
Hot Rod Williams,williho01,C,30,CLE,1993,67,2055.0,738,152,127,288,415,48,105,116,171,263,560,0.4696428571428571,0,0,0.0,263,560,0.4696428571428571,0.47,212,296,0.7162162162162162
Jayson Williams,willija01,PF,24,NJN,1993,12,139.0,49,0,22,19,41,4,4,8,24,21,46,0.4565217391304347,0,0,0.0,21,46,0.4565217391304347,0.457,7,18,0.3888888888888889
John Williams,willijo02,SF,26,LAC,1993,74,1638.0,492,142,88,228,316,83,23,79,188,205,477,0.429769392033543,12,53,0.2264150943396226,193,424,0.455188679245283,0.442,70,129,0.5426356589147286
Kenny Williams,willike03,SF,23,IND,1993,57,844.0,348,38,102,126,228,21,45,28,87,150,282,0.5319148936170213,0,3,0.0,150,279,0.5376344086021505,0.532,48,68,0.7058823529411765
Lorenzo Williams,willilo01,PF-C,23,TOT,1993,27,179.0,36,5,17,38,55,5,17,8,29,17,36,0.4722222222222222,0,0,0.0,17,36,0.4722222222222222,0.472,2,7,0.2857142857142857
Micheal Williams,willimi02,PG,26,MIN,1993,76,2661.0,1151,661,84,189,273,165,23,227,268,353,791,0.4462705436156763,26,107,0.2429906542056074,327,684,0.4780701754385965,0.463,419,462,0.9069264069264068
Reggie Williams,willire01,SF,28,DEN,1993,79,2722.0,1341,295,132,296,428,126,76,194,284,535,1167,0.4584404455869751,33,122,0.2704918032786885,502,1045,0.4803827751196172,0.473,238,296,0.8040540540540541
Scott Williams,willisc01,PF,24,CHI,1993,71,1369.0,422,68,168,283,451,55,66,73,230,166,356,0.4662921348314606,0,7,0.0,166,349,0.4756446991404011,0.466,90,126,0.7142857142857143
Walt Williams,williwa02,SF,22,SAC,1993,59,1673.0,1001,178,115,150,265,66,29,179,209,358,823,0.4349939246658566,61,191,0.3193717277486911,297,632,0.4699367088607595,0.472,224,302,0.7417218543046358
Kevin Willis,willike02,PF,30,ATL,1993,80,2878.0,1435,165,335,693,1028,68,41,213,264,616,1218,0.5057471264367817,7,29,0.2413793103448276,609,1189,0.5121951219512195,0.509,196,300,0.6533333333333333
Kennard Winchester,winchke01,SG,26,HOU,1993,39,340.0,143,13,17,32,49,10,10,15,40,61,139,0.4388489208633093,4,19,0.2105263157894736,57,120,0.475,0.453,17,22,0.7727272727272727
David Wingate,wingada01,SF,29,CHH,1993,72,1471.0,440,183,49,125,174,66,9,89,135,180,336,0.5357142857142857,1,6,0.1666666666666666,179,330,0.5424242424242425,0.537,79,107,0.7383177570093458
Joe Wolf,wolfjo01,C,28,TOT,1993,23,165.0,53,5,14,34,48,7,1,7,24,20,44,0.4545454545454545,0,1,0.0,20,43,0.4651162790697674,0.455,13,16,0.8125
David Wood,woodda01,PF,28,SAS,1993,64,598.0,155,34,38,59,97,13,12,29,93,52,117,0.4444444444444444,5,21,0.238095238095238,47,96,0.4895833333333333,0.466,46,55,0.8363636363636363
Randy Woods,woodsra01,PG,22,LAC,1993,41,174.0,68,40,6,8,14,14,1,16,26,23,66,0.3484848484848485,3,14,0.2142857142857142,20,52,0.3846153846153846,0.371,19,26,0.7307692307692307
Orlando Woolridge,woolror01,SF,33,TOT,1993,58,1555.0,698,115,87,98,185,27,27,79,122,289,599,0.4824707846410684,0,9,0.0,289,590,0.4898305084745762,0.482,120,177,0.6779661016949152
James Worthy,worthja01,SF,31,LAL,1993,82,2359.0,1221,278,73,174,247,92,27,137,87,510,1142,0.446584938704028,30,111,0.2702702702702703,480,1031,0.4655674102812803,0.46,171,211,0.8104265402843602
Howard Wright,wrighho02,PF,25,ORL,1993,4,10.0,8,0,1,1,2,0,0,0,0,4,5,0.8,0,0,0.0,4,5,0.8,0.8,0,2,0.0
Danny Young,youngda01,PG,30,DET,1993,65,836.0,188,119,13,34,47,31,5,30,36,69,167,0.4131736526946107,22,68,0.3235294117647059,47,99,0.4747474747474747,0.479,28,32,0.875
Alaa Abdelnaby,abdelal01,PF,25,BOS,1994,13,159.0,64,3,12,34,46,2,3,17,20,24,55,0.4363636363636363,0,0,0.0,24,55,0.4363636363636363,0.436,16,25,0.64
Mahmoud Abdul-Rauf,abdulma02,PG,24,DEN,1994,80,2617.0,1437,362,27,141,168,82,10,151,150,588,1279,0.4597341673182173,42,133,0.3157894736842105,546,1146,0.4764397905759162,0.476,219,229,0.9563318777292577
Michael Adams,adamsmi01,PG,31,WSB,1994,70,2337.0,849,480,37,146,183,96,6,167,140,285,698,0.4083094555873925,55,191,0.2879581151832461,230,507,0.4536489151873767,0.448,224,270,0.8296296296296296
Mark Aguirre,aguirma01,SF,34,LAC,1994,39,859.0,413,104,28,88,116,21,8,70,98,163,348,0.4683908045977011,37,93,0.3978494623655914,126,255,0.4941176470588235,0.522,50,72,0.6944444444444444
Danny Ainge,aingeda01,SG,34,PHO,1994,68,1555.0,606,180,28,103,131,57,8,81,140,224,537,0.4171322160148976,80,244,0.3278688524590163,144,293,0.4914675767918088,0.492,78,94,0.8297872340425532
Gary Alexander,alexaga01,PF,24,TOT,1994,11,55.0,19,2,7,8,15,3,0,8,10,8,14,0.5714285714285714,0,0,0.0,8,14,0.5714285714285714,0.571,3,9,0.3333333333333333
Victor Alexander,alexavi01,C,24,GSW,1994,69,1318.0,602,66,114,194,308,28,32,86,168,266,502,0.5298804780876494,2,13,0.1538461538461538,264,489,0.5398773006134969,0.532,68,129,0.5271317829457365
Eric Anderson,anderer01,PF,23,NYK,1994,11,39.0,21,2,6,11,17,0,1,2,9,7,17,0.4117647058823529,2,2,1.0,5,15,0.3333333333333333,0.471,5,14,0.3571428571428571
Greg Anderson,andergr01,PF,29,DET,1994,77,1624.0,491,51,183,388,571,55,68,94,234,201,370,0.5432432432432432,1,3,0.3333333333333333,200,367,0.5449591280653951,0.545,88,154,0.5714285714285714
Kenny Anderson,anderke01,PG,23,NJN,1994,82,3135.0,1538,784,89,233,322,158,15,266,201,576,1381,0.4170890658942795,40,132,0.303030303030303,536,1249,0.4291433146517214,0.432,346,423,0.817966903073286
Nick Anderson,anderni01,SG,26,ORL,1994,81,2811.0,1277,294,113,363,476,134,33,165,148,504,1054,0.4781783681214421,101,314,0.321656050955414,403,740,0.5445945945945946,0.526,168,250,0.672
Ron Anderson,anderro01,SF,35,TOT,1994,21,356.0,96,17,16,37,53,8,3,10,16,35,86,0.4069767441860465,7,26,0.2692307692307692,28,60,0.4666666666666667,0.448,19,23,0.8260869565217391
Willie Anderson,anderwi01,SG,27,SAS,1994,80,2488.0,955,347,68,174,242,71,46,153,187,394,837,0.4707287933094384,22,68,0.3235294117647059,372,769,0.4837451235370611,0.484,145,171,0.847953216374269
Greg Anthony,anthogr01,PG,26,NYK,1994,80,1994.0,628,365,43,146,189,114,13,127,163,225,571,0.3940455341506129,48,160,0.3,177,411,0.4306569343065693,0.436,130,168,0.7738095238095238
B.J. Armstrong,armstbj01,PG,26,CHI,1994,82,2770.0,1212,323,28,142,170,80,9,131,147,479,1007,0.4756703078450844,60,135,0.4444444444444444,419,872,0.4805045871559633,0.505,194,227,0.8546255506607929
Vincent Askew,askewvi01,SG,27,SEA,1994,80,1690.0,727,194,60,124,184,73,19,70,145,273,567,0.4814814814814814,6,31,0.1935483870967742,267,536,0.498134328358209,0.487,175,211,0.8293838862559242
Keith Askins,askinke01,SF,26,MIA,1994,37,319.0,85,13,33,49,82,11,1,21,57,36,88,0.4090909090909091,4,21,0.1904761904761904,32,67,0.4776119402985074,0.432,9,10,0.9
Stacey Augmon,augmost01,SG,25,ATL,1994,82,2605.0,1212,187,178,216,394,149,45,147,179,439,861,0.5098722415795587,1,7,0.1428571428571428,438,854,0.5128805620608899,0.51,333,436,0.7637614678899083
Isaac Austin,austiis01,C,24,PHI,1994,14,201.0,72,17,25,44,69,5,10,17,29,29,66,0.4393939393939394,0,1,0.0,29,65,0.4461538461538462,0.439,14,23,0.6086956521739131
Anthony Avent,aventan01,PF,24,TOT,1994,74,1371.0,389,65,144,194,338,33,31,85,147,150,398,0.3768844221105528,0,0,0.0,150,398,0.3768844221105528,0.377,89,123,0.7235772357723578
John Bagley,baglejo01,PG,33,ATL,1994,3,13.0,2,3,0,1,1,0,0,0,2,0,2,0.0,0,0,0.0,0,2,0.0,0.0,2,2,1.0
Thurl Bailey,baileth01,PF,32,MIN,1994,79,1297.0,583,54,66,149,215,20,58,58,93,232,455,0.5098901098901099,0,2,0.0,232,453,0.5121412803532008,0.51,119,149,0.7986577181208053
Vin Baker,bakervi01,C,22,MIL,1994,82,2560.0,1105,163,277,344,621,60,114,162,231,435,869,0.5005753739930955,1,5,0.2,434,864,0.5023148148148148,0.501,234,411,0.5693430656934306
Charles Barkley,barklch01,PF,30,PHO,1994,65,2298.0,1402,296,198,529,727,101,37,206,160,518,1046,0.4952198852772466,48,178,0.2696629213483146,470,868,0.5414746543778802,0.518,318,452,0.7035398230088495
Dana Barros,barroda01,PG,26,PHI,1994,81,2519.0,1075,424,28,168,196,107,5,167,96,412,878,0.4692482915717539,135,354,0.3813559322033898,277,524,0.5286259541984732,0.546,116,145,0.8
Jon Barry,barryjo01,SG,24,MIL,1994,72,1242.0,445,168,36,110,146,102,17,83,110,158,382,0.4136125654450261,32,115,0.2782608695652174,126,267,0.4719101123595505,0.455,97,122,0.7950819672131147
John Battle,battljo01,SG,31,CLE,1994,51,814.0,338,83,7,32,39,22,1,41,66,130,273,0.4761904761904761,5,19,0.2631578947368421,125,254,0.4921259842519685,0.485,73,97,0.7525773195876289
Benoit Benjamin,benjabe01,C,29,NJN,1994,77,1817.0,718,44,135,364,499,35,90,97,198,283,589,0.4804753820033955,0,0,0.0,283,589,0.4804753820033955,0.48,152,214,0.7102803738317757
Tony Bennett,benneto01,PG,24,CHH,1994,74,983.0,248,163,16,74,90,39,1,40,84,105,263,0.3992395437262357,27,75,0.36,78,188,0.4148936170212766,0.451,11,15,0.7333333333333333
David Benoit,benoida01,SF,25,UTA,1994,55,1070.0,358,23,89,171,260,23,37,37,115,139,361,0.3850415512465374,12,59,0.2033898305084746,127,302,0.4205298013245033,0.402,68,88,0.7727272727272727
Rolando Blackman,blackro01,SG,34,NYK,1994,55,969.0,400,76,23,70,93,25,6,44,100,161,369,0.4363143631436314,30,84,0.3571428571428571,131,285,0.4596491228070175,0.477,48,53,0.9056603773584906
Mookie Blaylock,blaylmo01,PG,26,ATL,1994,81,2915.0,1118,789,117,307,424,212,44,196,144,444,1079,0.4114921223354958,114,341,0.3343108504398827,330,738,0.4471544715447154,0.464,116,159,0.7295597484276729
Corie Blount,blounco01,PF,25,CHI,1994,67,690.0,198,56,76,118,194,19,33,52,93,76,174,0.4367816091954023,0,0,0.0,76,174,0.4367816091954023,0.437,46,75,0.6133333333333333
Muggsy Bogues,boguemu01,PG,29,CHH,1994,77,2746.0,835,780,78,235,313,133,2,171,147,354,751,0.4713715046604527,2,12,0.1666666666666666,352,739,0.476319350473613,0.473,125,155,0.8064516129032258
Manute Bol,bolma01,C,31,TOT,1994,14,116.0,8,1,3,15,18,2,16,5,13,4,19,0.2105263157894736,0,3,0.0,4,16,0.25,0.211,0,0,0.0
Walter Bond,bondwa01,SG,24,UTA,1994,56,559.0,176,31,20,41,61,16,12,17,90,63,156,0.4038461538461538,19,54,0.3518518518518518,44,102,0.4313725490196078,0.465,31,40,0.775
Anthony Bonner,bonnean01,SF,25,NYK,1994,73,1402.0,374,88,150,194,344,76,13,89,175,162,288,0.5625,0,0,0.0,162,288,0.5625,0.563,50,105,0.4761904761904761
Anthony Bowie,bowiean01,SG,30,ORL,1994,70,948.0,320,102,29,91,120,32,12,58,81,139,289,0.4809688581314879,1,18,0.0555555555555555,138,271,0.5092250922509225,0.483,41,49,0.8367346938775511
Sam Bowie,bowiesa01,C,32,LAL,1994,25,556.0,223,47,27,104,131,4,28,43,65,75,172,0.436046511627907,1,4,0.25,74,168,0.4404761904761904,0.439,72,83,0.8674698795180723
Shawn Bradley,bradlsh01,C,21,PHI,1994,49,1385.0,504,98,98,208,306,45,147,148,170,201,491,0.4093686354378819,0,3,0.0,201,488,0.4118852459016393,0.409,102,168,0.6071428571428571
Terrell Brandon,brandte01,PG,23,CLE,1994,73,1548.0,606,277,38,121,159,84,16,111,108,230,548,0.4197080291970803,7,32,0.21875,223,516,0.4321705426356589,0.426,139,162,0.8580246913580247
Randy Breuer,breuera01,C,33,SAC,1994,26,247.0,19,8,15,41,56,6,19,9,30,8,26,0.3076923076923077,0,1,0.0,8,25,0.32,0.308,3,14,0.2142857142857142
Frank Brickowski,brickfr01,C,34,TOT,1994,71,2094.0,935,222,85,319,404,80,27,181,242,368,754,0.4880636604774536,4,20,0.2,364,734,0.4959128065395095,0.491,195,254,0.7677165354330708
Kevin Brooks,brookke01,SF,24,DEN,1994,34,190.0,85,3,5,16,21,0,2,12,19,36,99,0.3636363636363636,4,23,0.1739130434782608,32,76,0.4210526315789473,0.384,9,10,0.9
Scott Brooks,brooksc01,PG,28,HOU,1994,73,1225.0,381,149,10,92,102,51,2,55,98,142,289,0.4913494809688581,23,61,0.3770491803278688,119,228,0.5219298245614035,0.531,74,85,0.8705882352941177
Chucky Brown,brownch01,SF,25,DAL,1994,1,10.0,3,0,0,1,1,0,0,0,2,1,1,1.0,0,0,0.0,1,1,1.0,1.0,1,1,1.0
Dee Brown,brownde01,SG,25,BOS,1994,77,2867.0,1192,347,63,237,300,156,47,126,207,490,1021,0.4799216454456415,30,96,0.3125,460,925,0.4972972972972973,0.495,182,219,0.8310502283105022
Mike Brown,brownmi01,C,30,MIN,1994,82,1921.0,299,72,119,328,447,51,29,75,218,111,260,0.4269230769230769,0,2,0.0,111,258,0.4302325581395348,0.427,77,118,0.652542372881356
P.J. Brown,brownpj01,C,24,NJN,1994,79,1950.0,450,93,188,305,493,71,93,72,177,167,402,0.4154228855721393,1,6,0.1666666666666666,166,396,0.4191919191919191,0.417,115,152,0.756578947368421
Randy Brown,brownra02,PG,25,SAC,1994,61,1041.0,273,133,40,72,112,63,14,75,132,110,251,0.4382470119521912,0,4,0.0,110,247,0.4453441295546558,0.438,53,87,0.6091954022988506
Mark Bryant,bryanma01,C,28,POR,1994,79,1441.0,442,37,117,198,315,32,29,66,187,185,384,0.4817708333333333,0,1,0.0,185,383,0.4830287206266319,0.482,72,104,0.6923076923076923
Jud Buechler,buechju01,SF,25,GSW,1994,36,218.0,106,16,13,19,32,8,1,12,24,42,84,0.5,12,29,0.4137931034482758,30,55,0.5454545454545454,0.571,10,20,0.5
Matt Bullard,bullama01,PF,26,HOU,1994,65,725.0,226,64,23,61,84,14,6,28,67,78,226,0.3451327433628318,50,154,0.3246753246753247,28,72,0.3888888888888889,0.456,20,26,0.7692307692307693
Evers Burns,burnsev01,PF,22,SAC,1994,23,143.0,56,9,13,17,30,6,3,7,33,22,55,0.4,0,0,0.0,22,55,0.4,0.4,12,23,0.5217391304347826
Scott Burrell,burresc01,SF,23,CHH,1994,51,767.0,244,62,46,86,132,37,16,45,88,98,234,0.4188034188034188,2,6,0.3333333333333333,96,228,0.4210526315789473,0.423,46,70,0.6571428571428571
Willie Burton,burtowi01,SF,25,MIA,1994,53,697.0,371,39,50,86,136,18,20,54,96,124,283,0.4381625441696113,3,15,0.2,121,268,0.4514925373134328,0.443,120,158,0.759493670886076
Mitchell Butler,butlemi02,SG,23,WSB,1994,75,1321.0,518,77,106,119,225,54,20,87,131,207,418,0.4952153110047846,0,5,0.0,207,413,0.5012106537530266,0.495,104,180,0.5777777777777777
Michael Cage,cagemi01,C,32,SEA,1994,82,1708.0,378,45,164,280,444,77,38,51,179,171,314,0.5445859872611465,0,1,0.0,171,313,0.5463258785942492,0.545,36,74,0.4864864864864865
Elden Campbell,campbel01,PF,25,LAL,1994,76,2253.0,934,86,167,352,519,64,146,98,241,373,808,0.4616336633663366,0,2,0.0,373,806,0.4627791563275434,0.462,188,273,0.6886446886446886
Tony Campbell,campbto01,SF,31,TOT,1994,63,1214.0,555,82,76,110,186,50,15,84,134,227,512,0.443359375,7,28,0.25,220,484,0.4545454545454545,0.45,94,120,0.7833333333333333
Antoine Carr,carran01,PF,32,SAS,1994,34,465.0,198,15,12,39,51,9,22,15,75,78,160,0.4875,0,1,0.0,78,159,0.490566037735849,0.488,42,58,0.7241379310344828
Bill Cartwright,cartwbi01,C,36,CHI,1994,42,780.0,235,57,43,109,152,8,8,50,83,98,191,0.5130890052356021,0,0,0.0,98,191,0.5130890052356021,0.513,39,57,0.6842105263157895
Sam Cassell,cassesa01,PG,24,HOU,1994,66,1122.0,440,192,25,109,134,59,7,94,136,162,388,0.4175257731958763,26,88,0.2954545454545454,136,300,0.4533333333333333,0.451,90,107,0.8411214953271028
Duane Causwell,causwdu01,C,25,SAC,1994,41,674.0,182,11,68,118,186,19,49,33,109,71,137,0.5182481751824818,0,0,0.0,71,137,0.5182481751824818,0.518,40,68,0.5882352941176471
Cedric Ceballos,cebalce01,SF,24,PHO,1994,53,1602.0,1010,91,153,191,344,59,23,93,124,425,795,0.5345911949685535,0,9,0.0,425,786,0.5407124681933843,0.535,160,221,0.7239819004524887
Tom Chambers,chambto01,PF,34,UTA,1994,80,1838.0,893,79,87,239,326,40,32,89,232,329,748,0.4398395721925133,14,45,0.3111111111111111,315,703,0.4480796586059744,0.449,221,281,0.7864768683274022
Rex Chapman,chapmre01,SG,26,WSB,1994,60,2025.0,1094,185,57,89,146,59,8,117,83,431,865,0.4982658959537572,64,165,0.3878787878787879,367,700,0.5242857142857142,0.535,168,206,0.8155339805825242
Calbert Cheaney,cheanca01,SG,22,WSB,1994,65,1604.0,779,126,88,102,190,63,10,108,148,327,696,0.4698275862068966,1,23,0.0434782608695652,326,673,0.4843982169390787,0.471,124,161,0.7701863354037267
Pete Chilcutt,chilcpe01,PF,25,TOT,1994,76,1365.0,450,86,129,242,371,53,39,74,164,203,448,0.453125,3,15,0.2,200,433,0.4618937644341801,0.456,41,65,0.6307692307692307
Doug Christie,chrisdo01,SG,23,LAL,1994,65,1515.0,672,136,93,142,235,89,28,140,186,244,562,0.4341637010676156,39,119,0.3277310924369748,205,443,0.4627539503386004,0.469,145,208,0.6971153846153846
Ben Coleman,colembe01,PF,32,DET,1994,9,77.0,28,0,10,16,26,2,2,7,9,12,25,0.48,0,0,0.0,12,25,0.48,0.48,4,8,0.5
Derrick Coleman,colemde01,PF,26,NJN,1994,77,2778.0,1559,262,262,608,870,68,142,208,209,541,1209,0.4474772539288668,38,121,0.3140495867768595,503,1088,0.4623161764705882,0.463,439,567,0.7742504409171076
Bimbo Coles,colesbi01,PG,25,MIA,1994,76,1726.0,588,263,50,109,159,75,12,107,132,233,519,0.4489402697495183,20,99,0.202020202020202,213,420,0.5071428571428571,0.468,102,131,0.7786259541984732
Marty Conlon,conloma01,C,26,TOT,1994,30,579.0,233,34,53,86,139,9,8,33,69,95,165,0.5757575757575758,0,2,0.0,95,163,0.5828220858895705,0.576,43,53,0.8113207547169812
Lester Conner,connele01,PG,34,IND,1994,11,169.0,31,31,10,14,24,14,1,9,12,14,38,0.3684210526315789,0,3,0.0,14,35,0.4,0.368,3,6,0.5
Anthony Cook,cookan01,PF,26,TOT,1994,25,203.0,62,4,20,36,56,3,14,12,22,26,54,0.4814814814814814,0,1,0.0,26,53,0.490566037735849,0.481,10,25,0.4
Duane Cooper,coopedu01,PG,24,PHO,1994,23,136.0,48,28,2,7,9,3,0,20,12,18,41,0.4390243902439024,1,7,0.1428571428571428,17,34,0.5,0.451,11,15,0.7333333333333333
Tyrone Corbin,corbity01,SF,31,UTA,1994,82,2149.0,659,122,150,239,389,99,24,92,212,268,588,0.4557823129251701,6,29,0.2068965517241379,262,559,0.4686940966010733,0.461,117,144,0.8125
Chris Corchiani,corchch01,PG,25,BOS,1994,51,467.0,117,86,8,36,44,22,2,38,47,40,94,0.425531914893617,11,38,0.2894736842105263,29,56,0.5178571428571429,0.484,26,38,0.6842105263157895
Joe Courtney,courtjo01,PF,24,TOT,1994,52,345.0,168,15,28,28,56,10,12,21,44,67,148,0.4527027027027027,2,3,0.6666666666666666,65,145,0.4482758620689655,0.459,32,47,0.6808510638297872
John Crotty,crottjo01,PG,24,UTA,1994,45,313.0,132,77,11,20,31,15,1,27,36,45,99,0.4545454545454545,11,24,0.4583333333333333,34,75,0.4533333333333333,0.51,31,36,0.8611111111111112
Terry Cummings,cummite01,PF,32,SAS,1994,59,1133.0,429,50,132,165,297,31,13,59,137,183,428,0.4275700934579439,0,2,0.0,183,426,0.4295774647887324,0.428,63,107,0.5887850467289719
Earl Cureton,curetea01,PF,36,HOU,1994,2,30.0,4,0,4,8,12,0,0,1,4,2,8,0.25,0,0,0.0,2,8,0.25,0.25,0,2,0.0
Dell Curry,curryde01,SG,29,CHH,1994,82,2173.0,1335,221,71,191,262,98,27,120,161,533,1171,0.4551665243381725,152,378,0.4021164021164021,381,793,0.4804539722572509,0.52,117,134,0.8731343283582089
Michael Curry,currymi01,SG,25,PHI,1994,10,43.0,9,1,0,1,1,1,0,3,6,3,14,0.2142857142857142,0,2,0.0,3,12,0.25,0.214,3,4,0.75
Lloyd Daniels,daniell01,SG,26,SAS,1994,65,980.0,370,94,45,66,111,29,16,60,69,140,372,0.3763440860215054,44,125,0.352,96,247,0.388663967611336,0.435,46,64,0.71875
Brad Daugherty,daughbr01,C,28,CLE,1994,50,1838.0,848,149,128,380,508,41,36,110,145,296,606,0.4884488448844885,0,0,0.0,296,606,0.4884488448844885,0.488,256,326,0.7852760736196319
Antonio Davis,davisan01,PF,25,IND,1994,81,1732.0,626,55,190,315,505,45,84,107,189,216,425,0.508235294117647,0,1,0.0,216,424,0.5094339622641509,0.508,194,302,0.6423841059602649
Brian Davis,davisbr02,SF,23,MIN,1994,68,374.0,131,22,21,34,55,16,4,19,34,40,126,0.3174603174603174,1,3,0.3333333333333333,39,123,0.3170731707317073,0.321,50,68,0.7352941176470589
Dale Davis,davisda01,PF,24,IND,1994,66,2292.0,771,100,280,438,718,48,106,102,214,308,582,0.5292096219931272,0,1,0.0,308,581,0.5301204819277109,0.529,155,294,0.5272108843537415
Hubert Davis,davishu01,SG,23,NYK,1994,56,1333.0,614,165,23,44,67,40,4,76,118,238,505,0.4712871287128712,53,132,0.4015151515151515,185,373,0.4959785522788204,0.524,85,103,0.8252427184466019
Terry Davis,daviste01,PF,26,DAL,1994,15,286.0,56,6,30,44,74,9,1,5,27,24,59,0.4067796610169492,0,0,0.0,24,59,0.4067796610169492,0.407,8,12,0.6666666666666666
Johnny Dawkins,dawkijo01,PG,30,PHI,1994,72,1343.0,475,263,28,95,123,63,5,111,74,177,423,0.4184397163120567,37,105,0.3523809523809524,140,318,0.440251572327044,0.462,84,100,0.84
Todd Day,dayto01,SG,24,MIL,1994,76,2127.0,966,138,115,195,310,103,52,129,221,351,845,0.4153846153846154,33,148,0.2229729729729729,318,697,0.4562410329985653,0.435,231,331,0.6978851963746223
Terry Dehere,deherte01,PG,22,LAC,1994,64,759.0,342,78,25,43,68,28,3,61,69,129,342,0.3771929824561403,23,57,0.4035087719298245,106,285,0.3719298245614035,0.411,61,81,0.7530864197530864
Vinny Del Negro,delnevi01,SG,27,SAS,1994,77,1949.0,773,320,27,134,161,64,1,102,168,309,634,0.4873817034700315,15,43,0.3488372093023256,294,591,0.4974619289340101,0.499,140,170,0.8235294117647058
Bison Dele,delebi01,C,24,DEN,1994,80,1507.0,639,50,138,308,446,49,87,104,221,251,464,0.540948275862069,0,3,0.0,251,461,0.544468546637744,0.541,137,211,0.6492890995260664
Dell Demps,dempsde01,PG,23,GSW,1994,2,11.0,4,1,0,0,0,2,0,1,1,2,6,0.3333333333333333,0,0,0.0,2,6,0.3333333333333333,0.333,0,2,0.0
Vlade Divac,divacvl01,C,25,LAL,1994,79,2685.0,1123,307,282,569,851,92,112,191,288,453,895,0.506145251396648,9,47,0.1914893617021276,444,848,0.5235849056603774,0.511,208,303,0.6864686468646864
Sherman Douglas,douglsh01,PG,27,BOS,1994,78,2789.0,1040,683,70,123,193,89,11,233,171,425,919,0.4624591947769314,13,56,0.2321428571428571,412,863,0.4774044032444959,0.47,177,276,0.6413043478260869
Greg Dreiling,dreilgr01,C,31,DAL,1994,54,685.0,132,31,47,123,170,16,24,43,159,52,104,0.5,1,1,1.0,51,103,0.4951456310679611,0.505,27,38,0.7105263157894737
Clyde Drexler,drexlcl01,SG,31,POR,1994,68,2334.0,1303,333,154,291,445,98,34,167,202,473,1105,0.4280542986425339,71,219,0.3242009132420091,402,886,0.45372460496614,0.46,286,368,0.7771739130434783
Kevin Duckworth,duckwke01,C,29,WSB,1994,69,1485.0,456,56,103,222,325,37,35,101,223,184,441,0.4172335600907029,0,0,0.0,184,441,0.4172335600907029,0.417,88,132,0.6666666666666666
Chris Dudley,dudlech02,C,28,POR,1994,6,86.0,14,5,16,8,24,4,3,2,18,6,25,0.24,0,0,0.0,6,25,0.24,0.24,2,4,0.5
Joe Dumars,dumarjo01,SG,30,DET,1994,69,2591.0,1410,261,35,116,151,63,4,159,118,505,1118,0.4516994633273703,124,320,0.3875,381,798,0.4774436090225564,0.507,276,330,0.8363636363636363
Acie Earl,earlac01,C,23,BOS,1994,74,1149.0,410,12,85,162,247,24,53,72,178,151,372,0.4059139784946236,0,1,0.0,151,371,0.4070080862533692,0.406,108,160,0.675
Bill Edwards,edwarbi01,PF,22,PHI,1994,3,44.0,6,4,5,9,14,3,1,4,6,2,18,0.1111111111111111,0,5,0.0,2,13,0.1538461538461538,0.111,2,5,0.4
Blue Edwards,edwarbl01,SF,28,MIL,1994,82,2322.0,953,171,104,225,329,83,27,146,235,382,800,0.4775,38,106,0.3584905660377358,344,694,0.4956772334293948,0.501,151,189,0.798941798941799
Doug Edwards,edwardo01,PF,23,ATL,1994,16,107.0,43,8,7,11,18,2,5,6,9,17,49,0.3469387755102041,0,1,0.0,17,48,0.3541666666666667,0.347,9,16,0.5625
James Edwards,edwarja01,C,38,LAL,1994,45,469.0,210,22,11,54,65,4,3,30,90,78,168,0.4642857142857143,0,0,0.0,78,168,0.4642857142857143,0.464,54,79,0.6835443037974683
Kevin Edwards,edwarke01,SG,28,NJN,1994,82,2727.0,1144,232,94,187,281,120,34,135,150,471,1028,0.4581712062256809,35,99,0.3535353535353535,436,929,0.4693218514531754,0.475,167,217,0.7695852534562212
Craig Ehlo,ehlocr01,SG,32,ATL,1994,82,2147.0,821,273,71,208,279,136,26,130,161,316,708,0.4463276836158192,77,221,0.3484162895927601,239,487,0.4907597535934291,0.501,112,154,0.7272727272727273
Mario Elie,eliema01,SF,30,HOU,1994,67,1606.0,626,208,28,153,181,50,8,109,124,208,466,0.4463519313304721,56,167,0.3353293413173652,152,299,0.5083612040133779,0.506,154,179,0.8603351955307262
Sean Elliott,elliose01,SF,25,DET,1994,73,2409.0,885,197,68,195,263,54,27,129,174,360,791,0.4551201011378002,26,87,0.2988505747126437,334,704,0.4744318181818182,0.472,139,173,0.8034682080924855
Dale Ellis,ellisda01,SF,33,SAS,1994,77,2590.0,1170,80,70,185,255,66,11,75,141,478,967,0.4943123061013443,131,332,0.394578313253012,347,635,0.5464566929133858,0.562,83,107,0.7757009345794392
Harold Ellis,ellisha01,SF,23,LAC,1994,49,923.0,424,31,94,59,153,73,2,43,97,159,292,0.5445205479452054,0,4,0.0,159,288,0.5520833333333334,0.545,106,149,0.7114093959731543
LaPhonso Ellis,ellisla01,PF,23,DEN,1994,79,2699.0,1215,167,220,462,682,63,80,172,304,483,963,0.5015576323987538,7,23,0.3043478260869565,476,940,0.5063829787234042,0.505,242,359,0.6740947075208914
LeRon Ellis,ellisle02,C,24,CHH,1994,50,680.0,221,24,70,118,188,17,25,21,83,88,182,0.4835164835164835,0,0,0.0,88,182,0.4835164835164835,0.484,45,68,0.6617647058823529
Pervis Ellison,ellispe01,C,26,WSB,1994,47,1178.0,344,70,77,165,242,25,50,73,140,137,292,0.4691780821917808,0,3,0.0,137,289,0.4740484429065744,0.469,70,97,0.7216494845360825
Jo Jo English,englijo01,SG,23,CHI,1994,36,419.0,130,38,9,36,45,8,10,36,61,56,129,0.4341085271317829,8,17,0.4705882352941176,48,112,0.4285714285714285,0.465,10,21,0.4761904761904761
Patrick Ewing,ewingpa01,C,31,NYK,1994,79,2972.0,1939,179,219,666,885,90,217,260,275,745,1503,0.4956753160345974,4,14,0.2857142857142857,741,1489,0.4976494291470786,0.497,445,582,0.7646048109965635
Jim Farmer,farmeji01,SG,29,DEN,1994,4,29.0,4,4,0,2,2,0,0,5,3,2,6,0.3333333333333333,0,2,0.0,2,4,0.5,0.333,0,0,0.0
Duane Ferrell,ferredu01,SF,28,ATL,1994,72,1155.0,513,65,62,67,129,44,16,64,85,184,379,0.4854881266490765,1,9,0.1111111111111111,183,370,0.4945945945945946,0.487,144,184,0.782608695652174
Danny Ferry,ferryda01,PF,27,CLE,1994,70,965.0,350,74,47,94,141,28,22,41,113,149,334,0.4461077844311377,14,51,0.2745098039215686,135,283,0.4770318021201413,0.467,38,43,0.8837209302325582
Vern Fleming,flemive01,PG,31,IND,1994,55,1053.0,358,173,27,96,123,40,6,87,98,147,318,0.4622641509433962,0,4,0.0,147,314,0.4681528662420382,0.462,64,87,0.735632183908046
Sleepy Floyd,floydsl01,PG,33,SAS,1994,53,737.0,200,101,10,60,70,12,8,61,71,70,209,0.3349282296650718,8,36,0.2222222222222222,62,173,0.3583815028901734,0.354,52,78,0.6666666666666666
Alphonso Ford,fordal01,PG,22,SEA,1994,6,16.0,16,1,0,0,0,2,0,1,2,7,13,0.5384615384615384,1,1,1.0,6,12,0.5,0.577,1,2,0.5
Greg Foster,fostegr01,PF,25,MIL,1994,3,19.0,10,0,0,3,3,0,1,1,3,4,7,0.5714285714285714,0,0,0.0,4,7,0.5714285714285714,0.571,2,2,1.0
Rick Fox,foxri01,SF,24,BOS,1994,82,2096.0,887,217,105,250,355,81,52,158,244,340,728,0.467032967032967,33,100,0.33,307,628,0.4888535031847134,0.49,174,230,0.7565217391304347
Tellis Frank,frankte01,PF,28,MIN,1994,67,959.0,188,57,83,137,220,35,35,49,163,67,160,0.41875,0,2,0.0,67,158,0.4240506329113924,0.419,54,76,0.7105263157894737
Corey Gaines,gaineco01,SG,28,NYK,1994,18,78.0,33,30,3,10,13,2,0,5,12,9,20,0.45,2,5,0.4,7,15,0.4666666666666667,0.5,13,15,0.8666666666666667
Chad Gallagher,gallach01,C,24,UTA,1994,2,3.0,6,0,0,0,0,0,0,0,2,3,3,1.0,0,0,0.0,3,3,1.0,1.0,0,0,0.0
Kevin Gamble,gamblke01,SF,28,BOS,1994,75,1880.0,864,149,41,118,159,57,22,77,134,368,804,0.4577114427860697,25,103,0.2427184466019417,343,701,0.4893009985734665,0.473,103,126,0.8174603174603174
Chris Gatling,gatlich01,C,26,GSW,1994,82,1296.0,671,41,143,254,397,40,63,84,223,271,461,0.5878524945770065,0,1,0.0,271,460,0.5891304347826087,0.588,129,208,0.6201923076923077
Kenny Gattison,gattike01,PF,29,CHH,1994,77,1644.0,592,95,105,253,358,59,46,79,229,233,445,0.5235955056179775,0,0,0.0,233,445,0.5235955056179775,0.524,126,195,0.6461538461538462
Andrew Gaze,gazean01,SG,28,WSB,1994,7,70.0,22,5,1,6,7,2,1,3,9,8,17,0.4705882352941176,4,8,0.5,4,9,0.4444444444444444,0.588,2,2,1.0
Matt Geiger,geigema01,C,24,MIA,1994,72,1199.0,521,32,119,184,303,36,29,61,201,202,352,0.5738636363636364,1,5,0.2,201,347,0.579250720461095,0.575,116,149,0.7785234899328859
Kendall Gill,gillke01,SG,25,SEA,1994,79,2435.0,1111,275,91,177,268,151,32,143,194,429,969,0.4427244582043343,38,120,0.3166666666666666,391,849,0.4605418138987043,0.462,215,275,0.7818181818181819
Armen Gilliam,gilliar01,PF,29,NJN,1994,82,1969.0,970,69,197,303,500,38,61,106,129,348,682,0.5102639296187683,0,1,0.0,348,681,0.5110132158590308,0.51,274,361,0.7590027700831025
Mike Gminski,gminsmi01,C,34,TOT,1994,29,309.0,86,11,22,52,74,13,16,13,23,36,103,0.3495145631067961,0,0,0.0,36,103,0.3495145631067961,0.35,14,18,0.7777777777777778
Ricky Grace,graceri01,PG,26,ATL,1994,3,8.0,4,1,0,1,1,0,0,0,3,2,3,0.6666666666666666,0,0,0.0,2,3,0.6666666666666666,0.667,0,2,0.0
Greg Graham,grahagr01,SG,23,PHI,1994,70,889.0,338,66,21,65,86,61,4,65,54,122,305,0.4,2,25,0.08,120,280,0.4285714285714285,0.403,92,110,0.8363636363636363
Paul Graham,grahapa01,SG,26,ATL,1994,21,128.0,58,13,4,8,12,4,5,5,11,21,57,0.3684210526315789,3,13,0.2307692307692307,18,44,0.4090909090909091,0.395,13,17,0.7647058823529411
Gary Grant,grantga01,PG,28,LAC,1994,78,1533.0,588,291,42,100,142,119,12,136,139,253,563,0.4493783303730018,17,62,0.2741935483870967,236,501,0.4710578842315369,0.464,65,76,0.8552631578947368
Harvey Grant,grantha01,SF,28,POR,1994,77,2112.0,798,107,109,242,351,70,49,56,179,356,774,0.4599483204134367,2,7,0.2857142857142857,354,767,0.4615384615384615,0.461,84,131,0.6412213740458015
Horace Grant,grantho01,PF,28,CHI,1994,70,2570.0,1057,236,306,463,769,74,84,109,164,460,878,0.5239179954441914,0,6,0.0,460,872,0.5275229357798165,0.524,137,230,0.5956521739130435
Josh Grant,grantjo01,PF,26,GSW,1994,53,382.0,157,24,27,62,89,18,8,30,62,59,146,0.4041095890410959,17,61,0.2786885245901639,42,85,0.4941176470588235,0.462,22,29,0.7586206896551724
Jeff Grayer,grayeje01,SG,28,GSW,1994,67,1096.0,455,62,76,115,191,33,13,63,103,191,363,0.5261707988980716,2,12,0.1666666666666666,189,351,0.5384615384615384,0.529,71,118,0.6016949152542372
A.C. Green,greenac01,PF,30,PHO,1994,82,2825.0,1204,137,275,478,753,70,38,100,142,465,926,0.5021598272138229,8,35,0.2285714285714285,457,891,0.5129068462401796,0.506,266,362,0.7348066298342542
Litterial Green,greenli01,PG,23,ORL,1994,29,126.0,73,9,6,6,12,6,1,13,16,22,57,0.3859649122807017,1,4,0.25,21,53,0.3962264150943396,0.395,28,37,0.7567567567567568
Sean Green,greense01,SG,23,TOT,1994,36,334.0,149,16,10,24,34,18,6,27,21,63,183,0.3442622950819672,10,41,0.2439024390243902,53,142,0.3732394366197183,0.372,13,18,0.7222222222222222
Tom Gugliotta,guglito01,PF,24,WSB,1994,78,2795.0,1333,276,189,539,728,172,51,247,174,540,1159,0.4659188955996549,40,148,0.2702702702702703,500,1011,0.4945598417408506,0.483,213,311,0.684887459807074
Andrés Guibert,guibean01,C,25,MIN,1994,5,33.0,15,2,10,6,16,0,1,6,6,6,20,0.3,0,0,0.0,6,20,0.3,0.3,3,6,0.5
Jay Guidinger,guidija01,C,24,CLE,1994,32,131.0,47,3,15,18,33,4,5,16,23,16,32,0.5,0,0,0.0,16,32,0.5,0.5,15,21,0.7142857142857143
Jack Haley,haleyja01,PF,30,SAS,1994,28,94.0,59,1,6,18,24,0,0,10,18,21,48,0.4375,0,0,0.0,21,48,0.4375,0.438,17,21,0.8095238095238095
Geert Hammink,hammige01,C,24,ORL,1994,1,3.0,2,1,1,0,1,0,0,0,1,1,3,0.3333333333333333,0,0,0.0,1,3,0.3333333333333333,0.333,0,0,0.0
Tom Hammonds,hammoto01,PF,26,DEN,1994,74,877.0,301,34,62,137,199,20,12,41,91,115,230,0.5,0,0,0.0,115,230,0.5,0.5,71,104,0.6826923076923077
Anfernee Hardaway,hardaan01,PG,22,ORL,1994,82,3015.0,1313,544,192,247,439,190,51,292,205,509,1092,0.4661172161172161,50,187,0.267379679144385,459,905,0.507182320441989,0.489,245,330,0.7424242424242424
Derek Harper,harpede01,PG,32,TOT,1994,82,2204.0,791,334,20,121,141,125,8,135,163,303,744,0.407258064516129,73,203,0.3596059113300492,230,541,0.4251386321626617,0.456,112,163,0.6871165644171779
Ron Harper,harpero01,SG,30,LAC,1994,75,2856.0,1508,344,129,331,460,144,54,242,167,569,1335,0.4262172284644194,71,236,0.3008474576271186,498,1099,0.4531392174704277,0.453,299,418,0.715311004784689
Lucious Harris,harrilu01,SG,23,DAL,1994,77,1165.0,418,106,45,112,157,49,10,78,117,162,385,0.4207792207792207,7,33,0.2121212121212121,155,352,0.4403409090909091,0.43,87,119,0.7310924369747899
Tony Harris,harrito01,SG,26,BOS,1994,5,88.0,44,8,3,7,10,4,0,6,8,9,31,0.2903225806451613,3,9,0.3333333333333333,6,22,0.2727272727272727,0.339,23,25,0.92
Antonio Harvey,harvean01,PF,23,LAL,1994,27,247.0,70,5,26,33,59,8,19,17,39,29,79,0.3670886075949367,0,0,0.0,29,79,0.3670886075949367,0.367,12,26,0.4615384615384615
Scott Haskin,haskisc01,C,23,IND,1994,27,186.0,55,6,17,38,55,2,15,13,33,21,45,0.4666666666666667,0,0,0.0,21,45,0.4666666666666667,0.467,13,19,0.6842105263157895
Hersey Hawkins,hawkihe01,SG,27,CHH,1994,82,2648.0,1180,216,89,288,377,135,22,158,167,395,859,0.459837019790454,78,235,0.3319148936170212,317,624,0.5080128205128205,0.505,312,362,0.861878453038674
Skeeter Henry,henrysk01,SG,26,PHO,1994,4,15.0,4,4,0,2,2,0,0,1,1,1,5,0.2,0,2,0.0,1,3,0.3333333333333333,0.2,2,4,0.5
Steve Henson,hensost01,PG,25,CHH,1994,3,17.0,3,5,0,1,1,0,0,1,3,1,2,0.5,1,1,1.0,0,1,0.0,0.75,0,0,0.0
Carl Herrera,herreca01,PF,27,HOU,1994,75,1292.0,353,37,101,184,285,32,26,69,159,142,310,0.4580645161290322,0,0,0.0,142,310,0.4580645161290322,0.458,69,97,0.711340206185567
Rod Higgins,higgiro01,SF,34,CLE,1994,36,547.0,195,36,25,57,82,25,14,21,53,71,163,0.4355828220858895,22,50,0.44,49,113,0.4336283185840708,0.503,31,42,0.7380952380952381
Tyrone Hill,hillty01,PF,25,CLE,1994,57,1447.0,603,46,184,315,499,53,35,78,193,216,398,0.542713567839196,0,2,0.0,216,396,0.5454545454545454,0.543,171,256,0.66796875
Donald Hodge,hodgedo01,C,24,DAL,1994,50,428.0,136,32,46,49,95,15,13,30,66,46,101,0.4554455445544554,0,0,0.0,46,101,0.4554455445544554,0.455,44,52,0.8461538461538461
Tito Horford,horfoti01,C,28,WSB,1994,3,28.0,0,0,1,2,3,1,3,1,3,0,2,0.0,0,0,0.0,0,2,0.0,0.0,0,0,0.0
Jeff Hornacek,hornaje01,SG,30,TOT,1994,80,2820.0,1274,419,60,219,279,127,13,171,186,472,1004,0.4701195219123506,70,208,0.3365384615384615,402,796,0.5050251256281407,0.505,260,296,0.8783783783783784
Robert Horry,horryro01,SF,23,HOU,1994,81,2370.0,803,231,128,312,440,119,75,137,186,322,702,0.4586894586894587,44,136,0.3235294117647059,278,566,0.4911660777385159,0.49,115,157,0.732484076433121
Allan Houston,houstal01,SG,22,DET,1994,79,1519.0,668,100,19,101,120,34,13,99,165,272,671,0.405365126676602,35,117,0.2991452991452991,237,554,0.427797833935018,0.431,89,108,0.8240740740740741
Byron Houston,houstby01,PF,24,GSW,1994,71,866.0,196,32,67,127,194,33,31,49,181,81,177,0.4576271186440678,1,7,0.1428571428571428,80,170,0.4705882352941176,0.46,33,54,0.6111111111111112
Stephen Howard,howarst01,SF,23,UTA,1994,9,53.0,31,1,10,6,16,1,3,6,13,10,17,0.5882352941176471,0,0,0.0,10,17,0.5882352941176471,0.588,11,16,0.6875
Jay Humphries,humphja01,SG,31,UTA,1994,75,1619.0,561,219,35,92,127,65,11,95,168,233,535,0.4355140186915888,38,96,0.3958333333333333,195,439,0.4441913439635535,0.471,57,76,0.75
Lindsey Hunter,hunteli01,PG,23,DET,1994,82,2172.0,843,390,47,142,189,121,10,184,174,335,893,0.3751399776035834,69,207,0.3333333333333333,266,686,0.3877551020408163,0.414,104,142,0.7323943661971831
Bobby Hurley,hurlebo01,PG,22,SAC,1994,19,499.0,134,115,6,28,34,13,1,48,28,54,146,0.3698630136986301,2,16,0.125,52,130,0.4,0.377,24,30,0.8
Jaren Jackson,jacksja01,SG,26,POR,1994,29,187.0,80,27,6,11,17,4,2,14,20,34,87,0.3908045977011494,0,6,0.0,34,81,0.419753086419753,0.391,12,14,0.8571428571428571
Jim Jackson,jacksji01,SG,23,DAL,1994,82,3066.0,1576,374,169,219,388,87,25,334,161,637,1432,0.4448324022346369,17,60,0.2833333333333333,620,1372,0.4518950437317784,0.451,285,347,0.8213256484149856
Mark Jackson,jacksma01,PG,28,LAC,1994,79,2711.0,865,678,107,241,348,120,6,232,115,331,732,0.4521857923497268,36,127,0.2834645669291338,295,605,0.4876033057851239,0.477,167,211,0.7914691943127962
Stanley Jackson,jacksst01,SG,23,MIN,1994,17,92.0,38,16,12,15,27,5,0,10,13,17,33,0.5151515151515151,1,5,0.2,16,28,0.5714285714285714,0.53,3,3,1.0
Dave Jamerson,jamerda01,SG,26,TOT,1994,5,14.0,2,1,0,4,4,0,0,1,0,0,7,0.0,0,0,0.0,0,7,0.0,0.0,2,3,0.6666666666666666
Henry James,jameshe01,PF,28,LAC,1994,12,75.0,41,1,6,8,14,2,0,2,9,16,42,0.3809523809523809,4,18,0.2222222222222222,12,24,0.5,0.429,5,5,1.0
Keith Jennings,jennike01,PG,25,GSW,1994,76,1097.0,432,218,16,73,89,65,0,74,62,138,342,0.4035087719298245,56,151,0.3708609271523179,82,191,0.4293193717277487,0.485,100,120,0.8333333333333334
Chris Jent,jentch01,SF,24,HOU,1994,3,78.0,31,7,4,11,15,0,0,5,13,13,26,0.5,4,11,0.3636363636363636,9,15,0.6,0.577,1,2,0.5
Avery Johnson,johnsav01,PG,28,GSW,1994,82,2332.0,890,433,41,135,176,113,8,172,160,356,724,0.4917127071823204,0,12,0.0,356,712,0.5,0.492,178,253,0.7035573122529645
Dave Johnson,johnsda01,SG,23,CHI,1994,17,119.0,47,4,9,7,16,4,0,9,7,17,54,0.3148148148148148,0,1,0.0,17,53,0.320754716981132,0.315,13,21,0.6190476190476191
Eddie Johnson,johnsed03,SF,34,CHH,1994,73,1460.0,836,125,80,144,224,36,8,84,143,339,738,0.4593495934959349,59,150,0.3933333333333333,280,588,0.4761904761904761,0.499,99,127,0.7795275590551181
Ervin Johnson,johnser02,C,26,SEA,1994,45,280.0,117,7,48,70,118,10,22,24,45,44,106,0.4150943396226415,0,0,0.0,44,106,0.4150943396226415,0.415,29,46,0.6304347826086957
Frank Johnson,johnsfr01,PG,35,PHO,1994,70,875.0,324,148,29,53,82,41,1,65,120,134,299,0.4481605351170568,2,12,0.1666666666666666,132,287,0.4599303135888501,0.452,54,69,0.782608695652174
Kevin Johnson,johnske02,PG,27,PHO,1994,67,2449.0,1340,637,55,112,167,125,10,235,127,477,980,0.486734693877551,6,27,0.2222222222222222,471,953,0.4942287513116474,0.49,380,464,0.8189655172413793
Larry Johnson,johnsla02,PF,24,CHH,1994,51,1757.0,834,184,143,305,448,29,14,116,131,346,672,0.5148809523809523,5,21,0.238095238095238,341,651,0.5238095238095238,0.519,137,197,0.6954314720812182
Charles Jones,jonesch01,C,36,DET,1994,42,877.0,91,29,89,146,235,14,43,12,136,36,78,0.4615384615384615,0,1,0.0,36,77,0.4675324675324675,0.462,19,34,0.5588235294117647
Popeye Jones,jonespo01,PF,23,DAL,1994,81,1773.0,468,99,299,306,605,61,31,94,246,195,407,0.4791154791154791,0,1,0.0,195,406,0.4802955665024631,0.479,78,107,0.7289719626168224
Adonis Jordan,jordaad01,PG,23,DEN,1994,6,79.0,15,19,3,3,6,0,1,6,6,6,23,0.2608695652173913,3,10,0.3,3,13,0.2307692307692307,0.326,0,0,0.0
Reggie Jordan,jordare01,SG,26,LAL,1994,23,259.0,125,26,46,21,67,14,5,14,26,44,103,0.4271844660194174,2,4,0.5,42,99,0.4242424242424242,0.437,35,51,0.6862745098039216
Adam Keefe,keefead01,PF,23,ATL,1994,63,763.0,273,34,77,124,201,20,9,60,80,96,213,0.4507042253521127,0,0,0.0,96,213,0.4507042253521127,0.451,81,111,0.7297297297297297
Shawn Kemp,kempsh01,PF,24,SEA,1994,79,2597.0,1431,207,312,539,851,142,166,259,312,533,990,0.5383838383838384,1,4,0.25,532,986,0.539553752535497,0.539,364,491,0.7413441955193483
Tim Kempton,kemptti01,PF,30,TOT,1994,13,136.0,39,9,10,14,24,6,2,11,33,15,38,0.3947368421052631,0,0,0.0,15,38,0.3947368421052631,0.395,9,16,0.5625
Steve Kerr,kerrst01,PG,28,CHI,1994,82,2036.0,709,210,26,105,131,75,3,57,97,287,577,0.4974003466204506,52,124,0.4193548387096774,235,453,0.5187637969094923,0.542,83,97,0.8556701030927835
Jerome Kersey,kerseje01,SF,31,POR,1994,78,1276.0,508,75,130,201,331,71,49,63,213,203,469,0.4328358208955223,1,8,0.125,202,461,0.4381778741865509,0.434,101,135,0.7481481481481481
Alec Kessler,kesslal01,PF,27,MIA,1994,15,66.0,33,2,4,6,10,1,1,5,14,11,25,0.44,5,9,0.5555555555555556,6,16,0.375,0.54,6,8,0.75
Warren Kidd,kiddwa01,PF,23,PHI,1994,68,884.0,247,19,76,157,233,19,23,44,129,100,169,0.591715976331361,0,0,0.0,100,169,0.591715976331361,0.592,47,86,0.5465116279069767
Chris King,kingch01,SF,24,SEA,1994,15,86.0,55,11,5,10,15,4,0,12,12,19,48,0.3958333333333333,2,7,0.2857142857142857,17,41,0.4146341463414634,0.417,15,26,0.5769230769230769
Rich King,kingri01,C,24,SEA,1994,27,78.0,41,8,9,11,20,1,2,7,18,15,34,0.4411764705882353,0,1,0.0,15,33,0.4545454545454545,0.441,11,22,0.5
Stacey King,kingst01,C,27,TOT,1994,49,1053.0,385,58,90,151,241,31,42,83,121,146,341,0.4281524926686217,0,2,0.0,146,339,0.4306784660766962,0.428,93,136,0.6838235294117647
Greg Kite,kitegr01,C,32,ORL,1994,29,309.0,34,4,22,48,70,2,12,17,61,13,35,0.3714285714285714,0,0,0.0,13,35,0.3714285714285714,0.371,8,22,0.3636363636363636
Joe Kleine,kleinjo01,C,32,PHO,1994,74,848.0,285,45,50,143,193,14,19,35,118,125,256,0.48828125,5,11,0.4545454545454545,120,245,0.4897959183673469,0.498,30,39,0.7692307692307693
Negele Knight,knighne01,PG,26,TOT,1994,65,1438.0,595,197,28,75,103,34,11,94,121,225,475,0.4736842105263157,4,21,0.1904761904761904,221,454,0.486784140969163,0.478,141,174,0.8103448275862069
Jon Koncak,koncajo01,C,30,ATL,1994,82,1823.0,342,102,83,282,365,63,125,44,236,159,369,0.4308943089430894,0,3,0.0,159,366,0.4344262295081967,0.431,24,36,0.6666666666666666
Larry Krystkowiak,krystla01,PF,29,ORL,1994,34,682.0,173,35,38,85,123,14,4,29,74,71,148,0.4797297297297297,0,1,0.0,71,147,0.4829931972789115,0.48,31,39,0.7948717948717948
Toni Kukoč,kukocto01,SF,25,CHI,1994,75,1808.0,814,252,98,199,297,81,33,167,122,313,726,0.431129476584022,32,118,0.2711864406779661,281,608,0.4621710526315789,0.453,156,210,0.7428571428571429
Christian Laettner,laettch01,PF,24,MIN,1994,70,2428.0,1173,307,160,442,602,87,86,259,264,396,883,0.4484711211778029,6,25,0.24,390,858,0.4545454545454545,0.452,375,479,0.7828810020876826
Bill Laimbeer,laimbbi01,C,36,DET,1994,11,248.0,108,14,9,47,56,6,4,10,30,47,90,0.5222222222222223,3,9,0.3333333333333333,44,81,0.5432098765432098,0.539,11,13,0.8461538461538461
Andrew Lang,langan01,C,27,ATL,1994,82,1608.0,504,51,126,187,313,38,87,81,192,215,458,0.4694323144104803,1,4,0.25,214,454,0.4713656387665198,0.471,73,106,0.6886792452830188
Eric Leckner,leckner01,C,27,PHI,1994,71,1163.0,362,86,75,207,282,18,34,86,190,139,286,0.486013986013986,0,2,0.0,139,284,0.4894366197183099,0.486,84,130,0.6461538461538462
Tim Legler,legleti01,SG,27,DAL,1994,79,1322.0,656,120,36,92,128,52,13,60,133,231,528,0.4375,52,139,0.3741007194244604,179,389,0.4601542416452442,0.487,142,169,0.8402366863905325
Jim Les,lesji01,PG,30,SAC,1994,18,169.0,45,39,5,8,13,7,1,11,16,13,34,0.3823529411764705,8,18,0.4444444444444444,5,16,0.3125,0.5,11,13,0.8461538461538461
Fat Lever,leverfa01,PG,33,DAL,1994,81,1947.0,555,213,83,200,283,159,15,88,155,227,557,0.40754039497307,26,74,0.3513513513513513,201,483,0.4161490683229814,0.431,75,98,0.7653061224489796
Marcus Liberty,liberma01,SF,25,TOT,1994,38,285.0,109,17,26,35,61,11,4,24,34,40,123,0.3252032520325203,10,28,0.3571428571428571,30,95,0.3157894736842105,0.366,19,39,0.4871794871794871
Todd Lichti,lichtto01,SG,27,TOT,1994,13,126.0,58,11,8,14,22,7,1,5,16,20,51,0.392156862745098,2,2,1.0,18,49,0.3673469387755102,0.412,16,25,0.64
Brad Lohaus,lohaubr01,PF,29,MIL,1994,67,962.0,270,62,33,117,150,30,55,58,142,102,281,0.3629893238434163,46,134,0.3432835820895522,56,147,0.3809523809523809,0.445,20,29,0.6896551724137931
Grant Long,longgr01,PF,27,MIA,1994,69,2201.0,788,170,190,305,495,89,26,125,244,300,672,0.4464285714285714,1,6,0.1666666666666666,299,666,0.4489489489489489,0.447,187,238,0.7857142857142857
Luc Longley,longllu01,C,25,TOT,1994,76,1502.0,528,109,129,304,433,45,79,119,216,219,465,0.4709677419354838,0,1,0.0,219,464,0.4719827586206896,0.471,90,125,0.72
George Lynch,lynchge01,SF,23,LAL,1994,71,1762.0,681,96,220,190,410,102,27,87,177,291,573,0.5078534031413613,0,5,0.0,291,568,0.5123239436619719,0.508,99,166,0.5963855421686747
Malcolm Mackey,mackema01,C,23,PHO,1994,22,69.0,32,1,12,12,24,0,3,2,9,14,37,0.3783783783783784,0,2,0.0,14,35,0.4,0.378,4,8,0.5
Don MacLean,macledo01,SF,24,WSB,1994,75,2487.0,1365,160,140,327,467,47,22,152,169,517,1030,0.5019417475728155,3,21,0.1428571428571428,514,1009,0.5094152626362736,0.503,328,398,0.8241206030150754
Mark Macon,maconma01,SG,24,TOT,1994,42,496.0,163,51,18,23,41,39,1,40,73,69,184,0.375,2,10,0.2,67,174,0.3850574712643678,0.38,23,34,0.6764705882352942
Gerald Madkins,madkige01,SG,24,CLE,1994,22,149.0,35,19,1,10,11,9,0,13,16,11,31,0.3548387096774194,5,15,0.3333333333333333,6,16,0.375,0.435,8,10,0.8
Rick Mahorn,mahorri01,PF,35,NJN,1994,28,226.0,59,5,16,38,54,3,5,7,38,23,47,0.4893617021276595,0,1,0.0,23,46,0.5,0.489,13,20,0.65
Dan Majerle,majerda01,SG,28,PHO,1994,80,3207.0,1320,275,120,229,349,129,43,137,153,476,1138,0.4182776801405975,192,503,0.3817097415506958,284,635,0.4472440944881889,0.503,176,238,0.7394957983193278
Jeff Malone,malonje01,SG,32,TOT,1994,77,2560.0,1262,125,51,148,199,40,5,85,123,525,1081,0.4856614246068455,7,12,0.5833333333333334,518,1069,0.4845650140318054,0.489,205,247,0.8299595141700404
Karl Malone,malonka01,PF,30,UTA,1994,82,3329.0,2063,328,235,705,940,125,126,234,268,772,1552,0.4974226804123711,8,32,0.25,764,1520,0.5026315789473684,0.5,511,736,0.6942934782608695
Moses Malone,malonmo01,C,38,PHI,1994,55,618.0,294,34,106,120,226,11,17,59,52,102,232,0.4396551724137931,0,1,0.0,102,231,0.4415584415584415,0.44,90,117,0.7692307692307693
Danny Manning,mannida01,PF,27,TOT,1994,68,2520.0,1403,261,131,334,465,99,82,233,260,586,1201,0.4879267277268942,3,17,0.1764705882352941,583,1184,0.4923986486486486,0.489,228,341,0.6686217008797654
Roy Marble,marblro01,SF,27,DEN,1994,5,32.0,4,1,3,5,8,0,2,3,1,2,12,0.1666666666666666,0,0,0.0,2,12,0.1666666666666666,0.167,0,3,0.0
Bob Martin,martibo01,C,24,LAC,1994,53,535.0,111,17,36,81,117,8,33,29,106,40,88,0.4545454545454545,0,0,0.0,40,88,0.4545454545454545,0.455,31,51,0.6078431372549019
Jamal Mashburn,mashbja01,SF,21,DAL,1994,79,2896.0,1513,266,107,246,353,89,14,245,205,561,1382,0.4059334298118668,85,299,0.2842809364548495,476,1083,0.4395198522622345,0.437,306,438,0.6986301369863014
Anthony Mason,masonan01,PF,27,NYK,1994,73,1903.0,528,151,158,269,427,31,9,107,190,206,433,0.4757505773672055,0,1,0.0,206,432,0.4768518518518518,0.476,116,161,0.7204968944099379
Marlon Maxey,maxeyma01,PF,24,MIN,1994,55,626.0,248,10,75,124,199,16,33,40,113,89,167,0.5329341317365269,0,2,0.0,89,165,0.5393939393939394,0.533,70,98,0.7142857142857143
Vernon Maxwell,maxweve01,SG,28,HOU,1994,75,2571.0,1023,380,42,187,229,125,20,185,143,380,976,0.3893442622950819,120,403,0.2977667493796526,260,573,0.4537521815008726,0.451,143,191,0.7486910994764397
Lee Mayberry,maybele01,PG,23,MIL,1994,82,1472.0,433,215,26,75,101,46,4,97,114,167,402,0.4154228855721393,41,119,0.3445378151260504,126,283,0.4452296819787986,0.466,58,84,0.6904761904761905
Xavier McDaniel,mcdanxa01,SF,30,BOS,1994,82,1971.0,928,126,142,258,400,48,39,116,193,387,839,0.4612634088200238,10,41,0.2439024390243902,377,798,0.4724310776942356,0.467,144,213,0.676056338028169
Derrick McKey,mckeyde01,SF,27,IND,1994,76,2613.0,911,327,129,273,402,111,49,228,248,355,710,0.5,9,31,0.2903225806451613,346,679,0.5095729013254786,0.506,192,254,0.7559055118110236
Nate McMillan,mcmilna01,PG,29,SEA,1994,73,1887.0,437,387,50,233,283,216,22,126,201,177,396,0.4469696969696969,52,133,0.3909774436090225,125,263,0.4752851711026616,0.513,31,55,0.5636363636363636
Darnell Mee,meeda01,SG,22,DEN,1994,38,285.0,73,16,17,18,35,15,13,18,34,28,88,0.3181818181818182,5,24,0.2083333333333333,23,64,0.359375,0.347,12,27,0.4444444444444444
Oliver Miller,milleol01,C,23,PHO,1994,69,1786.0,636,244,140,336,476,83,156,164,230,277,455,0.6087912087912087,2,9,0.2222222222222222,275,446,0.6165919282511211,0.611,80,137,0.583941605839416
Reggie Miller,millere01,SG,28,IND,1994,79,2638.0,1574,248,30,182,212,119,24,175,193,524,1042,0.5028790786948176,123,292,0.4212328767123288,401,750,0.5346666666666666,0.562,403,444,0.9076576576576576
Chris Mills,millsch01,SF,24,CLE,1994,79,2022.0,743,128,134,267,401,54,50,89,232,284,677,0.4194977843426883,38,122,0.3114754098360656,246,555,0.4432432432432432,0.448,137,176,0.7784090909090909
Terry Mills,millste01,PF,26,DET,1994,80,2773.0,1381,177,193,479,672,64,62,153,309,588,1151,0.5108601216333623,24,73,0.3287671232876712,564,1078,0.5231910946196661,0.521,181,227,0.7973568281938326
Harold Miner,minerha01,SG,22,MIA,1994,63,1358.0,661,95,75,81,156,31,13,95,132,254,532,0.4774436090225564,4,6,0.6666666666666666,250,526,0.4752851711026616,0.481,149,180,0.8277777777777777
Sam Mitchell,mitchsa01,PF,30,IND,1994,75,1084.0,362,65,71,119,190,33,9,50,152,140,306,0.457516339869281,0,5,0.0,140,301,0.4651162790697674,0.458,82,110,0.7454545454545455
Tracy Moore,mooretr01,SG,28,DET,1994,3,10.0,6,0,0,1,1,2,0,0,0,2,3,0.6666666666666666,0,0,0.0,2,3,0.6666666666666666,0.667,2,2,1.0
Darren Morningstar,mornida01,C,24,TOT,1994,23,367.0,96,15,31,50,81,14,2,19,70,39,82,0.4756097560975609,0,0,0.0,39,82,0.4756097560975609,0.476,18,30,0.6
Chris Morris,morrich01,SF,28,NJN,1994,50,1349.0,544,83,91,137,228,55,49,52,120,203,454,0.4471365638766519,53,147,0.3605442176870748,150,307,0.4885993485342019,0.506,85,118,0.7203389830508474
Alonzo Mourning,mournal01,C,23,CHH,1994,60,2018.0,1287,86,177,433,610,27,188,199,207,427,845,0.5053254437869823,0,2,0.0,427,843,0.5065243179122183,0.505,433,568,0.7623239436619719
Chris Mullin,mullich01,SF,30,GSW,1994,62,2324.0,1040,315,64,281,345,107,53,178,114,410,869,0.4718066743383199,55,151,0.3642384105960264,355,718,0.4944289693593314,0.503,165,219,0.7534246575342466
Eric Murdock,murdoer01,PG,25,MIL,1994,82,2533.0,1257,546,91,170,261,197,12,206,189,477,1019,0.4681059862610402,69,168,0.4107142857142857,408,851,0.4794359576968273,0.502,234,288,0.8125
Gheorghe Mureșan,muresgh01,C,22,WSB,1994,54,650.0,304,18,66,126,192,28,48,54,120,128,235,0.5446808510638298,0,0,0.0,128,235,0.5446808510638298,0.545,48,71,0.676056338028169
Tod Murphy,murphto01,PF,30,TOT,1994,9,67.0,15,4,4,6,10,2,0,1,10,6,12,0.5,0,0,0.0,6,12,0.5,0.5,3,6,0.5
Tracy Murray,murratr01,SF,22,POR,1994,66,820.0,434,31,43,68,111,21,20,37,76,167,355,0.4704225352112676,50,109,0.4587155963302752,117,246,0.4756097560975609,0.541,50,72,0.6944444444444444
Jerrod Mustaf,mustaje01,PF,24,PHO,1994,33,196.0,73,8,20,35,55,4,5,10,29,30,84,0.3571428571428571,0,0,0.0,30,84,0.3571428571428571,0.357,13,22,0.5909090909090909
Dikembe Mutombo,mutomdi01,C,27,DEN,1994,82,2853.0,986,127,286,685,971,59,336,206,262,365,642,0.5685358255451713,0,1,0.0,365,641,0.5694227769110765,0.569,256,439,0.5831435079726651
Pete Myers,myerspe01,SG,30,CHI,1994,82,2030.0,650,245,54,127,181,78,20,136,195,253,556,0.4550359712230216,8,29,0.2758620689655172,245,527,0.4648956356736243,0.462,136,194,0.7010309278350515
Larry Nance,nancela01,PF,34,CLE,1994,33,909.0,370,49,77,150,227,27,55,38,96,153,314,0.4872611464968153,0,0,0.0,153,314,0.4872611464968153,0.487,64,85,0.7529411764705882
Chuck Nevitt,nevitch01,C,34,SAS,1994,1,1.0,3,0,1,0,1,0,0,1,1,0,0,0.0,0,0,0.0,0,0,0.0,0.0,3,6,0.5
Johnny Newman,newmajo01,SF,30,TOT,1994,81,1697.0,832,72,86,94,180,69,27,90,196,313,664,0.4713855421686747,24,90,0.2666666666666666,289,574,0.5034843205574913,0.489,182,225,0.8088888888888889
Ken Norman,normake01,SF,29,MIL,1994,82,2539.0,979,222,169,331,500,58,46,150,209,412,919,0.4483133841131664,63,189,0.3333333333333333,349,730,0.4780821917808219,0.483,92,183,0.5027322404371585
Shaquille O'Neal,onealsh01,C,21,ORL,1994,81,3224.0,2377,195,384,688,1072,76,231,222,281,953,1591,0.5989943431803897,0,2,0.0,953,1589,0.5997482693517936,0.599,471,850,0.5541176470588235
Dan O'Sullivan,osullda01,C,25,DET,1994,13,56.0,17,3,2,8,10,0,0,3,10,4,12,0.3333333333333333,0,0,0.0,4,12,0.3333333333333333,0.333,9,12,0.75
Charles Oakley,oaklech01,PF,30,NYK,1994,82,2932.0,969,218,349,616,965,110,18,193,293,363,760,0.4776315789473684,0,3,0.0,363,757,0.4795244385733157,0.478,243,313,0.7763578274760383
Hakeem Olajuwon,olajuha01,C,31,HOU,1994,80,3277.0,2184,287,229,726,955,128,297,271,289,894,1694,0.5277449822904369,8,19,0.4210526315789473,886,1675,0.528955223880597,0.53,388,542,0.7158671586715867
Jimmy Oliver,oliveji01,SG,24,BOS,1994,44,540.0,216,33,8,38,46,16,1,21,39,89,214,0.4158878504672897,13,32,0.40625,76,182,0.4175824175824176,0.446,25,33,0.7575757575757576
Bo Outlaw,outlabo01,SF,22,LAC,1994,37,871.0,257,36,81,131,212,36,37,31,94,98,167,0.5868263473053892,0,2,0.0,98,165,0.593939393939394,0.587,61,103,0.5922330097087378
Doug Overton,overtdo01,PG,24,WSB,1994,61,749.0,218,92,19,50,69,21,1,54,48,87,216,0.4027777777777778,1,11,0.0909090909090909,86,205,0.4195121951219512,0.405,43,52,0.8269230769230769
Billy Owens,owensbi01,PF,24,GSW,1994,79,2738.0,1186,326,230,410,640,83,60,214,269,492,971,0.5066941297631308,3,15,0.2,489,956,0.5115062761506276,0.508,199,326,0.6104294478527608
Robert Pack,packro01,PG,24,DEN,1994,66,1382.0,631,356,25,98,123,81,9,204,147,223,503,0.4433399602385686,6,29,0.2068965517241379,217,474,0.4578059071729958,0.449,179,236,0.7584745762711864
Gerald Paddio,paddige01,SF,28,TOT,1994,18,137.0,53,11,5,11,16,4,0,6,9,22,60,0.3666666666666666,0,1,0.0,22,59,0.3728813559322034,0.367,9,16,0.5625
Robert Parish,parisro01,C,40,BOS,1994,74,1987.0,866,82,141,401,542,42,96,108,190,356,725,0.4910344827586207,0,0,0.0,356,725,0.4910344827586207,0.491,154,208,0.7403846153846154
John Paxson,paxsojo01,PG,33,CHI,1994,27,343.0,70,33,3,17,20,7,2,6,18,30,68,0.4411764705882353,9,22,0.4090909090909091,21,46,0.4565217391304347,0.507,1,2,0.5
Gary Payton,paytoga01,PG,25,SEA,1994,82,2881.0,1349,494,105,164,269,188,19,173,227,584,1159,0.5038826574633305,15,54,0.2777777777777778,569,1105,0.5149321266968325,0.51,166,279,0.5949820788530465
Anthony Peeler,peelean01,SG,24,LAL,1994,30,923.0,423,94,48,61,109,43,8,59,93,176,409,0.4303178484107579,14,63,0.2222222222222222,162,346,0.4682080924855491,0.447,57,71,0.8028169014084507
Mike Peplowski,peplomi01,C,23,SAC,1994,55,667.0,176,24,49,120,169,17,25,34,131,76,141,0.5390070921985816,0,1,0.0,76,140,0.5428571428571428,0.539,24,44,0.5454545454545454
Will Perdue,perduwi01,C,28,CHI,1994,43,397.0,117,34,40,86,126,8,11,42,61,47,112,0.4196428571428571,0,1,0.0,47,111,0.4234234234234234,0.42,23,32,0.71875
Sam Perkins,perkisa01,PF,32,SEA,1994,81,2170.0,999,111,120,246,366,67,31,103,197,341,779,0.4377406931964056,99,270,0.3666666666666666,242,509,0.4754420432220039,0.501,218,272,0.8014705882352942
Elliot Perry,perryel01,PG,24,PHO,1994,27,432.0,105,125,12,27,39,25,1,43,36,42,113,0.3716814159292035,0,3,0.0,42,110,0.3818181818181818,0.372,21,28,0.75
Tim Perry,perryti01,PF,28,PHI,1994,80,2336.0,719,94,117,287,404,60,82,80,154,272,625,0.4352,73,200,0.365,199,425,0.4682352941176471,0.494,102,176,0.5795454545454546
Chuck Person,persoch01,SF,29,MIN,1994,77,2029.0,894,185,55,198,253,45,12,121,164,356,843,0.4223013048635824,100,272,0.3676470588235294,256,571,0.4483362521891418,0.482,82,108,0.7592592592592593
Richard Petruška,petruri01,C,25,HOU,1994,22,92.0,53,1,9,22,31,2,3,15,15,20,46,0.4347826086956521,7,15,0.4666666666666667,13,31,0.4193548387096774,0.511,6,8,0.75
Bobby Phills,phillbo01,SG,24,CLE,1994,72,1531.0,598,133,71,141,212,67,12,63,135,242,514,0.4708171206225681,1,12,0.0833333333333333,241,502,0.4800796812749004,0.472,113,157,0.7197452229299363
Ricky Pierce,piercri01,SG,34,SEA,1994,51,1022.0,739,91,29,54,83,42,5,64,84,272,577,0.4714038128249567,6,32,0.1875,266,545,0.4880733944954128,0.477,189,211,0.8957345971563981
Ed Pinckney,pincked01,PF,30,BOS,1994,76,1524.0,394,62,160,318,478,58,44,62,131,151,289,0.5224913494809689,0,0,0.0,151,289,0.5224913494809689,0.522,92,125,0.736
Scottie Pippen,pippesc01,SF,28,CHI,1994,72,2759.0,1587,403,173,456,629,211,58,232,227,627,1278,0.4906103286384976,63,197,0.3197969543147208,564,1081,0.5217391304347826,0.515,270,409,0.6601466992665037
Olden Polynice,polynol01,C,29,TOT,1994,68,2402.0,789,41,299,510,809,42,67,78,189,346,662,0.5226586102719033,0,2,0.0,346,660,0.5242424242424243,0.523,97,191,0.5078534031413613
Terry Porter,portete01,PG,30,POR,1994,77,2074.0,1010,401,45,170,215,79,18,166,132,348,836,0.416267942583732,110,282,0.3900709219858156,238,554,0.4296028880866426,0.482,204,234,0.8717948717948718
Brent Price,pricebr01,PG,25,WSB,1994,65,1035.0,400,213,31,59,90,55,2,119,114,141,326,0.4325153374233129,50,150,0.3333333333333333,91,176,0.5170454545454546,0.509,68,87,0.7816091954022989
Mark Price,pricema01,PG,29,CLE,1994,76,2386.0,1316,589,39,189,228,103,11,189,93,480,1005,0.4776119402985074,118,297,0.3973063973063973,362,708,0.5112994350282486,0.536,238,268,0.8880597014925373
Dino Radja,radjadi01,PF,26,BOS,1994,80,2303.0,1208,114,191,386,577,70,67,149,276,491,942,0.5212314225053079,0,1,0.0,491,941,0.5217853347502657,0.521,226,301,0.7508305647840532
Kurt Rambis,rambiku01,PF,35,LAL,1994,50,635.0,164,32,84,105,189,22,23,26,89,59,114,0.5175438596491229,0,1,0.0,59,113,0.5221238938053098,0.518,46,71,0.647887323943662
Mark Randall,randama01,PF,26,DEN,1994,28,155.0,58,11,9,13,22,8,3,10,18,17,50,0.34,2,14,0.1428571428571428,15,36,0.4166666666666667,0.36,22,28,0.7857142857142857
J.R. Reid,reidjr01,PF,25,SAS,1994,70,1344.0,627,73,91,129,220,43,25,84,165,260,530,0.490566037735849,0,3,0.0,260,527,0.493358633776091,0.491,107,153,0.6993464052287581
Glen Rice,ricegl01,SF,26,MIA,1994,81,2999.0,1708,184,76,358,434,110,32,130,186,663,1421,0.4665728360309641,132,346,0.3815028901734104,531,1075,0.493953488372093,0.513,250,284,0.8802816901408451
Pooh Richardson,richapo01,PG,27,IND,1994,37,1022.0,370,237,28,82,110,32,3,88,78,160,354,0.4519774011299435,3,12,0.25,157,342,0.4590643274853801,0.456,47,77,0.6103896103896104
Mitch Richmond,richmmi01,SG,28,SAC,1994,78,2897.0,1823,313,70,216,286,103,17,216,211,635,1428,0.4446778711484593,127,312,0.407051282051282,508,1116,0.4551971326164875,0.489,426,511,0.8336594911937377
Isaiah Rider,rideris01,SG,22,MIN,1994,79,2415.0,1313,202,118,197,315,54,28,218,194,522,1115,0.4681614349775784,54,150,0.36,468,965,0.4849740932642487,0.492,215,265,0.8113207547169812
Eric Riley,rileyer01,C,23,HOU,1994,47,219.0,88,9,24,35,59,5,9,15,30,34,70,0.4857142857142857,0,1,0.0,34,69,0.4927536231884058,0.486,20,37,0.5405405405405406
Doc Rivers,riverdo01,PG,32,NYK,1994,19,499.0,143,100,4,35,39,25,5,29,44,55,127,0.4330708661417323,19,52,0.3653846153846153,36,75,0.48,0.508,14,22,0.6363636363636364
Stanley Roberts,roberst01,C,23,LAC,1994,14,350.0,104,11,27,66,93,6,25,24,54,43,100,0.43,0,0,0.0,43,100,0.43,0.43,18,44,0.4090909090909091
Clifford Robinson,robincl02,C,27,POR,1994,82,2853.0,1647,159,164,386,550,118,111,169,263,641,1404,0.4565527065527066,13,53,0.2452830188679245,628,1351,0.464840858623242,0.461,352,460,0.7652173913043478
David Robinson,robinda01,C,28,SAS,1994,80,3241.0,2383,381,241,614,855,139,265,253,228,840,1658,0.5066344993968637,10,29,0.3448275862068966,830,1629,0.5095150399017803,0.51,693,925,0.7491891891891892
James Robinson,robinja02,PG,23,POR,1994,58,673.0,276,68,34,44,78,30,15,52,69,104,285,0.3649122807017544,23,73,0.3150684931506849,81,212,0.3820754716981132,0.405,45,67,0.6716417910447762
Larry Robinson,robinla01,SG,26,HOU,1994,6,55.0,25,6,4,6,10,7,0,10,8,10,20,0.5,2,8,0.25,8,12,0.6666666666666666,0.55,3,8,0.375
Rumeal Robinson,robinru01,PG,27,TOT,1994,31,396.0,131,63,6,26,32,18,3,43,48,55,152,0.3618421052631579,8,20,0.4,47,132,0.3560606060606061,0.388,13,29,0.4482758620689655
Dennis Rodman,rodmade01,PF,32,SAS,1994,79,2989.0,370,184,453,914,1367,52,32,138,229,156,292,0.5342465753424658,5,24,0.2083333333333333,151,268,0.5634328358208955,0.543,53,102,0.5196078431372549
Rodney Rogers,rogerro01,SF,22,DEN,1994,79,1406.0,640,101,90,136,226,63,48,131,195,239,545,0.4385321100917431,35,92,0.3804347826086957,204,453,0.4503311258278146,0.471,127,189,0.671957671957672
Tree Rollins,rollitr01,C,38,ORL,1994,45,384.0,76,9,33,63,96,7,35,13,55,29,53,0.5471698113207547,0,0,0.0,29,53,0.5471698113207547,0.547,18,30,0.6
Sean Rooks,rooksse01,C,24,DAL,1994,47,1255.0,536,49,84,175,259,21,44,80,109,193,393,0.4910941475826972,0,1,0.0,193,392,0.4923469387755102,0.491,150,210,0.7142857142857143
Donald Royal,royaldo01,SF,27,ORL,1994,74,1357.0,547,61,94,154,248,50,16,76,121,174,347,0.5014409221902018,0,2,0.0,174,345,0.5043478260869565,0.501,199,269,0.7397769516728625
Bryon Russell,russebr01,SF,23,UTA,1994,67,1121.0,334,54,61,120,181,68,19,55,138,135,279,0.4838709677419355,2,22,0.0909090909090909,133,257,0.5175097276264592,0.487,62,101,0.6138613861386139
John Salley,sallejo01,PF,29,MIA,1994,76,1910.0,582,135,132,275,407,56,78,94,260,208,436,0.4770642201834862,2,3,0.6666666666666666,206,433,0.4757505773672055,0.479,164,225,0.7288888888888889
Danny Schayes,schayda01,C,34,TOT,1994,36,363.0,85,13,31,48,79,10,10,23,45,28,84,0.3333333333333333,0,0,0.0,28,84,0.3333333333333333,0.333,29,32,0.90625
Steve Scheffler,schefst01,C,26,SEA,1994,35,152.0,75,6,11,15,26,7,0,8,25,28,46,0.6086956521739131,0,0,0.0,28,46,0.6086956521739131,0.609,19,20,0.95
Dwayne Schintzius,schindw01,C,25,NJN,1994,30,319.0,68,13,26,63,89,7,17,13,49,29,84,0.3452380952380952,0,0,0.0,29,84,0.3452380952380952,0.345,10,17,0.5882352941176471
Detlef Schrempf,schrede01,SF,31,SEA,1994,81,2728.0,1212,275,144,310,454,73,9,173,273,445,903,0.4928017718715393,22,68,0.3235294117647059,423,835,0.5065868263473053,0.505,300,390,0.7692307692307693
Byron Scott,scottby01,SG,32,IND,1994,67,1197.0,696,133,19,91,110,62,9,103,80,256,548,0.4671532846715328,27,74,0.3648648648648648,229,474,0.4831223628691983,0.492,157,195,0.8051282051282052
Dennis Scott,scottde01,SF,25,ORL,1994,82,2283.0,1046,216,54,164,218,81,32,93,161,384,949,0.40463645943098,155,388,0.3994845360824742,229,561,0.4081996434937611,0.486,123,159,0.7735849056603774
Malik Sealy,sealyma01,SF,23,IND,1994,43,623.0,285,48,43,75,118,31,8,51,84,111,274,0.4051094890510949,4,16,0.25,107,258,0.4147286821705426,0.412,59,87,0.6781609195402298
Rony Seikaly,seikaro01,C,28,MIA,1994,72,2410.0,1088,136,244,496,740,59,100,195,279,392,803,0.4881693648816936,0,2,0.0,392,801,0.4893882646691635,0.488,304,422,0.7203791469194313
Brian Shaw,shawbr01,SG,27,MIA,1994,77,2037.0,693,385,104,246,350,71,21,173,195,278,667,0.416791604197901,73,216,0.3379629629629629,205,451,0.4545454545454545,0.472,64,89,0.7191011235955056
Lionel Simmons,simmoli01,SF,25,SAC,1994,75,2702.0,1129,305,168,394,562,104,50,183,189,436,996,0.4377510040160642,6,17,0.3529411764705882,430,979,0.4392236976506639,0.441,251,323,0.7770897832817337
Scott Skiles,skilesc01,PG,29,ORL,1994,82,2303.0,815,503,42,147,189,47,2,193,171,276,644,0.4285714285714285,68,165,0.4121212121212121,208,479,0.4342379958246347,0.481,195,222,0.8783783783783784
Charles Smith,smithch01,SF,28,NYK,1994,43,1105.0,447,50,66,99,165,26,45,64,144,176,397,0.4433249370277078,8,16,0.5,168,381,0.4409448818897638,0.453,87,121,0.71900826446281
Chris Smith,smithch03,PG,23,MIN,1994,80,1617.0,473,285,15,107,122,38,18,101,131,184,423,0.4349881796690307,10,39,0.2564102564102564,174,384,0.453125,0.447,95,141,0.6737588652482269
Doug Smith,smithdo03,PF,24,DAL,1994,79,1684.0,698,119,114,235,349,82,38,93,287,295,678,0.4351032448377581,2,9,0.2222222222222222,293,669,0.4379671150971599,0.437,106,127,0.8346456692913385
Kenny Smith,smithke01,PG,28,HOU,1994,78,2209.0,906,327,24,114,138,59,4,126,121,341,711,0.4796061884669479,89,220,0.4045454545454545,252,491,0.5132382892057027,0.542,135,155,0.8709677419354839
LaBradford Smith,smithla02,SG,24,TOT,1994,66,877.0,332,109,34,50,84,40,5,50,96,124,306,0.4052287581699346,21,60,0.35,103,246,0.4186991869918699,0.44,63,84,0.75
Reggie Smith,smithre01,PF,23,POR,1994,43,316.0,76,4,40,59,99,12,6,12,47,29,72,0.4027777777777778,0,0,0.0,29,72,0.4027777777777778,0.403,18,38,0.4736842105263157
Steve Smith,smithst01,SG,24,MIA,1994,78,2776.0,1346,394,156,196,352,84,35,202,217,491,1076,0.4563197026022305,91,262,0.3473282442748092,400,814,0.4914004914004914,0.499,273,327,0.8348623853211009
Tony Smith,smithto02,SG,25,LAL,1994,73,1617.0,645,148,106,89,195,59,14,76,128,272,617,0.4408427876823338,16,50,0.32,256,567,0.4514991181657848,0.454,85,119,0.7142857142857143
Rik Smits,smitsri01,C,27,IND,1994,78,2113.0,1224,156,135,348,483,49,82,151,281,493,923,0.5341278439869989,0,1,0.0,493,922,0.53470715835141,0.534,238,300,0.7933333333333333
Andre Spencer,spencan01,SF,29,TOT,1994,28,349.0,159,22,30,43,73,19,7,21,43,52,118,0.4406779661016949,0,0,0.0,52,118,0.4406779661016949,0.441,55,77,0.7142857142857143
Elmore Spencer,spencel01,C,24,LAC,1994,76,1930.0,673,75,96,319,415,30,127,168,208,288,540,0.5333333333333333,0,2,0.0,288,538,0.5353159851301115,0.533,97,162,0.5987654320987654
Felton Spencer,spencfe01,C,26,UTA,1994,79,2210.0,677,43,235,423,658,41,67,127,304,256,507,0.504930966469428,0,0,0.0,256,507,0.504930966469428,0.505,165,272,0.6066176470588235
Latrell Sprewell,sprewla01,SG,23,GSW,1994,82,3533.0,1720,385,80,321,401,180,76,226,158,613,1417,0.4326040931545519,141,391,0.3606138107416879,472,1026,0.4600389863547758,0.482,353,456,0.7741228070175439
John Starks,starkjo01,SG,28,NYK,1994,59,2057.0,1120,348,37,148,185,95,6,184,191,410,977,0.4196519959058342,113,337,0.3353115727002967,297,640,0.4640625,0.477,187,248,0.7540322580645161
Larry Stewart,stewala01,SF,25,WSB,1994,3,35.0,13,2,1,6,7,2,1,2,4,3,8,0.375,0,0,0.0,3,8,0.375,0.375,7,10,0.7
Bryant Stith,stithbr01,SG,23,DEN,1994,82,2853.0,1023,199,119,230,349,116,16,131,165,365,811,0.4500616522811344,2,9,0.2222222222222222,363,802,0.4526184538653366,0.451,291,351,0.8290598290598291
John Stockton,stockjo01,PG,31,UTA,1994,82,2969.0,1236,1031,72,186,258,199,22,266,236,458,868,0.5276497695852534,48,149,0.3221476510067114,410,719,0.5702364394993046,0.555,272,338,0.8047337278106509
Rod Strickland,stricro02,PG,27,POR,1994,82,2889.0,1411,740,122,248,370,147,24,257,171,528,1093,0.4830741079597438,2,10,0.2,526,1083,0.4856879039704525,0.484,353,471,0.7494692144373672
Derek Strong,stronde01,PF,25,MIL,1994,67,1131.0,444,48,109,172,281,38,14,61,69,141,341,0.4134897360703812,3,13,0.2307692307692307,138,328,0.4207317073170731,0.418,159,206,0.7718446601941747
Isiah Thomas,thomais01,PG,32,DET,1994,58,1750.0,856,399,46,113,159,68,6,202,126,318,763,0.4167758846657929,39,126,0.3095238095238095,279,637,0.4379905808477237,0.442,181,258,0.7015503875968992
Kevin Thompson,thompke01,C,22,POR,1994,14,58.0,13,3,7,6,13,0,2,5,11,6,14,0.4285714285714285,0,1,0.0,6,13,0.4615384615384615,0.429,1,2,0.5
LaSalle Thompson,thompla01,C,32,IND,1994,30,282.0,70,16,26,49,75,10,8,23,59,27,77,0.3506493506493506,0,0,0.0,27,77,0.3506493506493506,0.351,16,30,0.5333333333333333
Otis Thorpe,thorpot01,PF,31,HOU,1994,82,2909.0,1149,189,271,599,870,66,28,185,253,449,801,0.5605493133583022,0,2,0.0,449,799,0.5619524405506884,0.561,251,382,0.6570680628272252
Sedale Threatt,threase01,PG,32,LAL,1994,81,2278.0,965,344,28,125,153,110,19,106,186,411,852,0.4823943661971831,5,33,0.1515151515151515,406,819,0.4957264957264957,0.485,138,155,0.8903225806451613
Wayman Tisdale,tisdawa01,PF,29,SAC,1994,79,2557.0,1319,139,159,401,560,37,52,124,290,552,1102,0.5009074410163339,0,0,0.0,552,1102,0.5009074410163339,0.501,215,266,0.8082706766917294
Tom Tolbert,tolbeto01,SF,28,LAC,1994,49,640.0,187,30,36,72,108,13,15,39,61,74,177,0.4180790960451977,6,16,0.375,68,161,0.422360248447205,0.435,33,45,0.7333333333333333
Sedric Toney,toneyse01,PG,31,CLE,1994,12,64.0,6,11,1,2,3,0,0,5,8,2,12,0.1666666666666666,0,1,0.0,2,11,0.1818181818181818,0.167,2,2,1.0
Keith Tower,towerke01,C,23,ORL,1994,11,32.0,8,1,0,6,6,0,0,0,6,4,9,0.4444444444444444,0,0,0.0,4,9,0.4444444444444444,0.444,0,0,0.0
Jeff Turner,turneje01,PF,31,ORL,1994,68,1536.0,451,60,79,192,271,23,11,75,239,199,426,0.4671361502347418,18,55,0.3272727272727272,181,371,0.4878706199460916,0.488,35,45,0.7777777777777778
Nick Van Exel,vanexni01,PG,22,LAL,1994,81,2700.0,1099,466,47,191,238,85,8,145,154,413,1049,0.3937082936129647,123,364,0.3379120879120879,290,685,0.4233576642335766,0.452,150,192,0.78125
Loy Vaught,vaughlo01,PF,25,LAC,1994,75,2118.0,877,74,218,438,656,76,22,96,221,373,695,0.5366906474820143,0,5,0.0,373,690,0.5405797101449276,0.537,131,182,0.7197802197802198
Kenny Walker,walkeke01,SF,29,WSB,1994,73,1397.0,351,33,118,171,289,26,59,44,156,132,274,0.4817518248175182,0,3,0.0,132,271,0.4870848708487085,0.482,87,125,0.696
Rex Walters,waltere01,SG,23,NJN,1994,48,386.0,162,71,6,32,38,15,3,30,41,60,115,0.5217391304347826,14,28,0.5,46,87,0.5287356321839081,0.583,28,34,0.8235294117647058
Clarence Weatherspoon,weathcl01,SF,23,PHI,1994,82,3147.0,1506,192,254,578,832,100,116,195,152,602,1246,0.4831460674157303,4,17,0.2352941176470588,598,1229,0.4865744507729861,0.485,298,430,0.6930232558139535
Spud Webb,webbsp01,PG,30,SAC,1994,79,2567.0,1005,528,44,178,222,93,23,168,182,373,810,0.4604938271604938,55,164,0.3353658536585366,318,646,0.4922600619195046,0.494,204,251,0.8127490039840638
Chris Webber,webbech01,C,20,GSW,1994,76,2438.0,1333,272,305,389,694,93,164,206,247,572,1037,0.5515911282545806,0,14,0.0,572,1023,0.5591397849462365,0.552,189,355,0.532394366197183
Bill Wennington,wennibi01,C,30,CHI,1994,76,1371.0,542,70,117,236,353,43,29,75,214,235,482,0.487551867219917,0,2,0.0,235,480,0.4895833333333333,0.488,72,88,0.8181818181818182
Matt Wenstrom,wenstma01,C,23,BOS,1994,11,37.0,18,0,6,6,12,0,2,4,7,6,10,0.6,0,0,0.0,6,10,0.6,0.6,6,10,0.6
David Wesley,wesleda01,PG,23,NJN,1994,60,542.0,183,123,10,34,44,38,4,52,47,64,174,0.367816091954023,11,47,0.2340425531914893,53,127,0.4173228346456692,0.399,44,53,0.8301886792452831
Doug West,westdo01,SG,26,MIN,1994,72,2182.0,1056,172,61,170,231,65,24,137,236,434,891,0.4870931537598204,1,8,0.125,433,883,0.4903737259343148,0.488,187,231,0.8095238095238095
Mark West,westma01,C,33,PHO,1994,82,1236.0,382,33,112,183,295,31,109,74,214,162,286,0.5664335664335665,0,0,0.0,162,286,0.5664335664335665,0.566,58,116,0.5
Ennis Whatley,whatlen01,PG,31,ATL,1994,82,1004.0,292,181,22,77,99,59,2,78,93,120,236,0.5084745762711864,0,6,0.0,120,230,0.5217391304347826,0.508,52,66,0.7878787878787878
Randy White,whitera01,PF,26,DAL,1994,18,320.0,115,11,30,53,83,10,10,18,46,45,112,0.4017857142857143,6,20,0.3,39,92,0.4239130434782608,0.429,19,33,0.5757575757575758
Chris Whitney,whitnch01,PG,22,SAS,1994,40,339.0,72,53,5,24,29,11,1,37,53,25,82,0.3048780487804878,10,30,0.3333333333333333,15,52,0.2884615384615384,0.366,12,15,0.8
Morlon Wiley,wileymo01,PG,27,TOT,1994,16,158.0,21,23,0,10,10,15,0,17,21,9,29,0.3103448275862069,3,10,0.3,6,19,0.3157894736842105,0.362,0,0,0.0
Dominique Wilkins,wilkido01,SF,34,TOT,1994,74,2635.0,1923,169,182,299,481,92,30,172,126,698,1588,0.4395465994962216,85,295,0.288135593220339,613,1293,0.474091260634184,0.466,442,522,0.8467432950191571
Gerald Wilkins,wilkige01,SG,30,CLE,1994,82,2768.0,1170,255,106,197,303,105,38,131,186,446,975,0.4574358974358974,84,212,0.3962264150943396,362,763,0.4744429882044561,0.501,194,250,0.776
Aaron Williams,williaa01,PF,22,UTA,1994,6,12.0,4,1,1,2,3,0,0,1,4,2,8,0.25,0,0,0.0,2,8,0.25,0.25,0,1,0.0
Buck Williams,willibu01,PF,33,POR,1994,81,2636.0,783,80,315,528,843,58,47,111,239,291,524,0.5553435114503816,0,1,0.0,291,523,0.5564053537284895,0.555,201,296,0.6790540540540541
Corey Williams,willico01,PG,23,MIN,1994,4,46.0,11,6,1,5,6,2,0,2,6,5,13,0.3846153846153846,0,1,0.0,5,12,0.4166666666666667,0.385,1,1,1.0
Herb Williams,willihe01,C,35,NYK,1994,70,774.0,233,28,56,126,182,18,43,39,108,103,233,0.4420600858369098,0,1,0.0,103,232,0.4439655172413793,0.442,27,42,0.6428571428571429
Hot Rod Williams,williho01,PF,31,CLE,1994,76,2660.0,1040,193,207,368,575,78,130,139,219,394,825,0.4775757575757576,0,0,0.0,394,825,0.4775757575757576,0.478,252,346,0.7283236994219653
Jayson Williams,willija01,PF,25,NJN,1994,70,877.0,322,26,109,154,263,17,36,35,140,125,293,0.4266211604095563,0,0,0.0,125,293,0.4266211604095563,0.427,72,119,0.6050420168067226
John Williams,willijo02,SF,27,LAC,1994,34,725.0,191,97,37,90,127,25,10,35,85,81,188,0.4308510638297872,5,20,0.25,76,168,0.4523809523809524,0.444,24,36,0.6666666666666666
Kenny Williams,willike03,SF,24,IND,1994,68,982.0,427,52,93,112,205,24,49,45,99,191,391,0.4884910485933504,0,4,0.0,191,387,0.4935400516795866,0.488,45,64,0.703125
Lorenzo Williams,willilo01,PF,24,TOT,1994,38,716.0,110,25,95,122,217,18,46,22,92,49,110,0.4454545454545454,0,1,0.0,49,109,0.4495412844036697,0.445,12,28,0.4285714285714285
Micheal Williams,willimi02,PG,27,MIN,1994,71,2206.0,971,512,67,154,221,118,24,203,193,314,687,0.4570596797671033,10,45,0.2222222222222222,304,642,0.4735202492211838,0.464,333,397,0.8387909319899244
Reggie Williams,willire01,SF,29,DEN,1994,82,2654.0,1065,300,98,294,392,117,66,163,288,418,1014,0.4122287968441814,64,230,0.2782608695652174,354,784,0.4515306122448979,0.444,165,225,0.7333333333333333
Scott Williams,willisc01,C,25,CHI,1994,38,638.0,289,39,69,112,181,16,21,44,112,114,236,0.4830508474576271,1,5,0.2,113,231,0.4891774891774891,0.485,60,98,0.6122448979591837
Walt Williams,williwa02,SF,23,SAC,1994,57,1356.0,638,132,71,164,235,52,23,145,200,226,580,0.3896551724137931,38,132,0.2878787878787879,188,448,0.4196428571428571,0.422,148,233,0.6351931330472103
Kevin Willis,willike02,PF,31,ATL,1994,80,2867.0,1531,150,335,628,963,79,38,188,250,627,1257,0.4988066825775656,9,24,0.375,618,1233,0.5012165450121655,0.502,268,376,0.7127659574468085
Trevor Wilson,wilsotr01,PF,25,TOT,1994,57,1221.0,466,72,120,153,273,38,11,93,123,187,388,0.4819587628865979,0,2,0.0,187,386,0.4844559585492228,0.482,92,166,0.5542168674698795
David Wingate,wingada01,SG,30,CHH,1994,50,1005.0,310,104,30,104,134,42,6,53,85,136,283,0.4805653710247349,4,12,0.3333333333333333,132,271,0.4870848708487085,0.488,34,51,0.6666666666666666
David Wood,woodda01,PF,29,DET,1994,78,1182.0,322,51,104,135,239,39,19,35,201,119,259,0.4594594594594595,22,49,0.4489795918367347,97,210,0.4619047619047619,0.502,62,82,0.7560975609756098
Randy Woods,woodsra01,PG,23,LAC,1994,40,352.0,145,71,13,16,29,24,2,34,40,49,133,0.3684210526315789,27,78,0.3461538461538461,22,55,0.4,0.47,20,35,0.5714285714285714
Orlando Woolridge,woolror01,SF,34,PHI,1994,74,1955.0,937,139,103,195,298,41,56,142,186,364,773,0.4708926261319534,1,14,0.0714285714285714,363,759,0.4782608695652174,0.472,208,302,0.6887417218543046
Haywoode Workman,workmha01,PG,28,IND,1994,65,1714.0,501,404,32,172,204,85,4,151,152,195,460,0.4239130434782608,18,56,0.3214285714285714,177,404,0.4381188118811881,0.443,93,116,0.8017241379310345
James Worthy,worthja01,SF,32,LAL,1994,80,1597.0,812,154,48,133,181,45,18,97,80,340,838,0.4057279236276849,32,111,0.2882882882882883,308,727,0.4236588720770289,0.425,100,135,0.7407407407407407
Luther Wright,wrighlu01,C,22,UTA,1994,15,92.0,19,0,6,4,10,1,2,6,21,8,23,0.3478260869565217,0,1,0.0,8,22,0.3636363636363636,0.348,3,4,0.75
Alaa Abdelnaby,abdelal01,PF,26,TOT,1995,54,506.0,256,13,37,77,114,15,12,45,104,118,231,0.5108225108225108,0,2,0.0,118,229,0.5152838427947598,0.511,20,35,0.5714285714285714
Mahmoud Abdul-Rauf,abdulma02,PG,25,DEN,1995,73,2082.0,1165,263,32,105,137,77,9,119,126,472,1005,0.4696517412935323,83,215,0.386046511627907,389,790,0.4924050632911392,0.511,138,156,0.8846153846153846
Michael Adams,adamsmi01,PG,32,CHH,1995,29,443.0,188,95,6,23,29,23,1,26,41,67,148,0.4527027027027027,29,81,0.3580246913580246,38,67,0.5671641791044776,0.551,25,30,0.8333333333333334
Rafael Addison,addisra01,SF,30,DET,1995,79,1776.0,656,109,67,175,242,53,25,76,236,279,586,0.4761092150170648,24,83,0.2891566265060241,255,503,0.5069582504970179,0.497,74,99,0.7474747474747475
Danny Ainge,aingeda01,SG,35,PHO,1995,74,1374.0,571,210,25,84,109,46,7,79,155,194,422,0.4597156398104265,78,214,0.3644859813084112,116,208,0.5576923076923077,0.552,105,130,0.8076923076923077
Victor Alexander,alexavi01,C,25,GSW,1995,50,1237.0,502,60,87,204,291,28,29,76,145,230,447,0.5145413870246085,6,25,0.24,224,422,0.5308056872037915,0.521,36,60,0.6
Derrick Alston,alstode01,C,22,PHI,1995,64,1032.0,299,33,98,121,219,39,35,53,107,120,258,0.4651162790697674,0,4,0.0,120,254,0.4724409448818897,0.465,59,120,0.4916666666666666
Greg Anderson,andergr01,PF,30,ATL,1995,51,622.0,148,17,62,126,188,23,32,32,103,57,104,0.5480769230769231,0,0,0.0,57,104,0.5480769230769231,0.548,34,71,0.4788732394366197
Kenny Anderson,anderke01,PG,24,NJN,1995,72,2689.0,1267,680,73,177,250,103,14,225,184,411,1031,0.3986420950533462,97,294,0.3299319727891156,314,737,0.4260515603799186,0.446,348,414,0.8405797101449275
Nick Anderson,anderni01,SG,27,ORL,1995,76,2588.0,1200,314,85,250,335,125,22,141,124,439,923,0.475622968580715,179,431,0.4153132250580046,260,492,0.5284552845528455,0.573,143,203,0.7044334975369458
Willie Anderson,anderwi01,SG,28,SAS,1995,38,556.0,185,52,15,40,55,26,10,38,71,76,162,0.4691358024691358,3,19,0.1578947368421052,73,143,0.5104895104895105,0.478,30,41,0.7317073170731707
Greg Anthony,anthogr01,PG,27,NYK,1995,61,943.0,372,160,7,57,64,50,7,57,99,128,293,0.4368600682593856,56,155,0.3612903225806451,72,138,0.5217391304347826,0.532,60,76,0.7894736842105263
B.J. Armstrong,armstbj01,PG,27,CHI,1995,82,2577.0,1150,244,25,161,186,84,8,103,159,418,894,0.4675615212527964,108,253,0.4268774703557312,310,641,0.4836193447737909,0.528,206,233,0.8841201716738197
Darrell Armstrong,armstda01,PG,26,ORL,1995,3,8.0,10,3,1,0,1,1,0,1,3,3,8,0.375,2,6,0.3333333333333333,1,2,0.5,0.5,2,2,1.0
Vincent Askew,askewvi01,SG,28,SEA,1995,71,1721.0,703,176,65,116,181,49,13,85,191,248,504,0.492063492063492,31,94,0.3297872340425531,217,410,0.5292682926829269,0.523,176,238,0.7394957983193278
Keith Askins,askinke01,SF,27,MIA,1995,50,854.0,229,39,86,112,198,35,17,25,109,81,207,0.391304347826087,21,78,0.2692307692307692,60,129,0.4651162790697674,0.442,46,57,0.8070175438596491
Stacey Augmon,augmost01,SG,26,ATL,1995,76,2362.0,1053,197,157,211,368,100,47,152,163,397,876,0.4531963470319635,7,26,0.2692307692307692,390,850,0.4588235294117647,0.457,252,346,0.7283236994219653
Anthony Avent,aventan01,PF,25,ORL,1995,71,1066.0,258,41,97,196,293,28,50,53,170,105,244,0.430327868852459,0,0,0.0,105,244,0.430327868852459,0.43,48,75,0.64
Vin Baker,bakervi01,PF,23,MIL,1995,82,3361.0,1451,296,289,557,846,86,116,221,277,594,1229,0.4833197721724979,7,24,0.2916666666666667,587,1205,0.4871369294605809,0.486,256,432,0.5925925925925926
Charles Barkley,barklch01,PF,31,PHO,1995,68,2382.0,1561,276,203,553,756,110,45,150,201,554,1141,0.4855390008764242,74,219,0.3378995433789954,480,922,0.5206073752711496,0.518,379,507,0.747534516765286
Dana Barros,barroda01,PG,27,PHI,1995,82,3318.0,1686,619,27,247,274,149,4,242,159,571,1165,0.4901287553648069,197,425,0.4635294117647058,374,740,0.5054054054054054,0.575,347,386,0.8989637305699482
Jon Barry,barryjo01,SG,25,MIL,1995,52,602.0,191,85,15,34,49,30,4,41,54,57,134,0.4253731343283582,16,48,0.3333333333333333,41,86,0.4767441860465116,0.485,61,80,0.7625
John Battle,battljo01,SG,32,CLE,1995,28,280.0,116,37,3,8,11,8,1,17,28,43,114,0.3771929824561403,11,31,0.3548387096774194,32,83,0.3855421686746988,0.425,19,26,0.7307692307692307
Sergei Bazarevich,bazarse01,PG,29,ATL,1995,10,74.0,30,14,1,6,7,1,1,7,10,11,22,0.5,1,6,0.1666666666666666,10,16,0.625,0.523,7,9,0.7777777777777778
Benoit Benjamin,benjabe01,C,30,NJN,1995,61,1598.0,675,38,94,346,440,23,64,125,151,271,531,0.5103578154425612,0,0,0.0,271,531,0.5103578154425612,0.51,133,175,0.76
Elmer Bennett,benneel01,PG,24,CLE,1995,4,18.0,15,3,0,1,1,4,0,3,3,6,11,0.5454545454545454,0,2,0.0,6,9,0.6666666666666666,0.545,3,4,0.75
Tony Bennett,benneto01,PG,25,CHH,1995,3,46.0,14,4,0,2,2,0,0,3,6,6,13,0.4615384615384615,2,9,0.2222222222222222,4,4,1.0,0.538,0,0,0.0
David Benoit,benoida01,SF,26,UTA,1995,71,1841.0,740,58,96,272,368,45,47,75,183,285,587,0.4855195911413969,38,115,0.3304347826086956,247,472,0.5233050847457628,0.518,132,157,0.8407643312101911
James Blackwell,blackja01,PG,26,TOT,1995,13,80.0,18,11,2,9,11,4,0,5,8,8,13,0.6153846153846154,0,0,0.0,8,13,0.6153846153846154,0.615,2,3,0.6666666666666666
Mookie Blaylock,blaylmo01,PG,27,ATL,1995,80,3069.0,1373,616,117,276,393,200,26,242,164,509,1198,0.4248747913188648,199,555,0.3585585585585585,310,643,0.4821150855365474,0.508,156,214,0.7289719626168224
Corie Blount,blounco01,PF,26,CHI,1995,68,889.0,238,60,107,133,240,26,33,59,146,100,210,0.4761904761904761,0,2,0.0,100,208,0.4807692307692308,0.476,38,67,0.5671641791044776
Muggsy Bogues,boguemu01,PG,30,CHH,1995,78,2629.0,862,675,51,206,257,103,0,132,151,348,730,0.4767123287671233,6,30,0.2,342,700,0.4885714285714285,0.481,160,180,0.8888888888888888
Manute Bol,bolma01,C,32,GSW,1995,5,81.0,15,0,1,11,12,0,9,1,10,6,10,0.6,3,5,0.6,3,5,0.6,0.75,0,0,0.0
Walter Bond,bondwa01,SG,25,TOT,1995,23,290.0,107,24,8,24,32,6,4,17,47,39,84,0.4642857142857143,15,41,0.3658536585365853,24,43,0.5581395348837209,0.554,14,20,0.7
Anthony Bonner,bonnean01,PF,26,NYK,1995,58,1126.0,221,80,113,149,262,48,23,79,159,88,193,0.4559585492227979,1,5,0.2,87,188,0.4627659574468085,0.459,44,67,0.6567164179104478
Anthony Bowie,bowiean01,SG,31,ORL,1995,77,1261.0,427,159,54,85,139,47,21,86,138,177,369,0.4796747967479675,12,40,0.3,165,329,0.5015197568389058,0.496,61,73,0.8356164383561644
Sam Bowie,bowiesa01,C,33,LAL,1995,67,1225.0,306,118,72,216,288,21,80,91,182,118,267,0.4419475655430712,2,11,0.1818181818181818,116,256,0.453125,0.446,68,89,0.7640449438202247
Shawn Bradley,bradlsh01,C,22,PHI,1995,82,2365.0,778,53,243,416,659,54,274,142,338,315,693,0.4545454545454545,0,3,0.0,315,690,0.4565217391304347,0.455,148,232,0.6379310344827587
Terrell Brandon,brandte01,PG,24,CLE,1995,67,1961.0,889,363,35,151,186,107,14,144,118,341,762,0.44750656167979,48,121,0.396694214876033,293,641,0.4570982839313572,0.479,159,186,0.8548387096774194
Tim Breaux,breauti01,SF,24,HOU,1995,42,340.0,128,15,16,18,34,11,4,16,25,45,121,0.371900826446281,6,25,0.24,39,96,0.40625,0.397,32,49,0.6530612244897959
Scott Brooks,brooksc01,PG,29,TOT,1995,59,808.0,341,116,14,52,66,34,4,47,56,126,275,0.4581818181818182,25,69,0.3623188405797101,101,206,0.4902912621359223,0.504,64,79,0.810126582278481
Chucky Brown,brownch01,SF,26,HOU,1995,41,814.0,249,30,64,125,189,11,14,29,105,105,174,0.603448275862069,1,3,0.3333333333333333,104,171,0.6081871345029239,0.606,38,62,0.6129032258064516
Dee Brown,brownde01,SG,26,BOS,1995,79,2792.0,1236,301,63,186,249,110,49,146,181,437,977,0.4472876151484135,126,327,0.3853211009174312,311,650,0.4784615384615384,0.512,236,277,0.851985559566787
Mike Brown,brownmi01,C,31,MIN,1995,27,213.0,35,10,9,36,45,7,0,16,35,10,40,0.25,0,1,0.0,10,39,0.2564102564102564,0.25,15,27,0.5555555555555556
P.J. Brown,brownpj01,C,25,NJN,1995,80,2466.0,651,135,178,309,487,69,135,80,262,254,570,0.4456140350877193,4,24,0.1666666666666666,250,546,0.4578754578754578,0.449,139,207,0.6714975845410628
Randy Brown,brownra02,PG,26,SAC,1995,67,1086.0,317,133,24,84,108,99,19,78,153,124,287,0.4320557491289198,14,47,0.2978723404255319,110,240,0.4583333333333333,0.456,55,82,0.6707317073170732
Mark Bryant,bryanma01,PF,29,POR,1995,49,658.0,244,28,55,106,161,19,16,39,109,101,192,0.5260416666666666,1,2,0.5,100,190,0.5263157894736842,0.529,41,63,0.6507936507936508
Jud Buechler,buechju01,SF,26,CHI,1995,57,605.0,217,50,36,62,98,24,12,30,64,90,183,0.4918032786885246,15,48,0.3125,75,135,0.5555555555555556,0.533,22,39,0.5641025641025641
Scott Burrell,burresc01,SF,24,CHH,1995,65,2014.0,750,161,96,272,368,75,40,85,187,277,593,0.4671163575042159,96,235,0.4085106382978723,181,358,0.505586592178771,0.548,100,144,0.6944444444444444
Willie Burton,burtowi01,SF,26,PHI,1995,53,1564.0,812,96,49,115,164,32,19,122,167,243,606,0.400990099009901,106,275,0.3854545454545454,137,331,0.4138972809667673,0.488,220,267,0.8239700374531835
Mitchell Butler,butlemi02,SG,24,WSB,1995,76,1554.0,597,91,43,127,170,61,10,106,155,214,508,0.421259842519685,46,141,0.3262411347517731,168,367,0.4577656675749318,0.467,123,185,0.6648648648648648
Michael Cage,cagemi01,C,33,CLE,1995,82,2040.0,407,56,203,361,564,61,67,56,149,177,340,0.5205882352941177,0,2,0.0,177,338,0.5236686390532544,0.521,53,88,0.6022727272727273
Adrian Caldwell,caldwad01,PF,28,HOU,1995,7,30.0,5,0,1,9,10,1,0,1,6,1,4,0.25,0,0,0.0,1,4,0.25,0.25,3,6,0.5
Elden Campbell,campbel01,PF,26,LAL,1995,73,2076.0,913,92,168,277,445,69,132,98,246,360,785,0.4585987261146497,0,1,0.0,360,784,0.4591836734693877,0.459,193,290,0.6655172413793103
Tony Campbell,campbto01,SF,32,CLE,1995,78,1128.0,469,69,60,93,153,32,8,65,122,161,392,0.4107142857142857,15,42,0.3571428571428571,146,350,0.4171428571428571,0.43,132,159,0.8301886792452831
Antoine Carr,carran01,C,33,UTA,1995,78,1677.0,746,67,81,184,265,24,68,87,253,290,546,0.5311355311355311,1,4,0.25,289,542,0.533210332103321,0.532,165,201,0.8208955223880597
Bill Cartwright,cartwbi01,C,37,SEA,1995,29,430.0,69,10,25,62,87,6,3,18,70,27,69,0.391304347826087,0,0,0.0,27,69,0.391304347826087,0.391,15,24,0.625
Sam Cassell,cassesa01,PG,25,HOU,1995,82,1882.0,783,405,38,173,211,94,14,167,209,253,593,0.4266441821247892,63,191,0.3298429319371728,190,402,0.472636815920398,0.48,214,254,0.84251968503937
Duane Causwell,causwdu01,C,26,SAC,1995,58,820.0,209,15,57,117,174,14,80,33,146,76,147,0.5170068027210885,0,1,0.0,76,146,0.5205479452054794,0.517,57,98,0.5816326530612245
Cedric Ceballos,cebalce01,SF,25,LAL,1995,58,2029.0,1261,105,169,295,464,60,19,143,131,497,977,0.5087001023541453,58,146,0.3972602739726027,439,831,0.5282791817087846,0.538,209,292,0.7157534246575342
Tom Chambers,chambto01,PF,35,UTA,1995,81,1240.0,503,73,66,147,213,25,30,52,173,195,427,0.4566744730679157,4,24,0.1666666666666666,191,403,0.4739454094292804,0.461,109,135,0.8074074074074075
Rex Chapman,chapmre01,SG,27,WSB,1995,45,1468.0,731,128,23,90,113,67,15,62,85,254,639,0.3974960876369327,86,274,0.3138686131386861,168,365,0.4602739726027397,0.465,137,159,0.8616352201257862
Calbert Cheaney,cheanca01,SG,23,WSB,1995,78,2651.0,1293,177,105,216,321,80,21,151,215,512,1129,0.4534986713906112,96,283,0.3392226148409894,416,846,0.491725768321513,0.496,173,213,0.812206572769953
Pete Chilcutt,chilcpe01,PF,26,HOU,1995,68,1347.0,358,66,106,211,317,25,43,61,117,146,328,0.4451219512195122,35,86,0.4069767441860465,111,242,0.4586776859504132,0.498,31,42,0.7380952380952381
Chris Childs,childch01,PG,27,NJN,1995,53,1021.0,308,219,14,55,69,42,3,76,116,106,279,0.3799283154121863,41,125,0.328,65,154,0.422077922077922,0.453,55,73,0.7534246575342466
Doug Christie,chrisdo01,SG,24,NYK,1995,12,79.0,15,8,3,10,13,2,1,13,18,5,22,0.2272727272727272,1,7,0.1428571428571428,4,15,0.2666666666666666,0.25,4,5,0.8
Derrick Coleman,colemde01,PF,27,NJN,1995,56,2103.0,1146,187,167,424,591,35,94,172,162,371,875,0.424,28,120,0.2333333333333333,343,755,0.4543046357615894,0.44,376,490,0.7673469387755102
Bimbo Coles,colesbi01,PG,26,MIA,1995,68,2207.0,679,416,46,145,191,99,13,156,185,261,607,0.4299835255354201,16,76,0.2105263157894736,245,531,0.4613935969868173,0.443,141,174,0.8103448275862069
Steve Colter,coltest01,PG,32,CLE,1995,57,752.0,196,101,13,46,59,30,6,36,53,67,169,0.3964497041420118,8,35,0.2285714285714285,59,134,0.4402985074626865,0.42,54,71,0.7605633802816901
Marty Conlon,conloma01,C,27,MIL,1995,82,2064.0,815,110,160,266,426,42,18,123,218,344,647,0.5316846986089645,8,29,0.2758620689655172,336,618,0.5436893203883495,0.538,119,194,0.6134020618556701
Lester Conner,connele01,SG,35,LAL,1995,2,5.0,2,0,0,0,0,1,0,0,3,0,0,0.0,0,0,0.0,0,0,0.0,0.0,2,2,1.0
Tyrone Corbin,corbity01,SF,32,ATL,1995,81,1389.0,502,67,98,164,262,55,16,74,161,205,464,0.4418103448275862,14,56,0.25,191,408,0.4681372549019608,0.457,78,114,0.6842105263157895
John Crotty,crottjo01,PG,25,UTA,1995,80,1019.0,295,205,27,70,97,39,6,70,105,93,231,0.4025974025974026,11,36,0.3055555555555556,82,195,0.4205128205128205,0.426,98,121,0.8099173553719008
Corey Crowder,crowdco01,SF,25,SAS,1995,7,29.0,6,1,1,2,3,1,0,2,1,2,10,0.2,0,4,0.0,2,6,0.3333333333333333,0.2,2,6,0.3333333333333333
Terry Cummings,cummite01,PF,33,SAS,1995,76,1273.0,520,59,138,240,378,36,19,95,188,224,464,0.4827586206896552,0,0,0.0,224,464,0.4827586206896552,0.483,72,123,0.5853658536585366
Bill Curley,curlebi01,PF,22,DET,1995,53,595.0,143,25,54,70,124,21,21,25,128,58,134,0.4328358208955223,0,0,0.0,58,134,0.4328358208955223,0.433,27,36,0.75
Dell Curry,curryde01,SG,30,CHH,1995,69,1718.0,935,113,41,127,168,55,18,98,144,343,778,0.4408740359897172,154,361,0.4265927977839335,189,417,0.4532374100719424,0.54,95,111,0.8558558558558559
Lloyd Daniels,daniell01,SG,27,TOT,1995,30,604.0,208,40,29,34,63,22,10,31,48,80,209,0.3827751196172249,26,100,0.26,54,109,0.4954128440366973,0.445,22,27,0.8148148148148148
Yinka Dare,dareyi01,C,22,NJN,1995,1,3.0,0,0,0,1,1,0,0,1,2,0,1,0.0,0,0,0.0,0,1,0.0,0.0,0,0,0.0
Antonio Davis,davisan01,PF,26,IND,1995,44,1030.0,335,25,105,175,280,19,29,64,134,109,245,0.4448979591836735,0,0,0.0,109,245,0.4448979591836735,0.445,117,174,0.6724137931034483
Dale Davis,davisda01,PF,25,IND,1995,74,2346.0,786,58,259,437,696,72,116,124,222,324,576,0.5625,0,1,0.0,324,575,0.5634782608695652,0.563,138,259,0.5328185328185329
Hubert Davis,davishu01,SG,24,NYK,1995,82,1697.0,820,150,30,80,110,35,11,87,146,296,617,0.479740680713128,131,288,0.4548611111111111,165,329,0.5015197568389058,0.586,97,120,0.8083333333333333
Terry Davis,daviste01,PF,27,DAL,1995,46,580.0,140,10,63,93,156,6,3,30,76,49,113,0.4336283185840708,0,2,0.0,49,111,0.4414414414414414,0.434,42,66,0.6363636363636364
Johnny Dawkins,dawkijo01,PG,31,DET,1995,50,1170.0,325,205,28,85,113,52,1,86,74,125,270,0.4629629629629629,25,73,0.3424657534246575,100,197,0.5076142131979695,0.509,50,55,0.9090909090909092
Tony Dawson,dawsoto01,SF,27,BOS,1995,2,13.0,8,1,0,3,3,0,0,2,4,3,8,0.375,1,3,0.3333333333333333,2,5,0.4,0.438,1,1,1.0
Todd Day,dayto01,SG,25,MIL,1995,82,2717.0,1310,134,95,227,322,104,63,157,283,445,1049,0.4242135367016206,163,418,0.3899521531100478,282,631,0.4469096671949287,0.502,257,341,0.7536656891495601
Terry Dehere,deherte01,PG,23,LAC,1995,80,1774.0,835,225,35,117,152,45,7,157,200,279,685,0.4072992700729927,48,163,0.294478527607362,231,522,0.4425287356321839,0.442,229,292,0.7842465753424658
Vinny Del Negro,delnevi01,SG,28,SAS,1995,75,2360.0,938,226,28,164,192,61,14,56,179,372,766,0.4856396866840731,66,162,0.4074074074074074,306,604,0.5066225165562914,0.529,128,162,0.7901234567901234
Bison Dele,delebi01,C,25,DEN,1995,63,1261.0,498,53,98,200,298,38,43,114,210,196,333,0.5885885885885885,0,0,0.0,196,333,0.5885885885885885,0.589,106,162,0.654320987654321
Vlade Divac,divacvl01,C,26,LAL,1995,80,2807.0,1277,329,261,568,829,109,174,205,305,485,957,0.5067920585161965,10,53,0.1886792452830188,475,904,0.5254424778761062,0.512,297,382,0.7774869109947644
James Donaldson,donalja01,C,37,UTA,1995,43,613.0,110,14,19,88,107,6,28,22,66,44,74,0.5945945945945946,0,0,0.0,44,74,0.5945945945945946,0.595,22,31,0.7096774193548387
Sherman Douglas,douglsh01,PG,28,BOS,1995,65,2048.0,954,446,48,122,170,80,2,162,152,365,769,0.4746423927178153,20,82,0.2439024390243902,345,687,0.5021834061135371,0.488,204,296,0.6891891891891891
Greg Dreiling,dreilgr01,C,32,CLE,1995,58,483.0,110,22,32,84,116,6,22,25,108,42,102,0.4117647058823529,0,0,0.0,42,102,0.4117647058823529,0.412,26,41,0.6341463414634146
Clyde Drexler,drexlcl01,SG,32,TOT,1995,76,2728.0,1653,362,152,328,480,136,45,186,206,571,1238,0.4612277867528271,147,408,0.3602941176470588,424,830,0.5108433734939759,0.521,364,442,0.8235294117647058
Kevin Duckworth,duckwke01,C,30,WSB,1995,40,818.0,283,20,65,130,195,21,24,59,110,118,267,0.4419475655430712,2,10,0.2,116,257,0.4513618677042801,0.446,45,70,0.6428571428571429
Chris Dudley,dudlech02,C,29,POR,1995,82,2245.0,447,34,325,439,764,43,126,81,286,181,446,0.405829596412556,0,1,0.0,181,445,0.4067415730337079,0.406,85,183,0.4644808743169399
Joe Dumars,dumarjo01,SG,31,DET,1995,67,2544.0,1214,368,47,111,158,72,7,219,153,417,970,0.4298969072164949,103,338,0.3047337278106509,314,632,0.4968354430379746,0.483,277,344,0.8052325581395349
Richard Dumas,dumasri02,SF,25,PHO,1995,15,167.0,82,7,18,11,29,10,2,9,22,37,73,0.5068493150684932,0,1,0.0,37,72,0.5138888888888888,0.507,8,16,0.5
Tony Dumas,dumasto01,SG,22,DAL,1995,58,613.0,264,57,32,30,62,13,4,50,78,96,250,0.384,22,73,0.3013698630136986,74,177,0.4180790960451977,0.428,50,77,0.6493506493506493
Pat Durham,durhapa01,SF,27,MIN,1995,59,852.0,302,53,37,57,94,36,32,45,114,117,237,0.4936708860759494,5,26,0.1923076923076923,112,211,0.5308056872037915,0.504,63,96,0.65625
Ledell Eackles,eacklle01,SG,28,MIA,1995,54,898.0,395,72,33,62,95,19,2,53,88,143,326,0.4386503067484663,18,41,0.4390243902439024,125,285,0.4385964912280701,0.466,91,126,0.7222222222222222
Acie Earl,earlac01,C,24,BOS,1995,30,208.0,66,2,19,26,45,6,8,14,39,26,68,0.3823529411764705,0,0,0.0,26,68,0.3823529411764705,0.382,14,29,0.4827586206896552
Blue Edwards,edwarbl01,SF,29,TOT,1995,67,1112.0,459,77,50,80,130,43,16,81,143,181,393,0.460559796437659,22,75,0.2933333333333333,159,318,0.5,0.489,75,90,0.8333333333333334
Doug Edwards,edwardo01,PF,24,ATL,1995,38,212.0,67,13,19,29,48,5,4,22,30,22,48,0.4583333333333333,0,1,0.0,22,47,0.4680851063829787,0.458,23,32,0.71875
James Edwards,edwarja01,C,39,POR,1995,28,266.0,75,8,10,33,43,5,8,14,44,32,83,0.3855421686746988,0,0,0.0,32,83,0.3855421686746988,0.386,11,17,0.6470588235294118
Kevin Edwards,edwarke01,SG,29,NJN,1995,14,466.0,196,27,10,27,37,19,5,35,42,69,154,0.448051948051948,18,45,0.4,51,109,0.4678899082568807,0.506,40,42,0.9523809523809524
Craig Ehlo,ehlocr01,SG,33,ATL,1995,49,1166.0,477,113,55,92,147,46,6,73,86,191,422,0.45260663507109,51,134,0.3805970149253731,140,288,0.4861111111111111,0.513,44,71,0.6197183098591549
Howard Eisley,eisleho01,PG,22,TOT,1995,49,552.0,120,95,12,36,48,18,6,50,81,40,122,0.3278688524590163,9,37,0.2432432432432432,31,85,0.3647058823529411,0.365,31,40,0.775
Mario Elie,eliema01,SF,31,HOU,1995,81,1896.0,710,189,50,146,196,65,12,104,158,243,487,0.4989733059548255,80,201,0.3980099502487562,163,286,0.5699300699300699,0.581,144,171,0.8421052631578947
Sean Elliott,elliose01,SF,26,SAS,1995,81,2858.0,1466,206,63,224,287,78,38,151,216,502,1072,0.4682835820895522,136,333,0.4084084084084084,366,739,0.4952638700947226,0.532,326,404,0.806930693069307
Dale Ellis,ellisda01,SF,34,DEN,1995,81,1996.0,918,57,56,166,222,37,9,81,142,351,774,0.4534883720930232,106,263,0.403041825095057,245,511,0.4794520547945205,0.522,110,127,0.8661417322834646
Harold Ellis,ellisha01,SF,24,LAC,1995,69,656.0,252,40,56,32,88,67,12,49,102,91,189,0.4814814814814814,1,13,0.0769230769230769,90,176,0.5113636363636364,0.484,69,117,0.5897435897435898
LaPhonso Ellis,ellisla01,PF,24,DEN,1995,6,58.0,24,4,7,10,17,1,5,5,12,9,25,0.36,0,0,0.0,9,25,0.36,0.36,6,6,1.0
Pervis Ellison,ellispe01,C,27,BOS,1995,55,1083.0,375,34,124,185,309,22,54,76,179,152,300,0.5066666666666667,0,2,0.0,152,298,0.5100671140939598,0.507,71,99,0.7171717171717171
Jo Jo English,englijo01,SG,24,CHI,1995,8,127.0,43,7,1,2,3,7,1,6,19,15,39,0.3846153846153846,3,12,0.25,12,27,0.4444444444444444,0.423,10,13,0.7692307692307693
Patrick Ewing,ewingpa01,C,32,NYK,1995,79,2920.0,1886,212,157,710,867,68,159,256,272,730,1452,0.5027548209366391,6,21,0.2857142857142857,724,1431,0.5059399021663172,0.505,420,560,0.75
Duane Ferrell,ferredu01,SF,29,IND,1995,56,607.0,231,31,50,38,88,26,6,43,79,83,173,0.4797687861271676,1,6,0.1666666666666666,82,167,0.4910179640718562,0.483,64,85,0.7529411764705882
Danny Ferry,ferryda01,PF,28,CLE,1995,82,1290.0,614,96,30,113,143,27,22,59,131,223,500,0.446,94,233,0.4034334763948498,129,267,0.4831460674157303,0.54,74,84,0.8809523809523809
Matt Fish,fishma01,C,25,LAC,1995,26,370.0,123,17,32,52,84,16,7,28,70,49,103,0.4757281553398058,0,1,0.0,49,102,0.4803921568627451,0.476,25,37,0.6756756756756757
Vern Fleming,flemive01,PG,32,IND,1995,55,686.0,251,109,20,68,88,27,1,43,80,93,188,0.4946808510638298,0,7,0.0,93,181,0.5138121546961326,0.495,65,90,0.7222222222222222
Sleepy Floyd,floydsl01,SG,34,NJN,1995,48,831.0,197,126,8,46,54,13,6,51,73,71,212,0.3349056603773584,25,88,0.2840909090909091,46,124,0.3709677419354839,0.394,30,43,0.6976744186046512
Alphonso Ford,fordal01,SG,23,PHI,1995,5,98.0,19,9,8,12,20,1,0,8,5,9,39,0.2307692307692307,0,9,0.0,9,30,0.3,0.231,1,2,0.5
Greg Foster,fostegr01,PF,26,TOT,1995,78,1144.0,385,39,85,174,259,15,28,71,183,150,318,0.4716981132075472,7,23,0.3043478260869565,143,295,0.4847457627118644,0.483,78,111,0.7027027027027027
Rick Fox,foxri01,SF,25,BOS,1995,53,1039.0,464,139,61,94,155,52,19,78,154,169,351,0.4814814814814814,31,75,0.4133333333333333,138,276,0.5,0.526,95,123,0.7723577235772358
Corey Gaines,gaineco01,SG,29,PHI,1995,11,280.0,55,33,1,17,18,8,1,14,23,24,51,0.4705882352941176,2,15,0.1333333333333333,22,36,0.6111111111111112,0.49,5,11,0.4545454545454545
Kevin Gamble,gamblke01,SF,29,MIA,1995,77,1223.0,566,119,29,93,122,52,10,49,130,220,450,0.4888888888888889,39,98,0.3979591836734694,181,352,0.5142045454545454,0.532,87,111,0.7837837837837838
Winston Garland,garlawi01,PG,30,MIN,1995,73,1931.0,448,318,48,120,168,71,13,105,184,170,410,0.4146341463414634,19,75,0.2533333333333333,151,335,0.4507462686567164,0.438,89,112,0.7946428571428571
Chris Gatling,gatlich01,PF,27,GSW,1995,58,1470.0,796,51,144,299,443,39,52,117,184,324,512,0.6328125,0,1,0.0,324,511,0.6340508806262231,0.633,148,250,0.592
Kenny Gattison,gattike01,PF,30,CHH,1995,21,409.0,125,17,21,54,75,7,15,22,64,47,100,0.47,0,1,0.0,47,99,0.4747474747474747,0.47,31,51,0.6078431372549019
Matt Geiger,geigema01,C,25,MIA,1995,74,1712.0,617,55,146,267,413,41,51,113,245,260,485,0.5360824742268041,4,10,0.4,256,475,0.5389473684210526,0.54,93,143,0.6503496503496503
Tate George,georgta01,SG,26,MIL,1995,3,8.0,4,0,1,0,1,0,0,2,1,1,3,0.3333333333333333,0,1,0.0,1,2,0.5,0.333,2,2,1.0
Kendall Gill,gillke01,SG,26,SEA,1995,73,2125.0,1002,192,99,191,290,117,28,138,186,392,858,0.4568764568764569,63,171,0.3684210526315789,329,687,0.4788937409024745,0.494,155,209,0.7416267942583732
Armen Gilliam,gilliar01,PF,30,NJN,1995,82,2472.0,1212,99,192,421,613,67,89,152,171,455,905,0.5027624309392266,0,2,0.0,455,903,0.5038759689922481,0.503,302,392,0.7704081632653061
Greg Graham,grahagr01,SG,24,PHI,1995,50,775.0,251,66,19,43,62,29,6,48,76,95,223,0.4260089686098655,6,28,0.2142857142857142,89,195,0.4564102564102564,0.439,55,73,0.7534246575342466
Ron Grandison,grandro01,PF,30,NYK,1995,2,8.0,2,2,3,2,5,0,0,0,2,1,4,0.25,0,0,0.0,1,4,0.25,0.25,0,0,0.0
Brian Grant,grantbr01,PF,22,SAC,1995,80,2289.0,1058,99,207,391,598,49,116,163,276,413,809,0.5105067985166872,1,4,0.25,412,805,0.5118012422360249,0.511,231,363,0.6363636363636364
Gary Grant,grantga01,PG,29,LAC,1995,33,470.0,205,93,8,27,35,29,3,44,66,78,166,0.4698795180722891,4,16,0.25,74,150,0.4933333333333333,0.482,45,55,0.8181818181818182
Greg Grant,grantgr01,PG,28,DEN,1995,14,151.0,31,43,2,7,9,6,2,14,20,10,33,0.303030303030303,2,7,0.2857142857142857,8,26,0.3076923076923077,0.333,9,12,0.75
Harvey Grant,grantha01,PF,29,POR,1995,75,1771.0,683,82,103,181,284,56,53,62,163,286,621,0.4605475040257649,8,26,0.3076923076923077,278,595,0.4672268907563025,0.467,103,146,0.7054794520547946
Horace Grant,grantho01,PF,29,ORL,1995,74,2693.0,948,173,223,492,715,76,88,85,203,401,707,0.5671852899575672,0,8,0.0,401,699,0.5736766809728183,0.567,146,211,0.6919431279620853
Jeff Grayer,grayeje01,SG,29,PHI,1995,47,1098.0,389,74,58,91,149,27,4,56,80,163,381,0.4278215223097112,5,15,0.3333333333333333,158,366,0.4316939890710382,0.434,58,83,0.6987951807228916
A.C. Green,greenac01,SF,31,PHO,1995,82,2687.0,916,127,194,475,669,55,31,114,146,311,617,0.5040518638573744,43,127,0.3385826771653543,268,490,0.5469387755102041,0.539,251,343,0.7317784256559767
Tom Gugliotta,guglito01,SF-PF,25,TOT,1995,77,2568.0,976,279,165,407,572,132,62,189,203,371,837,0.4432497013142174,60,186,0.3225806451612903,311,651,0.477726574500768,0.479,174,252,0.6904761904761905
Andrés Guibert,guibean01,PF,26,MIN,1995,17,167.0,45,10,16,29,45,8,1,12,29,16,47,0.3404255319148936,0,4,0.0,16,43,0.3720930232558139,0.34,13,19,0.6842105263157895
Jack Haley,haleyja01,PF,31,SAS,1995,31,117.0,73,2,8,19,27,3,5,13,31,26,61,0.4262295081967213,0,1,0.0,26,60,0.4333333333333333,0.426,21,32,0.65625
Geert Hammink,hammige01,C,25,ORL,1995,1,7.0,4,1,0,2,2,0,0,0,1,1,3,0.3333333333333333,0,0,0.0,1,3,0.3333333333333333,0.333,2,2,1.0
Tom Hammonds,hammoto01,PF,27,DEN,1995,70,956.0,410,36,55,167,222,11,14,56,132,139,260,0.5346153846153846,0,1,0.0,139,259,0.5366795366795367,0.535,132,177,0.7457627118644068
Darrin Hancock,hancoda01,SF,23,CHH,1995,46,424.0,153,30,14,39,53,19,4,30,48,68,121,0.5619834710743802,1,3,0.3333333333333333,67,118,0.5677966101694916,0.566,16,39,0.4102564102564102
Anfernee Hardaway,hardaan01,PG,23,ORL,1995,77,2901.0,1613,551,139,197,336,130,26,258,158,585,1142,0.5122591943957968,87,249,0.3493975903614458,498,893,0.5576707726763718,0.55,356,463,0.7688984881209503
Tim Hardaway,hardati01,PG,28,GSW,1995,62,2321.0,1247,578,46,144,190,88,12,214,155,430,1007,0.4270109235352532,168,444,0.3783783783783784,262,563,0.4653641207815275,0.51,219,288,0.7604166666666666
Jerome Harmon,harmoje01,SG,25,PHI,1995,10,158.0,46,12,9,14,23,9,0,7,12,21,53,0.3962264150943396,1,1,1.0,20,52,0.3846153846153846,0.406,3,6,0.5
Derek Harper,harpede01,PG,33,NYK,1995,80,2716.0,919,458,31,163,194,79,10,151,219,337,756,0.4457671957671957,106,292,0.363013698630137,231,464,0.4978448275862069,0.516,139,192,0.7239583333333334
Ron Harper,harpero01,SG,31,CHI,1995,77,1536.0,530,157,51,129,180,97,27,100,132,209,491,0.4256619144602851,31,110,0.2818181818181818,178,381,0.4671916010498688,0.457,81,131,0.6183206106870229
Lucious Harris,harrilu01,SG,24,DAL,1995,79,1695.0,751,132,85,135,220,58,14,77,105,280,610,0.4590163934426229,55,142,0.3873239436619718,225,468,0.4807692307692308,0.504,136,170,0.8
Tony Harris,harrito01,SG,27,BOS,1995,3,18.0,14,0,0,0,0,0,0,1,2,3,8,0.375,0,1,0.0,3,7,0.4285714285714285,0.375,8,9,0.8888888888888888
Antonio Harvey,harvean01,PF,24,LAL,1995,59,572.0,179,23,39,63,102,15,41,25,87,77,176,0.4375,1,1,1.0,76,175,0.4342857142857143,0.44,24,45,0.5333333333333333
Hersey Hawkins,hawkihe01,SG,28,CHH,1995,82,2731.0,1172,262,60,254,314,122,18,150,178,390,809,0.4820766378244747,131,298,0.4395973154362416,259,511,0.5068493150684932,0.563,261,301,0.867109634551495
Steve Henson,hensost01,PG,26,POR,1995,37,380.0,119,85,3,23,26,9,0,30,52,37,86,0.4302325581395348,23,52,0.4423076923076923,14,34,0.4117647058823529,0.564,22,25,0.88
Carl Herrera,herreca01,PF,28,HOU,1995,61,1331.0,415,44,98,180,278,40,38,71,136,171,327,0.5229357798165137,0,2,0.0,171,325,0.5261538461538462,0.523,73,117,0.6239316239316239
Rod Higgins,higgiro01,SF,35,GSW,1995,5,46.0,10,3,4,3,7,1,1,1,7,3,12,0.25,1,6,0.1666666666666666,2,6,0.3333333333333333,0.292,3,4,0.75
Sean Higgins,higgise01,SF,26,NJN,1995,57,735.0,268,29,25,52,77,10,9,35,93,105,273,0.3846153846153846,23,78,0.2948717948717949,82,195,0.4205128205128205,0.427,35,40,0.875
Grant Hill,hillgr01,SF,22,DET,1995,70,2678.0,1394,353,125,320,445,124,62,202,203,508,1064,0.4774436090225564,4,27,0.1481481481481481,504,1037,0.4860173577627772,0.479,374,511,0.7318982387475538
Tyrone Hill,hillty01,C,26,CLE,1995,70,2397.0,963,55,269,496,765,55,41,151,245,350,694,0.5043227665706052,0,1,0.0,350,693,0.5050505050505051,0.504,263,397,0.6624685138539043
Donald Hodge,hodgedo01,C,25,DAL,1995,54,633.0,209,41,40,82,122,10,14,39,107,83,204,0.4068627450980392,4,14,0.2857142857142857,79,190,0.4157894736842105,0.417,39,51,0.7647058823529411
Jeff Hornacek,hornaje01,SG,31,UTA,1995,81,2696.0,1337,347,53,157,210,129,17,145,181,482,937,0.5144076840981857,89,219,0.4063926940639269,393,718,0.5473537604456824,0.562,284,322,0.8819875776397516
Robert Horry,horryro01,PF,24,HOU,1995,64,2074.0,652,216,81,243,324,94,76,122,161,240,537,0.4469273743016759,86,227,0.3788546255506608,154,310,0.4967741935483871,0.527,86,113,0.7610619469026548
Allan Houston,houstal01,SG,23,DET,1995,76,1996.0,1101,164,29,138,167,61,14,113,182,398,859,0.4633294528521536,158,373,0.4235924932975871,240,486,0.4938271604938271,0.555,147,171,0.8596491228070176
Byron Houston,houstby01,PF,25,SEA,1995,39,258.0,132,6,20,35,55,13,5,20,50,49,107,0.4579439252336448,6,22,0.2727272727272727,43,85,0.5058823529411764,0.486,28,38,0.7368421052631579
Tom Hovasse,hovasto01,SF,28,ATL,1995,2,4.0,0,0,0,0,0,1,0,0,1,0,1,0.0,0,1,0.0,0,0,0.0,0.0,0,0,0.0
Juwan Howard,howarju01,PF,21,WSB,1995,65,2348.0,1104,165,184,361,545,52,15,166,236,455,931,0.4887218045112781,0,7,0.0,455,924,0.4924242424242424,0.489,194,292,0.6643835616438356
Jay Humphries,humphja01,SG-PG,32,TOT,1995,18,201.0,20,19,4,9,13,9,0,17,35,8,34,0.2352941176470588,2,4,0.5,6,30,0.2,0.265,2,4,0.5
Lindsey Hunter,hunteli01,PG,24,DET,1995,42,944.0,314,159,24,51,75,51,7,79,94,119,318,0.3742138364779874,36,108,0.3333333333333333,83,210,0.3952380952380952,0.431,40,55,0.7272727272727273
Bobby Hurley,hurlebo01,PG,23,SAC,1995,68,1105.0,285,226,14,56,70,29,0,110,79,103,284,0.3626760563380282,21,76,0.2763157894736842,82,208,0.3942307692307692,0.4,58,76,0.7631578947368421
Jaren Jackson,jacksja01,SG,27,PHI,1995,21,257.0,70,19,18,24,42,9,5,17,33,25,68,0.3676470588235294,4,15,0.2666666666666666,21,53,0.3962264150943396,0.397,16,24,0.6666666666666666
Jim Jackson,jacksji01,SG,24,DAL,1995,51,1982.0,1309,191,120,140,260,28,12,160,92,484,1026,0.4717348927875243,35,110,0.3181818181818182,449,916,0.490174672489083,0.489,306,380,0.8052631578947368
Mark Jackson,jacksma01,PG,29,IND,1995,82,2402.0,624,616,73,233,306,105,16,210,148,239,566,0.4222614840989399,27,87,0.3103448275862069,212,479,0.4425887265135699,0.446,119,153,0.7777777777777778
Keith Jennings,jennike01,PG,26,GSW,1995,80,1722.0,589,373,26,122,148,95,2,120,133,190,425,0.4470588235294118,75,204,0.3676470588235294,115,221,0.5203619909502263,0.535,134,153,0.8758169934640523
Avery Johnson,johnsav01,PG,29,SAS,1995,82,3011.0,1101,670,49,159,208,114,13,207,154,448,863,0.5191193511008111,3,22,0.1363636363636363,445,841,0.5291319857312723,0.521,202,295,0.6847457627118644
Ervin Johnson,johnser02,C,27,SEA,1995,64,907.0,199,16,101,188,289,17,67,54,163,85,192,0.4427083333333333,0,1,0.0,85,191,0.4450261780104712,0.443,29,46,0.6304347826086957
Kevin Johnson,johnske02,PG,28,PHO,1995,47,1352.0,730,360,32,83,115,47,18,105,88,246,523,0.4703632887189292,4,26,0.1538461538461538,242,497,0.4869215291750503,0.474,234,289,0.8096885813148789
Larry Johnson,johnsla02,PF,25,CHH,1995,81,3234.0,1525,369,190,395,585,78,28,207,174,585,1219,0.4799015586546349,81,210,0.3857142857142857,504,1009,0.4995044598612487,0.513,274,354,0.7740112994350282
Askia Jones,jonesas01,SG,23,MIN,1995,11,139.0,45,16,6,5,11,6,0,9,19,15,44,0.3409090909090909,2,12,0.1666666666666666,13,32,0.40625,0.364,13,16,0.8125
Charles Jones,jonesch01,PF,37,HOU,1995,3,36.0,3,0,2,5,7,0,1,0,8,1,3,0.3333333333333333,0,0,0.0,1,3,0.3333333333333333,0.333,1,2,0.5
Eddie Jones,jonesed02,SG,23,LAL,1995,64,1981.0,897,128,79,170,249,131,41,75,175,342,744,0.4596774193548387,91,246,0.3699186991869919,251,498,0.5040160642570282,0.521,122,169,0.7218934911242604
Popeye Jones,jonespo01,PF,24,DAL,1995,80,2385.0,825,163,329,515,844,35,27,124,267,372,839,0.4433849821215733,1,12,0.0833333333333333,371,827,0.4486094316807739,0.444,80,124,0.6451612903225806
Michael Jordan,jordami01,SG,31,CHI,1995,17,668.0,457,90,25,92,117,30,13,35,47,166,404,0.4108910891089108,16,32,0.5,150,372,0.4032258064516129,0.431,109,136,0.8014705882352942
Adam Keefe,keefead01,SF,24,UTA,1995,75,1270.0,461,30,135,192,327,36,25,62,141,172,298,0.5771812080536913,0,0,0.0,172,298,0.5771812080536913,0.577,117,173,0.6763005780346821
Shawn Kemp,kempsh01,PF,25,SEA,1995,82,2679.0,1530,149,318,575,893,102,122,259,337,545,997,0.5466399197592778,2,7,0.2857142857142857,543,990,0.5484848484848485,0.548,438,585,0.7487179487179487
Steve Kerr,kerrst01,PG,29,CHI,1995,82,1839.0,674,151,20,99,119,44,3,48,114,261,495,0.5272727272727272,89,170,0.5235294117647059,172,325,0.5292307692307693,0.617,63,81,0.7777777777777778
Jerome Kersey,kerseje01,SF,32,POR,1995,63,1143.0,508,82,93,163,256,52,35,64,173,203,489,0.4151329243353783,7,27,0.2592592592592592,196,462,0.4242424242424242,0.422,95,124,0.7661290322580645
Randolph Keys,keysra01,SF,28,LAL,1995,6,83.0,20,2,6,11,17,1,2,2,16,9,26,0.3461538461538461,0,9,0.0,9,17,0.5294117647058824,0.346,2,2,1.0
Jason Kidd,kiddja01,PG,21,DAL,1995,79,2668.0,922,607,152,278,430,151,24,250,146,330,857,0.3850641773628938,70,257,0.2723735408560311,260,600,0.4333333333333333,0.426,192,275,0.6981818181818182
Rich King,kingri01,C,25,SEA,1995,2,6.0,0,0,0,0,0,0,0,0,1,0,2,0.0,0,0,0.0,0,2,0.0,0.0,0,2,0.0
Stacey King,kingst01,PF,28,MIN,1995,50,792.0,266,26,54,111,165,24,20,64,126,99,212,0.4669811320754717,0,1,0.0,99,211,0.4691943127962085,0.467,68,102,0.6666666666666666
Greg Kite,kitegr01,C,33,TOT,1995,11,77.0,8,1,12,10,22,0,0,6,15,3,17,0.1764705882352941,0,0,0.0,3,17,0.1764705882352941,0.176,2,10,0.2
Joe Kleine,kleinjo01,C,33,PHO,1995,75,968.0,280,39,82,177,259,14,18,35,174,119,265,0.4490566037735849,0,2,0.0,119,263,0.4524714828897338,0.449,42,49,0.8571428571428571
Negele Knight,knighne01,PG,27,TOT,1995,47,708.0,199,127,21,40,61,21,5,49,70,85,214,0.397196261682243,11,28,0.3928571428571428,74,186,0.3978494623655914,0.423,18,25,0.72
Jon Koncak,koncajo01,C,31,ATL,1995,62,943.0,179,52,23,161,184,36,46,20,137,77,187,0.4117647058823529,12,36,0.3333333333333333,65,151,0.4304635761589404,0.444,13,24,0.5416666666666666
Larry Krystkowiak,krystla01,PF,30,CHI,1995,19,287.0,83,26,19,40,59,9,2,25,34,28,72,0.3888888888888889,0,0,0.0,28,72,0.3888888888888889,0.389,27,30,0.9
Toni Kukoč,kukocto01,SF,26,CHI,1995,81,2584.0,1271,372,155,285,440,102,16,165,163,487,967,0.5036194415718718,62,198,0.3131313131313131,425,769,0.552665799739922,0.536,235,314,0.7484076433121019
Christian Laettner,laettch01,C,25,MIN,1995,81,2770.0,1322,234,164,449,613,101,87,225,302,450,920,0.4891304347826087,13,40,0.325,437,880,0.4965909090909091,0.496,409,500,0.818
Andrew Lang,langan01,C,28,ATL,1995,82,2340.0,794,72,154,302,456,45,144,108,271,320,677,0.4726735598227474,2,3,0.6666666666666666,318,674,0.4718100890207715,0.474,152,188,0.8085106382978723
Antonio Lang,langan02,SF,22,PHO,1995,12,53.0,11,1,3,1,4,0,2,5,11,4,10,0.4,0,0,0.0,4,10,0.4,0.4,3,4,0.75
Eric Leckner,leckner01,C,28,DET,1995,57,623.0,225,14,47,127,174,15,15,39,122,87,165,0.5272727272727272,0,2,0.0,87,163,0.5337423312883436,0.527,51,72,0.7083333333333334
Doug Lee,leedo01,SG,30,SAC,1995,22,75.0,43,5,0,5,5,6,3,5,18,9,25,0.36,7,18,0.3888888888888889,2,7,0.2857142857142857,0.5,18,21,0.8571428571428571
Tim Legler,legleti01,SG,28,GSW,1995,24,371.0,176,27,12,28,40,12,1,20,33,60,115,0.5217391304347826,26,50,0.52,34,65,0.5230769230769231,0.635,30,34,0.8823529411764706
Jim Les,lesji01,PG,31,ATL,1995,24,188.0,50,44,6,20,26,4,0,21,28,11,38,0.2894736842105263,5,23,0.217391304347826,6,15,0.4,0.355,23,27,0.8518518518518519
Cliff Levingston,levincl01,PF,34,DEN,1995,57,469.0,129,27,49,75,124,13,20,21,91,55,130,0.4230769230769231,0,1,0.0,55,129,0.4263565891472868,0.423,19,45,0.4222222222222222
Alton Lister,listeal01,C,36,MIL,1995,60,776.0,167,12,67,169,236,16,57,38,146,66,134,0.4925373134328358,0,1,0.0,66,133,0.4962406015037593,0.493,35,70,0.5
Brad Lohaus,lohaubr01,PF,30,MIA,1995,61,730.0,267,43,28,74,102,20,25,29,85,97,231,0.4199134199134199,63,155,0.4064516129032258,34,76,0.4473684210526316,0.556,10,15,0.6666666666666666
Grant Long,longgr01,PF,28,TOT,1995,81,2641.0,939,131,191,415,606,109,34,155,243,342,716,0.4776536312849162,11,31,0.3548387096774194,331,685,0.4832116788321168,0.485,244,325,0.7507692307692307
Luc Longley,longllu01,C,26,CHI,1995,55,1001.0,358,73,82,181,263,24,45,86,177,135,302,0.4470198675496689,0,2,0.0,135,300,0.45,0.447,88,107,0.822429906542056
Ryan Lorthridge,lorthry01,SG,22,GSW,1995,37,672.0,272,101,24,47,71,28,1,57,42,106,223,0.4753363228699551,3,14,0.2142857142857142,103,209,0.492822966507177,0.482,57,88,0.6477272727272727
George Lynch,lynchge01,SF,24,LAL,1995,56,953.0,341,62,75,109,184,51,10,73,86,138,295,0.4677966101694915,3,21,0.1428571428571428,135,274,0.4927007299270073,0.473,62,86,0.7209302325581395
Don MacLean,macledo01,PF,25,WSB,1995,39,1052.0,430,51,46,119,165,15,3,44,97,158,361,0.4376731301939058,10,40,0.25,148,321,0.4610591900311526,0.452,104,136,0.7647058823529411
Mark Macon,maconma01,SG,25,DET,1995,55,721.0,276,63,29,47,76,67,1,41,97,101,265,0.3811320754716981,20,62,0.3225806451612903,81,203,0.3990147783251231,0.419,54,68,0.7941176470588235
Gerald Madkins,madkige01,SG,25,CLE,1995,7,28.0,8,1,0,0,0,2,0,3,2,2,6,0.3333333333333333,1,2,0.5,1,4,0.25,0.417,3,4,0.75
Rick Mahorn,mahorri01,PF,36,NJN,1995,58,630.0,198,26,45,117,162,11,12,34,93,79,151,0.5231788079470199,1,3,0.3333333333333333,78,148,0.527027027027027,0.526,39,49,0.7959183673469388
Dan Majerle,majerda01,SF,29,PHO,1995,82,3091.0,1281,340,104,271,375,96,38,105,155,438,1031,0.4248302618816683,199,548,0.3631386861313868,239,483,0.494824016563147,0.521,206,282,0.7304964539007093
Jeff Malone,malonje01,SG,33,PHI,1995,19,660.0,350,29,11,44,55,15,0,29,35,144,284,0.5070422535211268,11,28,0.3928571428571428,133,256,0.51953125,0.526,51,59,0.864406779661017
Karl Malone,malonka01,PF,31,UTA,1995,82,3126.0,2187,285,156,715,871,129,85,236,269,830,1548,0.5361757105943152,11,41,0.2682926829268293,819,1507,0.5434638354346384,0.54,516,695,0.7424460431654676
Moses Malone,malonmo01,C,39,SAS,1995,17,149.0,49,6,20,26,46,2,3,11,15,13,35,0.3714285714285714,1,2,0.5,12,33,0.3636363636363636,0.386,22,32,0.6875
Danny Manning,mannida01,PF,28,PHO,1995,46,1510.0,822,154,97,179,276,41,57,121,176,340,622,0.5466237942122186,6,21,0.2857142857142857,334,601,0.5557404326123128,0.551,136,202,0.6732673267326733
Šarūnas Marčiulionis,marcisa01,SG,30,SEA,1995,66,1194.0,612,110,17,51,68,72,3,98,126,216,457,0.4726477024070022,35,87,0.4022988505747126,181,370,0.4891891891891892,0.511,145,198,0.7323232323232324
Donyell Marshall,marshdo01,SF,21,TOT,1995,72,2086.0,906,105,137,268,405,45,88,115,157,345,876,0.3938356164383562,69,243,0.2839506172839506,276,633,0.4360189573459715,0.433,147,222,0.6621621621621622
Bob Martin,martibo01,C,25,LAC,1995,1,14.0,2,1,2,0,2,0,1,0,2,1,5,0.2,0,0,0.0,1,5,0.2,0.2,0,0,0.0
Darrick Martin,martida01,PG,23,MIN,1995,34,803.0,254,133,14,50,64,34,0,62,88,95,233,0.407725321888412,7,38,0.1842105263157894,88,195,0.4512820512820513,0.423,57,65,0.8769230769230769
Jamal Mashburn,mashbja01,SF,22,DAL,1995,80,2980.0,1926,298,116,215,331,82,8,235,190,683,1566,0.4361430395913154,113,344,0.3284883720930232,570,1222,0.4664484451718494,0.472,447,605,0.7388429752066116
Anthony Mason,masonan01,PF,28,NYK,1995,77,2496.0,765,240,182,468,650,69,21,123,253,287,507,0.5660749506903353,0,1,0.0,287,506,0.567193675889328,0.566,191,298,0.6409395973154363
Tony Massenburg,masseto01,C,27,LAC,1995,80,2127.0,741,67,160,295,455,48,58,118,253,282,601,0.4692179700499168,0,3,0.0,282,598,0.471571906354515,0.469,177,235,0.7531914893617021
Vernon Maxwell,maxweve01,SG,29,HOU,1995,64,2038.0,854,274,18,146,164,75,13,137,157,306,777,0.3938223938223938,143,441,0.3242630385487528,163,336,0.4851190476190476,0.486,99,144,0.6875
Lee Mayberry,maybele01,PG,24,MIL,1995,82,1744.0,474,276,21,61,82,51,4,106,123,172,408,0.4215686274509804,72,177,0.4067796610169492,100,231,0.4329004329004329,0.51,58,83,0.6987951807228916
George McCloud,mccloge01,SF,27,DAL,1995,42,802.0,402,53,82,65,147,23,9,40,71,144,328,0.4390243902439024,34,89,0.3820224719101123,110,239,0.4602510460251046,0.491,80,96,0.8333333333333334
Xavier McDaniel,mcdanxa01,SF,31,BOS,1995,68,1430.0,587,108,94,206,300,30,20,89,146,246,546,0.4505494505494505,6,21,0.2857142857142857,240,525,0.4571428571428571,0.456,89,125,0.712
Jim McIlvaine,mcilvji01,C,22,WSB,1995,55,534.0,96,10,40,65,105,10,60,19,95,34,71,0.4788732394366197,0,0,0.0,34,71,0.4788732394366197,0.479,28,41,0.6829268292682927
Derrick McKey,mckeyde01,SF,28,IND,1995,81,2805.0,1075,276,125,269,394,125,49,168,260,411,833,0.4933973589435774,32,89,0.3595505617977528,379,744,0.5094086021505376,0.513,221,297,0.7441077441077442
Aaron McKie,mckieaa01,SG,22,POR,1995,45,827.0,293,89,35,94,129,36,16,39,97,116,261,0.4444444444444444,11,28,0.3928571428571428,105,233,0.4506437768240343,0.466,50,73,0.684931506849315
Nate McMillan,mcmilna01,PG,30,SEA,1995,80,2070.0,419,421,65,237,302,165,53,126,275,166,397,0.4181360201511335,53,155,0.3419354838709677,113,242,0.4669421487603306,0.485,34,58,0.5862068965517241
Darnell Mee,meeda01,SG,23,DEN,1995,2,8.0,3,2,0,1,1,1,0,0,0,1,5,0.2,1,3,0.3333333333333333,0,2,0.0,0.3,0,0,0.0
Anthony Miller,millean01,PF,23,LAL,1995,46,527.0,189,35,67,85,152,20,7,38,77,70,132,0.5303030303030303,2,5,0.4,68,127,0.5354330708661418,0.538,47,76,0.618421052631579
Oliver Miller,milleol01,PF,24,DET,1995,64,1558.0,545,93,162,313,475,60,116,115,217,232,418,0.5550239234449761,3,13,0.2307692307692307,229,405,0.5654320987654321,0.559,78,124,0.6290322580645161
Reggie Miller,millere01,SG,29,IND,1995,81,2665.0,1588,242,30,180,210,98,16,151,157,505,1092,0.4624542124542125,195,470,0.4148936170212766,310,622,0.4983922829581994,0.552,383,427,0.8969555035128806
Chris Mills,millsch01,SF,25,CLE,1995,80,2814.0,986,154,99,267,366,59,35,120,242,359,855,0.4198830409356725,94,240,0.3916666666666666,265,615,0.4308943089430894,0.475,174,213,0.8169014084507042
Terry Mills,millste01,PF,27,DET,1995,72,2514.0,1118,160,124,434,558,68,33,144,253,417,933,0.4469453376205787,109,285,0.3824561403508772,308,648,0.4753086419753086,0.505,175,219,0.7990867579908676
Harold Miner,minerha01,SG,23,MIA,1995,45,871.0,329,69,38,79,117,15,6,77,85,123,305,0.4032786885245901,14,49,0.2857142857142857,109,256,0.42578125,0.426,69,95,0.7263157894736842
Greg Minor,minorgr01,SG,23,BOS,1995,63,945.0,377,66,49,88,137,32,16,44,89,155,301,0.5149501661129569,2,12,0.1666666666666666,153,289,0.5294117647058824,0.518,65,78,0.8333333333333334
Sam Mitchell,mitchsa01,SF,31,IND,1995,81,1377.0,529,61,95,148,243,43,20,54,206,201,413,0.486682808716707,1,10,0.1,200,403,0.4962779156327543,0.488,126,174,0.7241379310344828
Eric Mobley,mobleer01,C,24,MIL,1995,46,587.0,180,21,55,98,153,8,27,24,63,78,132,0.5909090909090909,2,2,1.0,76,130,0.5846153846153846,0.598,22,45,0.4888888888888889
Eric Montross,montrer01,C,23,BOS,1995,78,2315.0,781,36,196,370,566,29,61,112,299,307,575,0.5339130434782609,0,1,0.0,307,574,0.5348432055749129,0.534,167,263,0.6349809885931559
Chris Morris,morrich01,SF,29,NJN,1995,71,2131.0,950,147,181,221,402,86,51,117,155,351,856,0.4100467289719626,106,317,0.334384858044164,245,539,0.4545454545454545,0.472,142,195,0.7282051282051282
Dwayne Morton,mortodw01,PG,23,GSW,1995,41,395.0,167,18,21,37,58,11,15,27,45,50,129,0.3875968992248062,9,25,0.36,41,104,0.3942307692307692,0.422,58,85,0.6823529411764706
Alonzo Mourning,mournal01,C,24,CHH,1995,77,2941.0,1643,111,200,561,761,49,225,241,275,571,1101,0.5186194368755677,11,34,0.3235294117647059,560,1067,0.5248359887535146,0.524,490,644,0.7608695652173914
Chris Mullin,mullich01,SF,31,GSW,1995,25,890.0,476,125,25,90,115,38,19,93,53,170,348,0.4885057471264368,42,93,0.4516129032258064,128,255,0.5019607843137255,0.549,94,107,0.8785046728971962
Eric Murdock,murdoer01,PG,26,MIL,1995,75,2158.0,977,482,48,166,214,113,12,194,139,338,814,0.4152334152334152,90,240,0.375,248,574,0.4320557491289198,0.471,211,267,0.7902621722846442
Gheorghe Mureșan,muresgh01,C,23,WSB,1995,73,1720.0,730,38,179,309,488,48,127,115,259,303,541,0.5600739371534196,0,0,0.0,303,541,0.5600739371534196,0.56,124,175,0.7085714285714285
Lamond Murray,murrala01,SF,21,LAC,1995,81,2556.0,1142,133,132,222,354,72,55,163,180,439,1093,0.4016468435498627,65,218,0.2981651376146789,374,875,0.4274285714285714,0.431,199,264,0.7537878787878788
Tracy Murray,murratr01,SF,23,TOT,1995,54,516.0,258,19,20,39,59,14,4,35,73,95,233,0.407725321888412,35,86,0.4069767441860465,60,147,0.4081632653061224,0.483,33,42,0.7857142857142857
Dikembe Mutombo,mutomdi01,C,28,DEN,1995,82,3100.0,946,113,319,710,1029,40,321,192,284,349,628,0.5557324840764332,0,0,0.0,349,628,0.5557324840764332,0.556,248,379,0.6543535620052771
Pete Myers,myerspe01,SG,31,CHI,1995,71,1270.0,318,148,57,82,139,58,15,88,125,119,287,0.4146341463414634,10,39,0.2564102564102564,109,248,0.439516129032258,0.432,70,114,0.6140350877192983
Ivano Newbill,newbiiv01,SF,24,DET,1995,34,331.0,40,17,40,41,81,12,11,12,60,16,45,0.3555555555555555,0,0,0.0,16,45,0.3555555555555555,0.356,8,22,0.3636363636363636
Johnny Newman,newmajo01,SF,31,MIL,1995,82,1896.0,634,91,72,101,173,69,13,86,234,226,488,0.4631147540983606,45,128,0.3515625,181,360,0.5027777777777778,0.509,137,171,0.8011695906432749
Ken Norman,normake01,SF,30,ATL,1995,74,1879.0,938,94,103,259,362,34,20,96,154,388,856,0.4532710280373832,98,285,0.343859649122807,290,571,0.5078809106830122,0.511,64,140,0.4571428571428571
Julius Nwosu,nwosuju01,C,23,SAS,1995,23,84.0,31,3,11,13,24,0,3,9,20,9,28,0.3214285714285714,0,0,0.0,9,28,0.3214285714285714,0.321,13,17,0.7647058823529411
Shaquille O'Neal,onealsh01,C,22,ORL,1995,79,2923.0,2315,214,328,573,901,73,192,204,258,930,1594,0.5834378920953576,0,5,0.0,930,1589,0.5852737570799245,0.583,455,854,0.5327868852459017
Charles Oakley,oaklech01,PF,31,NYK,1995,50,1567.0,506,126,155,290,445,60,7,103,179,192,393,0.4885496183206106,3,12,0.25,189,381,0.4960629921259842,0.492,119,150,0.7933333333333333
Hakeem Olajuwon,olajuha01,C,32,HOU,1995,72,2853.0,2005,255,172,603,775,133,242,237,250,798,1545,0.516504854368932,3,16,0.1875,795,1529,0.5199476782210595,0.517,406,537,0.7560521415270018
Brian Oliver,olivebr01,SG,26,WSB,1995,6,42.0,14,4,0,4,4,0,0,3,8,4,9,0.4444444444444444,0,0,0.0,4,9,0.4444444444444444,0.444,6,8,0.75
Bo Outlaw,outlabo01,PF,23,LAC,1995,81,1655.0,422,84,121,192,313,90,151,78,227,170,325,0.5230769230769231,0,5,0.0,170,320,0.53125,0.523,82,186,0.4408602150537634
Doug Overton,overtdo01,PG,25,WSB,1995,82,1704.0,576,246,26,117,143,53,2,104,126,207,498,0.4156626506024096,53,125,0.424,154,373,0.4128686327077748,0.469,109,125,0.872
Billy Owens,owensbi01,SG,25,MIA,1995,70,2296.0,1002,246,203,299,502,80,30,204,205,403,820,0.4914634146341463,2,22,0.0909090909090909,401,798,0.5025062656641605,0.493,194,313,0.6198083067092651
Robert Pack,packro01,PG,25,DEN,1995,42,1144.0,507,290,19,94,113,61,6,134,101,170,395,0.430379746835443,30,72,0.4166666666666667,140,323,0.4334365325077399,0.468,137,175,0.7828571428571428
Robert Parish,parisro01,C,41,CHH,1995,81,1352.0,389,44,93,257,350,27,36,66,132,159,372,0.4274193548387097,0,0,0.0,159,372,0.4274193548387097,0.427,71,101,0.7029702970297029
Gary Payton,paytoga01,PG,26,SEA,1995,82,3015.0,1689,583,108,173,281,204,13,201,206,685,1345,0.5092936802973977,70,232,0.3017241379310345,615,1113,0.5525606469002695,0.535,249,348,0.7155172413793104
Anthony Peeler,peelean01,SG,25,LAL,1995,73,1559.0,756,122,62,106,168,52,13,82,143,285,659,0.4324734446130501,84,216,0.3888888888888889,201,443,0.45372460496614,0.496,102,128,0.796875
Mike Peplowski,peplomi01,C,24,DET,1995,6,21.0,11,1,1,2,3,1,0,2,10,5,5,1.0,0,0,0.0,5,5,1.0,1.0,1,2,0.5
Will Perdue,perduwi01,C,29,CHI,1995,78,1592.0,621,90,211,311,522,26,56,116,220,254,459,0.5533769063180828,0,1,0.0,254,458,0.5545851528384279,0.553,113,194,0.5824742268041238
Sam Perkins,perkisa01,C,33,SEA,1995,82,2356.0,1043,135,96,302,398,72,45,77,186,346,742,0.4663072776280323,136,343,0.3965014577259475,210,399,0.5263157894736842,0.558,215,269,0.7992565055762082
Elliot Perry,perryel01,PG,25,PHO,1995,82,1977.0,795,394,51,100,151,156,4,163,142,306,588,0.5204081632653061,25,60,0.4166666666666667,281,528,0.5321969696969697,0.542,158,195,0.8102564102564103
Tim Perry,perryti01,PF,29,PHI,1995,42,446.0,76,12,38,51,89,10,15,21,51,27,78,0.3461538461538461,0,14,0.0,27,64,0.421875,0.346,22,40,0.55
Chuck Person,persoch01,SF,30,SAS,1995,81,2033.0,872,106,49,209,258,45,12,102,198,317,750,0.4226666666666667,172,445,0.3865168539325843,145,305,0.4754098360655737,0.537,66,102,0.6470588235294118
Wesley Person,persowe01,SG,23,PHO,1995,78,1800.0,814,105,67,134,201,48,24,79,149,309,638,0.4843260188087774,116,266,0.4360902255639097,193,372,0.5188172043010753,0.575,80,101,0.7920792079207921
Derrick Phelps,phelpde01,PG,22,SAC,1995,3,5.0,0,1,0,0,0,0,0,0,3,0,1,0.0,0,0,0.0,0,1,0.0,0.0,0,2,0.0
Bobby Phills,phillbo01,SG,25,CLE,1995,80,2500.0,878,180,90,175,265,115,25,113,206,338,816,0.4142156862745098,19,55,0.3454545454545454,319,761,0.4191852825229961,0.426,183,235,0.7787234042553192
Eric Piatkowski,piatker01,SG,24,LAC,1995,81,1208.0,566,77,63,70,133,37,15,63,150,201,456,0.4407894736842105,74,198,0.3737373737373737,127,258,0.4922480620155038,0.522,90,115,0.782608695652174
Ricky Pierce,piercri01,PG,35,GSW,1995,27,673.0,338,40,12,52,64,22,2,24,38,111,254,0.437007874015748,23,70,0.3285714285714285,88,184,0.4782608695652174,0.482,93,106,0.8773584905660378
Ed Pinckney,pincked01,PF,31,MIL,1995,62,835.0,140,21,65,146,211,34,17,26,64,48,97,0.4948453608247423,0,0,0.0,48,97,0.4948453608247423,0.495,44,62,0.7096774193548387
Scottie Pippen,pippesc01,SF,29,CHI,1995,79,3014.0,1692,409,175,464,639,232,89,271,238,634,1320,0.4803030303030303,109,316,0.3449367088607595,525,1004,0.5229083665338645,0.522,315,440,0.7159090909090909
Olden Polynice,polynol01,C,30,SAC,1995,81,2534.0,877,62,277,448,725,48,52,113,238,376,691,0.5441389290882779,1,1,1.0,375,690,0.5434782608695652,0.545,124,194,0.6391752577319587
Terry Porter,portete01,PG,31,POR,1995,35,770.0,312,133,18,63,81,30,2,58,60,105,267,0.3932584269662921,44,114,0.3859649122807017,61,153,0.3986928104575163,0.476,58,82,0.7073170731707317
Mark Price,pricema01,PG,30,CLE,1995,48,1375.0,757,335,25,87,112,35,4,142,50,253,612,0.4133986928104575,103,253,0.4071146245059288,150,359,0.4178272980501393,0.498,148,162,0.9135802469135802
Kevin Pritchard,pritcke01,PG,27,TOT,1995,19,194.0,44,34,0,12,12,2,1,12,22,13,32,0.40625,2,8,0.25,11,24,0.4583333333333333,0.438,16,21,0.7619047619047619
Dino Radja,radjadi01,PF,27,BOS,1995,66,2147.0,1133,111,149,424,573,60,86,159,232,450,919,0.4896626768226333,0,1,0.0,450,918,0.4901960784313725,0.49,233,307,0.758957654723127
Kurt Rambis,rambiku01,PF,36,LAL,1995,26,195.0,44,16,10,24,34,3,9,8,35,18,35,0.5142857142857142,0,0,0.0,18,35,0.5142857142857142,0.514,8,12,0.6666666666666666
Mark Randall,randama01,PF,27,DEN,1995,8,39.0,6,1,4,8,12,0,0,1,5,3,10,0.3,0,1,0.0,3,9,0.3333333333333333,0.3,0,0,0.0
Eldridge Recasner,recasel01,SG,27,DEN,1995,3,13.0,6,1,0,2,2,3,0,2,0,1,6,0.1666666666666666,0,1,0.0,1,5,0.2,0.167,4,4,1.0
Khalid Reeves,reevekh01,PG,22,MIA,1995,67,1462.0,619,288,52,134,186,77,10,132,139,206,465,0.443010752688172,67,171,0.391812865497076,139,294,0.4727891156462585,0.515,140,196,0.7142857142857143
J.R. Reid,reidjr01,PF,26,SAS,1995,81,1566.0,563,55,120,273,393,60,32,113,230,201,396,0.5075757575757576,1,2,0.5,200,394,0.5076142131979695,0.509,160,233,0.6866952789699571
Glen Rice,ricegl01,SF,27,MIA,1995,82,3014.0,1831,192,99,279,378,112,14,153,203,667,1403,0.4754098360655737,185,451,0.4101995565410199,482,952,0.5063025210084033,0.541,312,365,0.8547945205479452
Pooh Richardson,richapo01,PG,28,LAC,1995,80,2864.0,874,632,38,223,261,129,12,171,218,353,897,0.3935340022296544,87,244,0.3565573770491803,266,653,0.4073506891271056,0.442,81,125,0.648
Mitch Richmond,richmmi01,SG,29,SAC,1995,82,3172.0,1867,311,69,288,357,91,29,234,227,668,1497,0.4462257849031396,156,424,0.3679245283018867,512,1073,0.4771668219944082,0.498,375,445,0.8426966292134831
Isaiah Rider,rideris01,SG,23,MIN,1995,75,2645.0,1532,245,90,159,249,69,23,232,194,558,1249,0.4467574059247398,139,396,0.351010101010101,419,853,0.4912075029308324,0.502,277,339,0.8171091445427728
Eric Riley,rileyer01,C,24,LAC,1995,40,434.0,177,11,45,67,112,17,35,31,78,65,145,0.4482758620689655,0,1,0.0,65,144,0.4513888888888889,0.448,47,64,0.734375
Doc Rivers,riverdo01,PG,33,TOT,1995,63,989.0,321,162,15,94,109,65,21,60,150,108,302,0.3576158940397351,45,127,0.3543307086614173,63,175,0.36,0.432,60,82,0.7317073170731707
Fred Roberts,roberfr01,SF,34,CLE,1995,21,223.0,80,8,13,21,34,6,3,7,26,28,72,0.3888888888888889,4,11,0.3636363636363636,24,61,0.3934426229508196,0.417,20,26,0.7692307692307693
Clifford Robinson,robincl02,SF,28,POR,1995,75,2725.0,1601,198,152,271,423,79,82,158,240,597,1320,0.4522727272727272,142,383,0.370757180156658,455,937,0.4855923159018143,0.506,265,382,0.693717277486911
David Robinson,robinda01,C,29,SAS,1995,81,3074.0,2238,236,234,643,877,134,262,233,230,788,1487,0.5299260255548084,6,20,0.3,782,1467,0.5330606680299932,0.532,656,847,0.7744982290436836
Glenn Robinson,robingl01,SF,22,MIL,1995,80,2958.0,1755,197,169,344,513,115,22,313,234,636,1410,0.451063829787234,86,268,0.3208955223880597,550,1142,0.4816112084063047,0.482,397,499,0.7955911823647295
James Robinson,robinja02,PG,24,POR,1995,71,1539.0,651,180,42,90,132,48,13,127,142,255,624,0.4086538461538461,76,223,0.3408071748878923,179,401,0.4463840399002494,0.47,65,110,0.5909090909090909
Dennis Rodman,rodmade01,PF,33,SAS,1995,49,1568.0,349,97,274,549,823,31,23,98,159,137,240,0.5708333333333333,0,2,0.0,137,238,0.5756302521008403,0.571,75,111,0.6756756756756757
Carlos Rogers,rogerca01,C,23,GSW,1995,49,1017.0,438,37,108,170,278,22,52,84,124,180,340,0.5294117647058824,2,14,0.1428571428571428,178,326,0.5460122699386503,0.532,76,146,0.5205479452054794
Rodney Rogers,rogerro01,PF,23,DEN,1995,80,2142.0,979,161,132,253,385,95,46,173,281,375,769,0.4876462938881664,50,148,0.3378378378378378,325,621,0.5233494363929146,0.52,179,275,0.6509090909090909
Tree Rollins,rollitr01,C,39,ORL,1995,51,478.0,61,9,31,64,95,7,36,23,63,20,42,0.4761904761904761,0,0,0.0,20,42,0.4761904761904761,0.476,21,31,0.6774193548387096
Sean Rooks,rooksse01,C,25,MIN,1995,80,2405.0,868,97,165,321,486,29,71,142,208,289,615,0.4699186991869918,0,5,0.0,289,610,0.4737704918032787,0.47,290,381,0.7611548556430446
Jalen Rose,roseja01,SF,22,DEN,1995,81,1798.0,663,389,57,160,217,65,22,160,206,227,500,0.454,36,114,0.3157894736842105,191,386,0.4948186528497409,0.49,173,234,0.7393162393162394
Donald Royal,royaldo01,SF,28,ORL,1995,70,1841.0,635,198,83,196,279,45,16,125,156,206,434,0.4746543778801843,0,4,0.0,206,430,0.4790697674418605,0.475,223,299,0.745819397993311
Clifford Rozier,roziecl01,C,22,GSW,1995,66,1494.0,448,45,200,286,486,35,39,89,196,189,390,0.4846153846153846,2,7,0.2857142857142857,187,383,0.4882506527415143,0.487,68,152,0.4473684210526316
Trevor Ruffin,ruffitr01,PG,24,PHO,1995,49,319.0,233,48,8,15,23,14,2,47,52,84,197,0.4263959390862944,38,99,0.3838383838383838,46,98,0.4693877551020408,0.523,27,38,0.7105263157894737
Bryon Russell,russebr01,SF,24,UTA,1995,63,860.0,283,34,44,97,141,48,11,42,101,104,238,0.4369747899159664,13,44,0.2954545454545454,91,194,0.4690721649484536,0.464,62,93,0.6666666666666666
John Salley,sallejo01,C,30,MIA,1995,75,1955.0,547,123,110,226,336,47,85,97,279,197,395,0.4987341772151898,0,0,0.0,197,395,0.4987341772151898,0.499,153,207,0.7391304347826086
Danny Schayes,schayda01,C,35,PHO,1995,69,823.0,303,89,57,151,208,20,37,64,170,126,248,0.5080645161290323,1,1,1.0,125,247,0.5060728744939271,0.51,50,69,0.7246376811594203
Steve Scheffler,schefst01,C,27,SEA,1995,18,102.0,39,4,8,15,23,2,2,3,9,12,23,0.5217391304347826,0,0,0.0,12,23,0.5217391304347826,0.522,15,18,0.8333333333333334
Dwayne Schintzius,schindw01,C,26,NJN,1995,43,318.0,88,15,29,52,81,3,17,17,45,41,108,0.3796296296296296,0,0,0.0,41,108,0.3796296296296296,0.38,6,11,0.5454545454545454
Detlef Schrempf,schrede01,SF,32,SEA,1995,82,2886.0,1572,310,135,373,508,93,35,176,252,521,997,0.522567703109328,93,181,0.5138121546961326,428,816,0.5245098039215687,0.569,437,521,0.8387715930902111
Byron Scott,scottby01,PG,33,IND,1995,80,1528.0,802,108,18,133,151,61,13,119,123,265,583,0.4545454545454545,79,203,0.3891625615763547,186,380,0.4894736842105263,0.522,193,227,0.8502202643171806
Dennis Scott,scottde01,SF,26,ORL,1995,62,1499.0,802,131,25,121,146,45,14,57,119,283,645,0.4387596899224806,150,352,0.4261363636363636,133,293,0.4539249146757679,0.555,86,114,0.7543859649122807
Malik Sealy,sealyma01,SG,24,LAC,1995,60,1604.0,778,107,77,137,214,72,25,83,173,291,669,0.4349775784753363,22,73,0.3013698630136986,269,596,0.4513422818791946,0.451,174,223,0.7802690582959642
Rony Seikaly,seikaro01,C,29,GSW,1995,36,1035.0,435,45,77,189,266,20,37,104,122,162,314,0.5159235668789809,0,0,0.0,162,314,0.5159235668789809,0.516,111,160,0.69375
Charles Shackleford,shackch01,PF,28,MIN,1995,21,239.0,94,8,16,51,67,8,6,8,47,39,65,0.6,0,0,0.0,39,65,0.6,0.6,16,20,0.8
Brian Shaw,shawbr01,PG,28,ORL,1995,78,1836.0,502,406,52,189,241,73,18,184,184,192,494,0.388663967611336,48,184,0.2608695652173913,144,310,0.4645161290322581,0.437,70,95,0.7368421052631579
Lionel Simmons,simmoli01,SF,26,SAC,1995,58,1064.0,327,89,61,135,196,28,23,70,118,131,312,0.4198717948717949,6,16,0.375,125,296,0.4222972972972973,0.429,59,84,0.7023809523809523
Dickey Simpkins,simpkdi01,PF,22,CHI,1995,59,586.0,206,37,60,91,151,10,7,45,72,78,184,0.4239130434782608,0,0,0.0,78,184,0.4239130434782608,0.424,50,72,0.6944444444444444
Scott Skiles,skilesc01,PG,30,WSB,1995,62,2077.0,805,452,26,133,159,70,6,172,135,265,583,0.4545454545454545,96,228,0.4210526315789473,169,355,0.476056338028169,0.537,179,202,0.8861386138613861
Reggie Slater,slatere01,PF,24,DEN,1995,25,236.0,120,12,21,36,57,7,3,26,47,40,81,0.4938271604938271,0,0,0.0,40,81,0.4938271604938271,0.494,40,55,0.7272727272727273
Charles Smith,smithch01,SF,29,NYK,1995,76,2150.0,966,120,144,180,324,49,95,147,286,352,747,0.4712182061579651,7,31,0.2258064516129032,345,716,0.4818435754189944,0.476,255,322,0.7919254658385093
Chris Smith,smithch03,SG,24,MIN,1995,64,1073.0,320,146,14,59,73,32,22,50,119,116,264,0.4393939393939394,47,108,0.4351851851851852,69,156,0.4423076923076923,0.528,41,63,0.6507936507936508
Doug Smith,smithdo03,PF,25,DAL,1995,63,826.0,320,44,43,101,144,29,26,37,132,131,314,0.4171974522292994,1,12,0.0833333333333333,130,302,0.4304635761589404,0.419,57,75,0.76
Kenny Smith,smithke01,PG,29,HOU,1995,81,2030.0,842,323,27,128,155,71,10,123,109,287,593,0.4839797639123103,142,331,0.4290030211480362,145,262,0.5534351145038168,0.604,126,148,0.8513513513513513
Michael Smith,smithmi01,PF,29,LAC,1995,29,319.0,153,20,13,43,56,6,2,18,41,63,134,0.4701492537313433,1,8,0.125,62,126,0.492063492063492,0.474,26,30,0.8666666666666667
Michael Smith,smithmi02,PF,22,SAC,1995,82,1736.0,567,67,174,312,486,61,49,106,235,220,406,0.541871921182266,0,2,0.0,220,404,0.5445544554455446,0.542,127,262,0.4847328244274809
Steve Smith,smithst01,SG,25,TOT,1995,80,2665.0,1305,274,104,172,276,62,33,155,225,428,1005,0.4258706467661691,137,416,0.3293269230769231,291,589,0.4940577249575552,0.494,312,371,0.8409703504043127
Tony Smith,smithto02,SG,26,LAL,1995,61,1024.0,340,102,43,64,107,46,7,50,111,132,309,0.4271844660194174,32,91,0.3516483516483517,100,218,0.4587155963302752,0.479,44,63,0.6984126984126984
Rik Smits,smitsri01,C,28,IND,1995,78,2381.0,1400,111,192,409,601,40,79,189,278,558,1060,0.5264150943396226,0,2,0.0,558,1058,0.5274102079395085,0.526,284,377,0.753315649867374
Elmore Spencer,spencel01,C,25,LAC,1995,19,368.0,132,25,11,54,65,14,23,48,62,52,118,0.4406779661016949,0,1,0.0,52,117,0.4444444444444444,0.441,28,50,0.56
Felton Spencer,spencfe01,C,27,UTA,1995,34,905.0,317,17,90,170,260,12,32,68,131,105,215,0.4883720930232558,0,0,0.0,105,215,0.4883720930232558,0.488,107,135,0.7925925925925926
Latrell Sprewell,sprewla01,SG,24,GSW,1995,69,2771.0,1420,279,58,198,256,112,46,230,108,490,1171,0.4184457728437233,90,326,0.2760736196319018,400,845,0.4733727810650887,0.457,350,448,0.78125
John Starks,starkjo01,SG,29,NYK,1995,80,2725.0,1223,411,34,185,219,92,4,160,257,419,1062,0.3945386064030132,217,611,0.3551554828150572,202,451,0.4478935698447893,0.497,168,228,0.7368421052631579
Larry Stewart,stewala01,SF,26,WSB,1995,40,346.0,102,18,28,39,67,16,9,16,52,41,89,0.4606741573033708,0,2,0.0,41,87,0.4712643678160919,0.461,20,30,0.6666666666666666
Bryant Stith,stithbr01,SG,24,DEN,1995,81,2329.0,911,153,95,173,268,91,18,110,142,312,661,0.4720121028744327,20,68,0.2941176470588235,292,593,0.4924114671163575,0.487,267,324,0.8240740740740741
John Stockton,stockjo01,PG,32,UTA,1995,82,2867.0,1206,1011,57,194,251,194,22,267,215,429,791,0.5423514538558787,102,227,0.4493392070484581,327,564,0.5797872340425532,0.607,246,306,0.803921568627451
Mark Strickland,stricma01,PF,24,IND,1995,4,9.0,3,0,2,2,4,0,1,1,0,1,3,0.3333333333333333,0,0,0.0,1,3,0.3333333333333333,0.333,1,2,0.5
Rod Strickland,stricro02,PG,28,POR,1995,64,2267.0,1211,562,73,244,317,123,9,209,118,441,946,0.4661733615221987,46,123,0.3739837398373983,395,823,0.479951397326853,0.49,283,380,0.7447368421052631
Derek Strong,stronde01,PF,26,BOS,1995,70,1344.0,441,44,136,239,375,24,13,79,143,149,329,0.4528875379939209,2,7,0.2857142857142857,147,322,0.4565217391304347,0.456,141,172,0.8197674418604651
Greg Sutton,suttogr01,PG,27,CHH,1995,53,690.0,263,91,8,48,56,33,2,51,114,94,230,0.408695652173913,43,115,0.3739130434782609,51,115,0.4434782608695652,0.502,32,45,0.7111111111111111
Aaron Swinson,swinsaa01,SF,24,PHO,1995,9,51.0,24,3,3,5,8,1,0,5,8,10,18,0.5555555555555556,0,0,0.0,10,18,0.5555555555555556,0.556,4,5,0.8
Žan Tabak,tabakza01,C,24,HOU,1995,37,182.0,75,4,23,34,57,2,7,18,37,24,53,0.4528301886792453,0,1,0.0,24,52,0.4615384615384615,0.453,27,44,0.6136363636363636
Roy Tarpley,tarplro01,C,30,DAL,1995,55,1354.0,691,58,142,307,449,45,55,109,155,292,610,0.4786885245901639,5,18,0.2777777777777778,287,592,0.4847972972972973,0.483,102,122,0.8360655737704918
Brooks Thompson,thompbr01,PG,24,ORL,1995,38,246.0,116,43,7,16,23,10,2,27,46,45,114,0.3947368421052631,18,58,0.3103448275862069,27,56,0.4821428571428571,0.474,8,12,0.6666666666666666
LaSalle Thompson,thompla01,C,33,IND,1995,38,453.0,112,18,28,61,89,18,10,33,76,49,118,0.4152542372881356,0,0,0.0,49,118,0.4152542372881356,0.415,14,16,0.875
Otis Thorpe,thorpot01,PF,32,TOT,1995,70,2096.0,937,112,202,356,558,41,28,132,224,385,681,0.5653450807635829,0,7,0.0,385,674,0.5712166172106825,0.565,167,281,0.594306049822064
Sedale Threatt,threase01,PG,33,LAL,1995,59,1384.0,558,248,21,103,124,54,12,70,139,217,437,0.4965675057208238,36,95,0.3789473684210526,181,342,0.5292397660818714,0.538,88,111,0.7927927927927928
Wayman Tisdale,tisdawa01,PF,30,PHO,1995,65,1276.0,650,45,83,164,247,29,27,64,190,278,574,0.4843205574912892,0,0,0.0,278,574,0.4843205574912892,0.484,94,122,0.7704918032786885
Tom Tolbert,tolbeto01,PF,29,CHH,1995,10,57.0,14,2,7,10,17,0,0,3,9,6,18,0.3333333333333333,0,4,0.0,6,14,0.4285714285714285,0.333,2,2,1.0
Keith Tower,towerke01,C,24,ORL,1995,3,7.0,1,0,1,2,3,0,0,1,1,0,2,0.0,0,0,0.0,0,2,0.0,0.0,1,2,0.5
Anthony Tucker,tuckean01,SF,25,WSB,1995,62,982.0,243,68,44,126,170,46,11,56,129,96,210,0.4571428571428571,0,1,0.0,96,209,0.4593301435406698,0.457,51,83,0.6144578313253012
Henry Turner,turnehe02,PF,28,SAC,1995,30,149.0,68,7,17,11,28,8,1,12,20,23,57,0.4035087719298245,2,5,0.4,21,52,0.4038461538461538,0.421,20,35,0.5714285714285714
Jeff Turner,turneje01,PF,32,ORL,1995,49,576.0,199,38,23,74,97,12,3,22,102,73,178,0.4101123595505618,27,75,0.36,46,103,0.4466019417475728,0.486,26,29,0.896551724137931
B.J. Tyler,tylerbj01,PG,23,PHI,1995,55,809.0,195,174,13,49,62,36,2,97,58,72,189,0.3809523809523809,16,51,0.3137254901960784,56,138,0.4057971014492754,0.423,35,50,0.7
Nick Van Exel,vanexni01,PG,23,LAL,1995,80,2944.0,1348,660,27,196,223,97,6,220,157,465,1107,0.4200542005420054,183,511,0.3581213307240704,282,596,0.4731543624161073,0.503,235,300,0.7833333333333333
Loy Vaught,vaughlo01,PF,26,LAC,1995,80,2966.0,1401,139,261,511,772,104,29,166,243,609,1185,0.5139240506329114,7,33,0.2121212121212121,602,1152,0.5225694444444444,0.517,176,248,0.7096774193548387
Fred Vinson,vinsofr01,SG,24,ATL,1995,5,27.0,4,1,0,0,0,0,0,2,4,1,7,0.1428571428571428,1,6,0.1666666666666666,0,1,0.0,0.214,1,1,1.0
Kenny Walker,walkeke01,SF,30,WSB,1995,24,266.0,57,7,19,28,47,5,5,15,42,18,42,0.4285714285714285,0,0,0.0,18,42,0.4285714285714285,0.429,21,28,0.75
Rex Walters,waltere01,SG,24,NJN,1995,80,1435.0,523,121,18,75,93,37,16,71,135,206,469,0.4392324093816631,71,196,0.3622448979591837,135,273,0.4945054945054945,0.515,40,52,0.7692307692307693
Charlie Ward,wardch01,PG,24,NYK,1995,10,44.0,16,4,1,5,6,2,0,8,7,4,19,0.2105263157894736,1,10,0.1,3,9,0.3333333333333333,0.237,7,10,0.7
Jamie Watson,watsoja01,SF,22,UTA,1995,60,673.0,195,59,16,58,74,35,11,51,86,76,152,0.5,5,19,0.2631578947368421,71,133,0.5338345864661654,0.516,38,56,0.6785714285714286
Clarence Weatherspoon,weathcl01,SF,24,PHI,1995,76,2991.0,1373,215,144,382,526,115,67,191,195,543,1238,0.438610662358643,4,21,0.1904761904761904,539,1217,0.4428923582580115,0.44,283,377,0.7506631299734748
Spud Webb,webbsp01,PG,31,SAC,1995,76,2458.0,878,468,29,145,174,75,8,185,148,302,689,0.4383164005805515,48,145,0.3310344827586207,254,544,0.4669117647058823,0.473,226,242,0.9338842975206612
Chris Webber,webbech01,PF,21,WSB,1995,54,2067.0,1085,256,200,318,518,83,85,167,186,464,938,0.4946695095948827,40,145,0.2758620689655172,424,793,0.5346784363177806,0.516,117,233,0.5021459227467812
Bill Wennington,wennibi01,C,31,CHI,1995,73,956.0,363,40,64,126,190,22,17,39,198,156,317,0.4921135646687697,0,4,0.0,156,313,0.4984025559105431,0.492,51,63,0.8095238095238095
David Wesley,wesleda01,PG,24,BOS,1995,51,1380.0,378,266,31,86,117,82,9,87,144,128,313,0.4089456869009584,51,119,0.4285714285714285,77,194,0.3969072164948453,0.49,71,94,0.7553191489361702
Doug West,westdo01,SG,27,MIN,1995,71,2328.0,919,185,60,167,227,65,24,126,250,351,762,0.4606299212598425,11,61,0.180327868852459,340,701,0.485021398002853,0.468,206,246,0.8373983739837398
Mark West,westma01,C,34,DET,1995,67,1543.0,500,18,160,248,408,27,102,85,247,217,390,0.5564102564102564,0,0,0.0,217,390,0.5564102564102564,0.556,66,138,0.4782608695652174
Ennis Whatley,whatlen01,PG,32,ATL,1995,27,292.0,70,54,9,21,30,19,0,19,37,24,53,0.4528301886792453,2,8,0.25,22,45,0.4888888888888889,0.472,20,32,0.625
Chris Whitney,whitnch01,PG,23,SAS,1995,25,179.0,42,28,4,9,13,4,0,18,34,14,47,0.2978723404255319,3,19,0.1578947368421052,11,28,0.3928571428571428,0.33,11,11,1.0
Morlon Wiley,wileymo01,PG,28,TOT,1995,43,424.0,137,75,6,37,43,22,2,23,44,50,117,0.4273504273504273,30,79,0.379746835443038,20,38,0.5263157894736842,0.556,7,10,0.7
Dominique Wilkins,wilkido01,SF,35,BOS,1995,77,2423.0,1370,166,157,244,401,61,14,173,130,496,1169,0.4242942686056458,112,289,0.3875432525951557,384,880,0.4363636363636363,0.472,266,340,0.7823529411764706
Aaron Williams,williaa01,PF,23,MIL,1995,15,72.0,24,0,5,14,19,2,6,7,14,8,24,0.3333333333333333,0,1,0.0,8,23,0.3478260869565217,0.333,8,12,0.6666666666666666
Buck Williams,willibu01,PF,34,POR,1995,82,2422.0,757,78,251,418,669,67,69,119,254,309,604,0.5115894039735099,1,2,0.5,308,602,0.5116279069767442,0.512,138,205,0.6731707317073171
Herb Williams,willihe01,C,36,NYK,1995,56,743.0,187,27,23,109,132,13,45,40,108,82,180,0.4555555555555555,0,0,0.0,82,180,0.4555555555555555,0.456,23,37,0.6216216216216216
Hot Rod Williams,williho01,PF,32,CLE,1995,74,2641.0,929,192,173,334,507,83,101,149,211,366,810,0.4518518518518518,1,5,0.2,365,805,0.453416149068323,0.452,196,286,0.6853146853146853
Jayson Williams,willija01,PF,26,NJN,1995,75,982.0,363,35,179,246,425,26,33,59,160,149,323,0.4613003095975232,0,5,0.0,149,318,0.4685534591194968,0.461,65,122,0.5327868852459017
John Williams,willijo02,SF,28,IND,1995,34,402.0,100,27,23,39,62,10,2,35,48,41,115,0.3565217391304348,4,12,0.3333333333333333,37,103,0.3592233009708738,0.374,14,25,0.56
Lorenzo Williams,willilo01,C,25,DAL,1995,82,2383.0,328,124,291,399,690,52,148,105,306,145,304,0.4769736842105263,0,0,0.0,145,304,0.4769736842105263,0.477,38,101,0.3762376237623762
Micheal Williams,willimi02,PG,28,MIN,1995,1,28.0,6,3,0,1,1,2,0,3,3,1,4,0.25,0,0,0.0,1,4,0.25,0.25,4,5,0.8
Monty Williams,willimo01,SF,23,NYK,1995,41,503.0,137,49,42,56,98,20,4,41,87,60,133,0.4511278195488721,0,8,0.0,60,125,0.48,0.451,17,38,0.4473684210526316
Reggie Williams,willire01,SF,30,DEN,1995,74,2198.0,993,231,94,235,329,114,67,124,264,388,846,0.458628841607565,85,266,0.3195488721804511,303,580,0.5224137931034483,0.509,132,174,0.7586206896551724
Scott Williams,willisc01,PF,26,PHI,1995,77,1781.0,491,59,173,312,485,71,40,84,237,206,434,0.4746543778801843,0,7,0.0,206,427,0.4824355971896955,0.475,79,107,0.7383177570093458
Walt Williams,williwa02,SF,24,SAC,1995,77,2739.0,1259,316,100,245,345,123,63,243,265,445,998,0.4458917835671342,103,296,0.3479729729729729,342,702,0.4871794871794871,0.497,266,364,0.7307692307692307
Kevin Willis,willike02,PF,32,TOT,1995,67,2390.0,1154,86,227,505,732,60,36,162,215,473,1015,0.4660098522167488,3,15,0.2,470,1000,0.47,0.467,205,297,0.6902356902356902
Trevor Wilson,wilsotr01,PF,26,SAC,1995,15,147.0,47,12,10,16,26,4,2,6,12,18,40,0.45,0,0,0.0,18,40,0.45,0.45,11,14,0.7857142857142857
David Wingate,wingada01,SG,31,CHH,1995,52,515.0,122,56,11,49,60,19,6,27,60,50,122,0.4098360655737705,4,22,0.1818181818181818,46,100,0.46,0.426,18,24,0.75
Dontonio Wingfield,wingfdo01,SF,20,SEA,1995,20,81.0,46,3,11,19,30,5,3,8,15,18,51,0.3529411764705882,2,12,0.1666666666666666,16,39,0.4102564102564102,0.373,8,10,0.8
Joe Wolf,wolfjo01,PF,30,CHH,1995,63,583.0,90,37,34,95,129,9,6,22,101,38,81,0.4691358024691358,2,6,0.3333333333333333,36,75,0.48,0.481,12,16,0.75
David Wood,woodda01,PF,30,GSW,1995,78,1336.0,428,65,83,158,241,28,13,53,217,153,326,0.4693251533742331,31,91,0.3406593406593406,122,235,0.5191489361702127,0.517,91,117,0.7777777777777778
Randy Woods,woodsra01,PG,24,LAC,1995,62,495.0,124,134,10,34,44,41,0,55,87,37,117,0.3162393162393162,22,74,0.2972972972972973,15,43,0.3488372093023256,0.41,28,38,0.7368421052631579
Haywoode Workman,workmha01,PG,29,IND,1995,69,1028.0,292,194,21,90,111,59,5,73,115,101,269,0.3754646840148699,35,98,0.3571428571428571,66,171,0.3859649122807017,0.441,55,74,0.7432432432432432
Sharone Wright,wrighsh01,C,22,PHI,1995,79,2044.0,904,48,191,281,472,37,104,151,246,361,776,0.4652061855670103,0,8,0.0,361,768,0.4700520833333333,0.465,182,282,0.6453900709219859
Danny Young,youngda01,PG,32,MIL,1995,7,77.0,24,12,1,4,5,4,0,4,8,9,17,0.5294117647058824,5,12,0.4166666666666667,4,5,0.8,0.676,1,1,1.0
Mahmoud Abdul-Rauf,abdulma02,PG,26,DEN,1996,57,2029.0,1095,389,26,112,138,64,3,115,117,414,955,0.4335078534031413,121,309,0.3915857605177993,293,646,0.4535603715170279,0.497,146,157,0.929936305732484
Michael Adams,adamsmi01,PG,33,CHH,1996,21,329.0,114,67,5,17,22,21,4,25,25,37,83,0.4457831325301205,14,41,0.3414634146341463,23,42,0.5476190476190477,0.53,26,35,0.7428571428571429
Rafael Addison,addisra01,SF,31,CHH,1996,53,516.0,171,30,25,65,90,9,9,27,74,77,165,0.4666666666666667,0,9,0.0,77,156,0.4935897435897436,0.467,17,22,0.7727272727272727
Cory Alexander,alexaco01,PG,22,SAS,1996,60,560.0,168,121,9,33,42,27,2,68,94,63,155,0.4064516129032258,26,66,0.3939393939393939,37,89,0.4157303370786517,0.49,16,25,0.64
Jerome Allen,allenje01,SG,23,MIN,1996,41,362.0,108,49,5,20,25,21,5,34,42,36,105,0.3428571428571428,10,33,0.303030303030303,26,72,0.3611111111111111,0.39,26,36,0.7222222222222222
Derrick Alston,alstode01,C,23,PHI,1996,73,1614.0,452,61,127,175,302,56,52,59,191,198,387,0.5116279069767442,1,3,0.3333333333333333,197,384,0.5130208333333334,0.513,55,112,0.4910714285714285
John Amaechi,amaecjo01,PF,25,CLE,1996,28,357.0,77,9,13,39,52,6,11,34,49,29,70,0.4142857142857143,0,0,0.0,29,70,0.4142857142857143,0.414,19,33,0.5757575757575758
Ashraf Amaya,amayaas01,PF,24,VAN,1996,54,1104.0,339,33,114,189,303,22,10,57,151,121,252,0.4801587301587302,0,1,0.0,121,251,0.4820717131474104,0.48,97,149,0.6510067114093959
Greg Anderson,andergr01,PF,31,SAS,1996,46,344.0,54,10,29,71,100,9,24,22,66,24,47,0.5106382978723404,0,1,0.0,24,46,0.5217391304347826,0.511,6,25,0.24
Kenny Anderson,anderke01,PG,25,TOT,1996,69,2344.0,1050,575,63,140,203,111,14,146,178,349,834,0.4184652278177458,92,256,0.359375,257,578,0.444636678200692,0.474,260,338,0.7692307692307693
Nick Anderson,anderni01,SG,28,ORL,1996,77,2717.0,1134,279,92,323,415,121,46,141,135,400,904,0.4424778761061947,168,430,0.3906976744186046,232,474,0.4894514767932489,0.535,166,240,0.6916666666666667
Willie Anderson,anderwi01,SG,29,TOT,1996,76,2060.0,742,197,48,198,246,75,59,143,230,288,660,0.4363636363636363,34,120,0.2833333333333333,254,540,0.4703703703703704,0.462,132,163,0.8098159509202454
Greg Anthony,anthogr01,PG,28,VAN,1996,69,2096.0,967,476,29,145,174,116,11,160,137,324,781,0.4148527528809219,90,271,0.3321033210332103,234,510,0.4588235294117647,0.472,229,297,0.7710437710437711
B.J. Armstrong,armstbj01,PG,28,GSW,1996,82,2262.0,1012,401,22,162,184,68,6,128,147,340,727,0.4676753782668501,98,207,0.4734299516908212,242,520,0.4653846153846154,0.535,234,279,0.8387096774193549
Darrell Armstrong,armstda01,PG,27,ORL,1996,13,41.0,42,5,0,2,2,6,0,6,4,16,32,0.5,6,12,0.5,10,20,0.5,0.594,4,4,1.0
Vincent Askew,askewvi01,SG,29,SEA,1996,69,1725.0,582,163,65,153,218,47,15,96,178,215,436,0.4931192660550458,29,86,0.3372093023255814,186,350,0.5314285714285715,0.526,123,161,0.7639751552795031
Keith Askins,askinke01,SF,28,MIA,1996,75,1897.0,458,121,113,211,324,48,61,82,271,157,391,0.40153452685422,99,237,0.4177215189873418,58,154,0.3766233766233766,0.528,45,57,0.7894736842105263
Stacey Augmon,augmost01,SF,27,ATL,1996,77,2294.0,976,137,137,167,304,106,31,138,188,362,738,0.4905149051490515,1,4,0.25,361,734,0.491825613079019,0.491,251,317,0.7917981072555205
Anthony Avent,aventan01,PF,26,VAN,1996,71,1586.0,415,69,108,247,355,30,42,107,202,179,466,0.3841201716738197,0,0,0.0,179,466,0.3841201716738197,0.384,57,77,0.7402597402597403
Vin Baker,bakervi01,PF,24,MIL,1996,82,3319.0,1729,212,263,545,808,68,91,216,272,699,1429,0.4891532540237928,10,48,0.2083333333333333,689,1381,0.498913830557567,0.493,321,479,0.6701461377870563
Steve Bardo,bardost01,SG,27,DET,1996,9,123.0,22,15,2,20,22,4,1,5,17,9,23,0.391304347826087,0,4,0.0,9,19,0.4736842105263157,0.391,4,6,0.6666666666666666
Charles Barkley,barklch01,PF,32,PHO,1996,71,2632.0,1649,262,243,578,821,114,56,218,208,580,1160,0.5,49,175,0.28,531,985,0.5390862944162437,0.521,440,566,0.7773851590106007
Dana Barros,barroda01,PG,28,BOS,1996,80,2328.0,1038,306,21,171,192,58,3,120,116,379,806,0.4702233250620347,150,368,0.4076086956521739,229,438,0.5228310502283106,0.563,130,147,0.8843537414965986
Brent Barry,barrybr01,SG,24,LAC,1996,79,1898.0,800,230,38,130,168,95,22,120,196,283,597,0.474036850921273,123,296,0.4155405405405405,160,301,0.53156146179402,0.577,111,137,0.8102189781021898
Jon Barry,barryjo01,SG,26,GSW,1996,68,712.0,257,85,17,46,63,33,11,42,51,91,185,0.4918918918918919,44,93,0.4731182795698925,47,92,0.5108695652173914,0.611,31,37,0.8378378378378378
Corey Beck,beckco01,PG,24,CHH,1996,5,33.0,5,5,3,4,7,1,0,4,8,2,8,0.25,0,0,0.0,2,8,0.25,0.25,1,2,0.5
Benoit Benjamin,benjabe01,C,31,TOT,1996,83,1896.0,728,64,141,398,539,45,85,144,224,294,590,0.4983050847457627,0,3,0.0,294,587,0.5008517887563884,0.498,140,194,0.7216494845360825
Elmer Bennett,benneel01,PG,25,PHI,1996,8,66.0,11,8,1,4,5,1,1,7,6,4,17,0.2352941176470588,0,0,0.0,4,17,0.2352941176470588,0.235,3,4,0.75
Mario Bennett,bennema01,SF,22,PHO,1996,19,230.0,85,6,21,28,49,11,11,11,46,29,64,0.453125,0,1,0.0,29,63,0.4603174603174603,0.453,27,42,0.6428571428571429
David Benoit,benoida01,SF,27,UTA,1996,81,1961.0,661,82,90,293,383,43,49,71,166,255,581,0.4388984509466437,64,192,0.3333333333333333,191,389,0.4910025706940874,0.494,87,112,0.7767857142857143
Travis Best,besttr01,PG,23,IND,1996,59,571.0,221,97,11,33,44,20,3,63,80,69,163,0.4233128834355828,8,25,0.32,61,138,0.4420289855072464,0.448,75,90,0.8333333333333334
Mookie Blaylock,blaylmo01,PG,28,ATL,1996,81,2893.0,1268,478,110,222,332,212,17,188,151,455,1123,0.4051647373107747,231,623,0.3707865168539326,224,500,0.448,0.508,127,170,0.7470588235294118
Corie Blount,blounco01,PF,27,LAL,1996,57,715.0,183,42,69,101,170,25,35,47,109,79,167,0.4730538922155688,0,2,0.0,79,165,0.4787878787878787,0.473,25,44,0.5681818181818182
Muggsy Bogues,boguemu01,PG,31,CHH,1996,6,77.0,14,19,6,1,7,2,0,6,4,6,16,0.375,0,1,0.0,6,15,0.4,0.375,2,2,1.0
Anthony Bonner,bonnean01,PF,27,ORL,1996,4,43.0,13,4,6,13,19,3,0,3,11,5,15,0.3333333333333333,0,0,0.0,5,15,0.3333333333333333,0.333,3,7,0.4285714285714285
Melvin Booker,bookeme01,PG,23,HOU,1996,11,131.0,44,21,1,8,9,5,1,12,18,16,50,0.32,3,19,0.1578947368421052,13,31,0.4193548387096774,0.35,9,11,0.8181818181818182
Anthony Bowie,bowiean01,SG,32,ORL,1996,74,1078.0,308,105,40,83,123,34,10,55,112,128,272,0.4705882352941176,12,31,0.3870967741935484,116,241,0.4813278008298755,0.493,40,46,0.8695652173913043
Donnie Boyce,boycedo01,SG,22,ATL,1996,8,41.0,24,3,5,5,10,3,1,6,2,9,23,0.391304347826087,4,8,0.5,5,15,0.3333333333333333,0.478,2,4,0.5
Shawn Bradley,bradlsh01,C,23,TOT,1996,79,2329.0,944,63,221,417,638,49,288,179,286,387,873,0.4432989690721649,1,4,0.25,386,869,0.4441887226697353,0.444,169,246,0.6869918699186992
Marques Bragg,braggma01,PF,25,MIN,1996,53,369.0,131,8,38,41,79,17,8,26,71,54,120,0.45,0,0,0.0,54,120,0.45,0.45,23,41,0.5609756097560976
Terrell Brandon,brandte01,PG,25,CLE,1996,75,2570.0,1449,487,47,201,248,132,33,142,146,510,1096,0.4653284671532847,91,235,0.3872340425531915,419,861,0.48664343786295,0.507,338,381,0.8871391076115486
Tim Breaux,breauti01,SF,25,HOU,1996,54,570.0,161,24,22,38,60,11,8,30,42,59,161,0.3664596273291925,15,46,0.3260869565217391,44,115,0.3826086956521739,0.413,28,45,0.6222222222222222
Frank Brickowski,brickfr01,C,36,SEA,1996,63,986.0,339,58,26,125,151,26,8,78,185,123,252,0.4880952380952381,32,79,0.4050632911392405,91,173,0.5260115606936416,0.552,61,86,0.7093023255813954
Scott Brooks,brooksc01,PG,30,DAL,1996,69,716.0,352,100,11,30,41,42,3,43,53,134,293,0.4573378839590443,25,62,0.4032258064516129,109,231,0.4718614718614718,0.5,59,69,0.855072463768116
Chucky Brown,brownch01,PF,27,HOU,1996,82,2019.0,705,89,134,307,441,47,38,94,163,300,555,0.5405405405405406,1,8,0.125,299,547,0.546617915904936,0.541,104,150,0.6933333333333334
Dee Brown,brownde01,PG,27,BOS,1996,65,1591.0,695,146,36,100,136,80,12,74,119,246,616,0.3993506493506493,68,220,0.3090909090909091,178,396,0.4494949494949495,0.455,135,158,0.8544303797468354
Mike Brown,brownmi01,C,32,PHI,1996,9,162.0,26,3,14,23,37,3,2,6,24,9,16,0.5625,0,0,0.0,9,16,0.5625,0.563,8,17,0.4705882352941176
P.J. Brown,brownpj01,C,26,NJN,1996,81,2942.0,915,165,215,345,560,79,100,133,249,354,798,0.4436090225563909,3,15,0.2,351,783,0.4482758620689655,0.445,204,265,0.769811320754717
Randy Brown,brownra02,PG,27,CHI,1996,68,671.0,185,73,17,49,66,57,12,31,88,78,192,0.40625,1,11,0.0909090909090909,77,181,0.425414364640884,0.409,28,46,0.6086956521739131
Mark Bryant,bryanma01,PF,30,HOU,1996,71,1587.0,611,52,131,220,351,31,19,85,234,242,446,0.5426008968609866,0,2,0.0,242,444,0.545045045045045,0.543,127,177,0.7175141242937854
Jud Buechler,buechju01,SF,27,CHI,1996,74,740.0,278,56,45,66,111,34,7,39,70,112,242,0.4628099173553719,40,90,0.4444444444444444,72,152,0.4736842105263157,0.545,14,22,0.6363636363636364
Matt Bullard,bullama01,PF,28,ATL,1996,46,460.0,174,18,18,42,60,17,11,24,50,66,162,0.4074074074074074,26,72,0.3611111111111111,40,90,0.4444444444444444,0.488,16,20,0.8
Scott Burrell,burresc01,SF,25,CHH,1996,20,693.0,263,47,26,72,98,27,13,43,76,92,206,0.4466019417475728,37,98,0.3775510204081632,55,108,0.5092592592592593,0.536,42,56,0.75
Junior Burrough,burroju01,PF,23,BOS,1996,61,495.0,189,15,45,64,109,15,10,40,74,64,170,0.3764705882352941,0,0,0.0,64,170,0.3764705882352941,0.376,61,93,0.6559139784946236
Mitchell Butler,butlemi02,SG,25,WSB,1996,61,858.0,237,67,29,89,118,41,12,67,104,88,229,0.3842794759825327,13,60,0.2166666666666666,75,169,0.4437869822485207,0.413,48,83,0.5783132530120482
Jason Caffey,caffeja01,PF,22,CHI,1996,57,545.0,182,24,51,60,111,12,7,48,91,71,162,0.4382716049382716,0,1,0.0,71,161,0.4409937888198758,0.438,40,68,0.5882352941176471
Michael Cage,cagemi01,C,34,CLE,1996,82,2631.0,490,53,288,441,729,87,79,54,215,220,396,0.5555555555555556,0,1,0.0,220,395,0.5569620253164557,0.556,50,92,0.5434782608695652
Adrian Caldwell,caldwad01,PF,29,IND,1996,51,327.0,110,6,42,68,110,9,5,35,73,46,83,0.5542168674698795,0,0,0.0,46,83,0.5542168674698795,0.554,18,36,0.5
Elden Campbell,campbel01,PF,27,LAL,1996,82,2699.0,1143,181,162,461,623,88,212,137,300,447,888,0.5033783783783784,0,5,0.0,447,883,0.5062287655719139,0.503,249,349,0.7134670487106017
Antoine Carr,carran01,SF,34,UTA,1996,80,1532.0,580,74,71,129,200,28,65,78,254,233,510,0.4568627450980392,0,3,0.0,233,507,0.4595660749506903,0.457,114,144,0.7916666666666666
Chris Carr,carrch01,SG,21,PHO,1996,60,590.0,240,43,27,75,102,10,5,40,77,90,217,0.4147465437788018,11,42,0.2619047619047619,79,175,0.4514285714285714,0.44,49,60,0.8166666666666667
Sam Cassell,cassesa01,PG,26,HOU,1996,61,1682.0,886,278,51,137,188,53,4,157,166,289,658,0.439209726443769,73,210,0.3476190476190476,216,448,0.4821428571428571,0.495,235,285,0.8245614035087719
Duane Causwell,causwdu01,C,27,SAC,1996,73,1044.0,250,20,86,162,248,27,78,53,173,90,216,0.4166666666666667,0,1,0.0,90,215,0.4186046511627907,0.417,70,96,0.7291666666666666
Cedric Ceballos,cebalce01,SF,26,LAL,1996,78,2628.0,1656,119,215,321,536,94,22,167,144,638,1203,0.5303408146300914,51,184,0.2771739130434782,587,1019,0.5760549558390579,0.552,329,409,0.80440097799511
Rex Chapman,chapmre01,SG,28,MIA,1996,56,1865.0,786,166,22,123,145,45,10,79,117,289,679,0.4256259204712813,125,337,0.3709198813056379,164,342,0.47953216374269,0.518,83,113,0.7345132743362832
Calbert Cheaney,cheanca01,SF,24,WSB,1996,70,2324.0,1055,154,67,172,239,67,18,129,205,426,905,0.4707182320441989,52,154,0.3376623376623376,374,751,0.4980026631158455,0.499,151,214,0.705607476635514
Pete Chilcutt,chilcpe01,PF,27,HOU,1996,74,651.0,200,26,51,105,156,19,14,22,65,73,179,0.4078212290502793,37,98,0.3775510204081632,36,81,0.4444444444444444,0.511,17,26,0.6538461538461539
Randolph Childress,childra01,PG,23,POR,1996,28,250.0,85,32,1,18,19,8,1,28,22,25,79,0.3164556962025316,13,47,0.2765957446808511,12,32,0.375,0.399,22,27,0.8148148148148148
Chris Childs,childch01,PG,28,NJN,1996,78,2408.0,1002,548,51,194,245,111,8,230,246,324,778,0.416452442159383,95,259,0.3667953667953668,229,519,0.441233140655106,0.478,259,304,0.8519736842105263
Doug Christie,chrisdo01,SF,25,TOT,1996,55,1036.0,415,117,34,120,154,70,19,95,141,150,337,0.4451038575667655,46,106,0.4339622641509434,104,231,0.4502164502164502,0.513,69,93,0.7419354838709677
Robert Churchwell,churcro01,SG,23,GSW,1996,4,20.0,6,1,0,3,3,0,0,2,1,3,8,0.375,0,0,0.0,3,8,0.375,0.375,0,0,0.0
Charles Claxton,claxtch01,C,25,BOS,1996,3,7.0,2,0,2,0,2,0,1,1,4,1,2,0.5,0,0,0.0,1,2,0.5,0.5,0,2,0.0
John Coker,cokerjo01,C,24,PHO,1996,5,11.0,8,1,2,0,2,0,1,0,1,4,5,0.8,0,0,0.0,4,5,0.8,0.8,0,0,0.0
Derrick Coleman,colemde01,PF,28,PHI,1996,11,294.0,123,31,13,59,72,4,10,28,30,48,118,0.4067796610169492,7,21,0.3333333333333333,41,97,0.422680412371134,0.436,20,32,0.625
Bimbo Coles,colesbi01,PG,27,TOT,1996,81,2615.0,892,422,49,211,260,94,17,171,253,318,777,0.4092664092664093,88,254,0.3464566929133858,230,523,0.4397705544933078,0.466,168,211,0.7962085308056872
Marty Conlon,conloma01,C,28,MIL,1996,74,958.0,395,68,58,119,177,20,11,79,126,153,327,0.4678899082568807,5,30,0.1666666666666666,148,297,0.4983164983164983,0.476,84,110,0.7636363636363637
Anthony Cook,cookan01,PF,28,POR,1996,11,60.0,15,2,5,7,12,0,1,1,8,7,16,0.4375,0,2,0.0,7,14,0.5,0.438,1,4,0.25
Tyrone Corbin,corbity01,SF,33,TOT,1996,71,1284.0,413,84,81,163,244,63,20,67,147,155,351,0.4415954415954416,3,18,0.1666666666666666,152,333,0.4564564564564564,0.446,100,120,0.8333333333333334
Joe Courtney,courtjo01,PF,26,CLE,1996,23,200.0,38,9,24,25,49,5,6,17,35,15,35,0.4285714285714285,0,0,0.0,15,35,0.4285714285714285,0.429,8,18,0.4444444444444444
John Crotty,crottjo01,PG,26,CLE,1996,58,617.0,172,102,20,34,54,22,6,51,60,51,114,0.4473684210526316,8,27,0.2962962962962963,43,87,0.4942528735632184,0.482,62,72,0.8611111111111112
Terry Cummings,cummite01,PF,34,MIL,1996,81,1777.0,645,89,162,283,445,56,30,69,263,270,584,0.4623287671232877,1,7,0.1428571428571428,269,577,0.4662045060658579,0.463,104,160,0.65
Dell Curry,curryde01,SG,31,CHH,1996,82,2371.0,1192,176,68,196,264,108,25,130,173,441,974,0.4527720739219713,164,406,0.4039408866995074,277,568,0.4876760563380282,0.537,146,171,0.8538011695906432
Michael Curry,currymi01,SG-SF,27,TOT,1996,46,783.0,211,27,27,58,85,24,2,24,92,73,161,0.453416149068323,20,53,0.3773584905660377,53,108,0.4907407407407407,0.516,45,62,0.7258064516129032
Rastko Cvetković,cvetkra01,C,25,DEN,1996,14,48.0,10,3,4,7,11,2,1,3,11,5,16,0.3125,0,1,0.0,5,15,0.3333333333333333,0.313,0,4,0.0
Sasha Danilović,danilsa01,SG,25,MIA,1996,19,542.0,255,47,12,34,46,15,3,37,49,83,184,0.4510869565217391,34,78,0.4358974358974359,49,106,0.4622641509433962,0.543,55,72,0.7638888888888888
Yinka Dare,dareyi01,C,23,NJN,1996,58,626.0,164,0,56,125,181,8,40,72,117,63,144,0.4375,0,0,0.0,63,144,0.4375,0.438,38,62,0.6129032258064516
Antonio Davis,davisan01,PF,27,IND,1996,82,2092.0,719,43,188,313,501,33,66,87,248,236,482,0.4896265560165975,1,2,0.5,235,480,0.4895833333333333,0.491,246,345,0.7130434782608696
Dale Davis,davisda01,PF,26,IND,1996,78,2617.0,803,76,252,457,709,56,112,119,238,334,599,0.5575959933222037,0,0,0.0,334,599,0.5575959933222037,0.558,135,289,0.4671280276816609
Hubert Davis,davishu01,SG,25,NYK,1996,74,1773.0,789,103,35,88,123,31,8,63,120,275,566,0.4858657243816254,127,267,0.4756554307116105,148,299,0.4949832775919732,0.598,112,129,0.8682170542635659
Mark Davis,davisma02,SF,22,MIN,1996,57,571.0,188,47,56,69,125,40,22,68,92,55,149,0.3691275167785235,4,13,0.3076923076923077,51,136,0.375,0.383,74,116,0.6379310344827587
Terry Davis,daviste01,PF,28,DAL,1996,28,501.0,137,21,43,74,117,10,4,25,66,55,108,0.5092592592592593,0,0,0.0,55,108,0.5092592592592593,0.509,27,47,0.574468085106383
Todd Day,dayto01,SG,26,TOT,1996,79,1807.0,922,107,70,154,224,81,51,109,225,299,817,0.3659730722154223,100,302,0.3311258278145695,199,515,0.3864077669902913,0.427,224,287,0.7804878048780488
Andrew DeClercq,declean01,C,22,GSW,1996,22,203.0,59,9,18,21,39,7,5,4,30,24,50,0.48,0,1,0.0,24,49,0.4897959183673469,0.48,11,19,0.5789473684210527
Terry Dehere,deherte01,PG,24,LAC,1996,82,2018.0,1016,350,41,102,143,54,16,191,239,315,686,0.4591836734693877,139,316,0.439873417721519,176,370,0.4756756756756757,0.56,247,327,0.7553516819571865
Vinny Del Negro,delnevi01,SG,29,SAS,1996,82,2766.0,1191,315,36,236,272,85,6,100,166,478,962,0.4968814968814969,57,150,0.38,421,812,0.5184729064039408,0.527,178,214,0.8317757009345794
Bison Dele,delebi01,C,26,LAC,1996,65,2157.0,1029,122,149,343,492,70,55,190,226,416,766,0.5430809399477807,1,6,0.1666666666666666,415,760,0.5460526315789473,0.544,196,267,0.7340823970037453
Dell Demps,dempsde01,SG,25,SAS,1996,16,87.0,53,8,2,7,9,3,1,12,10,19,33,0.5757575757575758,1,2,0.5,18,31,0.5806451612903226,0.591,14,17,0.8235294117647058
Vlade Divac,divacvl01,C,27,LAL,1996,79,2470.0,1020,261,198,481,679,76,131,199,274,414,807,0.5130111524163569,3,18,0.1666666666666666,411,789,0.5209125475285171,0.515,189,295,0.6406779661016949
Sherman Douglas,douglsh01,PG,29,TOT,1996,79,2335.0,890,436,55,125,180,63,5,194,163,345,685,0.5036496350364964,40,110,0.3636363636363636,305,575,0.5304347826086957,0.533,160,219,0.730593607305936
Clyde Drexler,drexlcl01,SG,33,HOU,1996,52,1997.0,1005,302,97,276,373,105,24,134,153,331,764,0.4332460732984293,78,235,0.3319148936170212,253,529,0.4782608695652174,0.484,265,338,0.7840236686390533
Kevin Duckworth,duckwke01,C,31,MIL,1996,8,58.0,9,2,2,5,7,2,0,2,19,3,14,0.2142857142857142,0,0,0.0,3,14,0.2142857142857142,0.214,3,6,0.5
Chris Dudley,dudlech02,C,30,POR,1996,80,1924.0,404,37,239,481,720,41,100,79,251,162,358,0.4525139664804469,0,1,0.0,162,357,0.453781512605042,0.453,80,157,0.5095541401273885
Joe Dumars,dumarjo01,PG,32,DET,1996,67,2193.0,793,265,28,110,138,43,3,97,106,255,598,0.4264214046822742,121,298,0.4060402684563758,134,300,0.4466666666666666,0.528,162,197,0.8223350253807107
Richard Dumas,dumasri02,PF,26,PHI,1996,39,739.0,241,44,42,57,99,42,6,49,79,95,203,0.4679802955665024,2,9,0.2222222222222222,93,194,0.4793814432989691,0.473,49,70,0.7
Tony Dumas,dumasto01,SG,23,DAL,1996,67,1284.0,776,99,58,57,115,42,13,77,128,274,655,0.4183206106870229,74,207,0.357487922705314,200,448,0.4464285714285714,0.475,154,257,0.5992217898832685
Ledell Eackles,eacklle01,SG,29,WSB,1996,55,1238.0,474,86,44,104,148,28,3,57,84,161,377,0.4270557029177719,54,128,0.421875,107,249,0.429718875502008,0.499,98,118,0.8305084745762712
Acie Earl,earlac01,C,25,TOR,1996,42,655.0,316,27,51,78,129,18,37,49,73,117,276,0.4239130434782608,0,3,0.0,117,273,0.4285714285714285,0.424,82,114,0.7192982456140351
Tyus Edney,edneyty01,PG,22,SAC,1996,80,2481.0,860,491,63,138,201,89,3,192,203,305,740,0.4121621621621621,53,144,0.3680555555555556,252,596,0.4228187919463087,0.448,197,252,0.7817460317460317
Blue Edwards,edwarbl01,SF,30,VAN,1996,82,2773.0,1043,212,98,248,346,118,46,170,243,401,956,0.4194560669456067,84,245,0.3428571428571428,317,711,0.4458509142053445,0.463,157,208,0.7548076923076923
Doug Edwards,edwardo01,PF,25,VAN,1996,31,519.0,93,39,35,52,87,10,18,29,51,32,91,0.3516483516483517,0,4,0.0,32,87,0.367816091954023,0.352,29,38,0.7631578947368421
James Edwards,edwarja01,C,40,CHI,1996,28,274.0,98,11,15,25,40,1,8,21,61,41,110,0.3727272727272727,0,0,0.0,41,110,0.3727272727272727,0.373,16,26,0.6153846153846154
Kevin Edwards,edwarke01,SG,30,NJN,1996,34,1007.0,394,71,14,61,75,54,7,68,67,142,390,0.3641025641025641,42,104,0.4038461538461538,100,286,0.3496503496503496,0.418,68,84,0.8095238095238095
Craig Ehlo,ehlocr01,SG,34,ATL,1996,79,1758.0,669,138,65,191,256,85,9,104,138,253,591,0.428087986463621,82,221,0.3710407239819004,171,370,0.4621621621621621,0.497,81,103,0.7864077669902912
Howard Eisley,eisleho01,PG,23,UTA,1996,65,961.0,287,146,22,56,78,29,3,77,130,104,242,0.4297520661157025,14,62,0.2258064516129032,90,180,0.5,0.459,65,77,0.8441558441558441
Mario Elie,eliema01,SF,32,HOU,1996,45,1385.0,499,138,47,108,155,45,11,59,93,180,357,0.5042016806722689,41,127,0.3228346456692913,139,230,0.6043478260869565,0.562,98,115,0.8521739130434782
Sean Elliott,elliose01,SF,27,SAS,1996,77,2901.0,1537,211,69,327,396,69,33,198,178,525,1127,0.4658385093167702,161,392,0.4107142857142857,364,735,0.4952380952380952,0.537,326,423,0.7706855791962175
Dale Ellis,ellisda01,SF,35,DEN,1996,81,2626.0,1204,139,88,227,315,57,7,98,191,459,959,0.4786235662148071,150,364,0.412087912087912,309,595,0.519327731092437,0.557,136,179,0.7597765363128491
LaPhonso Ellis,ellisla01,SF,25,DEN,1996,45,1269.0,471,74,93,229,322,36,33,83,163,189,432,0.4375,4,22,0.1818181818181818,185,410,0.4512195121951219,0.442,89,148,0.6013513513513513
LeRon Ellis,ellisle02,C,26,MIA,1996,12,74.0,13,4,5,3,8,2,3,3,11,5,22,0.2272727272727272,0,0,0.0,5,22,0.2272727272727272,0.227,3,6,0.5
Pervis Ellison,ellispe01,C,28,BOS,1996,69,1431.0,365,62,151,300,451,39,99,84,207,145,295,0.4915254237288136,0,0,0.0,145,295,0.4915254237288136,0.492,75,117,0.6410256410256411
Vincenzo Esposito,esposvi01,PG,26,TOR,1996,30,282.0,116,23,4,12,16,7,0,39,27,36,100,0.36,13,56,0.2321428571428571,23,44,0.5227272727272727,0.425,31,39,0.7948717948717948
Patrick Ewing,ewingpa01,C,33,NYK,1996,76,2783.0,1711,160,157,649,806,68,184,221,247,678,1456,0.4656593406593406,4,28,0.1428571428571428,674,1428,0.4719887955182072,0.467,351,461,0.7613882863340564
Duane Ferrell,ferredu01,SF,30,IND,1996,54,591.0,202,30,32,61,93,23,3,34,83,80,166,0.4819277108433735,0,8,0.0,80,158,0.5063291139240507,0.482,42,57,0.7368421052631579
Danny Ferry,ferryda01,PF,29,CLE,1996,82,2680.0,1090,191,71,238,309,57,37,122,233,422,919,0.4591947769314472,143,363,0.3939393939393939,279,556,0.5017985611510791,0.537,103,134,0.7686567164179104
Michael Finley,finlemi01,SF,22,PHO,1996,82,3212.0,1233,289,139,235,374,85,31,133,199,465,976,0.4764344262295082,61,186,0.3279569892473118,404,790,0.5113924050632911,0.508,242,323,0.7492260061919505
Matt Fish,fishma01,C,26,TOT,1996,18,134.0,52,8,10,11,21,3,7,3,19,21,36,0.5833333333333334,0,0,0.0,21,36,0.5833333333333334,0.583,10,19,0.5263157894736842
Vern Fleming,flemive01,PG,33,NJN,1996,77,1747.0,590,255,49,121,170,41,5,122,115,227,524,0.433206106870229,3,28,0.1071428571428571,224,496,0.4516129032258064,0.436,133,177,0.751412429378531
Sherell Ford,fordsh01,SF,23,SEA,1996,28,139.0,90,5,12,12,24,8,1,6,27,30,80,0.375,4,25,0.16,26,55,0.4727272727272727,0.4,26,34,0.7647058823529411
Greg Foster,fostegr01,C,27,UTA,1996,73,803.0,276,25,53,125,178,7,22,58,120,107,244,0.4385245901639344,1,8,0.125,106,236,0.4491525423728814,0.441,61,72,0.8472222222222222
Rick Fox,foxri01,SF,26,BOS,1996,81,2588.0,1137,369,158,292,450,113,41,216,290,421,928,0.4536637931034483,99,272,0.3639705882352941,322,656,0.4908536585365853,0.507,196,254,0.7716535433070866
Kevin Gamble,gamblke01,SF,30,TOT,1996,65,1325.0,386,100,21,92,113,35,8,43,147,152,379,0.4010554089709762,44,114,0.3859649122807017,108,265,0.4075471698113208,0.459,38,48,0.7916666666666666
Kevin Garnett,garneke01,SF,19,MIN,1996,80,2293.0,835,145,175,326,501,86,131,110,189,361,735,0.491156462585034,8,28,0.2857142857142857,353,707,0.4992927864214992,0.497,105,149,0.7046979865771812
Chris Gatling,gatlich01,PF,28,TOT,1996,71,1427.0,791,43,129,288,417,36,40,95,217,326,567,0.5749559082892416,0,1,0.0,326,566,0.5759717314487632,0.575,139,207,0.6714975845410628
Kenny Gattison,gattike01,PF,31,VAN,1996,25,570.0,229,14,35,79,114,10,11,40,75,91,190,0.4789473684210526,0,0,0.0,91,190,0.4789473684210526,0.479,47,78,0.6025641025641025
Matt Geiger,geigema01,C,26,CHH,1996,77,2349.0,866,60,201,448,649,46,63,137,290,357,666,0.536036036036036,3,8,0.375,354,658,0.5379939209726444,0.538,149,205,0.7268292682926829
Kendall Gill,gillke01,SG,27,TOT,1996,47,1683.0,656,260,72,160,232,64,24,131,131,246,524,0.4694656488549618,26,79,0.3291139240506329,220,445,0.4943820224719101,0.494,138,176,0.7840909090909091
Armen Gilliam,gilliar01,SF,31,NJN,1996,78,2856.0,1429,140,241,472,713,73,53,177,180,576,1216,0.4736842105263157,0,1,0.0,576,1215,0.4740740740740741,0.474,277,350,0.7914285714285715
Gerald Glass,glassge01,SF,28,TOT,1996,15,71.0,26,4,6,2,8,3,1,0,10,12,33,0.3636363636363636,1,6,0.1666666666666666,11,27,0.4074074074074074,0.379,1,1,1.0
Anthony Goldwire,goldwan01,PG,24,CHH,1996,42,621.0,231,112,8,35,43,16,0,63,79,76,189,0.4021164021164021,33,83,0.3975903614457831,43,106,0.4056603773584906,0.489,46,60,0.7666666666666667
Greg Graham,grahagr01,SG,25,TOT,1996,53,613.0,240,52,17,40,57,25,1,46,64,78,193,0.4041450777202072,32,82,0.3902439024390244,46,111,0.4144144144144144,0.487,52,68,0.7647058823529411
Ron Grandison,grandro01,PF,31,TOT,1996,28,311.0,65,13,20,35,55,12,2,12,31,22,58,0.3793103448275862,4,14,0.2857142857142857,18,44,0.4090909090909091,0.414,17,25,0.68
Brian Grant,grantbr01,PF,23,SAC,1996,78,2398.0,1120,127,175,370,545,40,103,185,269,427,842,0.5071258907363421,4,17,0.2352941176470588,423,825,0.5127272727272727,0.51,262,358,0.7318435754189944
Gary Grant,grantga01,PG,30,NYK,1996,47,596.0,232,69,12,40,52,39,3,45,91,88,181,0.4861878453038674,8,24,0.3333333333333333,80,157,0.5095541401273885,0.508,48,58,0.8275862068965517
Greg Grant,grantgr01,PG,29,TOT,1996,31,527.0,83,97,7,27,34,22,2,30,43,35,99,0.3535353535353535,8,34,0.2352941176470588,27,65,0.4153846153846154,0.394,5,6,0.8333333333333334
Harvey Grant,grantha01,PF,30,POR,1996,76,2394.0,709,111,117,244,361,60,43,82,173,314,679,0.4624447717231222,21,67,0.3134328358208955,293,612,0.4787581699346405,0.478,60,110,0.5454545454545454
Horace Grant,grantho01,PF,30,ORL,1996,63,2286.0,847,170,178,402,580,62,74,64,144,347,677,0.5125553914327917,1,6,0.1666666666666666,346,671,0.5156482861400894,0.513,152,207,0.7342995169082126
A.C. Green,greenac01,SF,32,PHO,1996,82,2113.0,612,72,166,388,554,45,23,79,141,215,444,0.4842342342342342,14,52,0.2692307692307692,201,392,0.5127551020408163,0.5,168,237,0.7088607594936709
Tom Gugliotta,guglito01,PF,26,MIN,1996,78,2835.0,1261,238,176,514,690,139,96,234,265,473,1004,0.4711155378486056,26,86,0.3023255813953488,447,918,0.4869281045751634,0.484,289,374,0.7727272727272727
Jack Haley,haleyja01,C,32,CHI,1996,1,7.0,5,0,1,1,2,0,0,1,2,2,6,0.3333333333333333,0,0,0.0,2,6,0.3333333333333333,0.333,1,2,0.5
Thomas Hamilton,hamilth01,C,20,BOS,1996,11,70.0,25,1,10,12,22,0,9,9,12,9,31,0.2903225806451613,0,0,0.0,9,31,0.2903225806451613,0.29,7,18,0.3888888888888889
Geert Hammink,hammige01,C,26,TOT,1996,6,17.0,8,0,2,2,4,0,0,2,2,2,4,0.5,0,0,0.0,2,4,0.5,0.5,4,7,0.5714285714285714
Tom Hammonds,hammoto01,PF,28,DEN,1996,71,1045.0,342,23,85,138,223,23,13,48,137,127,268,0.4738805970149253,0,0,0.0,127,268,0.4738805970149253,0.474,88,115,0.7652173913043478
Darrin Hancock,hancoda01,SF,24,CHH,1996,63,838.0,272,47,40,58,98,28,5,56,94,112,214,0.5233644859813084,1,3,0.3333333333333333,111,211,0.5260663507109005,0.526,47,73,0.6438356164383562
Anfernee Hardaway,hardaan01,PG,24,ORL,1996,82,3015.0,1780,582,129,225,354,166,41,229,160,623,1215,0.5127572016460905,89,283,0.3144876325088339,534,932,0.572961373390558,0.549,445,580,0.7672413793103449
Tim Hardaway,hardati01,PG,29,TOT,1996,80,2534.0,1217,640,35,194,229,132,17,235,201,419,992,0.4223790322580645,138,379,0.3641160949868074,281,613,0.4584013050570962,0.492,241,305,0.7901639344262295
Derek Harper,harpede01,PG,34,NYK,1996,82,2893.0,1149,352,32,170,202,131,5,178,201,436,939,0.4643237486687966,121,325,0.3723076923076923,315,614,0.5130293159609121,0.529,156,206,0.7572815533980582
Ron Harper,harpero01,PG,32,CHI,1996,80,1886.0,594,208,74,139,213,105,32,73,137,234,501,0.467065868263473,28,104,0.2692307692307692,206,397,0.5188916876574308,0.495,98,139,0.7050359712230215
Lucious Harris,harrilu01,SG,25,DAL,1996,61,1016.0,481,79,41,81,122,35,3,46,56,183,397,0.4609571788413098,47,125,0.376,136,272,0.5,0.52,68,87,0.7816091954022989
Antonio Harvey,harvean01,PF,25,TOT,1996,55,821.0,204,15,69,131,200,27,47,44,76,83,224,0.3705357142857143,0,2,0.0,83,222,0.3738738738738739,0.371,38,83,0.4578313253012048
Hersey Hawkins,hawkihe01,SG,29,SEA,1996,82,2823.0,1281,218,86,211,297,149,14,164,172,443,936,0.4732905982905983,146,380,0.3842105263157894,297,556,0.5341726618705036,0.551,249,285,0.8736842105263158
Alvin Heggs,heggsal01,SF,28,HOU,1996,4,14.0,8,0,1,1,2,0,0,0,0,3,5,0.6,0,0,0.0,3,5,0.6,0.6,2,3,0.6666666666666666
Alan Henderson,hendeal01,PF,23,ATL,1996,79,1416.0,503,51,164,192,356,44,43,87,217,192,434,0.4423963133640553,0,3,0.0,192,431,0.445475638051044,0.442,119,200,0.595
Carl Herrera,herreca01,PF,29,SAS,1996,44,393.0,85,16,30,51,81,9,8,29,61,40,97,0.4123711340206185,0,1,0.0,40,96,0.4166666666666667,0.412,5,17,0.2941176470588235
Sean Higgins,higgise01,SF,27,PHI,1996,44,916.0,351,55,20,72,92,24,11,49,90,134,323,0.4148606811145511,48,129,0.3720930232558139,86,194,0.4432989690721649,0.489,35,37,0.945945945945946
Grant Hill,hillgr01,SF,23,DET,1996,80,3260.0,1618,548,127,656,783,100,48,263,242,564,1221,0.4619164619164619,5,26,0.1923076923076923,559,1195,0.4677824267782426,0.464,485,646,0.7507739938080495
Tyrone Hill,hillty01,PF,27,CLE,1996,44,929.0,341,33,94,150,244,31,20,64,144,130,254,0.5118110236220472,0,0,0.0,130,254,0.5118110236220472,0.512,81,135,0.6
Donald Hodge,hodgedo01,C,26,TOT,1996,15,115.0,18,4,9,14,23,1,8,2,26,9,24,0.375,0,0,0.0,9,24,0.375,0.375,0,0,0.0
Fred Hoiberg,hoibefr01,SG,23,IND,1996,15,85.0,32,8,4,5,9,6,1,7,12,8,19,0.4210526315789473,1,3,0.3333333333333333,7,16,0.4375,0.447,15,18,0.8333333333333334
Jeff Hornacek,hornaje01,SG,32,UTA,1996,82,2588.0,1247,340,62,147,209,106,20,127,171,442,880,0.5022727272727273,104,223,0.4663677130044843,338,657,0.5144596651445966,0.561,259,290,0.8931034482758621
Robert Horry,horryro01,SF,25,HOU,1996,71,2634.0,853,281,97,315,412,116,109,160,197,300,732,0.4098360655737705,142,388,0.3659793814432989,158,344,0.4593023255813953,0.507,111,143,0.7762237762237763
Allan Houston,houstal01,SG,24,DET,1996,82,3072.0,1617,250,54,246,300,61,16,233,233,564,1244,0.4533762057877814,191,447,0.4272930648769575,373,797,0.4680050188205771,0.53,298,362,0.8232044198895028
Byron Houston,houstby01,PF,26,SAC,1996,25,276.0,86,7,31,53,84,13,7,17,59,32,64,0.5,1,3,0.3333333333333333,31,61,0.5081967213114754,0.508,21,26,0.8076923076923077
Juwan Howard,howarju01,PF,22,WSB,1996,81,3294.0,1789,360,188,472,660,67,39,303,269,733,1500,0.4886666666666667,4,13,0.3076923076923077,729,1487,0.4902488231338265,0.49,319,426,0.7488262910798122
Lindsey Hunter,hunteli01,PG,25,DET,1996,80,2138.0,679,188,44,150,194,84,18,80,185,239,628,0.3805732484076433,117,289,0.4048442906574394,122,339,0.359882005899705,0.474,84,120,0.7
Bobby Hurley,hurlebo01,PG,24,SAC,1996,72,1059.0,220,216,12,63,75,28,3,86,121,65,230,0.2826086956521739,22,76,0.2894736842105263,43,154,0.2792207792207792,0.33,68,85,0.8
Jaren Jackson,jacksja01,SG,28,HOU,1996,4,33.0,8,0,0,3,3,1,0,0,5,0,8,0.0,0,5,0.0,0,3,0.0,0.0,8,10,0.8
Jim Jackson,jacksji01,SG,25,DAL,1996,82,2820.0,1604,235,173,237,410,47,22,191,165,569,1308,0.4350152905198777,121,333,0.3633633633633634,448,975,0.4594871794871795,0.481,345,418,0.8253588516746412
Mark Jackson,jacksma01,PG,30,IND,1996,81,2643.0,806,635,66,241,307,100,5,201,153,296,626,0.4728434504792332,64,149,0.4295302013422818,232,477,0.4863731656184486,0.524,150,191,0.7853403141361257
Henry James,jameshe01,PF,30,HOU,1996,7,58.0,30,2,3,3,6,0,0,4,13,10,24,0.4166666666666667,5,15,0.3333333333333333,5,9,0.5555555555555556,0.521,5,5,1.0
Avery Johnson,johnsav01,PG,30,SAS,1996,82,3084.0,1071,789,37,169,206,119,21,195,179,438,887,0.4937993235625704,6,31,0.1935483870967742,432,856,0.5046728971962616,0.497,189,262,0.7213740458015268
Darryl Johnson,johnsda02,PG,30,CLE,1996,11,28.0,12,1,2,0,2,0,0,1,3,5,12,0.4166666666666667,0,1,0.0,5,11,0.4545454545454545,0.417,2,2,1.0
Eddie Johnson,johnsed03,SF,36,IND,1996,62,1002.0,475,69,45,108,153,20,4,56,104,180,436,0.4128440366972477,45,128,0.3515625,135,308,0.4383116883116883,0.464,70,79,0.8860759493670886
Ervin Johnson,johnser02,C,28,SEA,1996,81,1519.0,446,48,129,304,433,40,129,98,245,180,352,0.5113636363636364,1,3,0.3333333333333333,179,349,0.5128939828080229,0.513,85,127,0.6692913385826772
Kevin Johnson,johnske02,PG,29,PHO,1996,56,2007.0,1047,517,42,179,221,82,13,170,144,342,674,0.5074183976261127,21,57,0.3684210526315789,321,617,0.520259319286872,0.523,342,398,0.8592964824120602
Larry Johnson,johnsla02,PF,26,CHH,1996,81,3274.0,1660,355,249,434,683,55,43,182,173,583,1225,0.4759183673469387,67,183,0.366120218579235,516,1042,0.4952015355086372,0.503,427,564,0.7570921985815603
Magic Johnson,johnsma02,PF,36,LAL,1996,32,958.0,468,220,40,143,183,26,13,103,48,137,294,0.4659863945578231,22,58,0.3793103448275862,115,236,0.4872881355932203,0.503,172,201,0.8557213930348259
Charles Jones,jonesch01,PF,38,HOU,1996,46,297.0,16,12,28,46,74,5,24,3,44,6,19,0.3157894736842105,0,0,0.0,6,19,0.3157894736842105,0.316,4,13,0.3076923076923077
Eddie Jones,jonesed02,SG,24,LAL,1996,70,2184.0,893,246,45,188,233,129,45,99,162,337,685,0.491970802919708,83,227,0.3656387665198238,254,458,0.5545851528384279,0.553,136,184,0.7391304347826086
Popeye Jones,jonespo01,PF,25,DAL,1996,68,2322.0,770,132,260,477,737,54,27,109,262,327,733,0.4461118690313779,14,39,0.358974358974359,313,694,0.4510086455331412,0.456,102,133,0.7669172932330827
Michael Jordan,jordami01,SG,32,CHI,1996,82,3090.0,2491,352,148,395,543,180,42,197,195,916,1850,0.4951351351351351,111,260,0.4269230769230769,805,1590,0.5062893081761006,0.525,548,657,0.8340943683409436
Reggie Jordan,jordare01,PG,28,ATL,1996,24,247.0,94,29,23,29,52,12,7,19,30,36,71,0.5070422535211268,0,0,0.0,36,71,0.5070422535211268,0.507,22,38,0.5789473684210527
Adam Keefe,keefead01,PF,25,UTA,1996,82,1708.0,499,64,176,279,455,51,41,88,174,180,346,0.5202312138728323,0,4,0.0,180,342,0.5263157894736842,0.52,139,201,0.6915422885572139
Shawn Kemp,kempsh01,PF,26,SEA,1996,79,2631.0,1550,173,276,628,904,93,127,315,299,526,937,0.5613660618996799,5,12,0.4166666666666667,521,925,0.5632432432432433,0.564,493,664,0.7424698795180723
Tim Kempton,kemptti01,PF,32,ATL,1996,3,11.0,0,1,0,2,2,0,0,1,5,0,0,0.0,0,0,0.0,0,0,0.0,0.0,0,0,0.0
Steve Kerr,kerrst01,PG,30,CHI,1996,82,1919.0,688,192,25,85,110,63,2,42,109,244,482,0.5062240663900415,122,237,0.5147679324894515,122,245,0.4979591836734693,0.633,78,84,0.9285714285714286
Jerome Kersey,kerseje01,SF,33,GSW,1996,76,1620.0,510,114,154,209,363,91,45,75,205,205,500,0.41,3,17,0.1764705882352941,202,483,0.4182194616977225,0.413,97,147,0.6598639455782312
Randolph Keys,keysra01,SF,29,MIL,1996,69,816.0,232,65,41,84,125,32,14,33,139,87,208,0.4182692307692308,22,71,0.3098591549295774,65,137,0.4744525547445255,0.471,36,43,0.8372093023255814
Jason Kidd,kiddja01,PG,22,DAL,1996,81,3034.0,1348,783,203,350,553,175,26,328,155,493,1293,0.3812838360402165,133,396,0.3358585858585858,360,897,0.4013377926421405,0.433,229,331,0.6918429003021148
Chris King,kingch01,SF,26,VAN,1996,80,1930.0,634,104,102,183,285,68,33,103,163,250,585,0.4273504273504273,44,113,0.3893805309734513,206,472,0.4364406779661017,0.465,90,136,0.6617647058823529
Frankie King,kingfr01,PG,23,LAL,1996,6,20.0,7,2,1,1,2,2,0,2,4,3,11,0.2727272727272727,0,1,0.0,3,10,0.3,0.273,1,3,0.3333333333333333
Jimmy King,kingji02,SG,22,TOR,1996,62,868.0,279,88,43,67,110,21,13,60,76,110,255,0.4313725490196078,5,34,0.1470588235294117,105,221,0.4751131221719457,0.441,54,77,0.7012987012987013
Stacey King,kingst01,PF,29,MIA,1996,15,156.0,38,2,9,14,23,7,2,18,39,17,36,0.4722222222222222,0,0,0.0,17,36,0.4722222222222222,0.472,4,8,0.5
Joe Kleine,kleinjo01,C,34,PHO,1996,56,663.0,164,44,36,96,132,13,6,37,113,71,169,0.4201183431952662,2,7,0.2857142857142857,69,162,0.4259259259259259,0.426,20,25,0.8
Jon Koncak,koncajo01,C,32,ORL,1996,67,1288.0,203,51,63,209,272,27,44,41,226,84,175,0.48,3,9,0.3333333333333333,81,166,0.4879518072289157,0.489,32,57,0.5614035087719298
Toni Kukoč,kukocto01,SF,27,CHI,1996,81,2103.0,1065,287,115,208,323,64,28,114,150,386,787,0.4904701397712833,87,216,0.4027777777777778,299,571,0.5236427320490368,0.546,206,267,0.7715355805243446
Christian Laettner,laettch01,C,26,TOT,1996,74,2495.0,1217,197,184,354,538,71,71,187,276,442,907,0.4873208379272326,9,39,0.2307692307692307,433,868,0.4988479262672811,0.492,324,396,0.8181818181818182
Andrew Lang,langan01,C,29,TOT,1996,71,2365.0,832,65,153,302,455,42,126,124,241,353,790,0.4468354430379747,1,5,0.2,352,785,0.4484076433121019,0.447,125,156,0.8012820512820513
Antonio Lang,langan02,SF,23,CLE,1996,41,367.0,116,12,17,36,53,14,12,24,61,41,77,0.5324675324675324,0,2,0.0,41,75,0.5466666666666666,0.532,34,47,0.723404255319149
Eric Leckner,leckner01,C,29,DET,1996,18,155.0,44,1,8,26,34,2,4,11,30,18,29,0.6206896551724138,0,0,0.0,18,29,0.6206896551724138,0.621,8,13,0.6153846153846154
Tim Legler,legleti01,SG,29,WSB,1996,77,1775.0,726,136,29,111,140,45,12,45,141,233,460,0.5065217391304347,128,245,0.5224489795918368,105,215,0.4883720930232558,0.646,132,153,0.8627450980392157
Voshon Lenard,lenarvo01,SG,22,MIA,1996,30,323.0,176,31,12,40,52,6,1,23,31,53,141,0.375886524822695,36,101,0.3564356435643564,17,40,0.425,0.504,34,43,0.7906976744186046
Cedric Lewis,lewisce01,C,26,WSB,1996,3,4.0,4,0,2,0,2,1,0,0,0,2,3,0.6666666666666666,0,0,0.0,2,3,0.6666666666666666,0.667,0,0,0.0
Martin Lewis,lewisma01,SF,20,TOR,1996,16,189.0,75,3,15,14,29,8,3,14,21,29,60,0.4833333333333333,2,7,0.2857142857142857,27,53,0.5094339622641509,0.5,15,25,0.6
Alton Lister,listeal01,C,37,TOT,1996,64,735.0,143,19,67,213,280,6,42,48,136,51,105,0.4857142857142857,0,0,0.0,51,105,0.4857142857142857,0.486,41,64,0.640625
Brad Lohaus,lohaubr01,PF,31,TOT,1996,55,598.0,197,44,7,57,64,10,17,20,70,71,175,0.4057142857142857,51,122,0.4180327868852459,20,53,0.3773584905660377,0.551,4,5,0.8
Grant Long,longgr01,PF,29,ATL,1996,82,3008.0,1078,183,248,540,788,108,34,157,233,395,838,0.4713603818615752,31,86,0.3604651162790697,364,752,0.4840425531914893,0.49,257,337,0.7626112759643917
Luc Longley,longllu01,C,27,CHI,1996,62,1641.0,564,119,104,214,318,22,84,114,223,242,502,0.4820717131474104,0,0,0.0,242,502,0.4820717131474104,0.482,80,103,0.7766990291262136
George Lynch,lynchge01,SF,25,LAL,1996,76,1012.0,291,51,82,127,209,47,10,40,106,117,272,0.4301470588235294,4,13,0.3076923076923077,113,259,0.4362934362934363,0.438,53,80,0.6625
Sam Mack,macksa01,SF,25,HOU,1996,31,868.0,335,79,18,80,98,22,9,28,75,121,287,0.4216027874564459,54,135,0.4,67,152,0.4407894736842105,0.516,39,46,0.8478260869565217
Don MacLean,macledo01,SF,26,DEN,1996,56,1107.0,625,89,62,143,205,21,5,68,105,233,547,0.4259597806215722,14,49,0.2857142857142857,219,498,0.4397590361445783,0.439,145,198,0.7323232323232324
Mark Macon,maconma01,PG,26,DET,1996,23,287.0,74,16,10,12,22,15,0,9,34,29,67,0.4328358208955223,7,15,0.4666666666666667,22,52,0.4230769230769231,0.485,9,11,0.8181818181818182
Rick Mahorn,mahorri01,C,37,NJN,1996,50,450.0,120,16,31,79,110,14,13,30,72,43,122,0.3524590163934426,0,1,0.0,43,121,0.3553719008264462,0.352,34,47,0.723404255319149
Dan Majerle,majerda01,SF,30,CLE,1996,82,2367.0,872,214,70,235,305,81,34,93,131,303,748,0.4050802139037433,146,414,0.3526570048309179,157,334,0.4700598802395209,0.503,120,169,0.7100591715976331
Jeff Malone,malonje01,SG,34,TOT,1996,32,510.0,186,26,8,32,40,16,0,22,25,76,193,0.3937823834196891,5,16,0.3125,71,177,0.4011299435028249,0.407,29,32,0.90625
Karl Malone,malonka01,PF,32,UTA,1996,82,3113.0,2106,345,175,629,804,138,56,199,245,789,1520,0.5190789473684211,16,40,0.4,773,1480,0.5222972972972973,0.524,512,708,0.7231638418079096
Danny Manning,mannida01,PF,29,PHO,1996,33,816.0,441,65,30,113,143,38,24,77,121,178,388,0.4587628865979381,3,14,0.2142857142857142,175,374,0.4679144385026738,0.463,82,109,0.7522935779816514
Rich Manning,manniri01,PF,25,VAN,1996,29,311.0,107,7,16,39,55,3,6,17,37,49,113,0.4336283185840708,0,1,0.0,49,112,0.4375,0.434,9,14,0.6428571428571429
Šarūnas Marčiulionis,marcisa01,SG,31,SAC,1996,53,1039.0,571,118,20,57,77,52,4,96,112,176,389,0.4524421593830334,64,157,0.4076433121019108,112,232,0.4827586206896552,0.535,155,200,0.775
Donny Marshall,marshdo02,SF,23,CLE,1996,34,208.0,77,7,9,17,26,8,2,7,26,24,68,0.3529411764705882,7,30,0.2333333333333333,17,38,0.4473684210526316,0.404,22,35,0.6285714285714286
Donyell Marshall,marshdo01,SF,22,GSW,1996,62,934.0,342,49,65,148,213,22,31,48,83,125,314,0.3980891719745223,28,94,0.2978723404255319,97,220,0.4409090909090909,0.443,64,83,0.7710843373493976
Cuonzo Martin,marticu01,SG,24,VAN,1996,4,19.0,9,2,1,1,2,1,0,1,1,3,5,0.6,3,3,1.0,0,2,0.0,0.9,0,2,0.0
Darrick Martin,martida01,PG,24,TOT,1996,59,1149.0,415,217,16,66,82,53,3,107,123,147,362,0.4060773480662983,20,69,0.2898550724637681,127,293,0.4334470989761092,0.434,101,120,0.8416666666666667
Jamal Mashburn,mashbja01,SF,23,DAL,1996,18,669.0,422,50,37,60,97,14,3,55,39,145,383,0.3785900783289817,35,102,0.3431372549019608,110,281,0.3914590747330961,0.424,97,133,0.7293233082706767
Anthony Mason,masonan01,SF,29,NYK,1996,82,3457.0,1196,363,220,544,764,69,34,211,246,449,798,0.5626566416040101,0,0,0.0,449,798,0.5626566416040101,0.563,298,414,0.7198067632850241
Tony Massenburg,masseto01,PF,28,TOT,1996,54,1463.0,539,30,127,225,352,28,20,73,140,214,432,0.4953703703703703,0,3,0.0,214,429,0.4988344988344988,0.495,111,157,0.7070063694267515
Vernon Maxwell,maxweve01,PG,30,PHI,1996,75,2467.0,1217,330,39,190,229,96,12,215,182,410,1052,0.3897338403041825,146,460,0.3173913043478261,264,592,0.4459459459459459,0.459,251,332,0.7560240963855421
Lee Mayberry,maybele01,PG,25,MIL,1996,82,1705.0,422,302,21,69,90,64,10,89,144,153,364,0.4203296703296703,75,189,0.3968253968253968,78,175,0.4457142857142857,0.523,41,68,0.6029411764705882
Bob McCann,mccanbo01,PF,31,WSB,1996,62,653.0,188,24,46,97,143,21,15,42,116,76,153,0.4967320261437908,1,2,0.5,75,151,0.4966887417218543,0.5,35,74,0.4729729729729729
George McCloud,mccloge01,SF,28,DAL,1996,79,2846.0,1497,212,116,263,379,113,38,166,212,530,1281,0.4137392661982826,257,678,0.3790560471976401,273,603,0.4527363184079602,0.514,180,224,0.8035714285714286
Clint McDaniel,mcdancl01,SG,23,SAC,1996,12,71.0,30,7,3,7,10,5,0,2,10,8,23,0.3478260869565217,2,6,0.3333333333333333,6,17,0.3529411764705882,0.391,12,16,0.75
Antonio McDyess,mcdyean01,PF,21,DEN,1996,76,2280.0,1020,75,229,343,572,54,114,154,250,427,881,0.4846765039727582,0,4,0.0,427,877,0.4868871151653364,0.485,166,243,0.6831275720164609
Jim McIlvaine,mcilvji01,C,23,WSB,1996,80,1195.0,182,11,66,164,230,21,166,36,171,62,145,0.4275862068965517,0,0,0.0,62,145,0.4275862068965517,0.428,58,105,0.5523809523809524
Derrick McKey,mckeyde01,SF,29,IND,1996,75,2440.0,879,262,123,238,361,83,44,143,246,346,712,0.4859550561797753,17,68,0.25,329,644,0.5108695652173914,0.498,170,221,0.7692307692307693
Aaron McKie,mckieaa01,SG,23,POR,1996,81,2259.0,864,205,86,218,304,92,21,135,205,337,722,0.4667590027700831,38,117,0.3247863247863248,299,605,0.4942148760330578,0.493,152,199,0.7638190954773869
Nate McMillan,mcmilna01,PG,31,SEA,1996,55,1261.0,275,197,41,169,210,95,18,75,143,100,238,0.4201680672268907,46,121,0.3801652892561983,54,117,0.4615384615384615,0.517,29,41,0.7073170731707317
Loren Meyer,meyerlo01,C,23,DAL,1996,72,1266.0,363,57,114,205,319,20,32,67,224,145,330,0.4393939393939394,3,11,0.2727272727272727,142,319,0.445141065830721,0.444,70,102,0.6862745098039216
Anthony Miller,millean01,PF,24,LAL,1996,27,123.0,36,4,11,14,25,4,1,8,19,15,35,0.4285714285714285,0,2,0.0,15,33,0.4545454545454545,0.429,6,10,0.6
Oliver Miller,milleol01,PF,25,TOR,1996,76,2516.0,982,219,177,385,562,108,143,202,277,418,795,0.5257861635220126,0,11,0.0,418,784,0.5331632653061225,0.526,146,221,0.6606334841628959
Reggie Miller,millere01,SG,30,IND,1996,76,2621.0,1606,253,38,176,214,77,13,189,175,504,1066,0.4727954971857411,168,410,0.4097560975609756,336,656,0.5121951219512195,0.552,430,498,0.8634538152610441
Chris Mills,millsch01,SF,26,CLE,1996,80,3060.0,1205,188,112,331,443,73,52,121,241,454,971,0.4675592173017507,79,210,0.3761904761904762,375,761,0.492772667542707,0.508,218,263,0.8288973384030418
Terry Mills,millste01,PF,28,DET,1996,82,1656.0,769,98,108,244,352,42,20,98,197,283,675,0.4192592592592593,82,207,0.3961352657004831,201,468,0.4294871794871794,0.48,121,157,0.7707006369426752
Harold Miner,minerha01,SG,24,CLE,1996,19,136.0,61,8,4,8,12,0,0,14,23,23,52,0.4423076923076923,2,10,0.2,21,42,0.5,0.462,13,13,1.0
Greg Minor,minorgr01,SG,24,BOS,1996,78,1761.0,746,146,93,164,257,36,11,78,161,320,640,0.5,7,27,0.2592592592592592,313,613,0.5106035889070146,0.505,99,130,0.7615384615384615
Sam Mitchell,mitchsa01,SF,32,MIN,1996,78,2145.0,844,74,107,232,339,49,26,87,220,303,618,0.4902912621359223,1,18,0.0555555555555555,302,600,0.5033333333333333,0.491,237,291,0.8144329896907216
Eric Mobley,mobleer01,C,25,TOT,1996,39,676.0,188,22,54,86,140,14,24,50,87,74,138,0.5362318840579711,1,2,0.5,73,136,0.5367647058823529,0.54,39,87,0.4482758620689655
Eric Montross,montrer01,C,24,BOS,1996,61,1432.0,442,43,119,233,352,19,29,83,181,196,346,0.5664739884393064,0,0,0.0,196,346,0.5664739884393064,0.566,50,133,0.3759398496240601
Tracy Moore,mooretr01,SG,30,HOU,1996,8,190.0,91,6,10,12,22,2,0,8,16,30,76,0.3947368421052631,13,30,0.4333333333333333,17,46,0.3695652173913043,0.48,18,19,0.9473684210526316
Chris Morris,morrich01,SG,30,UTA,1996,66,1424.0,691,77,100,129,229,63,20,71,140,265,606,0.4372937293729373,63,197,0.3197969543147208,202,409,0.4938875305623472,0.489,98,127,0.7716535433070866
Lawrence Moten,motenla01,SG,23,VAN,1996,44,573.0,291,50,36,25,61,29,8,44,54,112,247,0.4534412955465587,18,55,0.3272727272727272,94,192,0.4895833333333333,0.49,49,75,0.6533333333333333
Alonzo Mourning,mournal01,C,25,MIA,1996,70,2671.0,1623,159,218,509,727,70,189,262,245,563,1076,0.5232342007434945,9,30,0.3,554,1046,0.5296367112810707,0.527,488,712,0.6853932584269663
Chris Mullin,mullich01,SF,32,GSW,1996,55,1617.0,734,194,44,115,159,75,32,122,127,269,539,0.4990723562152133,59,150,0.3933333333333333,210,389,0.5398457583547558,0.554,137,160,0.85625
Todd Mundt,mundtto01,C,25,TOT,1996,33,151.0,37,3,11,17,28,2,5,3,29,16,41,0.3902439024390244,0,0,0.0,16,41,0.3902439024390244,0.39,5,8,0.625
Eric Murdock,murdoer01,PG,27,TOT,1996,73,1673.0,647,327,26,143,169,135,9,132,140,244,587,0.4156729131175468,45,145,0.3103448275862069,199,442,0.4502262443438914,0.454,114,143,0.7972027972027972
Gheorghe Mureșan,muresgh01,C,24,WSB,1996,76,2242.0,1104,56,248,480,728,52,172,143,297,466,798,0.5839598997493735,0,1,0.0,466,797,0.5846925972396487,0.584,172,278,0.6187050359712231
Lamond Murray,murrala01,SF,22,LAC,1996,77,1816.0,650,84,89,157,246,61,25,108,151,257,575,0.4469565217391304,37,116,0.3189655172413793,220,459,0.4793028322440087,0.479,99,132,0.75
Tracy Murray,murratr01,SF,24,TOR,1996,82,2458.0,1325,131,114,238,352,87,40,132,208,496,1092,0.4542124542124542,151,358,0.4217877094972067,345,734,0.4700272479564032,0.523,182,219,0.8310502283105022
Dikembe Mutombo,mutomdi01,C,29,DEN,1996,74,2713.0,814,108,249,622,871,38,332,150,258,284,569,0.4991212653778559,0,1,0.0,284,568,0.5,0.499,246,354,0.6949152542372882
Pete Myers,myerspe01,SG,32,TOT,1996,71,1092.0,276,145,35,105,140,34,17,81,132,91,247,0.3684210526315789,14,58,0.2413793103448276,77,189,0.4074074074074074,0.397,80,122,0.6557377049180327
Howard Nathan,nathaho01,PG,24,ATL,1996,5,15.0,13,2,0,0,0,3,0,8,2,5,9,0.5555555555555556,0,1,0.0,5,8,0.625,0.556,3,4,0.75
Johnny Newman,newmajo01,SG,32,MIL,1996,82,2690.0,889,154,66,134,200,90,15,108,257,321,649,0.4946070878274268,61,162,0.3765432098765432,260,487,0.5338809034907598,0.542,186,232,0.8017241379310345
Ken Norman,normake01,SF,31,ATL,1996,34,770.0,304,63,40,92,132,15,16,46,68,127,273,0.4652014652014652,33,84,0.3928571428571428,94,189,0.4973544973544973,0.526,17,48,0.3541666666666667
Ed O'Bannon,obanned01,SG,23,NJN,1996,64,1253.0,399,63,65,103,168,44,11,62,95,156,400,0.39,10,56,0.1785714285714285,146,344,0.4244186046511627,0.403,77,108,0.7129629629629629
Shaquille O'Neal,onealsh01,C,23,ORL,1996,54,1946.0,1434,155,182,414,596,34,115,155,193,592,1033,0.5730880929332043,1,2,0.5,591,1031,0.5732298739088264,0.574,249,511,0.487279843444227
Dan O'Sullivan,osullda01,C,27,TOR,1996,5,139.0,33,2,13,19,32,2,4,5,13,13,35,0.3714285714285714,0,1,0.0,13,34,0.3823529411764705,0.371,7,8,0.875
Charles Oakley,oaklech01,PF,32,NYK,1996,53,1775.0,604,137,162,298,460,58,14,104,195,211,448,0.4709821428571428,7,26,0.2692307692307692,204,422,0.4834123222748815,0.479,175,210,0.8333333333333334
Hakeem Olajuwon,olajuha01,C,33,HOU,1996,72,2797.0,1936,257,176,608,784,113,207,247,242,768,1494,0.5140562248995983,3,14,0.2142857142857142,765,1480,0.5168918918918919,0.515,397,548,0.7244525547445255
Greg Ostertag,ostergr01,C,22,UTA,1996,57,661.0,208,5,57,118,175,5,63,25,91,86,182,0.4725274725274725,0,0,0.0,86,182,0.4725274725274725,0.473,36,54,0.6666666666666666
Bo Outlaw,outlabo01,PF,24,LAC,1996,80,985.0,286,50,87,113,200,44,91,45,127,107,186,0.5752688172043011,0,3,0.0,107,183,0.5846994535519126,0.575,72,162,0.4444444444444444
Doug Overton,overtdo01,PG,26,DEN,1996,55,607.0,182,106,8,55,63,13,5,40,49,67,178,0.3764044943820224,8,26,0.3076923076923077,59,152,0.3881578947368421,0.399,40,55,0.7272727272727273
Billy Owens,owensbi01,SF,26,TOT,1996,62,1982.0,808,204,143,268,411,49,38,164,192,323,673,0.4799405646359584,5,18,0.2777777777777778,318,655,0.4854961832061069,0.484,157,247,0.6356275303643725
Robert Pack,packro01,PG,26,WSB,1996,31,1084.0,560,242,29,103,132,62,1,114,68,190,444,0.4279279279279279,26,98,0.2653061224489796,164,346,0.4739884393063583,0.457,154,182,0.8461538461538461
Robert Parish,parisro01,C,42,CHH,1996,74,1086.0,290,29,89,214,303,21,54,50,80,120,241,0.4979253112033195,0,0,0.0,120,241,0.4979253112033195,0.498,50,71,0.704225352112676
Cherokee Parks,parksch02,C,23,DAL,1996,64,869.0,250,29,66,150,216,25,32,31,100,101,247,0.4089068825910931,7,26,0.2692307692307692,94,221,0.4253393665158371,0.423,41,62,0.6612903225806451
Gary Payton,paytoga01,PG,27,SEA,1996,81,3162.0,1563,608,104,235,339,231,19,260,221,618,1276,0.4843260188087774,98,299,0.3277591973244147,520,977,0.5322415557830092,0.523,229,306,0.7483660130718954
Anthony Peeler,peelean01,SG,26,LAL,1996,73,1608.0,710,118,45,92,137,59,10,56,139,272,602,0.4518272425249169,105,254,0.4133858267716535,167,348,0.4798850574712643,0.539,61,86,0.7093023255813954
Mike Peplowski,peplomi01,C,25,TOT,1996,7,17.0,7,1,1,3,4,1,2,2,10,3,5,0.6,0,0,0.0,3,5,0.6,0.6,1,3,0.3333333333333333
Will Perdue,perduwi01,C,30,SAS,1996,80,1396.0,413,33,175,310,485,28,75,86,183,173,331,0.5226586102719033,0,1,0.0,173,330,0.5242424242424243,0.523,67,125,0.536
Sam Perkins,perkisa01,PF,34,SEA,1996,82,2169.0,970,120,101,266,367,83,48,82,174,325,797,0.4077791718946048,129,363,0.3553719008264462,196,434,0.4516129032258064,0.489,191,241,0.7925311203319502
Elliot Perry,perryel01,PG,26,PHO,1996,81,1668.0,697,353,34,102,136,87,5,146,140,261,549,0.4754098360655737,24,59,0.4067796610169492,237,490,0.4836734693877551,0.497,151,194,0.7783505154639175
Tim Perry,perryti01,PF,30,TOT,1996,30,254.0,71,8,21,27,48,4,13,10,16,31,65,0.4769230769230769,4,8,0.5,27,57,0.4736842105263157,0.508,5,9,0.5555555555555556
Chuck Person,persoch01,SF,31,SAS,1996,80,2131.0,873,100,76,337,413,49,26,91,197,308,705,0.4368794326241135,190,463,0.4103671706263499,118,242,0.4876033057851239,0.572,67,104,0.6442307692307693
Wesley Person,persowe01,SG,24,PHO,1996,82,2609.0,1045,138,56,265,321,55,22,89,148,390,877,0.4446978335233751,117,313,0.3738019169329074,273,564,0.4840425531914893,0.511,148,192,0.7708333333333334
Bobby Phills,phillbo01,SG,26,CLE,1996,72,2530.0,1051,271,62,199,261,102,27,126,192,386,826,0.4673123486682808,93,211,0.4407582938388625,293,615,0.4764227642276423,0.524,186,240,0.775
Eric Piatkowski,piatker01,SG,25,LAC,1996,65,784.0,301,48,40,63,103,24,10,45,83,98,242,0.4049586776859504,38,114,0.3333333333333333,60,128,0.46875,0.483,67,82,0.8170731707317073
Ricky Pierce,piercri01,SG,36,IND,1996,76,1404.0,737,101,40,96,136,57,6,93,188,264,590,0.447457627118644,35,104,0.3365384615384615,229,486,0.4711934156378601,0.477,174,205,0.848780487804878
Ed Pinckney,pincked01,PF,32,TOT,1996,74,1710.0,478,72,189,269,458,64,28,77,156,171,335,0.5104477611940299,0,3,0.0,171,332,0.5150602409638554,0.51,136,179,0.7597765363128491
Scottie Pippen,pippesc01,SF,30,CHI,1996,77,2825.0,1496,452,152,344,496,133,57,207,198,563,1216,0.4629934210526316,150,401,0.3740648379052369,413,815,0.5067484662576687,0.525,220,324,0.6790123456790124
Olden Polynice,polynol01,C,31,SAC,1996,81,2441.0,985,58,257,507,764,52,66,127,250,431,818,0.5268948655256723,1,3,0.3333333333333333,430,815,0.5276073619631901,0.528,122,203,0.6009852216748769
Terry Porter,portete01,PG,32,MIN,1996,82,2072.0,773,452,36,176,212,89,15,173,154,269,608,0.4424342105263157,71,226,0.3141592920353982,198,382,0.518324607329843,0.501,164,209,0.784688995215311
Brent Price,pricebr01,PG,27,WSB,1996,81,2042.0,810,416,38,190,228,78,4,153,184,252,534,0.4719101123595505,139,301,0.4617940199335548,113,233,0.4849785407725321,0.602,167,191,0.8743455497382199
Mark Price,pricema01,PG,31,WSB,1996,7,127.0,56,18,1,6,7,6,0,10,7,18,60,0.3,10,30,0.3333333333333333,8,30,0.2666666666666666,0.383,10,10,1.0
Kevin Pritchard,pritcke01,PG,28,WSB,1996,2,22.0,7,7,0,2,2,2,0,0,3,2,3,0.6666666666666666,1,1,1.0,1,2,0.5,0.833,2,3,0.6666666666666666
Dino Radja,radjadi01,PF,28,BOS,1996,53,1984.0,1043,83,113,409,522,48,81,117,161,426,852,0.5,0,0,0.0,426,852,0.5,0.5,191,275,0.6945454545454546
Theo Ratliff,ratlith01,C,22,DET,1996,75,1305.0,341,13,110,187,297,16,116,56,144,128,230,0.5565217391304348,0,1,0.0,128,229,0.5589519650655022,0.557,85,120,0.7083333333333334
Eldridge Recasner,recasel01,SG,28,HOU,1996,63,1275.0,436,170,31,113,144,23,5,61,111,149,359,0.415041782729805,81,191,0.4240837696335078,68,168,0.4047619047619047,0.528,57,66,0.8636363636363636
Bryant Reeves,reevebr01,C,22,VAN,1996,77,2460.0,1021,109,178,392,570,43,55,157,226,401,877,0.4572405929304447,0,3,0.0,401,874,0.4588100686498856,0.457,219,299,0.7324414715719063
Khalid Reeves,reevekh01,PG,23,TOT,1996,51,833.0,279,118,18,61,79,37,3,63,115,95,227,0.4185022026431718,28,91,0.3076923076923077,67,136,0.4926470588235294,0.48,61,82,0.7439024390243902
Don Reid,reiddo01,PF,22,DET,1996,69,997.0,263,11,78,125,203,47,40,41,199,106,187,0.5668449197860963,0,0,0.0,106,187,0.5668449197860963,0.567,51,77,0.6623376623376623
J.R. Reid,reidjr01,PF,27,TOT,1996,65,1313.0,427,42,73,182,255,43,17,79,187,160,324,0.4938271604938271,0,1,0.0,160,323,0.4953560371517028,0.494,107,142,0.7535211267605634
Terrence Rencher,renchte01,PG,22,TOT,1996,36,405.0,106,54,9,35,44,16,2,43,37,33,100,0.33,9,29,0.3103448275862069,24,71,0.3380281690140845,0.375,31,46,0.6739130434782609
Shawn Respert,respesh01,SG,23,MIL,1996,62,845.0,303,68,28,46,74,32,4,42,67,113,292,0.386986301369863,42,122,0.3442622950819672,71,170,0.4176470588235294,0.459,35,42,0.8333333333333334
Jerry Reynolds,reynoje01,SF,33,MIL,1996,19,191.0,56,12,13,20,33,15,6,16,20,21,53,0.3962264150943396,1,10,0.1,20,43,0.4651162790697674,0.406,13,21,0.6190476190476191
Glen Rice,ricegl01,SF,28,CHH,1996,79,3142.0,1710,232,86,292,378,91,19,163,217,610,1296,0.470679012345679,171,403,0.4243176178660049,439,893,0.4916013437849944,0.537,319,381,0.8372703412073491
Pooh Richardson,richapo01,PG,29,LAC,1996,63,2013.0,734,340,35,123,158,77,13,95,134,281,664,0.4231927710843373,94,245,0.3836734693877551,187,419,0.4463007159904534,0.494,78,105,0.7428571428571429
Mitch Richmond,richmmi01,SG,30,SAC,1996,81,2946.0,1872,255,54,215,269,125,19,220,233,611,1368,0.4466374269005848,225,515,0.4368932038834951,386,853,0.4525205158264947,0.529,425,491,0.8655804480651731
Isaiah Rider,rideris01,SG,24,MIN,1996,75,2594.0,1470,213,99,210,309,48,23,201,204,560,1206,0.4643449419568822,102,275,0.3709090909090909,458,931,0.4919441460794844,0.507,248,296,0.8378378378378378
Eric Riley,rileyer01,C,25,MIN,1996,25,310.0,92,5,32,44,76,8,16,17,42,35,74,0.4729729729729729,0,1,0.0,35,73,0.4794520547945205,0.473,22,28,0.7857142857142857
Doc Rivers,riverdo01,PG,34,SAS,1996,78,1235.0,311,123,30,108,138,73,21,57,175,108,290,0.3724137931034483,47,137,0.3430656934306569,61,153,0.3986928104575163,0.453,48,64,0.75
Fred Roberts,roberfr01,C,35,LAL,1996,33,317.0,122,26,18,29,47,16,4,24,24,48,97,0.4948453608247423,4,14,0.2857142857142857,44,83,0.5301204819277109,0.515,22,28,0.7857142857142857
Stanley Roberts,roberst01,C,25,LAC,1996,51,795.0,356,41,42,120,162,15,39,48,153,141,304,0.4638157894736842,0,0,0.0,141,304,0.4638157894736842,0.464,74,133,0.556390977443609
Alvin Robertson,roberal01,SG,33,TOR,1996,77,2478.0,718,323,110,232,342,166,36,183,268,285,607,0.4695222405271829,41,151,0.271523178807947,244,456,0.5350877192982456,0.503,107,158,0.6772151898734177
Clifford Robinson,robincl02,SF,29,POR,1996,78,2980.0,1644,190,123,320,443,86,68,194,248,553,1306,0.4234303215926493,178,471,0.3779193205944798,375,835,0.4491017964071856,0.492,360,542,0.6642066420664207
David Robinson,robinda01,C,30,SAS,1996,82,3019.0,2051,247,319,681,1000,111,271,190,262,711,1378,0.5159651669085631,3,9,0.3333333333333333,708,1369,0.5171658144631117,0.517,626,823,0.7606318347509113
Glenn Robinson,robingl01,SF,23,MIL,1996,82,3249.0,1660,293,136,368,504,95,42,282,236,627,1382,0.4536903039073806,90,263,0.3422053231939163,537,1119,0.4798927613941018,0.486,316,389,0.8123393316195373
James Robinson,robinja02,PG,25,POR,1996,76,1627.0,649,150,44,113,157,34,16,111,146,229,574,0.3989547038327526,102,284,0.3591549295774648,127,290,0.4379310344827586,0.488,89,135,0.6592592592592592
Rumeal Robinson,robinru01,PG,29,POR,1996,43,715.0,247,142,19,59,78,26,5,72,79,92,221,0.416289592760181,30,79,0.379746835443038,62,142,0.4366197183098591,0.484,33,51,0.6470588235294118
Dennis Rodman,rodmade01,PF,34,CHI,1996,64,2088.0,351,160,356,596,952,36,27,138,196,146,304,0.4802631578947368,3,27,0.1111111111111111,143,277,0.516245487364621,0.485,56,106,0.5283018867924528
Lou Roe,roelo01,SF,23,DET,1996,49,372.0,90,15,30,48,78,10,8,17,42,32,90,0.3555555555555555,2,9,0.2222222222222222,30,81,0.3703703703703703,0.367,24,32,0.75
Carlos Rogers,rogerca01,PF,24,TOR,1996,56,1043.0,430,35,80,90,170,25,48,61,87,178,344,0.5174418604651163,3,21,0.1428571428571428,175,323,0.541795665634675,0.522,71,130,0.5461538461538461
Rodney Rogers,rogerro01,SF,24,LAC,1996,67,1950.0,774,167,113,173,286,75,35,144,216,306,641,0.4773790951638065,49,153,0.3202614379084967,257,488,0.5266393442622951,0.516,113,180,0.6277777777777778
Sean Rooks,rooksse01,C,26,TOT,1996,65,1117.0,424,47,81,174,255,23,42,80,141,144,285,0.5052631578947369,1,7,0.1428571428571428,143,278,0.5143884892086331,0.507,135,202,0.6683168316831684
Jalen Rose,roseja01,SG,23,DEN,1996,80,2134.0,803,495,46,214,260,53,39,234,229,290,604,0.4801324503311258,32,108,0.2962962962962963,258,496,0.5201612903225806,0.507,191,277,0.6895306859205776
Donald Royal,royaldo01,SF,29,ORL,1996,64,963.0,337,42,57,96,153,29,15,52,97,106,216,0.4907407407407407,0,2,0.0,106,214,0.4953271028037383,0.491,125,164,0.7621951219512195
Clifford Rozier,roziecl01,C,23,GSW,1996,59,723.0,184,22,71,100,171,19,30,40,135,79,135,0.5851851851851851,0,2,0.0,79,133,0.5939849624060151,0.585,26,55,0.4727272727272727
Trevor Ruffin,ruffitr01,PG,25,PHI,1996,61,1551.0,778,269,21,111,132,43,2,149,132,263,648,0.4058641975308642,104,284,0.3661971830985915,159,364,0.4368131868131868,0.486,148,182,0.8131868131868132
Stefano Rusconi,ruscost01,PF,27,PHO,1996,7,30.0,8,3,3,3,6,0,2,3,10,3,9,0.3333333333333333,0,0,0.0,3,9,0.3333333333333333,0.333,2,5,0.4
Bryon Russell,russebr01,SF,25,UTA,1996,59,577.0,174,29,28,62,90,29,8,36,66,56,142,0.3943661971830985,14,40,0.35,42,102,0.4117647058823529,0.444,48,67,0.7164179104477612
Arvydas Sabonis,sabonar01,C,31,POR,1996,73,1735.0,1058,130,147,441,588,64,78,154,211,394,723,0.5449515905947441,39,104,0.375,355,619,0.5735056542810986,0.572,231,305,0.7573770491803279
John Salley,sallejo01,PF,31,TOT,1996,42,673.0,185,54,46,94,140,19,27,55,110,63,140,0.45,0,0,0.0,63,140,0.45,0.45,59,85,0.6941176470588235
Danny Schayes,schayda01,C,36,MIA,1996,32,399.0,101,9,29,60,89,11,16,23,60,32,94,0.3404255319148936,0,0,0.0,32,94,0.3404255319148936,0.34,37,46,0.8043478260869565
Steve Scheffler,schefst01,C,28,SEA,1996,35,181.0,58,2,15,18,33,6,2,8,25,24,45,0.5333333333333333,1,5,0.2,23,40,0.575,0.544,9,19,0.4736842105263157
Dwayne Schintzius,schindw01,C,27,IND,1996,33,297.0,111,14,23,55,78,9,12,19,53,49,110,0.4454545454545454,0,0,0.0,49,110,0.4454545454545454,0.445,13,21,0.6190476190476191
Detlef Schrempf,schrede01,SF,33,SEA,1996,63,2200.0,1080,276,73,255,328,56,8,146,179,360,740,0.4864864864864865,73,179,0.4078212290502793,287,561,0.5115864527629234,0.536,287,370,0.7756756756756756
Byron Scott,scottby01,SG,34,VAN,1996,80,1894.0,819,123,40,152,192,63,22,100,126,271,676,0.400887573964497,74,221,0.334841628959276,197,455,0.432967032967033,0.456,203,243,0.8353909465020576
Dennis Scott,scottde01,SF,27,ORL,1996,82,3041.0,1431,243,63,246,309,90,29,122,169,491,1117,0.4395702775290958,267,628,0.4251592356687898,224,489,0.4580777096114519,0.559,182,222,0.8198198198198198
Malik Sealy,sealyma01,SF,25,LAC,1996,62,1601.0,712,116,76,164,240,84,28,113,150,272,655,0.4152671755725191,21,100,0.21,251,555,0.4522522522522522,0.431,147,184,0.7989130434782609
Rony Seikaly,seikaro01,C,30,GSW,1996,64,1813.0,776,71,166,333,499,40,69,180,219,285,568,0.5017605633802817,2,3,0.6666666666666666,283,565,0.5008849557522124,0.504,204,282,0.723404255319149
Brian Shaw,shawbr01,PG,29,ORL,1996,75,1679.0,496,336,58,166,224,58,11,173,160,182,486,0.3744855967078189,41,144,0.2847222222222222,141,342,0.4122807017543859,0.417,91,114,0.7982456140350878
Lionel Simmons,simmoli01,SF,27,SAC,1996,54,810.0,246,83,41,104,145,31,20,51,85,86,217,0.3963133640552995,19,51,0.3725490196078431,67,166,0.4036144578313253,0.44,55,75,0.7333333333333333
Dickey Simpkins,simpkdi01,PF,23,CHI,1996,60,685.0,216,38,66,90,156,9,8,56,78,77,160,0.48125,1,1,1.0,76,159,0.4779874213836478,0.484,61,97,0.6288659793814433
Scott Skiles,skilesc01,PG,31,PHI,1996,10,236.0,63,38,1,15,16,7,0,16,21,20,57,0.3508771929824561,15,34,0.4411764705882353,5,23,0.217391304347826,0.482,8,10,0.8
Reggie Slater,slatere01,PF,25,TOT,1996,11,72.0,31,2,4,11,15,2,3,9,11,14,27,0.5185185185185185,0,0,0.0,14,27,0.5185185185185185,0.519,3,7,0.4285714285714285
Charles Smith,smithch02,PG,28,MIN,1996,8,39.0,6,6,0,5,5,1,0,5,7,3,10,0.3,0,3,0.0,3,7,0.4285714285714285,0.3,0,2,0.0
Charles Smith,smithch01,PF,30,TOT,1996,73,1716.0,609,65,133,229,362,50,80,106,224,244,578,0.4221453287197231,2,15,0.1333333333333333,242,563,0.4298401420959147,0.424,119,163,0.7300613496932515
Doug Smith,smithdo03,PF,26,BOS,1996,17,92.0,33,4,12,10,22,3,0,11,21,14,39,0.358974358974359,0,0,0.0,14,39,0.358974358974359,0.359,5,8,0.625
Joe Smith,smithjo02,PF,20,GSW,1996,82,2821.0,1251,79,300,417,717,85,134,138,224,469,1024,0.4580078125,10,28,0.3571428571428571,459,996,0.4608433734939759,0.463,303,392,0.7729591836734694
Kenny Smith,smithke01,PG,30,HOU,1996,68,1617.0,580,245,21,75,96,47,3,100,116,201,464,0.4331896551724138,91,238,0.3823529411764705,110,226,0.4867256637168141,0.531,87,106,0.8207547169811321
Michael Smith,smithmi02,PF,23,SAC,1996,65,1384.0,357,110,143,246,389,47,46,72,166,144,238,0.6050420168067226,1,1,1.0,143,237,0.6033755274261603,0.607,68,177,0.384180790960452
Steve Smith,smithst01,SG,26,ATL,1996,80,2856.0,1446,224,124,202,326,68,17,151,207,494,1143,0.4321959755030621,140,423,0.3309692671394799,354,720,0.4916666666666666,0.493,318,385,0.825974025974026
Tony Smith,smithto02,SG,27,TOT,1996,59,938.0,298,154,30,65,95,37,10,66,106,116,274,0.4233576642335766,38,116,0.3275862068965517,78,158,0.4936708860759494,0.493,28,46,0.6086956521739131
Rik Smits,smitsri01,C,29,IND,1996,63,1901.0,1164,110,119,314,433,21,45,160,226,466,894,0.5212527964205816,1,5,0.2,465,889,0.5230596175478065,0.522,231,293,0.78839590443686
Eric Snow,snower01,PG,22,SEA,1996,43,389.0,115,73,9,34,43,28,0,38,53,42,100,0.42,2,10,0.2,40,90,0.4444444444444444,0.43,29,49,0.5918367346938775
Elmore Spencer,spencel01,C,26,TOT,1996,17,58.0,14,1,3,10,13,0,2,6,12,5,13,0.3846153846153846,0,0,0.0,5,13,0.3846153846153846,0.385,4,6,0.6666666666666666
Felton Spencer,spencfe01,C,28,UTA,1996,71,1267.0,396,11,100,206,306,20,54,77,240,146,281,0.5195729537366548,0,0,0.0,146,281,0.5195729537366548,0.52,104,151,0.6887417218543046
Latrell Sprewell,sprewla01,SG,25,GSW,1996,78,3064.0,1473,328,124,256,380,127,45,222,150,515,1202,0.4284525790349417,91,282,0.3226950354609929,424,920,0.4608695652173913,0.466,352,446,0.7892376681614349
Jerry Stackhouse,stackje01,SG,21,PHI,1996,72,2701.0,1384,278,90,175,265,76,79,252,179,452,1091,0.4142988084326306,93,292,0.3184931506849315,359,799,0.4493116395494368,0.457,387,518,0.747104247104247
John Starks,starkjo01,SG,30,NYK,1996,81,2491.0,1024,315,31,206,237,103,11,156,226,375,846,0.4432624113475177,143,396,0.3611111111111111,232,450,0.5155555555555555,0.528,131,174,0.7528735632183908
Bryant Stith,stithbr01,SG,25,DEN,1996,82,2810.0,1119,241,125,275,400,114,16,157,187,379,911,0.41602634467618,41,148,0.277027027027027,338,763,0.4429882044560944,0.439,320,379,0.8443271767810027
John Stockton,stockjo01,PG,33,UTA,1996,82,2915.0,1209,916,54,172,226,140,15,246,207,440,818,0.5378973105134475,95,225,0.4222222222222222,345,593,0.581787521079258,0.596,234,282,0.8297872340425532
Damon Stoudamire,stoudda01,PG,22,TOR,1996,70,2865.0,1331,653,59,222,281,98,19,267,166,481,1129,0.4260407440212577,133,337,0.3946587537091988,348,792,0.4393939393939394,0.485,236,296,0.7972972972972973
Rod Strickland,stricro02,PG,29,POR,1996,67,2526.0,1256,640,89,208,297,97,16,255,135,471,1023,0.4604105571847507,38,111,0.3423423423423423,433,912,0.4747807017543859,0.479,276,423,0.6524822695035462
Derek Strong,stronde01,PF,27,LAL,1996,63,746.0,214,32,60,118,178,18,12,20,80,72,169,0.4260355029585799,1,9,0.1111111111111111,71,160,0.44375,0.429,69,85,0.8117647058823529
Bob Sura,surabo01,SG,22,CLE,1996,79,1150.0,422,233,34,101,135,56,21,115,126,148,360,0.4111111111111111,27,78,0.3461538461538461,121,282,0.4290780141843971,0.449,99,141,0.7021276595744681
Greg Sutton,suttogr01,PG,28,TOT,1996,48,655.0,252,102,8,42,50,25,2,62,92,85,217,0.391705069124424,47,117,0.4017094017094017,38,100,0.38,0.5,35,46,0.7608695652173914
Larry Sykes,sykesla01,PF,22,BOS,1996,1,2.0,0,0,1,1,2,0,0,1,0,0,0,0.0,0,0,0.0,0,0,0.0,0.0,0,0,0.0
Žan Tabak,tabakza01,C,25,TOR,1996,67,1332.0,514,62,117,203,320,24,31,101,204,225,414,0.5434782608695652,0,1,0.0,225,413,0.5447941888619855,0.543,64,114,0.5614035087719298
Kurt Thomas,thomaku01,PF,23,MIA,1996,74,1655.0,666,46,122,317,439,47,36,98,271,274,547,0.5009140767824497,0,2,0.0,274,545,0.5027522935779817,0.501,118,178,0.6629213483146067
Brooks Thompson,thompbr01,PG,25,ORL,1996,33,246.0,140,31,4,20,24,12,0,24,35,48,103,0.4660194174757281,25,64,0.390625,23,39,0.5897435897435898,0.587,19,27,0.7037037037037037
LaSalle Thompson,thompla01,C,34,PHI,1996,44,773.0,85,26,62,137,199,19,20,37,125,33,83,0.3975903614457831,0,0,0.0,33,83,0.3975903614457831,0.398,19,24,0.7916666666666666
Bob Thornton,thornbo01,PF,33,WSB,1996,7,31.0,3,0,6,6,12,1,0,1,7,1,6,0.1666666666666666,0,0,0.0,1,6,0.1666666666666666,0.167,1,2,0.5
Otis Thorpe,thorpot01,PF,33,DET,1996,82,2841.0,1161,158,211,477,688,53,39,195,300,452,853,0.52989449003517,0,4,0.0,452,849,0.5323910482921084,0.53,257,362,0.7099447513812155
Sedale Threatt,threase01,PG,34,LAL,1996,82,1687.0,596,269,20,75,95,68,11,74,178,241,526,0.4581749049429657,60,169,0.3550295857988165,181,357,0.5070028011204482,0.515,54,71,0.7605633802816901
Wayman Tisdale,tisdawa01,PF,31,PHO,1996,63,1152.0,672,58,55,159,214,15,36,63,188,279,564,0.4946808510638298,0,0,0.0,279,564,0.4946808510638298,0.495,114,149,0.7651006711409396
Andy Toolson,toolsan01,SF,30,UTA,1996,13,53.0,22,1,0,6,6,0,0,2,12,8,22,0.3636363636363636,3,12,0.25,5,10,0.5,0.432,3,4,0.75
Keith Tower,towerke01,C,25,LAC,1996,34,305.0,82,5,22,29,51,4,11,16,50,32,72,0.4444444444444444,0,1,0.0,32,71,0.4507042253521127,0.444,18,26,0.6923076923076923
Gary Trent,trentga01,PF,21,POR,1996,69,1219.0,518,50,84,154,238,25,11,92,116,220,429,0.5128205128205128,0,9,0.0,220,420,0.5238095238095238,0.513,78,141,0.5531914893617021
Jeff Turner,turneje01,PF,33,ORL,1996,13,192.0,47,6,10,18,28,2,1,11,33,18,51,0.3529411764705882,9,27,0.3333333333333333,9,24,0.375,0.441,2,2,1.0
Nick Van Exel,vanexni01,PG,24,LAL,1996,74,2513.0,1099,509,29,152,181,70,10,156,115,396,950,0.4168421052631579,144,403,0.3573200992555831,252,547,0.4606946983546618,0.493,163,204,0.7990196078431373
Logan Vander Velden,vandelo01,SF,24,LAC,1996,15,31.0,9,1,1,5,6,0,0,0,4,3,14,0.2142857142857142,0,5,0.0,3,9,0.3333333333333333,0.214,3,4,0.75
David Vaughn,vaughda02,PF,22,ORL,1996,33,266.0,64,8,33,47,80,6,15,18,68,27,80,0.3375,0,1,0.0,27,79,0.3417721518987341,0.338,10,18,0.5555555555555556
Loy Vaught,vaughlo01,PF,27,LAC,1996,80,2966.0,1298,112,204,604,808,87,40,158,241,571,1087,0.5252989880404784,7,19,0.3684210526315789,564,1068,0.5280898876404494,0.529,149,205,0.7268292682926829
Rasheed Wallace,wallara01,PF,21,WSB,1996,65,1788.0,655,85,93,210,303,42,54,103,206,275,565,0.4867256637168141,27,82,0.3292682926829268,248,483,0.5134575569358178,0.511,78,120,0.65
Rex Walters,waltere01,SG,25,TOT,1996,44,610.0,186,106,13,42,55,25,4,41,53,61,148,0.4121621621621621,22,66,0.3333333333333333,39,82,0.4756097560975609,0.486,42,52,0.8076923076923077
Charlie Ward,wardch01,PG,25,NYK,1996,62,787.0,244,132,29,73,102,54,6,79,98,87,218,0.3990825688073394,33,99,0.3333333333333333,54,119,0.453781512605042,0.475,37,54,0.6851851851851852
Jamie Watson,watsoja01,SF,23,UTA,1996,16,217.0,48,24,5,22,27,8,2,17,30,18,43,0.4186046511627907,3,7,0.4285714285714285,15,36,0.4166666666666667,0.453,9,13,0.6923076923076923
Clarence Weatherspoon,weathcl01,SF,25,PHI,1996,78,3096.0,1300,158,237,516,753,112,108,179,214,491,1015,0.483743842364532,0,2,0.0,491,1013,0.4846989141164857,0.484,318,426,0.7464788732394366
Spud Webb,webbsp01,PG,32,TOT,1996,77,1462.0,544,294,26,74,100,52,7,110,109,186,430,0.4325581395348837,47,129,0.3643410852713178,139,301,0.4617940199335548,0.487,125,145,0.8620689655172413
Chris Webber,webbech01,PF,22,WSB,1996,15,558.0,356,75,37,77,114,27,9,49,51,150,276,0.5434782608695652,15,34,0.4411764705882353,135,242,0.5578512396694215,0.571,41,69,0.5942028985507246
Jeff Webster,webstje01,SF,24,WSB,1996,11,58.0,18,3,2,5,7,4,0,3,7,8,23,0.3478260869565217,2,6,0.3333333333333333,6,17,0.3529411764705882,0.391,0,0,0.0
Bill Wennington,wennibi01,C,32,CHI,1996,71,1065.0,376,46,58,116,174,21,16,37,171,169,343,0.4927113702623906,1,1,1.0,168,342,0.4912280701754385,0.494,37,43,0.8604651162790697
Robert Werdann,werdaro01,C,25,NJN,1996,13,93.0,39,2,5,18,23,5,3,6,17,16,32,0.5,0,0,0.0,16,32,0.5,0.5,7,13,0.5384615384615384
David Wesley,wesleda01,PG,25,BOS,1996,82,2104.0,1009,390,68,196,264,100,11,159,207,338,736,0.4592391304347826,116,272,0.4264705882352941,222,464,0.4784482758620689,0.538,217,288,0.7534722222222222
Doug West,westdo01,SG,28,MIN,1996,73,1639.0,465,119,48,113,161,30,17,81,228,175,393,0.4452926208651399,1,13,0.0769230769230769,174,380,0.4578947368421052,0.447,114,144,0.7916666666666666
Mark West,westma01,C,35,DET,1996,47,682.0,150,6,49,84,133,6,37,35,135,61,126,0.4841269841269841,0,0,0.0,61,126,0.4841269841269841,0.484,28,45,0.6222222222222222
Dwayne Whitfield,whitfdw01,PF,23,TOR,1996,8,122.0,40,2,9,16,25,3,2,8,14,13,30,0.4333333333333333,0,0,0.0,13,30,0.4333333333333333,0.433,14,22,0.6363636363636364
Chris Whitney,whitnch01,PG,24,WSB,1996,21,335.0,150,51,2,31,33,18,1,23,46,45,99,0.4545454545454545,19,44,0.4318181818181818,26,55,0.4727272727272727,0.551,41,44,0.9318181818181818
Gerald Wilkins,wilkige01,SG,32,VAN,1996,28,738.0,188,68,22,43,65,22,2,37,55,77,205,0.375609756097561,14,64,0.21875,63,141,0.4468085106382978,0.41,20,23,0.8695652173913043
Buck Williams,willibu01,PF,35,POR,1996,70,1672.0,511,42,159,245,404,40,47,90,187,192,384,0.5,2,3,0.6666666666666666,190,381,0.4986876640419947,0.503,125,187,0.6684491978609626
Eric Williams,willier01,SF,23,BOS,1996,64,1470.0,685,70,92,125,217,56,11,88,147,241,546,0.4413919413919414,3,10,0.3,238,536,0.4440298507462686,0.444,200,298,0.6711409395973155
Herb Williams,willihe01,PF-C,37,TOT,1996,44,571.0,138,27,15,75,90,14,33,22,79,62,152,0.4078947368421052,1,4,0.25,61,148,0.4121621621621621,0.411,13,20,0.65
Hot Rod Williams,williho01,C,33,PHO,1996,62,1652.0,455,62,129,243,372,46,90,62,170,180,397,0.4534005037783375,0,1,0.0,180,396,0.4545454545454545,0.453,95,130,0.7307692307692307
Jayson Williams,willija01,PF,27,NJN,1996,80,1858.0,721,47,342,461,803,35,57,106,238,279,660,0.4227272727272727,2,7,0.2857142857142857,277,653,0.4241960183767228,0.424,161,272,0.5919117647058824
Lorenzo Williams,willilo01,C,26,DAL,1996,65,1806.0,198,85,234,287,521,48,122,78,226,87,214,0.4065420560747663,0,1,0.0,87,213,0.4084507042253521,0.407,24,70,0.3428571428571428
Micheal Williams,willimi02,PG,29,MIN,1996,9,189.0,55,31,3,20,23,5,3,23,37,13,40,0.325,1,3,0.3333333333333333,12,37,0.3243243243243243,0.338,28,33,0.8484848484848485
Monty Williams,willimo01,SF,24,TOT,1996,31,184.0,68,8,20,20,40,6,2,18,26,27,68,0.3970588235294117,0,1,0.0,27,67,0.4029850746268656,0.397,14,20,0.7
Reggie Williams,willire01,SF,31,DEN,1996,52,817.0,241,74,25,97,122,34,21,51,137,94,254,0.3700787401574803,20,89,0.2247191011235955,74,165,0.4484848484848485,0.409,33,39,0.8461538461538461
Scott Williams,willisc01,PF,27,PHI,1996,13,193.0,40,5,13,33,46,6,7,8,27,15,29,0.5172413793103449,0,2,0.0,15,27,0.5555555555555556,0.517,10,12,0.8333333333333334
Walt Williams,williwa02,SF,25,TOT,1996,73,2169.0,995,230,99,220,319,85,58,151,238,359,808,0.4443069306930693,114,293,0.3890784982935154,245,515,0.4757281553398058,0.515,163,232,0.7025862068965517
Corliss Williamson,willico02,SF,22,SAC,1996,53,609.0,297,23,56,58,114,11,9,76,115,125,268,0.4664179104477612,0,3,0.0,125,265,0.4716981132075472,0.466,47,84,0.5595238095238095
Kevin Willis,willike02,PF,33,TOT,1996,75,2135.0,794,53,208,430,638,32,41,161,253,325,712,0.4564606741573033,1,9,0.1111111111111111,324,703,0.460881934566145,0.457,143,202,0.7079207920792079
Trevor Wilson,wilsotr01,PF,27,PHI,1996,6,79.0,23,4,7,7,14,3,0,1,9,10,20,0.5,0,0,0.0,10,20,0.5,0.5,3,4,0.75
David Wingate,wingada01,SG,32,SEA,1996,60,695.0,223,58,17,39,56,20,4,42,66,88,212,0.4150943396226415,15,34,0.4411764705882353,73,178,0.4101123595505618,0.45,32,41,0.7804878048780488
Dontonio Wingfield,wingfdo01,SF,21,POR,1996,44,487.0,165,28,45,59,104,20,6,31,73,60,157,0.3821656050955414,19,63,0.3015873015873015,41,94,0.4361702127659574,0.443,26,34,0.7647058823529411
Joe Wolf,wolfjo01,PF,31,TOT,1996,64,1065.0,291,63,49,138,187,15,5,42,163,135,263,0.5133079847908745,0,6,0.0,135,257,0.5252918287937743,0.513,21,29,0.7241379310344828
David Wood,woodda01,PF,31,TOT,1996,62,772.0,208,34,51,103,154,19,10,24,150,75,174,0.4310344827586206,20,62,0.3225806451612903,55,112,0.4910714285714285,0.489,38,50,0.76
Randy Woods,woodsra01,PG,25,DEN,1996,8,72.0,19,12,3,3,6,6,1,5,13,6,22,0.2727272727272727,5,21,0.238095238095238,1,1,1.0,0.386,2,2,1.0
Haywoode Workman,workmha01,PG,30,IND,1996,77,1164.0,279,213,27,97,124,65,4,93,152,101,259,0.3899613899613899,23,71,0.323943661971831,78,188,0.4148936170212766,0.434,54,73,0.7397260273972602
Sharone Wright,wrighsh01,C,23,TOT,1996,57,1434.0,664,38,148,208,356,30,49,109,163,248,512,0.484375,1,3,0.3333333333333333,247,509,0.4852652259332023,0.485,167,259,0.6447876447876448
George Zídek,zidekge01,C,22,CHH,1996,71,888.0,281,16,69,114,183,9,7,38,170,105,248,0.4233870967741935,0,0,0.0,105,248,0.4233870967741935,0.423,71,93,0.7634408602150538
Mahmoud Abdul-Rauf,abdulma02,PG,27,SAC,1997,75,2131.0,1031,189,16,106,122,56,6,119,174,411,924,0.4448051948051948,94,246,0.3821138211382114,317,678,0.467551622418879,0.496,115,136,0.8455882352941176
Shareef Abdur-Rahim,abdursh01,PF,20,VAN,1997,80,2802.0,1494,175,216,339,555,79,79,225,199,550,1214,0.4530477759472817,7,27,0.2592592592592592,543,1187,0.4574557708508845,0.456,387,519,0.7456647398843931
Rafael Addison,addisra01,SF,32,CHH,1997,41,355.0,128,34,19,26,45,8,3,17,52,49,122,0.4016393442622951,8,20,0.4,41,102,0.4019607843137255,0.434,22,28,0.7857142857142857
Cory Alexander,alexaco01,PG,23,SAS,1997,80,1454.0,577,254,29,94,123,82,16,146,148,194,490,0.3959183673469387,94,252,0.373015873015873,100,238,0.4201680672268907,0.492,95,129,0.7364341085271318
Jerome Allen,allenje01,SG,24,TOT,1997,76,943.0,228,152,25,73,98,31,4,69,84,78,221,0.3529411764705882,30,93,0.3225806451612903,48,128,0.375,0.421,42,72,0.5833333333333334
Ray Allen,allenra02,SG,21,MIL,1997,82,2532.0,1102,210,97,229,326,75,10,149,218,390,908,0.4295154185022026,117,298,0.3926174496644295,273,610,0.4475409836065573,0.494,205,249,0.8232931726907631
Derrick Alston,alstode01,C,24,ATL,1997,2,11.0,0,0,3,1,4,0,0,0,0,0,5,0.0,0,0,0.0,0,5,0.0,0.0,0,2,0.0
Ashraf Amaya,amayaas01,PF,25,WSB,1997,31,144.0,40,3,19,33,52,7,3,10,29,12,40,0.3,1,1,1.0,11,39,0.282051282051282,0.313,15,28,0.5357142857142857
Greg Anderson,andergr01,C,32,SAS,1997,82,1659.0,322,34,157,291,448,63,67,73,225,130,262,0.4961832061068702,0,1,0.0,130,261,0.4980842911877394,0.496,62,93,0.6666666666666666
Kenny Anderson,anderke01,PG,26,POR,1997,82,3081.0,1436,584,91,272,363,162,15,193,222,485,1137,0.426561125769569,132,366,0.360655737704918,353,771,0.4578469520103761,0.485,334,435,0.767816091954023
Nick Anderson,anderni01,SG,29,ORL,1997,63,2163.0,757,182,66,238,304,120,32,86,160,288,725,0.3972413793103448,143,405,0.3530864197530864,145,320,0.453125,0.496,38,94,0.4042553191489361
Shandon Anderson,andersh01,SG,23,UTA,1997,65,1066.0,386,49,52,127,179,27,8,73,113,147,318,0.4622641509433962,24,47,0.5106382978723404,123,271,0.4538745387453874,0.5,68,99,0.6868686868686869
Willie Anderson,anderwi01,SG,30,MIA,1997,28,303.0,83,34,15,27,42,14,4,19,36,29,64,0.453125,8,19,0.4210526315789473,21,45,0.4666666666666667,0.516,17,20,0.85
Greg Anthony,anthogr01,PG,29,VAN,1997,65,1863.0,616,407,25,159,184,129,4,129,122,199,507,0.3925049309664694,88,238,0.3697478991596639,111,269,0.4126394052044609,0.479,130,178,0.7303370786516854
B.J. Armstrong,armstbj01,PG,29,GSW,1997,49,1020.0,389,126,7,67,74,25,2,53,56,148,327,0.4525993883792049,25,90,0.2777777777777778,123,237,0.5189873417721519,0.491,68,79,0.8607594936708861
Darrell Armstrong,armstda01,PG,28,ORL,1997,67,1010.0,411,175,35,41,76,61,9,99,114,132,345,0.3826086956521739,55,181,0.3038674033149171,77,164,0.4695121951219512,0.462,92,106,0.8679245283018868
Vincent Askew,askewvi01,SG,30,TOT,1997,43,838.0,239,90,25,73,98,17,6,46,123,81,186,0.4354838709677419,7,24,0.2916666666666667,74,162,0.4567901234567901,0.454,70,88,0.7954545454545454
Keith Askins,askinke01,SF,29,MIA,1997,78,1773.0,384,75,86,185,271,53,19,59,196,138,319,0.4326018808777429,69,172,0.4011627906976744,69,147,0.4693877551020408,0.541,39,58,0.6724137931034483
Stacey Augmon,augmost01,SG,28,TOT,1997,60,942.0,279,56,47,91,138,42,17,64,87,105,220,0.4772727272727273,0,0,0.0,105,220,0.4772727272727273,0.477,69,97,0.711340206185567
Isaac Austin,austiis01,C,27,MIA,1997,82,1881.0,792,101,136,342,478,45,43,161,244,321,639,0.5023474178403756,0,3,0.0,321,636,0.5047169811320755,0.502,150,226,0.6637168141592921
Vin Baker,bakervi01,PF,25,MIL,1997,78,3159.0,1637,211,267,537,804,81,112,245,275,632,1251,0.5051958433253397,15,54,0.2777777777777778,617,1197,0.5154553049289892,0.511,358,521,0.6871401151631478
Charles Barkley,barklch01,PF,33,HOU,1997,53,2009.0,1016,248,212,504,716,69,25,151,153,335,692,0.4841040462427746,58,205,0.2829268292682926,277,487,0.5687885010266941,0.526,288,415,0.6939759036144578
Dana Barros,barroda01,PG,29,BOS,1997,24,708.0,300,81,5,43,48,26,6,39,34,110,253,0.4347826086956521,43,105,0.4095238095238095,67,148,0.4527027027027027,0.52,37,43,0.8604651162790697
Brent Barry,barrybr01,SG,25,LAC,1997,59,1094.0,442,154,30,80,110,51,15,76,88,155,379,0.4089709762532981,56,173,0.3236994219653179,99,206,0.4805825242718446,0.483,76,93,0.8172043010752689
Jon Barry,barryjo01,SG,27,ATL,1997,58,965.0,285,115,26,73,99,55,3,59,56,100,246,0.4065040650406504,48,124,0.3870967741935484,52,122,0.4262295081967213,0.504,37,46,0.8043478260869565
Benoit Benjamin,benjabe01,C,32,TOR,1997,4,44.0,13,1,3,6,9,1,0,2,5,5,12,0.4166666666666667,0,0,0.0,5,12,0.4166666666666667,0.417,3,4,0.75
Elmer Bennett,benneel01,PG,26,TOT,1997,9,75.0,22,11,0,4,4,4,0,10,7,6,19,0.3157894736842105,3,9,0.3333333333333333,3,10,0.3,0.395,7,10,0.7
Travis Best,besttr01,PG,24,IND,1997,76,2064.0,754,318,36,130,166,98,5,153,221,274,620,0.4419354838709677,57,155,0.3677419354838709,217,465,0.4666666666666667,0.488,149,197,0.7563451776649747
Mookie Blaylock,blaylmo01,PG,29,ATL,1997,78,3056.0,1354,463,114,299,413,212,20,185,141,501,1159,0.4322691975841242,221,604,0.3658940397350993,280,555,0.5045045045045045,0.528,131,174,0.7528735632183908
Corie Blount,blounco01,PF,28,LAL,1997,58,1009.0,241,35,113,163,276,22,26,50,121,92,179,0.5139664804469274,1,3,0.3333333333333333,91,176,0.5170454545454546,0.517,56,83,0.6746987951807228
Muggsy Bogues,boguemu01,PG,32,CHH,1997,65,1880.0,522,469,25,116,141,82,2,108,114,204,443,0.4604966139954853,60,144,0.4166666666666667,144,299,0.4816053511705686,0.528,54,64,0.84375
Dexter Boney,boneyde01,SG,26,PHO,1997,8,48.0,19,0,3,3,6,2,1,1,3,6,19,0.3157894736842105,1,6,0.1666666666666666,5,13,0.3846153846153846,0.342,6,8,0.75
Melvin Booker,bookeme01,PG,24,TOT,1997,21,430.0,122,53,7,22,29,3,2,27,28,46,105,0.4380952380952381,12,37,0.3243243243243243,34,68,0.5,0.495,18,20,0.9
Bruce Bowen,bowenbr01,SF,25,MIA,1997,1,1.0,0,0,0,0,0,0,1,0,0,0,0,0.0,0,0,0.0,0,0,0.0,0.0,0,0,0.0
Donnie Boyce,boycedo01,SG,23,ATL,1997,22,154.0,55,13,7,8,15,10,4,16,17,21,63,0.3333333333333333,2,16,0.125,19,47,0.4042553191489361,0.349,11,22,0.5
Shawn Bradley,bradlsh01,C,24,TOT,1997,73,2288.0,961,52,221,390,611,40,248,134,237,406,905,0.4486187845303867,0,8,0.0,406,897,0.4526198439241917,0.449,149,228,0.6535087719298246
Mark Bradtke,bradtma01,C,28,PHI,1997,36,251.0,59,7,26,42,68,5,5,9,34,25,58,0.4310344827586206,0,0,0.0,25,58,0.4310344827586206,0.431,9,13,0.6923076923076923
Terrell Brandon,brandte01,PG,26,CLE,1997,78,2868.0,1519,490,48,253,301,138,30,178,177,575,1313,0.4379284082254379,101,271,0.3726937269372694,474,1042,0.45489443378119,0.476,268,297,0.9023569023569024
Frank Brickowski,brickfr01,PF,37,BOS,1997,17,255.0,81,15,6,28,34,5,4,19,42,32,73,0.4383561643835616,7,20,0.35,25,53,0.4716981132075472,0.486,10,14,0.7142857142857143
Scott Brooks,brooksc01,PG,31,NYK,1997,38,251.0,57,29,6,12,18,21,0,17,35,19,39,0.4871794871794871,5,12,0.4166666666666667,14,27,0.5185185185185185,0.551,14,15,0.9333333333333332
Chucky Brown,brownch01,SF,28,TOT,1997,70,757.0,204,28,41,107,148,9,22,19,100,78,154,0.5064935064935064,1,6,0.1666666666666666,77,148,0.5202702702702703,0.51,47,70,0.6714285714285714
Dee Brown,brownde01,PG,28,BOS,1997,21,522.0,160,67,8,40,48,31,7,24,45,61,166,0.3674698795180723,20,65,0.3076923076923077,41,101,0.4059405940594059,0.428,18,22,0.8181818181818182
Marcus Brown,brownma01,PG,22,POR,1997,21,184.0,82,20,4,11,15,8,2,13,26,28,70,0.4,13,32,0.40625,15,38,0.3947368421052631,0.493,13,19,0.6842105263157895
Mike Brown,brownmi01,C,33,PHO,1997,6,83.0,16,5,9,16,25,1,1,2,9,5,12,0.4166666666666667,0,0,0.0,5,12,0.4166666666666667,0.417,6,10,0.6
P.J. Brown,brownpj01,PF,27,MIA,1997,80,2592.0,761,92,239,431,670,85,98,113,283,300,656,0.4573170731707317,0,2,0.0,300,654,0.4587155963302752,0.457,161,220,0.7318181818181818
Randy Brown,brownra02,PG,28,CHI,1997,72,1057.0,341,133,34,77,111,81,17,58,116,140,333,0.4204204204204204,4,22,0.1818181818181818,136,311,0.4372990353697749,0.426,57,84,0.6785714285714286
Kobe Bryant,bryanko01,SF,18,LAL,1997,71,1103.0,539,91,47,85,132,49,23,112,102,176,422,0.4170616113744075,51,136,0.375,125,286,0.4370629370629371,0.477,136,166,0.8192771084337349
Mark Bryant,bryanma01,PF,31,PHO,1997,41,1018.0,380,47,67,145,212,22,5,46,136,152,275,0.5527272727272727,0,0,0.0,152,275,0.5527272727272727,0.553,76,108,0.7037037037037037
Jud Buechler,buechju01,SF,28,CHI,1997,76,703.0,139,60,45,81,126,23,21,27,50,58,158,0.3670886075949367,18,54,0.3333333333333333,40,104,0.3846153846153846,0.424,5,14,0.3571428571428571
Matt Bullard,bullama01,PF,29,HOU,1997,71,1025.0,320,67,13,104,117,21,18,38,68,114,284,0.4014084507042254,67,183,0.366120218579235,47,101,0.4653465346534653,0.519,25,34,0.7352941176470589
Scott Burrell,burresc01,SF,26,TOT,1997,57,939.0,294,74,49,109,158,28,19,53,120,98,271,0.3616236162361623,41,116,0.3534482758620689,57,155,0.3677419354838709,0.437,57,76,0.75
Willie Burton,burtowi01,SF,28,ATL,1997,24,380.0,148,11,11,30,41,8,3,26,55,39,116,0.3362068965517241,13,46,0.2826086956521739,26,70,0.3714285714285714,0.392,57,68,0.8382352941176471
Mitchell Butler,butlemi02,SG,26,POR,1997,49,465.0,148,30,19,34,53,13,2,27,55,52,125,0.416,12,39,0.3076923076923077,40,86,0.4651162790697674,0.464,32,50,0.64
Jason Caffey,caffeja01,PF,23,CHI,1997,75,1405.0,549,89,135,166,301,25,9,97,149,205,385,0.5324675324675324,0,1,0.0,205,384,0.5338541666666666,0.532,139,211,0.6587677725118484
Michael Cage,cagemi01,C,35,PHI,1997,82,1247.0,151,43,112,208,320,48,42,17,118,66,141,0.4680851063829787,0,0,0.0,66,141,0.4680851063829787,0.468,19,41,0.4634146341463415
Adrian Caldwell,caldwad01,PF,30,TOT,1997,45,569.0,101,12,58,109,167,16,8,28,87,40,92,0.4347826086956521,0,2,0.0,40,90,0.4444444444444444,0.435,21,50,0.42
Marcus Camby,cambyma01,C,22,TOR,1997,63,1897.0,935,97,131,263,394,66,130,134,214,375,778,0.4820051413881748,2,14,0.1428571428571428,373,764,0.4882198952879581,0.483,183,264,0.6931818181818182
Elden Campbell,campbel01,PF,28,LAL,1997,77,2516.0,1148,126,207,408,615,46,117,130,276,442,942,0.4692144373673036,1,4,0.25,441,938,0.4701492537313433,0.47,263,370,0.7108108108108108
Antoine Carr,carran01,PF,35,UTA,1997,82,1460.0,603,74,60,135,195,24,63,75,214,252,522,0.4827586206896552,0,3,0.0,252,519,0.4855491329479768,0.483,99,127,0.7795275590551181
Chris Carr,carrch01,SG,22,MIN,1997,55,830.0,337,48,31,82,113,24,10,37,93,125,271,0.4612546125461255,31,88,0.3522727272727273,94,183,0.5136612021857924,0.518,56,73,0.7671232876712328
Jimmy Carruth,carruji01,PF,27,MIL,1997,4,21.0,5,0,0,4,4,0,2,1,4,2,3,0.6666666666666666,0,0,0.0,2,3,0.6666666666666666,0.667,1,1,1.0
Sam Cassell,cassesa01,PG,27,TOT,1997,61,1714.0,967,305,47,135,182,77,19,168,200,337,783,0.4303959131545338,81,231,0.3506493506493506,256,552,0.463768115942029,0.482,212,251,0.8446215139442231
Duane Causwell,causwdu01,C,28,SAC,1997,46,581.0,118,20,57,70,127,15,38,34,131,48,94,0.5106382978723404,2,3,0.6666666666666666,46,91,0.5054945054945055,0.521,20,37,0.5405405405405406
Cedric Ceballos,cebalce01,SF,27,TOT,1997,50,1426.0,729,64,102,228,330,33,23,85,113,282,617,0.4570502431118314,26,102,0.2549019607843137,256,515,0.4970873786407767,0.478,139,186,0.7473118279569892
Tom Chambers,chambto01,PF,37,CHH,1997,12,83.0,19,4,3,11,14,1,0,9,14,7,31,0.2258064516129032,2,3,0.6666666666666666,5,28,0.1785714285714285,0.258,3,4,0.75
Rex Chapman,chapmre01,SG,29,PHO,1997,65,1833.0,898,182,25,156,181,52,7,96,108,332,749,0.4432576769025367,110,314,0.3503184713375796,222,435,0.5103448275862069,0.517,124,149,0.8322147651006712
Calbert Cheaney,cheanca01,SG,25,WSB,1997,79,2411.0,837,114,70,198,268,77,18,94,226,369,730,0.5054794520547945,4,30,0.1333333333333333,365,700,0.5214285714285715,0.508,95,137,0.6934306569343066
Pete Chilcutt,chilcpe01,PF,28,VAN,1997,54,662.0,182,47,67,89,156,26,17,28,52,72,165,0.4363636363636363,25,69,0.3623188405797101,47,96,0.4895833333333333,0.512,13,22,0.5909090909090909
Randolph Childress,childra01,PG,24,TOT,1997,23,155.0,39,17,1,5,6,9,0,18,16,14,40,0.35,5,19,0.2631578947368421,9,21,0.4285714285714285,0.413,6,8,0.75
Chris Childs,childch01,PG,29,NYK,1997,65,2076.0,605,398,22,169,191,78,11,180,213,211,510,0.4137254901960784,70,181,0.3867403314917127,141,329,0.4285714285714285,0.482,113,149,0.7583892617449665
Doug Christie,chrisdo01,SG,26,TOR,1997,81,3127.0,1176,315,85,347,432,201,45,200,245,396,949,0.4172813487881981,147,383,0.3838120104438642,249,566,0.4399293286219081,0.495,237,306,0.7745098039215687
Derrick Coleman,colemde01,PF,29,PHI,1997,57,2102.0,1032,193,157,416,573,50,75,184,164,364,836,0.4354066985645933,32,119,0.2689075630252101,332,717,0.4630404463040446,0.455,272,365,0.7452054794520548
Bimbo Coles,colesbi01,PG,28,GSW,1997,51,1183.0,311,149,39,79,118,35,7,59,96,122,314,0.3885350318471338,30,102,0.2941176470588235,92,212,0.4339622641509434,0.436,37,49,0.7551020408163265
Marty Conlon,conloma01,C,29,BOS,1997,74,1614.0,574,104,128,195,323,46,18,109,154,214,454,0.4713656387665198,2,10,0.2,212,444,0.4774774774774775,0.474,144,171,0.8421052631578947
Tyrone Corbin,corbity01,SF,34,ATL,1997,70,2305.0,666,124,76,218,294,90,7,85,176,253,600,0.4216666666666667,74,208,0.3557692307692308,179,392,0.4566326530612244,0.483,86,108,0.7962962962962963
Joe Courtney,courtjo01,PF,27,TOT,1997,9,100.0,25,0,9,7,16,0,0,3,14,11,30,0.3666666666666666,0,0,0.0,11,30,0.3666666666666666,0.367,3,5,0.6
John Crotty,crottjo01,PG,27,MIA,1997,48,659.0,232,102,15,32,47,18,0,42,79,79,154,0.512987012987013,20,49,0.4081632653061224,59,105,0.5619047619047619,0.578,54,64,0.84375
Terry Cummings,cummite01,PF,35,SEA,1997,45,828.0,370,39,70,113,183,33,7,45,113,155,319,0.4858934169278996,3,5,0.6,152,314,0.4840764331210191,0.491,57,82,0.6951219512195121
Earl Cureton,curetea01,PF,39,TOR,1997,9,46.0,7,4,4,5,9,0,0,1,10,3,8,0.375,0,0,0.0,3,8,0.375,0.375,1,3,0.3333333333333333
Dell Curry,curryde01,SG,32,CHH,1997,68,2078.0,1008,118,40,171,211,60,14,93,147,384,836,0.4593301435406698,126,296,0.4256756756756756,258,540,0.4777777777777778,0.535,114,142,0.8028169014084507
Michael Curry,currymi01,SG,28,DET,1997,81,1217.0,318,43,23,96,119,31,12,28,128,99,221,0.4479638009049774,23,77,0.2987012987012987,76,144,0.5277777777777778,0.5,97,108,0.8981481481481481
Erick Dampier,dampier01,C,21,IND,1997,72,1052.0,370,43,96,198,294,19,73,84,153,131,336,0.3898809523809524,1,1,1.0,130,335,0.3880597014925373,0.391,107,168,0.6369047619047619
Lloyd Daniels,daniell01,SG,29,TOT,1997,22,310.0,98,26,19,24,43,10,3,14,33,36,119,0.3025210084033613,21,70,0.3,15,49,0.3061224489795918,0.391,5,6,0.8333333333333334
Sasha Danilović,danilsa01,SG,26,TOT,1997,56,1789.0,702,102,29,107,136,54,9,116,160,248,570,0.4350877192982456,85,236,0.3601694915254237,163,334,0.4880239520958084,0.51,121,151,0.8013245033112583
Yinka Dare,dareyi01,C,24,NJN,1997,41,313.0,57,3,35,47,82,4,28,21,51,19,54,0.3518518518518518,0,0,0.0,19,54,0.3518518518518518,0.352,19,37,0.5135135135135135
Antonio Davis,davisan01,PF,28,IND,1997,82,2335.0,858,65,190,408,598,42,84,141,260,308,641,0.4804992199687987,1,14,0.0714285714285714,307,627,0.4896331738437001,0.481,241,362,0.6657458563535912
Ben Davis,davisbe01,PF,24,PHO,1997,20,98.0,29,0,12,15,27,4,1,3,16,10,26,0.3846153846153846,0,0,0.0,10,26,0.3846153846153846,0.385,9,20,0.45
Dale Davis,davisda01,PF,27,IND,1997,80,2589.0,832,59,301,471,772,60,77,108,233,370,688,0.5377906976744186,0,0,0.0,370,688,0.5377906976744186,0.538,92,215,0.427906976744186
Emanual Davis,davisem01,PG,28,HOU,1997,13,230.0,65,26,2,20,22,9,2,17,20,24,54,0.4444444444444444,12,27,0.4444444444444444,12,27,0.4444444444444444,0.556,5,8,0.625
Hubert Davis,davishu01,SG,26,TOR,1997,36,623.0,181,34,11,29,40,11,2,21,40,74,184,0.4021739130434782,16,70,0.2285714285714285,58,114,0.5087719298245614,0.446,17,23,0.7391304347826086
Mark Davis,davisma02,SF,23,PHI,1997,75,1705.0,639,135,138,185,323,85,31,118,230,251,535,0.4691588785046729,24,93,0.2580645161290322,227,442,0.5135746606334841,0.492,113,168,0.6726190476190477
Todd Day,dayto01,SG,27,BOS,1997,81,2277.0,1178,117,109,221,330,108,48,127,208,398,999,0.3983983983983984,126,348,0.3620689655172414,272,651,0.4178187403993855,0.461,256,331,0.7734138972809668
Andrew DeClercq,declean01,C,23,GSW,1997,71,1065.0,375,32,122,176,298,33,27,76,229,142,273,0.5201465201465202,0,0,0.0,142,273,0.5201465201465202,0.52,91,151,0.6026490066225165
Terry Dehere,deherte01,PG,25,LAC,1997,73,1053.0,470,158,15,80,95,27,3,96,142,148,383,0.3864229765013054,52,160,0.325,96,223,0.4304932735426009,0.454,122,148,0.8243243243243243
Vinny Del Negro,delnevi01,SG,30,SAS,1997,72,2243.0,886,231,39,171,210,59,7,92,131,365,781,0.4673495518565941,44,140,0.3142857142857143,321,641,0.500780031201248,0.496,112,129,0.8682170542635659
Bison Dele,delebi01,C,27,CHI,1997,9,138.0,63,12,14,19,33,3,5,11,20,26,63,0.4126984126984127,0,0,0.0,26,63,0.4126984126984127,0.413,11,15,0.7333333333333333
Tony Delk,delkto01,PG,23,CHH,1997,61,867.0,332,99,31,68,99,36,6,68,71,119,256,0.46484375,52,112,0.4642857142857143,67,144,0.4652777777777778,0.566,42,51,0.8235294117647058
Dell Demps,dempsde01,SG,26,ORL,1997,2,10.0,2,0,0,0,0,1,0,0,1,0,3,0.0,0,1,0.0,0,2,0.0,0.0,2,2,1.0
Vlade Divac,divacvl01,C,28,CHH,1997,81,2840.0,1024,301,241,484,725,103,180,193,277,418,847,0.4935064935064935,11,47,0.2340425531914893,407,800,0.50875,0.5,177,259,0.6833976833976834
Sherman Douglas,douglsh01,PG,30,MIL,1997,79,2316.0,764,427,57,136,193,78,10,153,191,306,610,0.5016393442622951,38,114,0.3333333333333333,268,496,0.5403225806451613,0.533,114,171,0.6666666666666666
Greg Dreiling,dreilgr01,C,34,DAL,1997,40,389.0,80,11,19,57,76,8,7,9,65,34,74,0.4594594594594595,1,1,1.0,33,73,0.4520547945205479,0.466,11,27,0.4074074074074074
Clyde Drexler,drexlcl01,SG,34,HOU,1997,62,2271.0,1114,354,118,255,373,119,36,156,151,397,899,0.4416017797552836,119,335,0.3552238805970149,278,564,0.4929078014184397,0.508,201,268,0.75
Nate Driggers,driggna01,SG,23,BOS,1997,15,132.0,36,6,12,10,22,3,2,6,10,13,43,0.3023255813953488,0,9,0.0,13,34,0.3823529411764705,0.302,10,14,0.7142857142857143
Kevin Duckworth,duckwke01,C,32,LAC,1997,26,384.0,104,16,23,37,60,9,11,33,63,45,103,0.4368932038834951,3,4,0.75,42,99,0.4242424242424242,0.451,11,16,0.6875
Chris Dudley,dudlech02,C,31,POR,1997,81,1840.0,317,41,204,389,593,39,96,80,247,126,293,0.4300341296928328,0,0,0.0,126,293,0.4300341296928328,0.43,65,137,0.4744525547445255
Joe Dumars,dumarjo01,SG,33,DET,1997,79,2923.0,1158,318,38,153,191,57,1,128,97,385,875,0.44,166,384,0.4322916666666667,219,491,0.4460285132382892,0.535,222,256,0.8671875
Tony Dumas,dumasto01,SG,24,TOT,1997,24,278.0,86,25,3,13,16,10,2,16,45,33,96,0.34375,4,28,0.1428571428571428,29,68,0.4264705882352941,0.365,16,25,0.64
Acie Earl,earlac01,C,26,TOT,1997,47,500.0,188,20,35,61,96,15,28,35,61,67,180,0.3722222222222222,0,5,0.0,67,175,0.3828571428571428,0.372,54,84,0.6428571428571429
Tyus Edney,edneyty01,PG,23,SAC,1997,70,1376.0,485,226,34,79,113,60,2,112,98,150,391,0.3836317135549872,8,42,0.1904761904761904,142,349,0.4068767908309456,0.394,177,215,0.8232558139534883
Blue Edwards,edwarbl01,SF,31,VAN,1997,61,1439.0,478,114,49,140,189,38,20,81,135,182,458,0.3973799126637554,25,89,0.2808988764044944,157,369,0.4254742547425474,0.425,89,109,0.8165137614678899
Kevin Edwards,edwarke01,PG,31,NJN,1997,32,477.0,190,57,9,34,43,17,4,49,34,69,183,0.3770491803278688,15,43,0.3488372093023256,54,140,0.3857142857142857,0.418,37,43,0.8604651162790697
Craig Ehlo,ehlocr01,SG,35,SEA,1997,62,848.0,214,68,39,71,110,36,4,45,71,87,248,0.3508064516129032,27,95,0.2842105263157894,60,153,0.392156862745098,0.405,13,26,0.5
Howard Eisley,eisleho01,PG,24,UTA,1997,82,1083.0,368,198,20,64,84,44,10,110,141,139,308,0.4512987012987013,20,72,0.2777777777777778,119,236,0.5042372881355932,0.484,70,89,0.7865168539325843
Mario Elie,eliema01,SF,33,HOU,1997,78,2687.0,909,310,60,175,235,92,12,135,200,291,585,0.4974358974358974,120,286,0.4195804195804196,171,299,0.5719063545150501,0.6,207,231,0.8961038961038961
Sean Elliott,elliose01,SF,28,SAS,1997,39,1393.0,582,124,48,142,190,24,24,89,105,196,464,0.4224137931034483,42,126,0.3333333333333333,154,338,0.4556213017751479,0.468,148,196,0.7551020408163265
Dale Ellis,ellisda01,SF,36,DEN,1997,82,2940.0,1361,165,99,194,293,60,7,146,178,477,1151,0.4144222415291051,192,528,0.3636363636363636,285,623,0.4574638844301765,0.498,215,263,0.8174904942965779
LaPhonso Ellis,ellisla01,PF,26,DEN,1997,55,2002.0,1203,131,107,279,386,44,41,117,181,445,1014,0.4388560157790927,95,259,0.3667953667953668,350,755,0.4635761589403973,0.486,218,282,0.7730496453900709
Pervis Ellison,ellispe01,PF,29,BOS,1997,6,125.0,15,4,9,17,26,5,9,7,21,6,16,0.375,0,0,0.0,6,16,0.375,0.375,3,5,0.6
Brian Evans,evansbr01,SF,23,ORL,1997,14,59.0,20,7,1,7,8,1,2,2,6,8,22,0.3636363636363636,4,8,0.5,4,14,0.2857142857142857,0.455,0,0,0.0
Patrick Ewing,ewingpa01,C,34,NYK,1997,78,2887.0,1751,156,175,659,834,69,189,269,250,655,1342,0.4880774962742176,2,9,0.2222222222222222,653,1333,0.4898724681170293,0.489,439,582,0.7542955326460481
Jamie Feick,feickja01,PF-C,22,TOT,1997,41,624.0,151,26,82,132,214,16,14,31,78,56,157,0.3566878980891719,5,14,0.3571428571428571,51,143,0.3566433566433566,0.373,34,67,0.5074626865671642
Duane Ferrell,ferredu01,SF,31,IND,1997,62,1115.0,394,66,57,84,141,38,6,55,120,159,337,0.4718100890207715,18,44,0.4090909090909091,141,293,0.4812286689419795,0.499,58,94,0.6170212765957447
Danny Ferry,ferryda01,PF,30,CLE,1997,82,2633.0,870,151,82,255,337,56,32,94,245,341,794,0.4294710327455919,114,284,0.4014084507042254,227,510,0.4450980392156862,0.501,74,87,0.8505747126436781
Michael Finley,finlemi01,SF,23,TOT,1997,83,2790.0,1249,224,88,284,372,68,24,164,138,475,1071,0.4435107376283846,101,280,0.3607142857142857,374,791,0.472819216182048,0.491,198,245,0.8081632653061225
Matt Fish,fishma01,C,27,TOT,1997,6,8.0,2,0,1,4,5,0,0,2,2,1,3,0.3333333333333333,0,0,0.0,1,3,0.3333333333333333,0.333,0,0,0.0
Derek Fisher,fishede01,PG,22,LAL,1997,80,921.0,309,119,25,72,97,41,5,71,87,104,262,0.3969465648854962,22,73,0.3013698630136986,82,189,0.4338624338624338,0.439,79,120,0.6583333333333333
Greg Foster,fostegr01,C,28,UTA,1997,79,920.0,278,31,56,131,187,10,20,54,145,111,245,0.4530612244897959,2,3,0.6666666666666666,109,242,0.4504132231404958,0.457,54,65,0.8307692307692308
Rick Fox,foxri01,SF,27,BOS,1997,76,2650.0,1174,286,114,280,394,167,40,178,279,433,950,0.4557894736842105,101,278,0.3633093525179856,332,672,0.494047619047619,0.509,207,263,0.7870722433460076
Todd Fuller,fulleto02,C,22,GSW,1997,75,949.0,304,24,108,141,249,10,20,52,146,114,266,0.4285714285714285,0,0,0.0,114,266,0.4285714285714285,0.429,76,110,0.6909090909090909
Kevin Gamble,gamblke01,SF,31,SAC,1997,62,953.0,307,77,13,94,107,21,17,27,76,123,286,0.43006993006993,54,112,0.4821428571428571,69,174,0.396551724137931,0.524,7,10,0.7
Kevin Garnett,garneke01,SF,20,MIN,1997,77,2995.0,1309,236,190,428,618,105,163,175,199,549,1100,0.4990909090909091,6,21,0.2857142857142857,543,1079,0.5032437442075997,0.502,205,272,0.7536764705882353
Dean Garrett,garrede01,C,30,MIN,1997,68,1665.0,542,38,149,346,495,40,95,34,158,223,389,0.5732647814910026,0,0,0.0,223,389,0.5732647814910026,0.573,96,138,0.6956521739130435
Chris Gatling,gatlich01,PF,29,TOT,1997,47,1283.0,891,28,134,236,370,39,31,120,138,327,623,0.5248796147672552,1,6,0.1666666666666666,326,617,0.5283630470016207,0.526,236,329,0.7173252279635258
Reggie Geary,gearyre01,PG,23,CLE,1997,39,246.0,57,36,4,11,15,13,2,15,36,22,58,0.3793103448275862,8,21,0.3809523809523809,14,37,0.3783783783783784,0.448,5,11,0.4545454545454545
Matt Geiger,geigema01,C,27,CHH,1997,49,1044.0,437,38,100,158,258,20,27,67,153,171,350,0.4885714285714285,6,20,0.3,165,330,0.5,0.497,89,127,0.7007874015748031
Kendall Gill,gillke01,SF,28,NJN,1997,82,3199.0,1789,326,183,316,499,154,46,218,225,644,1453,0.4432209222298692,74,220,0.3363636363636363,570,1233,0.462287104622871,0.469,427,536,0.7966417910447762
Armen Gilliam,gilliar01,PF,32,MIL,1997,80,2050.0,691,53,136,361,497,61,40,105,206,246,522,0.4712643678160919,0,0,0.0,246,522,0.4712643678160919,0.471,199,259,0.7683397683397684
Anthony Goldwire,goldwan01,PG,25,TOT,1997,60,1188.0,387,219,12,72,84,33,2,76,104,131,330,0.396969696969697,64,153,0.4183006535947712,67,177,0.3785310734463277,0.494,61,78,0.782051282051282
Greg Graham,grahagr01,SG,26,SEA,1997,28,197.0,93,11,2,11,13,12,1,10,12,29,80,0.3625,9,31,0.2903225806451613,20,49,0.4081632653061224,0.419,26,40,0.65
Brian Grant,grantbr01,PF,24,SAC,1997,24,607.0,252,28,49,93,142,19,25,44,75,91,207,0.4396135265700483,0,0,0.0,91,207,0.4396135265700483,0.44,70,90,0.7777777777777778
Gary Grant,grantga01,PG,31,MIA,1997,28,365.0,110,45,8,30,38,16,0,27,39,39,110,0.3545454545454545,14,46,0.3043478260869565,25,64,0.390625,0.418,18,22,0.8181818181818182
Harvey Grant,grantha01,PF,31,WSB,1997,78,1604.0,316,68,63,193,256,46,48,30,167,129,314,0.410828025477707,28,89,0.3146067415730337,101,225,0.4488888888888889,0.455,30,39,0.7692307692307693
Horace Grant,grantho01,PF,31,ORL,1997,67,2496.0,845,163,206,394,600,101,65,99,157,358,695,0.5151079136690647,1,6,0.1666666666666666,357,689,0.5181422351233672,0.516,128,179,0.7150837988826816
Devin Gray,grayde01,PF,24,TOT,1997,6,49.0,18,2,6,8,14,4,0,5,11,8,26,0.3076923076923077,0,0,0.0,8,26,0.3076923076923077,0.308,2,5,0.4
Evric Gray,grayev01,SF,27,NJN,1997,5,42.0,13,2,1,2,3,1,0,3,5,4,15,0.2666666666666666,1,4,0.25,3,11,0.2727272727272727,0.3,4,4,1.0
Jeff Grayer,grayeje01,SG,31,SAC,1997,25,316.0,91,25,21,17,38,8,7,15,42,38,83,0.4578313253012048,4,11,0.3636363636363636,34,72,0.4722222222222222,0.482,11,20,0.55
A.C. Green,greenac01,PF,33,TOT,1997,83,2492.0,597,69,222,434,656,70,16,74,145,234,484,0.4834710743801653,1,20,0.05,233,464,0.5021551724137931,0.485,128,197,0.649746192893401
Litterial Green,greenli01,PG,26,DET,1997,45,311.0,90,41,6,16,22,16,1,15,27,30,64,0.46875,0,10,0.0,30,54,0.5555555555555556,0.469,30,47,0.6382978723404256
Tom Gugliotta,guglito01,PF,27,MIN,1997,81,3131.0,1672,335,187,515,702,130,89,293,237,592,1339,0.4421209858103062,24,93,0.2580645161290322,568,1246,0.4558587479935794,0.451,464,566,0.8197879858657244
Jack Haley,haleyja01,C,33,NJN,1997,20,74.0,40,5,13,19,32,1,1,2,14,13,37,0.3513513513513513,0,0,0.0,13,37,0.3513513513513513,0.351,14,19,0.7368421052631579
Darvin Ham,hamda01,SF,23,TOT,1997,36,318.0,83,14,29,27,56,9,8,22,57,33,62,0.532258064516129,0,0,0.0,33,62,0.532258064516129,0.532,17,35,0.4857142857142857
Steve Hamer,hamerst01,C,23,BOS,1997,35,268.0,76,7,17,43,60,2,4,13,39,30,57,0.5263157894736842,0,2,0.0,30,55,0.5454545454545454,0.526,16,29,0.5517241379310345
Tom Hammonds,hammoto01,PF,29,DEN,1997,81,1758.0,506,64,135,266,401,16,24,88,205,191,398,0.4798994974874372,0,2,0.0,191,396,0.4823232323232323,0.48,124,172,0.7209302325581395
Darrin Hancock,hancoda01,SF,25,TOT,1997,24,133.0,42,12,4,14,18,9,1,11,15,16,35,0.4571428571428571,0,0,0.0,16,35,0.4571428571428571,0.457,10,14,0.7142857142857143
Anfernee Hardaway,hardaan01,PG,25,ORL,1997,59,2221.0,1210,332,82,181,263,93,35,145,123,421,941,0.4473963868225292,85,267,0.3183520599250936,336,674,0.4985163204747774,0.493,283,345,0.8202898550724638
Tim Hardaway,hardati01,PG,30,MIA,1997,81,3136.0,1644,695,49,228,277,151,9,230,165,575,1384,0.4154624277456647,203,590,0.3440677966101695,372,794,0.4685138539042821,0.489,291,364,0.7994505494505495
Derek Harper,harpede01,PG,35,DAL,1997,75,2210.0,753,321,30,107,137,92,12,132,144,299,674,0.443620178041543,60,176,0.3409090909090909,239,498,0.4799196787148594,0.488,95,128,0.7421875
Ron Harper,harpero01,PG,33,CHI,1997,76,1740.0,480,191,46,147,193,86,38,50,138,177,406,0.4359605911330049,68,188,0.3617021276595745,109,218,0.5,0.52,58,82,0.7073170731707317
Othella Harrington,harriot01,PF,23,HOU,1997,57,860.0,273,18,75,123,198,12,22,57,112,112,204,0.5490196078431373,0,3,0.0,112,201,0.5572139303482587,0.549,49,81,0.6049382716049383
Lucious Harris,harrilu01,SG,26,PHI,1997,54,813.0,293,50,27,44,71,41,3,34,45,112,294,0.3809523809523809,36,99,0.3636363636363636,76,195,0.3897435897435897,0.442,33,47,0.7021276595744681
Antonio Harvey,harvean01,PF,26,SEA,1997,6,26.0,15,1,2,8,10,0,4,1,8,5,11,0.4545454545454545,0,0,0.0,5,11,0.4545454545454545,0.455,5,6,0.8333333333333334
Hersey Hawkins,hawkihe01,SG,30,SEA,1997,82,2755.0,1139,250,92,228,320,159,12,130,146,369,795,0.4641509433962264,143,355,0.4028169014084507,226,440,0.5136363636363637,0.554,258,295,0.8745762711864407
Michael Hawkins,hawkimi01,PG,24,BOS,1997,29,326.0,80,64,9,22,31,16,1,28,40,29,68,0.4264705882352941,10,31,0.3225806451612903,19,37,0.5135135135135135,0.5,12,15,0.8
Shane Heal,healsh01,PG,26,MIN,1997,43,236.0,75,33,2,16,18,3,3,17,20,26,97,0.268041237113402,20,65,0.3076923076923077,6,32,0.1875,0.371,3,5,0.6
Alan Henderson,hendeal01,PF,24,ATL,1997,30,501.0,199,23,47,69,116,21,6,29,73,77,162,0.4753086419753086,0,0,0.0,77,162,0.4753086419753086,0.475,45,75,0.6
Mark Hendrickson,hendrma01,PF,22,PHI,1997,29,301.0,85,3,35,57,92,10,4,14,32,32,77,0.4155844155844156,3,12,0.25,29,65,0.4461538461538462,0.435,18,26,0.6923076923076923
Carl Herrera,herreca01,PF,30,SAS,1997,75,1837.0,597,50,118,222,340,62,53,95,217,257,593,0.433389544688027,2,6,0.3333333333333333,255,587,0.434412265758092,0.435,81,118,0.6864406779661016
Grant Hill,hillgr01,SF,24,DET,1997,80,3147.0,1710,583,123,598,721,144,48,259,186,625,1259,0.4964257347100874,10,33,0.303030303030303,615,1226,0.50163132137031,0.5,450,633,0.7109004739336493
Tyrone Hill,hillty01,C,28,CLE,1997,74,2582.0,955,92,259,477,736,63,30,147,268,357,595,0.6,0,1,0.0,357,594,0.601010101010101,0.6,241,381,0.6325459317585301
Fred Hoiberg,hoibefr01,SG,24,IND,1997,47,572.0,224,41,13,68,81,27,6,22,51,67,156,0.4294871794871794,29,70,0.4142857142857143,38,86,0.4418604651162791,0.522,61,77,0.7922077922077922
Jeff Hornacek,hornaje01,SG,33,UTA,1997,82,2592.0,1191,361,60,181,241,124,26,134,188,413,856,0.4824766355140187,72,195,0.3692307692307692,341,661,0.5158850226928896,0.525,293,326,0.8987730061349694
Robert Horry,horryro01,SF,26,TOT,1997,54,1395.0,423,110,68,169,237,66,55,72,153,157,360,0.4361111111111111,49,154,0.3181818181818182,108,206,0.5242718446601942,0.504,60,90,0.6666666666666666
Allan Houston,houstal01,SG,25,NYK,1997,81,2681.0,1197,179,43,197,240,41,18,167,233,437,1032,0.4234496124031007,148,384,0.3854166666666667,289,648,0.4459876543209876,0.495,175,218,0.8027522935779816
Juwan Howard,howarju01,SF,23,WSB,1997,82,3324.0,1570,311,202,450,652,93,23,246,259,638,1313,0.4859101294744859,0,2,0.0,638,1311,0.486651411136537,0.486,294,389,0.7557840616966581
Stephen Howard,howarst01,SF,26,TOT,1997,49,418.0,176,11,29,56,85,19,12,25,62,62,108,0.5740740740740741,0,0,0.0,62,108,0.5740740740740741,0.574,52,81,0.6419753086419753
Lindsey Hunter,hunteli01,PG,26,DET,1997,82,3023.0,1166,154,59,174,233,129,24,96,206,421,1042,0.4040307101727447,166,468,0.3547008547008547,255,574,0.4442508710801394,0.484,158,203,0.7783251231527094
Bobby Hurley,hurlebo01,PG,25,SAC,1997,49,632.0,143,146,9,29,38,27,3,55,53,46,125,0.368,14,45,0.3111111111111111,32,80,0.4,0.424,37,53,0.6981132075471698
Allen Iverson,iversal01,PG,21,PHI,1997,76,3045.0,1787,567,115,197,312,157,24,337,233,625,1504,0.4155585106382978,155,455,0.3406593406593406,470,1049,0.4480457578646329,0.467,382,544,0.7022058823529411
Jaren Jackson,jacksja01,SG,29,WSB,1997,75,1133.0,374,65,31,101,132,45,16,60,131,134,329,0.4072948328267477,53,158,0.3354430379746835,81,171,0.4736842105263157,0.488,53,69,0.7681159420289855
Jim Jackson,jacksji01,SG-SF,26,TOT,1997,77,2831.0,1226,316,132,279,411,86,32,208,194,444,1029,0.4314868804664723,86,247,0.3481781376518219,358,782,0.4578005115089514,0.473,252,310,0.8129032258064516
Mark Jackson,jacksma01,PG,31,TOT,1997,82,3054.0,812,935,91,304,395,97,12,274,161,289,679,0.4256259204712813,66,178,0.3707865168539326,223,501,0.4451097804391217,0.474,168,213,0.7887323943661971
Henry James,jameshe01,PF,31,ATL,1997,53,945.0,356,21,27,54,81,11,1,29,98,125,306,0.4084967320261438,76,181,0.4198895027624309,49,125,0.392,0.533,30,36,0.8333333333333334
Chris Jent,jentch01,SF,27,NYK,1997,3,10.0,6,1,1,0,1,0,0,0,2,2,6,0.3333333333333333,2,3,0.6666666666666666,0,3,0.0,0.5,0,0,0.0
Avery Johnson,johnsav01,PG,31,SAS,1997,76,2472.0,800,513,32,115,147,96,15,146,158,327,685,0.4773722627737226,6,26,0.2307692307692307,321,659,0.4871016691957511,0.482,140,203,0.6896551724137931
Eddie Johnson,johnsed03,SF,37,TOT,1997,52,913.0,424,52,27,111,138,15,2,47,81,160,362,0.4419889502762431,49,131,0.3740458015267175,111,231,0.4805194805194805,0.51,55,68,0.8088235294117647
Ervin Johnson,johnser02,C,29,DEN,1997,82,2599.0,582,71,231,682,913,65,227,118,288,243,467,0.5203426124197003,0,2,0.0,243,465,0.5225806451612903,0.52,96,156,0.6153846153846154
Kevin Johnson,johnske02,PG,30,PHO,1997,70,2658.0,1410,653,54,199,253,102,12,217,141,441,890,0.495505617977528,89,202,0.4405940594059406,352,688,0.5116279069767442,0.546,439,515,0.8524271844660194
Larry Johnson,johnsla02,SF,27,NYK,1997,76,2613.0,976,174,165,228,393,64,36,136,249,376,735,0.5115646258503401,34,105,0.3238095238095238,342,630,0.5428571428571428,0.535,190,274,0.6934306569343066
Charles Jones,jonesch01,PF,39,HOU,1997,12,93.0,4,3,5,8,13,2,4,0,8,2,5,0.4,0,0,0.0,2,5,0.4,0.4,0,0,0.0
Eddie Jones,jonesed02,SG,25,LAL,1997,80,2998.0,1374,270,90,236,326,189,49,169,226,473,1081,0.4375578168362627,152,389,0.390745501285347,321,692,0.4638728323699422,0.508,276,337,0.8189910979228486
Popeye Jones,jonespo01,PF,26,TOR,1997,79,2421.0,616,84,270,410,680,58,39,116,269,258,537,0.4804469273743016,1,13,0.0769230769230769,257,524,0.4904580152671756,0.481,99,121,0.8181818181818182
Michael Jordan,jordami01,SG,33,CHI,1997,82,3106.0,2431,352,113,369,482,140,44,166,156,920,1892,0.4862579281183932,111,297,0.3737373737373737,809,1595,0.5072100313479624,0.516,480,576,0.8333333333333334
Reggie Jordan,jordare01,SG,29,TOT,1997,19,130.0,40,12,11,16,27,7,3,8,15,16,26,0.6153846153846154,0,0,0.0,16,26,0.6153846153846154,0.615,8,17,0.4705882352941176
Adam Keefe,keefead01,C,26,UTA,1997,62,915.0,235,32,75,141,216,30,13,45,97,82,160,0.5125,0,1,0.0,82,159,0.5157232704402516,0.513,71,103,0.6893203883495146
Shawn Kemp,kempsh01,PF,27,SEA,1997,81,2750.0,1516,156,275,532,807,125,81,280,320,526,1032,0.5096899224806202,12,33,0.3636363636363636,514,999,0.5145145145145145,0.516,452,609,0.7422003284072249
Tim Kempton,kemptti01,PF,33,SAS,1997,10,59.0,4,2,3,5,8,1,1,7,4,1,5,0.2,0,0,0.0,1,5,0.2,0.2,2,2,1.0
Steve Kerr,kerrst01,PG,31,CHI,1997,82,1861.0,662,175,29,101,130,67,3,43,98,249,467,0.5331905781584583,110,237,0.4641350210970464,139,230,0.6043478260869565,0.651,54,67,0.8059701492537313
Jerome Kersey,kerseje01,SF,34,LAL,1997,70,1766.0,476,89,112,251,363,119,49,74,219,194,449,0.4320712694877505,17,65,0.2615384615384615,177,384,0.4609375,0.451,71,118,0.6016949152542372
Jason Kidd,kiddja01,PG,23,TOT,1997,55,1964.0,599,496,64,185,249,124,20,142,114,213,529,0.4026465028355387,61,165,0.3696969696969697,152,364,0.4175824175824176,0.46,112,165,0.6787878787878788
Frankie King,kingfr01,SG,24,PHI,1997,7,59.0,20,5,4,10,14,4,0,3,7,7,17,0.4117647058823529,1,2,0.5,6,15,0.4,0.441,5,5,1.0
Jimmy King,kingji02,SG,23,DEN,1997,2,22.0,6,2,2,0,2,3,0,1,2,2,6,0.3333333333333333,0,0,0.0,2,6,0.3333333333333333,0.333,2,4,0.5
Stacey King,kingst01,C,30,TOT,1997,11,103.0,24,1,11,16,27,2,1,6,14,11,22,0.5,0,0,0.0,11,22,0.5,0.5,2,7,0.2857142857142857
Kerry Kittles,kittlke01,SG,22,NJN,1997,82,3012.0,1347,249,106,213,319,157,35,127,165,507,1189,0.4264087468460891,158,419,0.3770883054892601,349,770,0.4532467532467532,0.493,175,227,0.7709251101321586
Joe Kleine,kleinjo01,C,35,TOT,1997,59,848.0,168,35,62,141,203,17,18,41,110,69,170,0.4058823529411764,2,3,0.6666666666666666,67,167,0.4011976047904191,0.412,28,38,0.7368421052631579
Travis Knight,knightr01,C,22,LAL,1997,71,1156.0,342,39,130,189,319,31,58,49,170,140,275,0.509090909090909,0,0,0.0,140,275,0.509090909090909,0.509,62,100,0.62
Larry Krystkowiak,krystla01,PF,32,LAL,1997,3,11.0,3,3,2,3,5,2,0,1,3,1,2,0.5,0,0,0.0,1,2,0.5,0.5,1,2,0.5
Toni Kukoč,kukocto01,SF,28,CHI,1997,57,1610.0,754,256,94,167,261,60,29,91,97,285,605,0.4710743801652892,50,151,0.3311258278145695,235,454,0.5176211453744494,0.512,134,174,0.7701149425287356
Christian Laettner,laettch01,PF,27,ATL,1997,82,3140.0,1486,223,212,508,720,102,64,218,277,548,1128,0.4858156028368794,31,88,0.3522727272727273,517,1040,0.4971153846153846,0.5,359,440,0.8159090909090909
Andrew Lang,langan01,C,30,MIL,1997,52,1194.0,274,25,94,184,278,26,47,39,140,115,248,0.4637096774193548,0,0,0.0,115,248,0.4637096774193548,0.464,44,61,0.7213114754098361
Antonio Lang,langan02,PF,24,CLE,1997,64,843.0,171,33,52,75,127,33,30,50,111,68,162,0.419753086419753,0,6,0.0,68,156,0.4358974358974359,0.42,35,48,0.7291666666666666
Priest Lauderdale,laudepr01,C,23,ATL,1997,35,180.0,111,12,16,27,43,1,9,37,39,49,89,0.550561797752809,0,1,0.0,49,88,0.5568181818181818,0.551,13,23,0.5652173913043478
Eric Leckner,leckner01,C,30,TOT,1997,20,126.0,34,5,5,31,36,3,2,10,35,14,33,0.4242424242424242,0,0,0.0,14,33,0.4242424242424242,0.424,6,12,0.5
Tim Legler,legleti01,SG,30,WSB,1997,15,182.0,44,7,0,21,21,3,5,9,21,15,48,0.3125,8,29,0.2758620689655172,7,19,0.3684210526315789,0.396,6,7,0.8571428571428571
Voshon Lenard,lenarvo01,SG,23,MIA,1997,73,2111.0,897,161,38,179,217,50,18,109,168,314,684,0.4590643274853801,183,442,0.4140271493212669,131,242,0.5413223140495868,0.593,86,105,0.819047619047619
Martin Lewis,lewisma01,SF,21,TOR,1997,9,50.0,14,4,4,2,6,1,2,1,8,6,14,0.4285714285714285,1,3,0.3333333333333333,5,11,0.4545454545454545,0.464,1,2,0.5
Alton Lister,listeal01,C,38,BOS,1997,53,516.0,87,13,66,102,168,8,14,30,95,32,77,0.4155844155844156,0,0,0.0,32,77,0.4155844155844156,0.416,23,31,0.7419354838709677
Randy Livingston,livinra01,PG,21,HOU,1997,64,981.0,251,155,32,62,94,39,12,102,107,100,229,0.4366812227074236,9,22,0.4090909090909091,91,207,0.4396135265700483,0.456,42,65,0.6461538461538462
Horacio Llamas,llamaho01,C,23,PHO,1997,20,101.0,34,4,4,14,18,10,5,11,25,15,28,0.5357142857142857,0,0,0.0,15,28,0.5357142857142857,0.536,4,8,0.5
Brad Lohaus,lohaubr01,PF,32,TOR,1997,6,45.0,10,1,1,6,7,1,0,1,6,4,15,0.2666666666666666,2,7,0.2857142857142857,2,8,0.25,0.333,0,0,0.0
Grant Long,longgr01,PF,30,DET,1997,65,1166.0,326,39,88,134,222,43,6,48,106,123,275,0.4472727272727272,17,47,0.3617021276595745,106,228,0.4649122807017544,0.478,63,84,0.75
John Long,longjo01,SG,40,TOR,1997,32,370.0,129,21,6,34,40,9,2,24,28,46,117,0.3931623931623931,12,34,0.3529411764705882,34,83,0.4096385542168674,0.444,25,28,0.8928571428571429
Luc Longley,longllu01,C,28,CHI,1997,59,1472.0,537,141,121,211,332,23,66,111,191,221,485,0.4556701030927835,0,2,0.0,221,483,0.4575569358178054,0.456,95,120,0.7916666666666666
George Lynch,lynchge01,SF,26,VAN,1997,41,1059.0,342,76,98,163,261,63,17,64,97,137,291,0.4707903780068728,8,31,0.2580645161290322,129,260,0.4961538461538461,0.485,60,97,0.6185567010309279
Sam Mack,macksa01,SF,26,HOU,1997,52,904.0,292,58,20,86,106,29,6,42,67,105,262,0.4007633587786259,47,142,0.3309859154929577,58,120,0.4833333333333333,0.49,35,42,0.8333333333333334
Don MacLean,macledo01,SF,27,PHI,1997,37,733.0,402,37,41,99,140,12,10,47,71,163,365,0.4465753424657534,12,38,0.3157894736842105,151,327,0.4617737003058104,0.463,64,97,0.6597938144329897
Rick Mahorn,mahorri01,C,38,DET,1997,22,218.0,56,6,19,34,53,4,3,10,34,20,54,0.3703703703703703,0,1,0.0,20,53,0.3773584905660377,0.37,16,22,0.7272727272727273
Dan Majerle,majerda01,SF,31,MIA,1997,36,1264.0,390,116,45,117,162,54,14,50,75,141,347,0.4063400576368876,68,201,0.3383084577114428,73,146,0.5,0.504,40,59,0.6779661016949152
Karl Malone,malonka01,PF,33,UTA,1997,82,2998.0,2249,368,193,616,809,113,48,233,217,864,1571,0.5499681731381286,0,13,0.0,864,1558,0.5545571245186136,0.55,521,690,0.755072463768116
Matt Maloney,malonma01,PG,25,HOU,1997,82,2386.0,767,303,19,141,160,82,1,122,125,271,615,0.440650406504065,154,381,0.4041994750656168,117,234,0.5,0.566,71,93,0.7634408602150538
Danny Manning,mannida01,PF,30,PHO,1997,77,2134.0,1040,173,137,332,469,81,74,161,268,426,795,0.5358490566037736,7,36,0.1944444444444444,419,759,0.5520421607378129,0.54,181,251,0.7211155378486056
Rich Manning,manniri01,PF,26,TOT,1997,26,201.0,75,3,16,23,39,4,2,7,29,32,82,0.3902439024390244,2,4,0.5,30,78,0.3846153846153846,0.402,9,14,0.6428571428571429
Stephon Marbury,marbust01,PG,19,MIN,1997,67,2324.0,1057,522,54,130,184,67,19,210,159,355,871,0.4075774971297359,102,288,0.3541666666666667,253,583,0.4339622641509434,0.466,245,337,0.7270029673590505
Šarūnas Marčiulionis,marcisa01,SG,32,DEN,1997,17,255.0,116,25,12,18,30,12,1,40,38,38,101,0.3762376237623762,11,30,0.3666666666666666,27,71,0.380281690140845,0.431,29,36,0.8055555555555556
Donny Marshall,marshdo02,SF,24,CLE,1997,56,548.0,175,24,22,48,70,24,3,32,60,52,160,0.325,33,87,0.3793103448275862,19,73,0.2602739726027397,0.428,38,54,0.7037037037037037
Donyell Marshall,marshdo01,SF,23,GSW,1997,61,1022.0,444,54,92,184,276,25,46,55,96,174,421,0.4133016627078384,35,111,0.3153153153153153,139,310,0.4483870967741935,0.455,61,98,0.6224489795918368
Cuonzo Martin,marticu01,SG,25,MIL,1997,3,13.0,0,1,1,0,1,0,0,1,1,0,7,0.0,0,2,0.0,0,5,0.0,0.0,0,0,0.0
Darrick Martin,martida01,PG,25,LAC,1997,82,1820.0,893,339,26,87,113,57,2,127,165,292,718,0.4066852367688022,91,234,0.3888888888888889,201,484,0.4152892561983471,0.47,218,250,0.872
Jamal Mashburn,mashbja01,SF,24,TOT,1997,69,2164.0,822,204,69,225,294,78,12,114,186,286,743,0.3849259757738896,90,277,0.3249097472924188,196,466,0.4206008583690987,0.445,160,228,0.7017543859649122
Anthony Mason,masonan01,PF,30,CHH,1997,73,3143.0,1186,414,186,643,829,76,33,165,202,433,825,0.5248484848484849,1,3,0.3333333333333333,432,822,0.5255474452554745,0.525,319,428,0.7453271028037384
Tony Massenburg,masseto01,PF,29,NJN,1997,79,1954.0,568,23,222,295,517,38,50,91,217,219,452,0.4845132743362831,0,1,0.0,219,451,0.4855875831485587,0.485,130,206,0.6310679611650486
Vernon Maxwell,maxweve01,SG,31,SAS,1997,72,2068.0,929,153,27,132,159,87,19,121,168,340,906,0.3752759381898454,115,372,0.3091397849462365,225,534,0.4213483146067415,0.439,134,180,0.7444444444444445
Lee Mayberry,maybele01,PG,26,VAN,1997,80,1952.0,410,329,29,105,134,60,8,90,159,149,370,0.4027027027027027,83,221,0.3755656108597285,66,149,0.4429530201342282,0.515,29,46,0.6304347826086957
Walter McCarty,mccarwa01,PF,22,NYK,1997,35,192.0,64,13,8,15,23,7,9,17,38,26,68,0.3823529411764705,4,14,0.2857142857142857,22,54,0.4074074074074074,0.412,8,14,0.5714285714285714
Amal McCaskill,mccasam01,C,23,ORL,1997,17,109.0,28,7,4,18,22,3,5,11,7,10,32,0.3125,0,2,0.0,10,30,0.3333333333333333,0.313,8,12,0.6666666666666666
George McCloud,mccloge01,SF,29,TOT,1997,64,1493.0,658,109,36,143,179,61,8,61,126,238,578,0.4117647058823529,99,254,0.389763779527559,139,324,0.4290123456790123,0.497,83,101,0.8217821782178217
Xavier McDaniel,mcdanxa01,PF,33,NJN,1997,62,1170.0,346,65,124,194,318,36,17,70,144,138,355,0.3887323943661971,5,25,0.2,133,330,0.403030303030303,0.396,65,89,0.7303370786516854
Antonio McDyess,mcdyean01,PF,22,DEN,1997,74,2565.0,1352,106,155,382,537,62,126,199,276,536,1157,0.463267070008643,6,35,0.1714285714285714,530,1122,0.4723707664884135,0.466,274,387,0.7080103359173127
Jim McIlvaine,mcilvji01,C,24,SEA,1997,82,1477.0,314,23,132,198,330,39,164,62,247,130,276,0.4710144927536231,1,7,0.1428571428571428,129,269,0.4795539033457249,0.473,53,107,0.4953271028037383
Jeff McInnis,mcinnje01,PG,22,DEN,1997,13,117.0,65,18,2,4,6,2,1,13,16,23,49,0.4693877551020408,12,26,0.4615384615384615,11,23,0.4782608695652174,0.592,7,10,0.7
Derrick McKey,mckeyde01,SF,30,IND,1997,50,1449.0,400,135,80,161,241,47,30,83,141,148,379,0.3905013192612137,15,58,0.2586206896551724,133,321,0.4143302180685358,0.41,89,123,0.7235772357723578
Aaron McKie,mckieaa01,SG,24,TOT,1997,83,1625.0,433,161,40,181,221,77,22,90,130,150,365,0.410958904109589,41,103,0.3980582524271844,109,262,0.416030534351145,0.467,92,110,0.8363636363636363
Nate McMillan,mcmilna01,PG,32,SEA,1997,37,798.0,169,140,15,103,118,58,6,32,78,61,149,0.4093959731543624,28,84,0.3333333333333333,33,65,0.5076923076923077,0.503,19,29,0.6551724137931034
Loren Meyer,meyerlo01,PF,24,TOT,1997,54,708.0,266,19,53,92,145,11,15,62,125,108,244,0.4426229508196721,4,7,0.5714285714285714,104,237,0.4388185654008439,0.451,46,64,0.71875
Anthony Miller,millean01,PF,25,ATL,1997,1,14.0,0,0,2,5,7,0,0,0,2,0,5,0.0,0,0,0.0,0,5,0.0,0.0,0,0,0.0
Oliver Miller,milleol01,C,26,TOT,1997,61,1152.0,294,87,105,201,306,47,63,90,181,123,238,0.5168067226890757,0,2,0.0,123,236,0.5211864406779662,0.517,48,79,0.6075949367088608
Reggie Miller,millere01,SG,31,IND,1997,81,2966.0,1751,273,53,233,286,75,25,166,172,552,1244,0.4437299035369775,229,536,0.4272388059701492,323,708,0.4562146892655367,0.536,418,475,0.88
Chris Mills,millsch01,SF,27,CLE,1997,80,3167.0,1072,198,118,379,497,86,41,120,222,405,894,0.4530201342281879,86,220,0.3909090909090909,319,674,0.4732937685459941,0.501,176,209,0.8421052631578947
Terry Mills,millste01,PF,29,DET,1997,79,1997.0,857,99,68,309,377,35,27,85,161,312,702,0.4444444444444444,175,415,0.4216867469879518,137,287,0.4773519163763066,0.569,58,70,0.8285714285714286
Greg Minor,minorgr01,SF,25,BOS,1997,23,547.0,220,34,30,50,80,15,2,22,45,94,196,0.4795918367346938,1,8,0.125,93,188,0.4946808510638298,0.482,31,36,0.8611111111111112
Sam Mitchell,mitchsa01,SF,33,MIN,1997,82,2044.0,766,79,112,214,326,51,20,93,232,269,603,0.4461028192371476,4,25,0.16,265,578,0.458477508650519,0.449,224,295,0.7593220338983051
Eric Mobley,mobleer01,C,26,VAN,1997,28,307.0,72,14,30,28,58,5,10,29,44,28,63,0.4444444444444444,0,0,0.0,28,63,0.4444444444444444,0.444,16,30,0.5333333333333333
Eric Montross,montrer01,C,25,TOT,1997,78,1828.0,339,61,181,337,518,20,73,77,268,159,349,0.4555873925501432,0,0,0.0,159,349,0.4555873925501432,0.456,21,62,0.3387096774193548
Tracy Moore,mooretr01,SG,31,HOU,1997,27,237.0,99,20,11,15,26,5,0,14,19,33,85,0.388235294117647,11,43,0.2558139534883721,22,42,0.5238095238095238,0.453,22,31,0.7096774193548387
Chris Morris,morrich01,SF,31,UTA,1997,73,977.0,314,43,37,125,162,29,24,45,121,122,299,0.4080267558528428,31,113,0.2743362831858407,91,186,0.489247311827957,0.46,39,54,0.7222222222222222
Lawrence Moten,motenla01,SG,24,VAN,1997,67,1214.0,447,129,43,76,119,48,24,81,83,171,441,0.3877551020408163,41,141,0.2907801418439716,130,300,0.4333333333333333,0.434,64,99,0.6464646464646465
Alonzo Mourning,mournal01,C,26,MIA,1997,66,2320.0,1310,104,189,467,656,56,189,226,272,473,885,0.5344632768361582,1,9,0.1111111111111111,472,876,0.5388127853881278,0.535,363,565,0.6424778761061947
Chris Mullin,mullich01,SF,33,GSW,1997,79,2733.0,1143,322,75,242,317,130,33,192,155,438,792,0.553030303030303,83,202,0.4108910891089108,355,590,0.6016949152542372,0.605,184,213,0.863849765258216
Eric Murdock,murdoer01,PG,28,DEN,1997,12,114.0,45,24,1,10,11,9,2,11,9,15,33,0.4545454545454545,4,10,0.4,11,23,0.4782608695652174,0.515,11,12,0.9166666666666666
Gheorghe Mureșan,muresgh01,C,25,WSB,1997,73,1849.0,777,29,141,340,481,43,96,117,230,327,541,0.6044362292051756,0,0,0.0,327,541,0.6044362292051756,0.604,123,199,0.6180904522613065
Lamond Murray,murrala01,SF,23,LAC,1997,74,1295.0,549,57,85,148,233,53,29,86,113,181,435,0.4160919540229885,31,91,0.3406593406593406,150,344,0.436046511627907,0.452,156,211,0.7393364928909952
Tracy Murray,murratr01,SF,25,WSB,1997,82,1814.0,817,78,84,169,253,69,19,86,150,288,678,0.4247787610619469,106,300,0.3533333333333333,182,378,0.4814814814814814,0.503,135,161,0.8385093167701864
Dikembe Mutombo,mutomdi01,C,30,ATL,1997,80,2973.0,1066,110,268,661,929,49,264,186,249,380,721,0.5270457697642164,0,0,0.0,380,721,0.5270457697642164,0.527,306,434,0.7050691244239631
Martin Müürsepp,muursma01,PF,22,TOT,1997,42,348.0,156,20,35,32,67,12,11,18,58,54,131,0.4122137404580153,4,24,0.1666666666666666,50,107,0.4672897196261682,0.427,44,70,0.6285714285714286
Steve Nash,nashst01,PG,22,PHO,1997,65,684.0,213,138,16,47,63,20,0,63,92,74,175,0.4228571428571429,23,55,0.4181818181818181,51,120,0.425,0.489,42,51,0.8235294117647058
Ruben Nembhard,nembhru01,SG-PG,24,TOT,1997,10,113.0,40,17,3,5,8,9,0,8,12,16,37,0.4324324324324324,0,6,0.0,16,31,0.5161290322580645,0.432,8,10,0.8
Ivano Newbill,newbiiv01,PF,26,ATL,1997,72,850.0,100,24,76,128,204,28,15,42,115,40,91,0.4395604395604395,0,0,0.0,40,91,0.4395604395604395,0.44,20,52,0.3846153846153846
Johnny Newman,newmajo01,SF,33,MIL,1997,82,2060.0,715,116,66,120,186,73,17,115,257,246,547,0.449725776965265,34,98,0.3469387755102041,212,449,0.4721603563474387,0.481,189,247,0.7651821862348178
Gaylon Nickerson,nickega01,SG,27,TOT,1997,4,42.0,15,1,1,4,5,1,1,1,1,4,12,0.3333333333333333,0,2,0.0,4,10,0.4,0.333,7,7,1.0
Ken Norman,normake01,SF,32,ATL,1997,17,220.0,64,12,8,31,39,7,3,18,17,27,94,0.2872340425531915,6,38,0.1578947368421052,21,56,0.375,0.319,4,12,0.3333333333333333
Moochie Norris,norrimo01,PG,23,VAN,1997,8,89.0,12,23,3,9,12,4,0,5,5,4,22,0.1818181818181818,2,10,0.2,2,12,0.1666666666666666,0.227,2,5,0.4
Ed O'Bannon,obanned01,SF,24,TOT,1997,64,809.0,235,39,50,98,148,29,12,20,97,93,279,0.3333333333333333,18,70,0.2571428571428571,75,209,0.3588516746411483,0.366,31,35,0.8857142857142857
Jermaine O'Neal,onealje01,PF,18,POR,1997,45,458.0,185,8,39,85,124,2,26,27,46,69,153,0.4509803921568627,0,1,0.0,69,152,0.4539473684210526,0.451,47,78,0.6025641025641025
Shaquille O'Neal,onealsh01,C,24,LAL,1997,51,1941.0,1336,159,195,445,640,46,147,146,180,552,991,0.557013118062563,0,4,0.0,552,987,0.5592705167173252,0.557,232,479,0.4843423799582463
Charles Oakley,oaklech01,PF,33,NYK,1997,80,2873.0,864,221,246,535,781,111,21,171,305,339,694,0.4884726224783862,5,19,0.2631578947368421,334,675,0.4948148148148148,0.492,181,224,0.8080357142857143
Hakeem Olajuwon,olajuha01,C,34,HOU,1997,78,2852.0,1810,236,173,543,716,117,173,281,249,727,1426,0.5098176718092566,5,16,0.3125,722,1410,0.5120567375886524,0.512,351,446,0.7869955156950673
Jimmy Oliver,oliveji01,SG,27,TOR,1997,4,43.0,11,1,1,4,5,2,0,3,2,4,13,0.3076923076923077,1,6,0.1666666666666666,3,7,0.4285714285714285,0.346,2,2,1.0
Greg Ostertag,ostergr01,C,23,UTA,1997,77,1818.0,559,27,180,385,565,24,152,74,233,210,408,0.5147058823529411,0,4,0.0,210,404,0.5198019801980198,0.515,139,205,0.6780487804878049
Bo Outlaw,outlabo01,PF,25,LAC,1997,82,2195.0,625,157,174,280,454,94,142,107,227,254,417,0.6091127098321343,0,8,0.0,254,409,0.6210268948655256,0.609,117,232,0.5043103448275862
Doug Overton,overtdo01,PG,27,PHI,1997,61,634.0,217,101,18,50,68,24,0,39,44,81,190,0.4263157894736842,10,40,0.25,71,150,0.4733333333333333,0.453,45,48,0.9375
Billy Owens,owensbi01,SF,27,SAC,1997,66,1995.0,724,187,134,258,392,62,25,133,187,299,640,0.4671875,25,72,0.3472222222222222,274,568,0.4823943661971831,0.487,101,145,0.696551724137931
Ray Owes,owesra01,PF,24,GSW,1997,57,592.0,177,15,64,99,163,15,20,23,86,75,180,0.4166666666666667,1,5,0.2,74,175,0.4228571428571429,0.419,26,46,0.5652173913043478
Robert Pack,packro01,PG,27,TOT,1997,54,1782.0,771,452,28,118,146,94,6,217,139,272,693,0.3924963924963925,31,112,0.2767857142857143,241,581,0.414802065404475,0.415,196,243,0.8065843621399177
Robert Parish,parisro01,C,43,CHI,1997,43,406.0,161,22,42,47,89,6,19,28,40,70,143,0.4895104895104895,0,0,0.0,70,143,0.4895104895104895,0.49,21,31,0.6774193548387096
Cherokee Parks,parksch02,PF,24,MIN,1997,76,961.0,252,34,83,112,195,41,48,32,150,103,202,0.5099009900990099,0,1,0.0,103,201,0.5124378109452736,0.51,46,76,0.6052631578947368
Gary Payton,paytoga01,PG,28,SEA,1997,82,3213.0,1785,583,106,272,378,197,13,215,208,706,1482,0.47638326585695,119,380,0.3131578947368421,587,1102,0.5326678765880217,0.517,254,355,0.7154929577464789
Anthony Peeler,peelean01,SG,27,VAN,1997,72,2291.0,1041,256,54,193,247,105,17,157,168,402,1011,0.3976261127596439,128,343,0.3731778425655976,274,668,0.4101796407185629,0.461,109,133,0.8195488721804511
Will Perdue,perduwi01,C,31,SAS,1997,65,1918.0,565,38,251,387,638,32,102,87,184,233,410,0.5682926829268292,0,0,0.0,233,410,0.5682926829268292,0.568,99,171,0.5789473684210527
Sam Perkins,perkisa01,C,35,SEA,1997,81,1976.0,889,103,74,226,300,69,49,77,134,290,661,0.4387291981845688,122,309,0.3948220064724919,168,352,0.4772727272727273,0.531,187,229,0.8165938864628821
Elliot Perry,perryel01,PG,27,MIL,1997,82,1595.0,562,247,24,100,124,98,3,111,117,217,458,0.4737991266375546,49,137,0.3576642335766423,168,321,0.5233644859813084,0.527,79,106,0.7452830188679245
Wesley Person,persowe01,SG,25,PHO,1997,80,2326.0,1080,123,68,224,292,86,20,76,102,409,903,0.4529346622369878,171,414,0.4130434782608695,238,489,0.4867075664621677,0.548,91,114,0.7982456140350878
Bobby Phills,phillbo01,SG,27,CLE,1997,69,2375.0,866,233,63,182,245,113,21,135,174,328,766,0.4281984334203655,85,216,0.3935185185185185,243,550,0.4418181818181818,0.484,125,174,0.7183908045977011
Eric Piatkowski,piatker01,SG,26,LAC,1997,65,747.0,388,52,49,56,105,33,10,46,85,134,298,0.4496644295302013,51,120,0.425,83,178,0.4662921348314606,0.535,69,84,0.8214285714285714
Ricky Pierce,piercri01,SG,37,TOT,1997,60,1250.0,659,80,36,85,121,28,9,68,97,239,497,0.4808853118712273,42,95,0.4421052631578947,197,402,0.4900497512437811,0.523,139,155,0.896774193548387
Ed Pinckney,pincked01,PF,33,MIA,1997,27,273.0,66,6,25,40,65,8,9,19,30,23,43,0.5348837209302325,0,0,0.0,23,43,0.5348837209302325,0.535,20,25,0.8
Scottie Pippen,pippesc01,SF,31,CHI,1997,82,3095.0,1656,467,160,371,531,154,45,214,213,648,1366,0.4743777452415813,156,424,0.3679245283018867,492,942,0.5222929936305732,0.531,204,291,0.7010309278350515
Olden Polynice,polynol01,C,32,SAC,1997,82,2893.0,1025,178,272,500,772,46,80,166,298,442,967,0.4570837642192347,0,6,0.0,442,961,0.4599375650364204,0.457,141,251,0.5617529880478087
Terry Porter,portete01,PG,33,MIN,1997,82,1568.0,568,295,31,145,176,54,11,128,104,187,449,0.4164810690423162,67,200,0.335,120,249,0.4819277108433735,0.491,127,166,0.7650602409638554
Vitaly Potapenko,potapvi01,C,21,CLE,1997,80,1238.0,465,40,105,112,217,26,34,109,216,186,423,0.4397163120567376,1,2,0.5,185,421,0.4394299287410926,0.441,92,125,0.736
Brent Price,pricebr01,PG,28,HOU,1997,25,390.0,126,65,10,19,29,17,0,32,34,44,105,0.419047619047619,17,53,0.320754716981132,27,52,0.5192307692307693,0.5,21,21,1.0
Mark Price,pricema01,PG,32,GSW,1997,70,1876.0,793,342,36,143,179,67,3,161,100,263,589,0.4465195246179966,112,283,0.3957597173144876,151,306,0.4934640522875817,0.542,155,171,0.9064327485380116
Dino Radja,radjadi01,C,29,BOS,1997,25,874.0,349,48,44,167,211,23,48,70,76,149,339,0.43952802359882,0,1,0.0,149,338,0.4408284023668639,0.44,51,71,0.7183098591549296
Theo Ratliff,ratlith01,C,23,DET,1997,76,1292.0,439,13,109,147,256,29,111,56,181,179,337,0.5311572700296736,0,0,0.0,179,337,0.5311572700296736,0.531,81,116,0.6982758620689655
Eldridge Recasner,recasel01,SG,29,ATL,1997,71,1207.0,405,94,35,80,115,38,4,65,97,148,350,0.4228571428571429,58,140,0.4142857142857143,90,210,0.4285714285714285,0.506,51,58,0.8793103448275862
Bryant Reeves,reevebr01,C,23,VAN,1997,75,2777.0,1213,160,174,436,610,29,67,175,270,498,1025,0.4858536585365853,1,11,0.0909090909090909,497,1014,0.490138067061144,0.486,216,307,0.7035830618892508
Khalid Reeves,reevekh01,PG,24,TOT,1997,63,1432.0,516,226,34,85,119,34,9,108,159,184,470,0.3914893617021276,83,227,0.3656387665198238,101,243,0.4156378600823045,0.48,65,87,0.7471264367816092
Don Reid,reiddo01,PF,23,DET,1997,47,462.0,132,14,36,65,101,16,15,23,105,54,112,0.4821428571428571,0,1,0.0,54,111,0.4864864864864865,0.482,24,32,0.75
Shawn Respert,respesh01,SG,24,TOT,1997,41,495.0,172,40,14,25,39,20,2,30,40,59,139,0.4244604316546763,20,57,0.3508771929824561,39,82,0.4756097560975609,0.496,34,39,0.8717948717948718
Glen Rice,ricegl01,SF,29,CHH,1997,79,3362.0,2115,160,67,251,318,72,26,177,190,722,1513,0.4771976206212822,207,440,0.4704545454545454,515,1073,0.4799627213420316,0.546,464,535,0.8672897196261682
Pooh Richardson,richapo01,PG,30,LAC,1997,59,1065.0,330,169,25,73,98,54,5,62,82,131,344,0.3808139534883721,42,128,0.328125,89,216,0.412037037037037,0.442,26,43,0.6046511627906976
Mitch Richmond,richmmi01,SG,31,SAC,1997,81,3125.0,2095,338,59,260,319,118,24,237,211,717,1578,0.4543726235741445,204,477,0.4276729559748428,513,1101,0.4659400544959128,0.519,457,531,0.8606403013182674
Isaiah Rider,rideris01,SG,25,POR,1997,76,2563.0,1223,198,94,210,304,45,19,212,199,456,983,0.4638860630722278,99,257,0.3852140077821012,357,726,0.4917355371900826,0.514,212,261,0.8122605363984674
Fred Roberts,roberfr01,PF,36,DAL,1997,12,40.0,22,0,2,8,10,0,1,5,2,6,15,0.4,0,0,0.0,6,15,0.4,0.4,10,14,0.7142857142857143
Stanley Roberts,roberst01,C,26,LAC,1997,18,378.0,171,9,24,67,91,8,23,23,57,63,148,0.4256756756756756,0,0,0.0,63,148,0.4256756756756756,0.426,45,64,0.703125
Chris Robinson,robinch01,SG,22,VAN,1997,41,681.0,188,65,23,48,71,28,9,34,85,69,182,0.3791208791208791,34,89,0.3820224719101123,35,93,0.3763440860215054,0.473,16,26,0.6153846153846154
Clifford Robinson,robincl02,SF,30,POR,1997,81,3077.0,1224,261,90,231,321,99,66,172,251,444,1043,0.4256951102588686,121,350,0.3457142857142857,323,693,0.4660894660894661,0.484,215,309,0.6957928802588996
David Robinson,robinda01,C,31,SAS,1997,6,147.0,106,8,19,32,51,6,6,8,9,36,72,0.5,0,0,0.0,36,72,0.5,0.5,34,52,0.6538461538461539
Glenn Robinson,robingl01,SF,24,MIL,1997,80,3114.0,1689,248,130,372,502,103,68,269,225,669,1438,0.4652294853963838,63,180,0.35,606,1258,0.4817170111287758,0.487,288,364,0.7912087912087912
James Robinson,robinja02,PG,26,MIN,1997,69,1309.0,572,126,24,88,112,30,8,69,125,196,482,0.4066390041493776,102,267,0.3820224719101123,94,215,0.4372093023255814,0.512,78,114,0.6842105263157895
Rumeal Robinson,robinru01,PG,30,TOT,1997,54,508.0,176,73,6,41,47,24,2,43,60,66,164,0.4024390243902439,18,56,0.3214285714285714,48,108,0.4444444444444444,0.457,26,35,0.7428571428571429
Dennis Rodman,rodmade01,PF,35,CHI,1997,55,1947.0,311,170,320,563,883,32,19,111,172,128,286,0.4475524475524475,5,19,0.2631578947368421,123,267,0.4606741573033708,0.456,50,88,0.5681818181818182
Lou Roe,roelo01,SF,24,GSW,1997,17,107.0,40,6,7,7,14,3,1,11,10,14,48,0.2916666666666667,3,11,0.2727272727272727,11,37,0.2972972972972973,0.323,9,19,0.4736842105263157
Carlos Rogers,rogerca01,PF,25,TOR,1997,56,1397.0,551,37,120,184,304,42,69,53,140,212,404,0.5247524752475248,25,66,0.3787878787878788,187,338,0.5532544378698225,0.556,102,170,0.6
Rodney Rogers,rogerro01,SF,25,LAC,1997,81,2480.0,1072,222,137,274,411,88,61,221,272,408,884,0.4615384615384615,65,180,0.3611111111111111,343,704,0.4872159090909091,0.498,191,288,0.6631944444444444
Roy Rogers,rogerro02,PF,23,VAN,1997,82,1848.0,543,46,139,247,386,21,163,86,214,244,483,0.505175983436853,1,1,1.0,243,482,0.504149377593361,0.506,54,94,0.574468085106383
Sean Rooks,rooksse01,C,27,LAL,1997,69,735.0,265,42,56,107,163,17,38,51,123,87,185,0.4702702702702703,0,1,0.0,87,184,0.4728260869565217,0.47,91,130,0.7
Jalen Rose,roseja01,SF,24,IND,1997,66,1188.0,482,155,27,94,121,57,18,107,136,172,377,0.4562334217506631,21,72,0.2916666666666667,151,305,0.4950819672131147,0.484,117,156,0.75
Malik Rose,rosema01,PF,22,CHH,1997,54,525.0,160,32,70,94,164,28,17,41,114,61,128,0.4765625,0,2,0.0,61,126,0.4841269841269841,0.477,38,62,0.6129032258064516
Donald Royal,royaldo01,SF,30,TOT,1997,62,858.0,218,25,52,102,154,23,11,47,100,62,146,0.4246575342465753,0,2,0.0,62,144,0.4305555555555556,0.425,94,117,0.8034188034188035
Clifford Rozier,roziecl01,C,24,TOT,1997,42,737.0,189,31,102,132,234,24,44,29,97,79,174,0.4540229885057471,0,2,0.0,79,172,0.4593023255813953,0.454,31,61,0.5081967213114754
Bryon Russell,russebr01,SF,26,UTA,1997,81,2525.0,873,123,79,252,331,129,27,94,237,297,620,0.4790322580645161,108,264,0.4090909090909091,189,356,0.5308988764044944,0.566,171,244,0.7008196721311475
Arvydas Sabonis,sabonar01,C,32,POR,1997,69,1762.0,928,146,114,433,547,63,84,151,203,328,658,0.4984802431610942,49,132,0.3712121212121212,279,526,0.5304182509505704,0.536,223,287,0.7770034843205574
Kevin Salvadori,salvake01,C,26,SAC,1997,23,154.0,37,10,6,19,25,2,13,12,17,12,33,0.3636363636363636,0,0,0.0,12,33,0.3636363636363636,0.364,13,18,0.7222222222222222
Jason Sasser,sasseja01,SF,23,TOT,1997,8,69.0,19,2,1,7,8,3,0,2,11,9,23,0.391304347826087,1,3,0.3333333333333333,8,20,0.4,0.413,0,0,0.0
Danny Schayes,schayda01,PF,37,ORL,1997,45,540.0,133,14,41,84,125,15,16,27,74,47,120,0.3916666666666666,0,1,0.0,47,119,0.3949579831932773,0.392,39,52,0.75
Steve Scheffler,schefst01,C,29,SEA,1997,7,29.0,13,0,1,2,3,0,0,5,5,6,7,0.8571428571428571,0,0,0.0,6,7,0.8571428571428571,0.857,1,2,0.5
Dwayne Schintzius,schindw01,C,28,LAC,1997,15,116.0,34,4,9,13,22,1,9,7,22,13,36,0.3611111111111111,1,2,0.5,12,34,0.3529411764705882,0.375,7,8,0.875
Detlef Schrempf,schrede01,SF,34,SEA,1997,61,2192.0,1022,266,87,307,394,63,16,150,151,356,724,0.4917127071823204,57,161,0.3540372670807453,299,563,0.5310834813499112,0.531,253,316,0.8006329113924051
Brent Scott,scottbr01,PF,25,IND,1997,16,55.0,19,3,3,6,9,1,1,4,14,8,17,0.4705882352941176,0,0,0.0,8,17,0.4705882352941176,0.471,3,6,0.5
Byron Scott,scottby01,SG,35,LAL,1997,79,1440.0,526,99,21,97,118,46,16,53,72,163,379,0.4300791556728232,73,188,0.3882978723404255,90,191,0.4712041884816754,0.526,127,151,0.8410596026490066
Dennis Scott,scottde01,SF,28,ORL,1997,66,2166.0,823,139,40,163,203,74,19,81,138,298,749,0.3978638184245661,147,373,0.3941018766756032,151,376,0.4015957446808511,0.496,80,101,0.7920792079207921
James Scott,scottja01,SF,24,MIA,1997,8,32.0,1,3,1,5,6,2,0,2,5,0,8,0.0,0,4,0.0,0,4,0.0,0.0,1,2,0.5
Shawnelle Scott,scottsh01,C,24,CLE,1997,16,50.0,20,0,8,8,16,0,3,0,6,8,16,0.5,0,0,0.0,8,16,0.5,0.5,4,11,0.3636363636363636
Malik Sealy,sealyma01,SG,26,LAC,1997,80,2456.0,1079,165,59,179,238,124,45,154,185,373,942,0.3959660297239915,79,222,0.3558558558558558,294,720,0.4083333333333333,0.438,254,290,0.8758620689655172
Rony Seikaly,seikaro01,C,31,ORL,1997,74,2615.0,1277,92,274,427,701,49,107,218,275,460,907,0.5071664829106945,0,3,0.0,460,904,0.5088495575221239,0.507,357,500,0.714
Brian Shaw,shawbr01,PG,30,ORL,1997,77,1867.0,552,319,47,147,194,67,26,170,197,189,516,0.3662790697674418,63,194,0.3247422680412371,126,322,0.391304347826087,0.427,111,140,0.7928571428571428
Lionel Simmons,simmoli01,SF,28,SAC,1997,41,521.0,139,57,30,74,104,8,13,34,63,45,136,0.3308823529411764,7,30,0.2333333333333333,38,106,0.3584905660377358,0.357,42,48,0.875
Dickey Simpkins,simpkdi01,PF,24,CHI,1997,48,395.0,91,31,36,56,92,5,5,35,44,31,93,0.3333333333333333,1,4,0.25,30,89,0.3370786516853932,0.339,28,40,0.7
Reggie Slater,slatere01,PF,26,TOR,1997,26,406.0,203,21,40,55,95,9,6,29,34,82,149,0.5503355704697986,0,2,0.0,82,147,0.5578231292517006,0.55,39,75,0.52
Charles Smith,smithch01,PF,31,SAS,1997,19,329.0,88,14,18,47,65,13,22,22,44,34,84,0.4047619047619047,0,1,0.0,34,83,0.4096385542168674,0.405,20,26,0.7692307692307693
Joe Smith,smithjo02,PF,21,GSW,1997,80,3086.0,1493,125,261,418,679,74,86,192,244,587,1293,0.4539829853054911,12,46,0.2608695652173913,575,1247,0.4611066559743384,0.459,307,377,0.8143236074270557
Kenny Smith,smithke01,PG,31,TOT,1997,48,765.0,300,116,4,40,44,19,0,71,30,101,239,0.4225941422594142,59,135,0.437037037037037,42,104,0.4038461538461538,0.546,39,45,0.8666666666666667
Michael Smith,smithmi02,PF,24,SAC,1997,81,2526.0,532,191,257,512,769,82,60,130,251,202,375,0.5386666666666666,0,0,0.0,202,375,0.5386666666666666,0.539,128,258,0.4961240310077519
Steve Smith,smithst01,SG,27,ATL,1997,72,2818.0,1445,305,90,148,238,62,23,176,173,491,1145,0.4288209606986899,130,388,0.3350515463917525,361,757,0.4768824306472919,0.486,333,393,0.8473282442748091
Stevin Smith,smithst02,SG,25,DAL,1997,8,60.0,14,4,2,8,10,1,0,4,9,6,18,0.3333333333333333,1,6,0.1666666666666666,5,12,0.4166666666666667,0.361,1,1,1.0
Tony Smith,smithto02,PG,28,CHH,1997,69,1291.0,346,150,38,56,94,48,19,73,110,138,337,0.4094955489614243,32,99,0.3232323232323232,106,238,0.4453781512605042,0.457,38,59,0.6440677966101694
Rik Smits,smitsri01,C,30,IND,1997,52,1518.0,887,67,105,256,361,22,59,126,175,356,733,0.485675306957708,2,8,0.25,354,725,0.4882758620689655,0.487,173,217,0.7972350230414746
Eric Snow,snower01,PG,23,SEA,1997,67,775.0,199,159,17,53,70,37,3,48,94,74,164,0.4512195121951219,4,15,0.2666666666666666,70,149,0.4697986577181208,0.463,47,66,0.7121212121212122
Elmore Spencer,spencel01,C,27,SEA,1997,1,5.0,0,0,0,0,0,1,0,1,0,0,1,0.0,0,0,0.0,0,1,0.0,0.0,0,0,0.0
Felton Spencer,spencfe01,C,29,TOT,1997,73,1558.0,372,22,157,259,416,34,50,88,275,139,284,0.4894366197183099,0,0,0.0,139,284,0.4894366197183099,0.489,94,161,0.5838509316770186
Latrell Sprewell,sprewla01,SG,26,GSW,1997,80,3353.0,1938,507,58,308,366,132,45,322,153,649,1444,0.4494459833795013,147,415,0.3542168674698795,502,1029,0.4878522837706511,0.5,493,585,0.8427350427350427
Jerry Stackhouse,stackje01,SG,22,PHI,1997,81,3166.0,1679,253,156,182,338,93,63,316,219,533,1308,0.4074923547400612,102,342,0.2982456140350877,431,966,0.4461697722567287,0.446,511,667,0.7661169415292354
John Starks,starkjo01,SG,31,NYK,1997,77,2042.0,1061,217,36,169,205,90,11,158,196,369,856,0.4310747663551402,150,407,0.3685503685503685,219,449,0.487750556792873,0.519,173,225,0.7688888888888888
Matt Steigenga,steigma01,SF,26,CHI,1997,2,12.0,3,2,0,3,3,1,1,2,1,1,4,0.25,0,2,0.0,1,2,0.5,0.25,1,2,0.5
Joe Stephens,stephjo01,PF,24,HOU,1997,2,9.0,3,0,2,1,3,3,0,3,3,1,5,0.2,1,3,0.3333333333333333,0,2,0.0,0.3,0,0,0.0
Larry Stewart,stewala01,SF,28,SEA,1997,70,982.0,300,52,75,96,171,31,23,63,108,112,252,0.4444444444444444,9,37,0.2432432432432432,103,215,0.4790697674418605,0.462,67,93,0.7204301075268817
Bryant Stith,stithbr01,SG,26,DEN,1997,52,1788.0,774,133,74,143,217,60,20,101,119,251,603,0.4162520729684908,70,182,0.3846153846153846,181,421,0.4299287410926365,0.474,202,234,0.8632478632478633
John Stockton,stockjo01,PG,34,UTA,1997,82,2896.0,1183,860,45,183,228,166,15,248,194,416,759,0.5480895915678524,76,180,0.4222222222222222,340,579,0.5872193436960277,0.598,275,325,0.8461538461538461
Damon Stoudamire,stoudda01,PG,23,TOR,1997,81,3311.0,1634,709,86,244,330,123,13,288,162,564,1407,0.4008528784648187,176,496,0.3548387096774194,388,911,0.4259055982436882,0.463,330,401,0.8229426433915212
Erick Strickland,stricer01,SG,23,DAL,1997,28,759.0,297,68,21,69,90,27,5,66,75,102,256,0.3984375,28,92,0.3043478260869565,74,164,0.4512195121951219,0.453,65,80,0.8125
Mark Strickland,stricma01,PF,26,MIA,1997,31,153.0,62,1,16,21,37,4,10,15,17,25,60,0.4166666666666667,0,1,0.0,25,59,0.423728813559322,0.417,12,21,0.5714285714285714
Rod Strickland,stricro02,PG,30,WSB,1997,82,2997.0,1410,727,95,240,335,143,14,270,166,515,1105,0.4660633484162896,13,77,0.1688311688311688,502,1028,0.4883268482490272,0.472,367,497,0.738430583501006
Derek Strong,stronde01,PF,28,ORL,1997,82,2004.0,699,73,174,345,519,47,20,102,196,262,586,0.447098976109215,0,13,0.0,262,573,0.4572425828970332,0.447,175,218,0.8027522935779816
Bob Sura,surabo01,SG,23,CLE,1997,82,2269.0,755,390,76,232,308,90,33,181,218,253,587,0.4310051107325383,53,164,0.3231707317073171,200,423,0.4728132387706856,0.476,196,319,0.6144200626959248
Brett Szabo,szabobr01,C,28,BOS,1997,70,662.0,153,17,56,109,165,16,32,41,119,54,121,0.4462809917355372,0,1,0.0,54,120,0.45,0.446,45,61,0.7377049180327869
Žan Tabak,tabakza01,C,26,TOR,1997,13,218.0,84,14,20,29,49,6,11,21,35,32,71,0.4507042253521127,0,0,0.0,32,71,0.4507042253521127,0.451,20,29,0.6896551724137931
Carl Thomas,thomaca01,SG,27,CLE,1997,19,77.0,21,8,3,10,13,2,1,6,7,9,24,0.375,2,12,0.1666666666666666,7,12,0.5833333333333334,0.417,1,1,1.0
Kurt Thomas,thomaku01,PF,24,MIA,1997,18,374.0,113,9,31,76,107,12,9,25,67,39,105,0.3714285714285714,0,1,0.0,39,104,0.375,0.371,35,46,0.7608695652173914
Brooks Thompson,thompbr01,PG,26,TOT,1997,67,1055.0,445,180,18,78,96,55,2,87,126,162,406,0.3990147783251231,97,244,0.3975409836065574,65,162,0.4012345679012346,0.518,24,38,0.631578947368421
LaSalle Thompson,thompla01,C,35,TOT,1997,26,140.0,10,2,7,27,34,3,6,9,33,3,19,0.1578947368421052,0,0,0.0,3,19,0.1578947368421052,0.158,4,6,0.6666666666666666
Otis Thorpe,thorpot01,C,34,DET,1997,79,2661.0,1036,133,226,396,622,59,17,145,298,419,787,0.5324015247776366,0,2,0.0,419,785,0.5337579617834395,0.532,198,303,0.6534653465346535
Sedale Threatt,threase01,SG,35,HOU,1997,21,334.0,70,40,5,19,24,15,3,13,29,28,74,0.3783783783783784,8,20,0.4,20,54,0.3703703703703703,0.432,6,8,0.75
Wayman Tisdale,tisdawa01,PF,32,PHO,1997,53,778.0,346,20,35,85,120,8,21,36,111,158,371,0.4258760107816711,0,0,0.0,158,371,0.4258760107816711,0.426,30,48,0.625
Keith Tower,towerke01,C,26,MIL,1997,5,72.0,7,1,2,7,9,2,1,2,12,3,8,0.375,0,0,0.0,3,8,0.375,0.375,1,8,0.125
Gary Trent,trentga01,PF,22,POR,1997,82,1918.0,882,87,156,272,428,48,35,129,186,361,674,0.5356083086053413,0,11,0.0,361,663,0.5444947209653092,0.536,160,229,0.6986899563318777
Nick Van Exel,vanexni01,PG,25,LAL,1997,79,2937.0,1206,672,44,182,226,75,10,212,110,432,1075,0.4018604651162791,177,468,0.3782051282051282,255,607,0.4200988467874794,0.484,165,200,0.825
David Vaughn,vaughda02,PF,23,ORL,1997,35,298.0,81,7,35,60,95,8,15,29,43,31,72,0.4305555555555556,0,0,0.0,31,72,0.4305555555555556,0.431,19,30,0.6333333333333333
Loy Vaught,vaughlo01,PF,28,LAC,1997,82,2838.0,1220,110,222,595,817,85,25,137,241,542,1084,0.5,2,12,0.1666666666666666,540,1072,0.503731343283582,0.501,134,191,0.7015706806282722
Stojko Vranković,vrankst01,C,33,MIN,1997,53,766.0,181,14,57,111,168,10,67,52,121,78,139,0.5611510791366906,0,0,0.0,78,139,0.5611510791366906,0.561,25,37,0.6756756756756757
Antoine Walker,walkean02,PF,20,BOS,1997,82,2970.0,1435,262,288,453,741,105,53,230,271,576,1354,0.4254062038404727,52,159,0.3270440251572327,524,1195,0.4384937238493724,0.445,231,366,0.6311475409836066
Samaki Walker,walkesa01,PF,20,DAL,1997,43,602.0,214,17,47,100,147,15,22,39,71,83,187,0.4438502673796791,0,1,0.0,83,186,0.4462365591397849,0.444,48,74,0.6486486486486487
Ben Wallace,wallabe01,PF,22,WSB,1997,34,197.0,38,2,25,33,58,8,11,18,27,16,46,0.3478260869565217,0,0,0.0,16,46,0.3478260869565217,0.348,6,20,0.3
John Wallace,wallajo01,SF,22,NYK,1997,68,787.0,325,37,51,104,155,21,25,76,102,122,236,0.5169491525423728,2,4,0.5,120,232,0.5172413793103449,0.521,79,110,0.7181818181818181
Rasheed Wallace,wallara01,PF,22,POR,1997,62,1892.0,938,74,122,297,419,48,59,114,198,380,681,0.5580029368575624,9,33,0.2727272727272727,371,648,0.5725308641975309,0.565,169,265,0.6377358490566037
Rex Walters,waltere01,SG,26,PHI,1997,59,1041.0,402,113,21,86,107,28,3,61,75,148,325,0.4553846153846154,57,148,0.3851351351351351,91,177,0.5141242937853108,0.543,49,62,0.7903225806451613
Charlie Ward,wardch01,PG,26,NYK,1997,79,1763.0,409,326,45,175,220,83,15,147,188,133,337,0.3946587537091988,48,154,0.3116883116883117,85,183,0.4644808743169399,0.466,95,125,0.76
Jamie Watson,watsoja01,SF,24,TOT,1997,23,340.0,78,33,18,29,47,22,4,24,34,31,72,0.4305555555555556,4,12,0.3333333333333333,27,60,0.45,0.458,12,16,0.75
Clarence Weatherspoon,weathcl01,SF,26,PHI,1997,82,2949.0,1003,140,219,460,679,74,86,137,187,398,811,0.4907521578298397,1,6,0.1666666666666666,397,805,0.493167701863354,0.491,206,279,0.7383512544802867
Chris Webber,webbech01,PF,23,WSB,1997,72,2806.0,1445,331,238,505,743,122,137,230,258,604,1167,0.517566409597258,60,151,0.3973509933774834,544,1016,0.5354330708661418,0.543,177,313,0.5654952076677316
Bill Wennington,wennibi01,C,33,CHI,1997,61,783.0,280,41,46,83,129,10,11,31,132,118,237,0.4978902953586498,0,2,0.0,118,235,0.502127659574468,0.498,44,53,0.8301886792452831
Robert Werdann,werdaro01,C,26,NJN,1997,6,31.0,9,0,3,3,6,2,1,2,10,3,7,0.4285714285714285,0,0,0.0,3,7,0.4285714285714285,0.429,3,3,1.0
David Wesley,wesleda01,PG,26,BOS,1997,74,2991.0,1240,537,67,197,264,162,13,211,221,456,974,0.4681724845995893,103,286,0.3601398601398601,353,688,0.5130813953488372,0.521,225,288,0.78125
Doug West,westdo01,SG,29,MIN,1997,68,1920.0,531,113,37,111,148,61,24,66,218,226,484,0.4669421487603306,15,45,0.3333333333333333,211,439,0.4806378132118451,0.482,64,94,0.6808510638297872
Mark West,westma01,C,36,CLE,1997,70,959.0,227,19,69,117,186,11,55,52,142,100,180,0.5555555555555556,0,0,0.0,100,180,0.5555555555555556,0.556,27,56,0.4821428571428571
Ennis Whatley,whatlen01,PG,34,POR,1997,3,22.0,4,3,0,3,3,0,0,1,5,2,4,0.5,0,0,0.0,2,4,0.5,0.5,0,0,0.0
Donald Whiteside,whitedo01,PG,27,TOR,1997,27,259.0,59,36,2,10,12,11,0,17,23,18,55,0.3272727272727272,12,36,0.3333333333333333,6,19,0.3157894736842105,0.436,11,15,0.7333333333333333
Chris Whitney,whitnch01,PG,25,WSB,1997,82,1117.0,430,182,13,91,104,49,4,68,100,139,330,0.4212121212121212,58,163,0.3558282208588957,81,167,0.4850299401197604,0.509,94,113,0.831858407079646
Dominique Wilkins,wilkido01,SF,37,SAS,1997,63,1945.0,1145,119,169,233,402,39,31,135,100,397,953,0.4165792235047219,70,239,0.2928870292887029,327,714,0.4579831932773109,0.453,281,350,0.8028571428571428
Gerald Wilkins,wilkige01,SG,33,ORL,1997,80,2202.0,848,173,59,114,173,54,12,123,144,323,759,0.4255599472990777,66,203,0.3251231527093596,257,556,0.4622302158273381,0.469,136,190,0.7157894736842105
Aaron Williams,williaa01,PF-C,25,TOT,1997,33,563.0,203,15,62,81,143,16,29,32,72,85,148,0.5743243243243243,0,1,0.0,85,147,0.5782312925170068,0.574,33,49,0.673469387755102
Buck Williams,willibu01,PF,36,NYK,1997,74,1496.0,465,53,166,231,397,40,38,79,204,175,326,0.5368098159509203,0,1,0.0,175,325,0.5384615384615384,0.537,115,179,0.6424581005586593
Eric Williams,willier01,SG,24,BOS,1997,72,2435.0,1078,129,126,203,329,72,13,139,213,374,820,0.4560975609756098,2,8,0.25,372,812,0.458128078817734,0.457,328,436,0.7522935779816514
Herb Williams,willihe01,PF,38,NYK,1997,21,184.0,39,5,9,22,31,4,5,5,18,18,46,0.391304347826087,0,1,0.0,18,45,0.4,0.391,3,4,0.75
Hot Rod Williams,williho01,C,34,PHO,1997,68,2137.0,541,100,178,384,562,67,88,66,176,204,416,0.4903846153846153,0,2,0.0,204,414,0.4927536231884058,0.49,133,198,0.6717171717171717
Jayson Williams,willija01,PF,28,NJN,1997,41,1432.0,550,51,242,311,553,24,36,82,158,221,540,0.4092592592592592,0,4,0.0,221,536,0.4123134328358209,0.409,108,183,0.5901639344262295
Jerome Williams,willije01,PF,23,DET,1997,33,177.0,49,7,22,28,50,13,1,13,18,20,51,0.392156862745098,0,0,0.0,20,51,0.392156862745098,0.392,9,17,0.5294117647058824
Lorenzo Williams,willilo01,C,27,WSB,1997,19,264.0,45,4,28,41,69,6,8,18,49,20,31,0.6451612903225806,0,0,0.0,20,31,0.6451612903225806,0.645,5,7,0.7142857142857143
Monty Williams,willimo01,SF,25,SAS,1997,65,1345.0,588,91,98,108,206,55,52,116,161,234,460,0.508695652173913,0,1,0.0,234,459,0.5098039215686274,0.509,120,186,0.6451612903225806
Reggie Williams,willire01,SF,32,TOT,1997,13,200.0,76,10,5,26,31,8,4,12,33,29,76,0.3815789473684211,9,34,0.2647058823529412,20,42,0.4761904761904761,0.441,9,12,0.75
Scott Williams,willisc01,C,28,PHI,1997,62,1317.0,362,41,155,242,397,44,41,50,206,162,318,0.5094339622641509,0,2,0.0,162,316,0.5126582278481012,0.509,38,55,0.6909090909090909
Walt Williams,williwa02,SF,26,TOR,1997,73,2647.0,1199,197,103,264,367,97,62,174,282,419,982,0.4266802443991853,175,437,0.4004576659038901,244,545,0.4477064220183486,0.516,186,243,0.7654320987654321
Corliss Williamson,willico02,SF,23,SAC,1997,79,1992.0,915,124,139,187,326,60,49,157,263,371,745,0.497986577181208,0,3,0.0,371,742,0.5,0.498,173,251,0.6892430278884463
Kevin Willis,willike02,PF,34,HOU,1997,75,1964.0,842,71,146,415,561,42,32,119,216,350,728,0.4807692307692308,2,14,0.1428571428571428,348,714,0.4873949579831932,0.482,140,202,0.693069306930693
David Wingate,wingada01,SG,33,SEA,1997,65,929.0,236,80,23,51,74,44,5,37,108,89,214,0.4158878504672897,25,71,0.352112676056338,64,143,0.4475524475524475,0.474,33,40,0.825
Dontonio Wingfield,wingfdo01,SF,22,POR,1997,47,569.0,211,45,63,74,137,14,6,49,101,79,193,0.4093264248704663,26,77,0.3376623376623376,53,116,0.4568965517241379,0.477,27,40,0.675
Joe Wolf,wolfjo01,C,32,MIL,1997,56,525.0,95,20,32,80,112,14,11,14,105,40,89,0.449438202247191,1,7,0.1428571428571428,39,82,0.4756097560975609,0.455,14,19,0.7368421052631579
David Wood,woodda01,PF,32,MIL,1997,46,240.0,57,13,5,22,27,7,6,6,36,20,38,0.5263157894736842,5,15,0.3333333333333333,15,23,0.6521739130434783,0.592,12,18,0.6666666666666666
Haywoode Workman,workmha01,PG,31,IND,1997,4,81.0,22,11,4,3,7,3,0,5,10,11,20,0.55,0,3,0.0,11,17,0.6470588235294118,0.55,0,1,0.0
Lorenzen Wright,wrighlo02,C,21,LAC,1997,77,1936.0,561,49,206,265,471,48,60,79,211,236,491,0.4806517311608961,1,4,0.25,235,487,0.4825462012320328,0.482,88,150,0.5866666666666667
Sharone Wright,wrighsh01,C,24,TOR,1997,60,1009.0,390,28,79,107,186,15,50,93,146,161,403,0.3995037220843672,0,1,0.0,161,402,0.4004975124378109,0.4,68,133,0.5112781954887218
George Zídek,zidekge01,C,23,TOT,1997,52,376.0,143,14,35,51,86,5,3,27,61,49,118,0.4152542372881356,0,2,0.0,49,116,0.4224137931034483,0.415,45,57,0.7894736842105263
Aleksandar Djordjevic,djordal01,SG,29,POR,1997,8,61.0,25,5,1,4,5,0,0,5,3,8,16,0.5,5,7,0.7142857142857143,3,9,0.3333333333333333,0.656,4,5,0.8
Mahmoud Abdul-Rauf,abdulma02,PG,28,SAC,1998,31,530.0,227,58,6,31,37,16,1,19,31,103,273,0.3772893772893773,5,31,0.1612903225806451,98,242,0.4049586776859504,0.386,16,16,1.0
Tariq Abdul-Wahad,abdulta01,SG,23,SAC,1998,59,959.0,376,51,44,72,116,35,13,65,81,144,357,0.4033613445378151,4,19,0.2105263157894736,140,338,0.4142011834319526,0.409,84,125,0.672
Shareef Abdur-Rahim,abdursh01,SF,21,VAN,1998,82,2950.0,1829,213,227,354,581,89,76,257,201,653,1347,0.4847809948032665,21,51,0.4117647058823529,632,1296,0.4876543209876543,0.493,502,640,0.784375
Cory Alexander,alexaco01,PG,24,TOT,1998,60,1298.0,488,209,17,129,146,70,11,112,98,171,400,0.4275,66,176,0.375,105,224,0.46875,0.51,80,102,0.7843137254901961
Ray Allen,allenra02,SG,22,MIL,1998,82,3287.0,1602,356,127,278,405,111,12,263,244,563,1315,0.4281368821292776,134,368,0.3641304347826087,429,947,0.4530095036958817,0.479,342,391,0.8746803069053708
Derek Anderson,anderde01,SF,23,CLE,1998,66,1839.0,770,227,55,132,187,86,13,128,136,239,586,0.4078498293515358,17,84,0.2023809523809523,222,502,0.4422310756972111,0.422,275,315,0.873015873015873
Greg Anderson,andergr01,C,33,ATL,1998,50,398.0,88,15,39,79,118,19,10,17,85,36,81,0.4444444444444444,0,5,0.0,36,76,0.4736842105263157,0.444,16,41,0.3902439024390244
Kenny Anderson,anderke01,PG,27,TOT,1998,61,1858.0,746,345,39,134,173,87,1,143,135,268,674,0.3976261127596439,57,160,0.35625,211,514,0.4105058365758754,0.44,153,194,0.788659793814433
Nick Anderson,anderni01,SF,30,ORL,1998,58,1701.0,890,119,98,199,297,72,23,85,98,343,754,0.4549071618037135,77,214,0.3598130841121495,266,540,0.4925925925925926,0.506,127,199,0.6381909547738693
Shandon Anderson,andersh01,SG,24,UTA,1998,82,1602.0,681,89,86,141,227,66,18,91,145,269,500,0.538,7,32,0.21875,262,468,0.5598290598290598,0.545,136,185,0.7351351351351352
Chris Anstey,anstech01,C,23,DAL,1998,41,680.0,240,35,53,104,157,31,27,41,95,92,231,0.3982683982683982,3,16,0.1875,89,215,0.413953488372093,0.405,53,74,0.7162162162162162
Greg Anthony,anthogr01,PG,30,SEA,1998,80,1021.0,419,205,18,93,111,64,3,91,97,150,349,0.4297994269340974,66,159,0.4150943396226415,84,190,0.4421052631578947,0.524,53,80,0.6625
B.J. Armstrong,armstbj01,PG,30,TOT,1998,66,831.0,261,150,16,60,76,29,0,42,74,105,213,0.4929577464788732,9,35,0.2571428571428571,96,178,0.5393258426966292,0.514,42,50,0.84
Darrell Armstrong,armstda01,PG,29,ORL,1998,48,1236.0,442,236,65,94,159,58,5,112,96,156,380,0.4105263157894737,25,68,0.3676470588235294,131,312,0.4198717948717949,0.443,105,123,0.8536585365853658
Vincent Askew,askewvi01,SG,31,POR,1998,30,443.0,66,38,21,47,68,19,5,35,39,19,54,0.3518518518518518,0,2,0.0,19,52,0.3653846153846153,0.352,28,39,0.717948717948718
Keith Askins,askinke01,SF,30,MIA,1998,46,681.0,111,29,28,73,101,27,12,26,107,39,122,0.319672131147541,21,74,0.2837837837837837,18,48,0.375,0.406,12,19,0.631578947368421
Stacey Augmon,augmost01,SG,29,POR,1998,71,1445.0,403,88,104,131,235,57,32,81,144,154,372,0.4139784946236559,1,7,0.1428571428571428,153,365,0.4191780821917808,0.415,94,156,0.6025641025641025
Isaac Austin,austiis01,C,28,TOT,1998,78,2266.0,1055,175,199,358,557,61,56,206,231,406,871,0.4661308840413318,0,8,0.0,406,863,0.4704519119351101,0.466,243,363,0.6694214876033058
Vin Baker,bakervi01,C,26,SEA,1998,82,2944.0,1574,152,286,370,656,91,86,174,278,631,1164,0.5420962199312714,1,7,0.1428571428571428,630,1157,0.5445116681071738,0.543,311,526,0.591254752851711
Charles Barkley,barklch01,PF,34,HOU,1998,68,2243.0,1036,217,241,553,794,71,28,147,187,361,744,0.4852150537634409,18,84,0.2142857142857142,343,660,0.5196969696969697,0.497,296,397,0.7455919395465995
Dana Barros,barroda01,PG,30,BOS,1998,80,1686.0,784,286,28,125,153,83,6,107,124,281,609,0.4614121510673235,100,246,0.4065040650406504,181,363,0.4986225895316804,0.544,122,144,0.8472222222222222
Brent Barry,barrybr01,SG,26,TOT,1998,58,1600.0,631,153,29,142,171,64,27,104,118,213,506,0.4209486166007905,90,229,0.3930131004366812,123,277,0.4440433212996389,0.51,115,134,0.8582089552238806
Drew Barry,barrydr01,PG,24,ATL,1998,27,256.0,56,49,5,30,35,10,1,30,28,18,38,0.4736842105263157,9,21,0.4285714285714285,9,17,0.5294117647058824,0.592,11,13,0.8461538461538461
Jon Barry,barryjo01,SG,28,LAL,1998,49,374.0,121,51,8,29,37,24,3,22,33,38,104,0.3653846153846153,18,61,0.2950819672131147,20,43,0.4651162790697674,0.452,27,29,0.9310344827586208
Tony Battie,battito01,PF,21,DEN,1998,65,1506.0,544,60,138,213,351,54,69,98,199,234,525,0.4457142857142857,3,14,0.2142857142857142,231,511,0.4520547945205479,0.449,73,104,0.7019230769230769
Corey Beck,beckco01,PG,26,CHH,1998,59,738.0,191,98,27,63,90,33,7,70,100,73,159,0.4591194968553459,2,4,0.5,71,155,0.4580645161290322,0.465,43,59,0.7288135593220338
Benoit Benjamin,benjabe01,C,33,PHI,1998,14,197.0,63,3,18,35,53,4,4,12,26,22,41,0.5365853658536586,0,0,0.0,22,41,0.5365853658536586,0.537,19,30,0.6333333333333333
Mario Bennett,bennema01,PF,24,LAL,1998,45,354.0,177,18,60,66,126,19,11,21,61,80,135,0.5925925925925926,1,2,0.5,79,133,0.5939849624060151,0.596,16,44,0.3636363636363636
David Benoit,benoida01,SF,29,TOT,1998,77,1123.0,420,25,60,143,203,35,20,52,157,152,408,0.3725490196078431,55,170,0.3235294117647059,97,238,0.407563025210084,0.44,61,74,0.8243243243243243
Travis Best,besttr01,PG,25,IND,1998,82,1547.0,535,281,28,94,122,85,5,111,193,201,480,0.41875,21,70,0.3,180,410,0.4390243902439024,0.441,112,131,0.8549618320610687
Chauncey Billups,billuch01,PG,21,TOT,1998,80,2216.0,893,314,62,128,190,107,4,174,172,280,749,0.3738317757009345,107,325,0.3292307692307692,173,424,0.4080188679245283,0.445,226,266,0.849624060150376
Mookie Blaylock,blaylmo01,PG,30,ATL,1998,70,2700.0,921,469,81,260,341,183,21,176,122,368,938,0.3923240938166311,90,334,0.2694610778443114,278,604,0.4602649006622517,0.44,95,134,0.7089552238805971
Corie Blount,blounco01,PF,29,LAL,1998,70,1029.0,253,37,114,184,298,29,25,51,157,107,187,0.5721925133689839,0,4,0.0,107,183,0.5846994535519126,0.572,39,78,0.5
Muggsy Bogues,boguemu01,PG,33,TOT,1998,61,1570.0,347,331,30,102,132,67,3,105,58,141,323,0.436532507739938,4,16,0.25,137,307,0.4462540716612377,0.443,61,68,0.8970588235294118
Etdrick Bohannon,bohanet01,PF,24,IND,1998,5,11.0,0,1,2,4,6,0,2,3,3,0,4,0.0,0,0,0.0,0,4,0.0,0.0,0,0,0.0
Keith Booth,boothke01,SF,23,CHI,1998,6,17.0,10,1,2,2,4,0,0,3,3,2,6,0.3333333333333333,0,1,0.0,2,5,0.4,0.333,6,6,1.0
Bruce Bowen,bowenbr01,SF,26,BOS,1998,61,1305.0,340,81,79,95,174,87,29,52,174,122,298,0.4093959731543624,20,59,0.3389830508474576,102,239,0.4267782426778242,0.443,76,122,0.6229508196721312
Anthony Bowie,bowiean01,SG,34,NYK,1998,27,224.0,75,11,9,17,26,6,2,7,25,32,59,0.5423728813559322,3,4,0.75,29,55,0.5272727272727272,0.568,8,9,0.8888888888888888
Shawn Bradley,bradlsh01,C,25,DAL,1998,64,1822.0,731,60,164,354,518,51,214,96,214,300,711,0.4219409282700422,1,3,0.3333333333333333,299,708,0.422316384180791,0.423,130,180,0.7222222222222222
Terrell Brandon,brandte01,PG,27,MIL,1998,50,1784.0,841,387,23,153,176,111,17,145,120,339,731,0.4637482900136799,31,93,0.3333333333333333,308,638,0.4827586206896552,0.485,132,156,0.8461538461538461
Tim Breaux,breauti01,SF,27,MIL,1998,6,30.0,10,2,0,2,2,2,1,1,1,4,11,0.3636363636363636,1,3,0.3333333333333333,3,8,0.375,0.409,1,2,0.5
Scott Brooks,brooksc01,PG,32,CLE,1998,43,312.0,79,49,6,24,30,18,3,12,25,28,66,0.4242424242424242,5,11,0.4545454545454545,23,55,0.4181818181818181,0.462,18,20,0.9
Chucky Brown,brownch01,SF,29,ATL,1998,77,1202.0,387,55,57,126,183,23,13,51,100,161,372,0.4327956989247312,2,8,0.25,159,364,0.4368131868131868,0.435,63,87,0.7241379310344828
Dee Brown,brownde01,SG,29,TOT,1998,72,1719.0,658,154,24,128,152,82,23,73,123,246,562,0.4377224199288256,108,271,0.3985239852398524,138,291,0.4742268041237113,0.534,58,71,0.8169014084507042
P.J. Brown,brownpj01,PF,28,MIA,1998,74,2362.0,707,103,235,400,635,66,98,97,264,278,590,0.4711864406779661,0,0,0.0,278,590,0.4711864406779661,0.471,151,197,0.766497461928934
Randy Brown,brownra02,PG,29,CHI,1998,71,1147.0,288,151,34,60,94,71,12,63,118,116,302,0.3841059602649007,0,5,0.0,116,297,0.3905723905723905,0.384,56,78,0.717948717948718
Rick Brunson,brunsri01,PG,25,POR,1998,38,622.0,162,100,14,42,56,25,3,52,55,49,141,0.3475177304964539,22,61,0.360655737704918,27,80,0.3375,0.426,42,62,0.6774193548387096
Kobe Bryant,bryanko01,SF,19,LAL,1998,79,2056.0,1220,199,79,163,242,74,40,157,180,391,913,0.4282584884994523,75,220,0.3409090909090909,316,693,0.455988455988456,0.469,363,457,0.7943107221006565
Mark Bryant,bryanma01,C,32,PHO,1998,70,1110.0,291,46,92,152,244,36,15,58,180,109,225,0.4844444444444444,0,1,0.0,109,224,0.4866071428571428,0.484,73,95,0.7684210526315789
Jud Buechler,buechju01,SF,29,CHI,1998,74,608.0,198,49,24,53,77,22,15,21,47,85,176,0.4829545454545454,25,65,0.3846153846153846,60,111,0.5405405405405406,0.554,3,6,0.5
Matt Bullard,bullama01,SF,30,HOU,1998,67,1190.0,466,60,25,121,146,31,24,39,104,175,389,0.4498714652956298,96,231,0.4155844155844156,79,158,0.5,0.573,20,27,0.7407407407407407
Scott Burrell,burresc01,SF,27,CHI,1998,80,1096.0,416,65,80,118,198,64,37,50,131,159,375,0.424,51,144,0.3541666666666667,108,231,0.4675324675324675,0.492,47,64,0.734375
Willie Burton,burtowi01,SF,29,SAS,1998,13,43.0,27,1,3,6,9,2,2,1,7,8,21,0.3809523809523809,3,9,0.3333333333333333,5,12,0.4166666666666667,0.452,8,12,0.6666666666666666
Mitchell Butler,butlemi02,SG,27,CLE,1998,18,206.0,37,18,6,16,22,8,0,8,26,15,47,0.3191489361702128,1,6,0.1666666666666666,14,41,0.3414634146341463,0.33,6,10,0.6
Jason Caffey,caffeja01,PF,24,TOT,1998,80,1423.0,583,67,160,184,344,25,20,105,181,226,466,0.4849785407725321,0,2,0.0,226,464,0.4870689655172414,0.485,131,200,0.655
Michael Cage,cagemi01,C,36,NJN,1998,79,1201.0,106,32,115,193,308,45,44,23,105,43,84,0.5119047619047619,0,1,0.0,43,83,0.5180722891566265,0.512,20,36,0.5555555555555556
Adrian Caldwell,caldwad01,PF,31,DAL,1998,1,3.0,0,0,0,0,0,0,0,0,0,0,0,0.0,0,0,0.0,0,0,0.0,0.0,0,0,0.0
Marcus Camby,cambyma01,C,23,TOR,1998,63,2002.0,765,111,203,263,466,68,230,134,200,308,747,0.4123159303882195,0,2,0.0,308,745,0.4134228187919463,0.412,149,244,0.610655737704918
Elden Campbell,campbel01,PF,29,LAL,1998,81,1784.0,816,78,143,312,455,35,102,115,209,289,624,0.4631410256410256,1,2,0.5,288,622,0.4630225080385852,0.464,237,342,0.6929824561403509
Antoine Carr,carran01,PF,36,UTA,1998,66,1086.0,378,48,42,89,131,11,53,48,195,151,325,0.4646153846153846,0,0,0.0,151,325,0.4646153846153846,0.465,76,98,0.7755102040816326
Chris Carr,carrch01,SG,23,MIN,1998,51,1165.0,504,85,43,112,155,17,11,69,129,190,452,0.4203539823008849,40,127,0.3149606299212598,150,325,0.4615384615384615,0.465,84,99,0.8484848484848485
Sam Cassell,cassesa01,PG,28,NJN,1998,75,2606.0,1471,603,73,155,228,121,20,269,262,510,1156,0.4411764705882353,15,80,0.1875,495,1076,0.4600371747211896,0.448,436,507,0.8599605522682445
Kelvin Cato,catoke01,C,23,POR,1998,74,1007.0,282,23,91,161,252,29,94,44,164,98,229,0.4279475982532751,0,3,0.0,98,226,0.4336283185840708,0.428,86,125,0.688
Duane Causwell,causwdu01,C,29,MIA,1998,37,363.0,89,5,29,70,99,7,27,18,73,37,89,0.4157303370786517,0,0,0.0,37,89,0.4157303370786517,0.416,15,26,0.5769230769230769
Cedric Ceballos,cebalce01,SF,28,TOT,1998,47,990.0,536,60,75,146,221,33,16,72,88,204,415,0.491566265060241,21,70,0.3,183,345,0.5304347826086957,0.517,107,145,0.7379310344827587
Tom Chambers,chambto01,PF,38,PHI,1998,1,10.0,6,0,0,2,2,2,0,1,2,2,2,1.0,0,0,0.0,2,2,1.0,1.0,2,2,1.0
Rex Chapman,chapmre01,SG,30,PHO,1998,68,2263.0,1082,203,30,143,173,71,14,116,102,408,956,0.4267782426778242,120,311,0.3858520900321543,288,645,0.4465116279069767,0.49,146,187,0.7807486631016043
Calbert Cheaney,cheanca01,SG,26,WAS,1998,82,2841.0,1050,173,82,242,324,96,36,104,264,448,981,0.4566768603465851,15,53,0.2830188679245283,433,928,0.4665948275862069,0.464,139,215,0.6465116279069767
Pete Chilcutt,chilcpe01,PF,29,VAN,1998,82,1420.0,405,104,77,229,306,53,37,62,158,156,359,0.4345403899721448,54,130,0.4153846153846154,102,229,0.445414847161572,0.51,39,59,0.6610169491525424
Chris Childs,childch01,PG,30,NYK,1998,68,1599.0,429,268,29,133,162,56,6,103,179,149,354,0.4209039548022599,27,87,0.3103448275862069,122,267,0.4569288389513108,0.459,104,126,0.8253968253968254
Doug Christie,chrisdo01,SG,27,TOR,1998,78,2939.0,1287,282,94,310,404,190,57,228,198,458,1071,0.4276377217553688,100,307,0.3257328990228013,358,764,0.468586387434555,0.474,271,327,0.8287461773700305
Keith Closs,closske01,C,21,LAC,1998,58,740.0,232,19,63,105,168,12,81,38,73,93,207,0.4492753623188406,0,0,0.0,93,207,0.4492753623188406,0.449,46,77,0.5974025974025974
Derrick Coleman,colemde01,PF,30,PHI,1998,59,2135.0,1040,145,149,438,587,46,68,157,144,356,867,0.4106113033448673,26,98,0.2653061224489796,330,769,0.4291287386215864,0.426,302,391,0.7723785166240409
Bimbo Coles,colesbi01,PG,29,GSW,1998,53,1471.0,423,248,17,106,123,51,13,89,135,166,438,0.3789954337899543,13,57,0.2280701754385964,153,381,0.4015748031496063,0.394,78,88,0.8863636363636364
James Collins,collija01,SG,24,LAC,1998,23,103.0,59,3,7,7,14,6,3,8,12,21,55,0.3818181818181818,9,20,0.45,12,35,0.3428571428571428,0.464,8,14,0.5714285714285714
Marty Conlon,conloma01,C,30,MIA,1998,18,209.0,88,12,16,30,46,9,5,11,27,28,62,0.4516129032258064,0,0,0.0,28,62,0.4516129032258064,0.452,32,44,0.7272727272727273
Tyrone Corbin,corbity01,SF,35,ATL,1998,79,2699.0,806,173,78,284,362,105,7,86,197,328,747,0.4390896921017403,49,141,0.3475177304964539,279,606,0.4603960396039604,0.472,101,128,0.7890625
James Cotton,cottoja02,SG,22,SEA,1998,9,33.0,24,0,2,4,6,1,1,6,3,8,21,0.3809523809523809,0,4,0.0,8,17,0.4705882352941176,0.381,8,9,0.8888888888888888
Chris Crawford,crawfch01,PF,22,ATL,1998,40,256.0,150,9,20,21,41,12,7,18,27,46,110,0.4181818181818181,1,3,0.3333333333333333,45,107,0.4205607476635514,0.423,57,68,0.8382352941176471
Austin Croshere,croshau01,PF,22,IND,1998,26,243.0,76,8,10,35,45,9,5,13,32,32,86,0.3720930232558139,4,13,0.3076923076923077,28,73,0.3835616438356164,0.395,8,14,0.5714285714285714
John Crotty,crottjo01,PG,28,POR,1998,26,379.0,96,63,4,28,32,10,1,42,28,29,90,0.3222222222222222,6,20,0.3,23,70,0.3285714285714285,0.356,32,34,0.9411764705882352
Terry Cummings,cummite01,PF,36,TOT,1998,74,1185.0,467,47,97,186,283,38,10,51,181,200,428,0.4672897196261682,0,1,0.0,200,427,0.468384074941452,0.467,67,98,0.6836734693877551
William Cunningham,cunniwi01,C,23,TOT,1998,7,39.0,8,1,4,6,10,2,0,0,10,4,9,0.4444444444444444,0,0,0.0,4,9,0.4444444444444444,0.444,0,0,0.0
Bill Curley,curlebi01,PF,25,MIN,1998,11,146.0,34,4,11,17,28,3,1,3,28,16,33,0.4848484848484848,0,1,0.0,16,32,0.5,0.485,2,3,0.6666666666666666
Dell Curry,curryde01,SG,33,CHH,1998,52,971.0,490,69,26,75,101,31,4,54,85,194,434,0.4470046082949309,61,145,0.4206896551724138,133,289,0.4602076124567474,0.517,41,52,0.7884615384615384
Michael Curry,currymi01,SG,29,MIL,1998,82,1978.0,543,137,26,72,98,56,14,77,218,196,418,0.4688995215311005,4,9,0.4444444444444444,192,409,0.4694376528117359,0.474,147,176,0.8352272727272727
Erick Dampier,dampier01,C,22,GSW,1998,82,2656.0,971,94,272,443,715,39,139,175,281,352,791,0.4450063211125158,0,2,0.0,352,789,0.4461343472750317,0.445,267,399,0.6691729323308271
Antonio Daniels,daniean01,SG,22,VAN,1998,74,1956.0,579,334,22,121,143,55,10,164,88,228,548,0.4160583941605839,11,52,0.2115384615384615,217,496,0.4375,0.426,112,170,0.6588235294117647
Lloyd Daniels,daniell01,SG,30,TOR,1998,6,82.0,34,4,4,3,7,3,2,4,4,12,29,0.4137931034482758,2,9,0.2222222222222222,10,20,0.5,0.448,8,10,0.8
Yinka Dare,dareyi01,C,25,NJN,1998,10,60.0,12,1,10,7,17,0,2,2,9,4,18,0.2222222222222222,0,0,0.0,4,18,0.2222222222222222,0.222,4,8,0.5
Antonio Davis,davisan01,PF,29,IND,1998,82,2191.0,785,61,192,368,560,45,72,103,234,254,528,0.4810606060606061,0,3,0.0,254,525,0.4838095238095238,0.481,277,398,0.6959798994974874
Ben Davis,davisbe01,PF,25,NYK,1998,7,13.0,4,0,6,0,6,1,0,0,3,2,10,0.2,0,0,0.0,2,10,0.2,0.2,0,0,0.0
Dale Davis,davisda01,C,28,IND,1998,78,2174.0,626,70,233,378,611,51,87,73,209,273,498,0.5481927710843374,0,0,0.0,273,498,0.5481927710843374,0.548,80,172,0.4651162790697674
Emanual Davis,davisem01,PG,29,HOU,1998,45,599.0,184,59,10,37,47,17,3,52,55,63,142,0.4436619718309859,27,72,0.375,36,70,0.5142857142857142,0.539,31,37,0.8378378378378378
Hubert Davis,davishu01,SG,27,DAL,1998,81,2378.0,898,157,34,135,169,43,5,88,117,350,767,0.4563233376792698,101,230,0.4391304347826087,249,537,0.4636871508379888,0.522,97,116,0.8362068965517241
Mark Davis,davisma02,SF,24,PHI,1998,71,906.0,282,73,64,94,158,49,18,91,95,109,244,0.4467213114754098,0,6,0.0,109,238,0.4579831932773109,0.447,64,101,0.6336633663366337
Terry Davis,daviste01,PF,30,WAS,1998,74,1705.0,323,30,209,271,480,41,24,56,193,127,256,0.49609375,0,1,0.0,127,255,0.4980392156862745,0.496,69,119,0.5798319327731093
Todd Day,dayto01,SG,28,MIA,1998,5,69.0,30,7,4,2,6,7,0,3,10,11,31,0.3548387096774194,2,12,0.1666666666666666,9,19,0.4736842105263157,0.387,6,9,0.6666666666666666
Andrew DeClercq,declean01,C,24,BOS,1998,81,1523.0,439,59,180,212,392,85,49,84,277,169,340,0.4970588235294118,0,1,0.0,169,339,0.4985250737463126,0.497,101,168,0.6011904761904762
Terry Dehere,deherte01,PG,26,SAC,1998,77,1410.0,489,196,21,85,106,52,4,96,150,180,451,0.3991130820399113,50,132,0.3787878787878788,130,319,0.4075235109717868,0.455,79,99,0.797979797979798
Vinny Del Negro,delnevi01,SG,31,SAS,1998,54,1721.0,513,183,13,139,152,39,6,53,113,211,479,0.4405010438413361,17,39,0.4358974358974359,194,440,0.4409090909090909,0.458,74,93,0.7956989247311828
Bison Dele,delebi01,C,28,DET,1998,78,2619.0,1261,94,223,472,695,67,55,181,252,531,1040,0.510576923076923,1,3,0.3333333333333333,530,1037,0.5110896817743491,0.511,198,280,0.7071428571428572
Tony Delk,delkto01,PG,24,TOT,1998,77,1681.0,781,172,38,134,172,73,12,109,96,314,798,0.3934837092731829,42,157,0.267515923566879,272,641,0.4243369734789392,0.42,111,151,0.7350993377483444
Vlade Divac,divacvl01,C,29,CHH,1998,64,1805.0,667,172,183,335,518,83,94,114,179,267,536,0.498134328358209,3,14,0.2142857142857142,264,522,0.5057471264367817,0.501,130,188,0.6914893617021277
Sherman Douglas,douglsh01,PG,31,NJN,1998,80,1699.0,639,319,52,83,135,55,7,110,156,255,515,0.4951456310679611,14,46,0.3043478260869565,241,469,0.5138592750533049,0.509,115,172,0.6686046511627907
Clyde Drexler,drexlcl01,SG,35,HOU,1998,70,2473.0,1287,382,105,241,346,126,42,189,193,452,1059,0.4268177525967894,106,334,0.3173652694610778,346,725,0.4772413793103448,0.477,277,346,0.8005780346820809
Chris Dudley,dudlech02,C,32,NYK,1998,51,858.0,157,21,108,167,275,13,51,44,139,58,143,0.4055944055944055,0,0,0.0,58,143,0.4055944055944055,0.406,41,92,0.4456521739130434
Joe Dumars,dumarjo01,SG,34,DET,1998,72,2326.0,943,253,14,90,104,44,2,84,99,329,791,0.415929203539823,158,426,0.3708920187793427,171,365,0.4684931506849315,0.516,127,154,0.8246753246753247
Tony Dumas,dumasto01,SG,25,CLE,1998,7,47.0,14,5,1,4,5,0,0,5,5,6,12,0.5,2,4,0.5,4,8,0.5,0.583,0,3,0.0
Tim Duncan,duncati01,PF,21,SAS,1998,82,3204.0,1731,224,274,703,977,55,206,279,254,706,1287,0.5485625485625486,0,10,0.0,706,1277,0.552858261550509,0.549,319,482,0.6618257261410788
Ledell Eackles,eacklle01,SG,31,WAS,1998,42,547.0,218,16,25,50,75,17,0,29,43,75,175,0.4285714285714285,16,46,0.3478260869565217,59,129,0.4573643410852713,0.474,52,59,0.8813559322033898
Tyus Edney,edneyty01,PG,24,BOS,1998,52,623.0,277,139,20,35,55,51,1,66,69,93,216,0.4305555555555556,3,10,0.3,90,206,0.4368932038834951,0.438,88,111,0.7927927927927928
Blue Edwards,edwarbl01,SG,32,VAN,1998,81,1968.0,872,201,61,156,217,86,27,134,183,326,742,0.4393530997304582,40,120,0.3333333333333333,286,622,0.4598070739549839,0.466,180,215,0.8372093023255814
Kevin Edwards,edwarke01,SG,32,TOT,1998,39,487.0,150,39,20,34,54,26,1,30,28,57,165,0.3454545454545454,6,15,0.4,51,150,0.34,0.364,30,35,0.8571428571428571
Howard Eisley,eisleho01,PG,25,UTA,1998,82,1726.0,633,346,25,141,166,54,13,160,182,229,519,0.441233140655106,48,118,0.4067796610169492,181,401,0.4513715710723192,0.487,127,149,0.8523489932885906
Mario Elie,eliema01,SF,34,HOU,1998,73,1988.0,612,221,39,117,156,81,8,100,115,206,456,0.4517543859649123,55,189,0.291005291005291,151,267,0.5655430711610487,0.512,145,174,0.8333333333333334
Sean Elliott,elliose01,SF,29,SAS,1998,36,1012.0,334,62,16,108,124,24,14,57,92,122,303,0.4026402640264026,34,90,0.3777777777777777,88,213,0.4131455399061033,0.459,56,78,0.717948717948718
Dale Ellis,ellisda01,SF,37,SEA,1998,79,1939.0,934,89,51,133,184,60,5,74,128,348,700,0.4971428571428571,127,274,0.4635036496350365,221,426,0.5187793427230047,0.588,111,142,0.7816901408450704
Harold Ellis,ellisha01,SF,27,DEN,1998,27,344.0,164,18,27,23,50,19,4,19,53,62,111,0.5585585585585585,0,4,0.0,62,107,0.5794392523364486,0.559,40,63,0.6349206349206349
LaPhonso Ellis,ellisla01,SF,27,DEN,1998,76,2575.0,1083,213,146,398,544,65,49,173,226,410,1007,0.407149950347567,57,201,0.2835820895522388,353,806,0.4379652605459057,0.435,206,256,0.8046875
Pervis Ellison,ellispe01,PF,30,BOS,1998,33,447.0,100,31,52,57,109,20,31,28,90,40,70,0.5714285714285714,0,0,0.0,40,70,0.5714285714285714,0.571,20,34,0.5882352941176471
Brian Evans,evansbr01,SF,24,TOT,1998,72,893.0,321,55,49,88,137,29,13,38,101,123,312,0.3942307692307692,29,87,0.3333333333333333,94,225,0.4177777777777778,0.441,46,57,0.8070175438596491
Patrick Ewing,ewingpa01,C,35,NYK,1998,26,848.0,540,28,59,206,265,16,58,77,74,203,403,0.5037220843672456,0,2,0.0,203,401,0.5062344139650873,0.504,134,186,0.7204301075268817
Tony Farmer,farmeto01,C,28,CHH,1998,27,169.0,67,5,16,16,32,10,4,9,23,17,53,0.320754716981132,2,9,0.2222222222222222,15,44,0.3409090909090909,0.34,31,39,0.7948717948717948
Jamie Feick,feickja01,PF,23,MIL,1998,45,450.0,102,16,45,79,124,25,17,21,67,39,90,0.4333333333333333,4,13,0.3076923076923077,35,77,0.4545454545454545,0.456,20,41,0.4878048780487805
Duane Ferrell,ferredu01,SF,32,GSW,1998,50,461.0,94,26,25,22,47,21,6,18,50,41,111,0.3693693693693693,0,6,0.0,41,105,0.3904761904761905,0.369,12,22,0.5454545454545454
Danny Ferry,ferryda01,PF,31,CLE,1998,69,1034.0,291,59,23,91,114,26,17,53,118,113,286,0.3951048951048951,33,99,0.3333333333333333,80,187,0.427807486631016,0.453,32,40,0.8
Michael Finley,finlemi01,SF,24,DAL,1998,82,3394.0,1763,405,150,288,438,132,30,219,163,675,1505,0.4485049833887043,87,244,0.3565573770491803,588,1261,0.4662965900079302,0.477,326,416,0.7836538461538461
Derek Fisher,fishede01,PG,23,LAL,1998,82,1760.0,474,333,38,155,193,75,5,119,126,164,378,0.4338624338624338,31,81,0.382716049382716,133,297,0.4478114478114478,0.475,115,152,0.756578947368421
Danny Fortson,fortsda01,PF,21,DEN,1998,80,1811.0,816,76,182,266,448,44,30,157,314,276,611,0.4517184942716857,1,3,0.3333333333333333,275,608,0.4523026315789473,0.453,263,339,0.775811209439528
Greg Foster,fostegr01,C,29,UTA,1998,78,1446.0,441,51,85,188,273,15,28,68,187,186,418,0.4449760765550239,2,9,0.2222222222222222,184,409,0.4498777506112469,0.447,67,87,0.7701149425287356
Rick Fox,foxri01,SF,28,LAL,1998,82,2709.0,983,276,78,280,358,100,48,201,309,363,771,0.4708171206225681,86,265,0.3245283018867924,277,506,0.5474308300395256,0.527,171,230,0.7434782608695653
Adonal Foyle,foylead01,C,22,GSW,1998,55,656.0,165,14,73,111,184,13,52,50,94,69,170,0.4058823529411764,0,1,0.0,69,169,0.408284023668639,0.406,27,62,0.4354838709677419
Todd Fuller,fulleto02,C,23,GSW,1998,57,613.0,227,10,61,135,196,6,16,37,89,86,205,0.4195121951219512,0,4,0.0,86,201,0.4278606965174129,0.42,55,80,0.6875
Lawrence Funderburke,fundela01,PF,27,SAC,1998,52,1094.0,493,63,80,154,234,19,15,62,56,191,390,0.4897435897435897,1,7,0.1428571428571428,190,383,0.4960835509138381,0.491,110,162,0.6790123456790124
Chris Garner,garnech01,PG,22,TOR,1998,38,293.0,53,45,7,17,24,21,4,25,50,23,70,0.3285714285714285,4,14,0.2857142857142857,19,56,0.3392857142857143,0.357,3,7,0.4285714285714285
Kevin Garnett,garneke01,PF,21,MIN,1998,82,3222.0,1518,348,222,564,786,139,150,192,224,635,1293,0.4911059551430781,3,16,0.1875,632,1277,0.494909945184025,0.492,245,332,0.7379518072289156
Dean Garrett,garrede01,C,31,DEN,1998,82,2632.0,598,90,227,417,644,57,133,84,197,242,565,0.4283185840707965,0,0,0.0,242,565,0.4283185840707965,0.428,114,176,0.6477272727272727
Kiwane Lemorris Garris,garriki01,SG,23,DEN,1998,28,225.0,68,28,3,16,19,7,1,15,22,22,65,0.3384615384615385,5,14,0.3571428571428571,17,51,0.3333333333333333,0.377,19,25,0.76
Chris Gatling,gatlich01,PF,30,NJN,1998,57,1359.0,656,53,118,216,334,52,29,99,152,248,545,0.455045871559633,1,4,0.25,247,541,0.4565619223659889,0.456,159,265,0.6
Reggie Geary,gearyre01,PG,24,SAS,1998,62,685.0,152,74,19,48,67,37,12,42,95,56,169,0.3313609467455621,12,40,0.3,44,129,0.3410852713178294,0.367,28,56,0.5
Matt Geiger,geigema01,C,28,CHH,1998,78,1839.0,885,78,196,325,521,68,87,111,191,358,709,0.5049365303244006,1,11,0.0909090909090909,357,698,0.5114613180515759,0.506,168,236,0.711864406779661
Kendall Gill,gillke01,SF,29,NJN,1998,81,2733.0,1087,200,112,279,391,156,64,124,268,418,974,0.4291581108829568,26,101,0.2574257425742574,392,873,0.4490263459335624,0.443,225,327,0.6880733944954128
Armen Gilliam,gilliar01,PF,33,MIL,1998,82,2114.0,921,104,146,293,439,65,37,148,177,327,676,0.4837278106508875,0,4,0.0,327,672,0.4866071428571428,0.484,267,333,0.8018018018018018
Anthony Goldwire,goldwan01,PG,26,DEN,1998,82,2212.0,751,277,40,107,147,86,7,85,149,269,636,0.4229559748427673,63,164,0.3841463414634146,206,472,0.4364406779661017,0.472,150,186,0.8064516129032258
Greg Graham,grahagr01,SG,27,CLE,1998,6,56.0,16,6,0,1,1,1,0,10,7,7,12,0.5833333333333334,0,3,0.0,7,9,0.7777777777777778,0.583,2,2,1.0
Brian Grant,grantbr01,SF,25,POR,1998,61,1921.0,737,86,197,358,555,44,45,110,184,283,557,0.5080789946140036,0,1,0.0,283,556,0.5089928057553957,0.508,171,228,0.75
Gary Grant,grantga01,PG,32,POR,1998,22,359.0,105,84,8,40,48,17,2,24,30,43,93,0.4623655913978494,7,19,0.3684210526315789,36,74,0.4864864864864865,0.5,12,14,0.8571428571428571
Harvey Grant,grantha01,SF,32,WAS,1998,65,895.0,170,39,60,108,168,23,15,26,94,75,196,0.3826530612244898,1,6,0.1666666666666666,74,190,0.3894736842105263,0.385,19,30,0.6333333333333333
Horace Grant,grantho01,C,32,ORL,1998,76,2803.0,921,172,228,390,618,81,79,88,180,393,857,0.4585764294049008,0,7,0.0,393,850,0.4623529411764706,0.459,135,199,0.678391959798995
Ed Gray,grayed01,SG,22,ATL,1998,30,472.0,227,34,9,36,45,15,11,30,73,77,202,0.3811881188118812,18,46,0.391304347826087,59,156,0.3782051282051282,0.426,55,65,0.8461538461538461
Jeff Grayer,grayeje01,SG,32,TOT,1998,5,34.0,10,2,0,4,4,2,0,4,7,4,11,0.3636363636363636,2,6,0.3333333333333333,2,5,0.4,0.455,0,0,0.0
A.C. Green,greenac01,PF,34,DAL,1998,82,2649.0,600,123,219,449,668,78,27,68,157,242,534,0.4531835205992509,0,4,0.0,242,530,0.4566037735849056,0.453,116,162,0.7160493827160493
Litterial Green,greenli01,PG,27,MIL,1998,21,124.0,25,16,1,6,7,4,0,8,11,5,23,0.217391304347826,0,2,0.0,5,21,0.238095238095238,0.217,15,20,0.75
Derek Grimm,grimmde01,SF,23,SAC,1998,9,34.0,14,0,0,4,4,3,1,3,6,4,14,0.2857142857142857,4,12,0.3333333333333333,0,2,0.0,0.429,2,2,1.0
Tom Gugliotta,guglito01,SF,28,MIN,1998,41,1582.0,823,167,106,250,356,61,22,109,102,319,635,0.5023622047244094,2,17,0.1176470588235294,317,618,0.5129449838187702,0.504,183,223,0.820627802690583
Jack Haley,haleyja01,C,34,NJN,1998,16,51.0,22,0,5,10,15,0,1,4,9,5,18,0.2777777777777778,0,1,0.0,5,17,0.2941176470588235,0.278,12,21,0.5714285714285714
Darvin Ham,hamda01,SF,24,WAS,1998,71,635.0,145,16,72,59,131,21,25,37,118,55,104,0.5288461538461539,0,0,0.0,55,104,0.5288461538461539,0.529,35,74,0.4729729729729729
Tom Hammonds,hammoto01,PF,30,MIN,1998,57,1140.0,346,36,100,171,271,15,17,48,127,127,246,0.516260162601626,0,1,0.0,127,245,0.5183673469387755,0.516,92,132,0.696969696969697
Reggie Hanson,hansore01,SF,29,BOS,1998,8,26.0,6,1,3,3,6,2,1,3,8,3,6,0.5,0,0,0.0,3,6,0.5,0.5,0,0,0.0
Anfernee Hardaway,hardaan01,SG,26,ORL,1998,19,625.0,311,68,8,68,76,28,15,46,45,103,273,0.3772893772893773,15,50,0.3,88,223,0.3946188340807174,0.405,90,118,0.7627118644067796
Tim Hardaway,hardati01,PG,31,MIA,1998,81,3031.0,1528,672,48,251,299,136,16,224,200,558,1296,0.4305555555555556,155,442,0.3506787330316742,403,854,0.4718969555035129,0.49,257,329,0.7811550151975684
Derek Harper,harpede01,SG,36,ORL,1998,66,1761.0,566,233,23,80,103,72,10,101,140,226,542,0.4169741697416974,59,164,0.3597560975609756,167,378,0.4417989417989418,0.471,55,79,0.6962025316455697
Ron Harper,harpero01,PG,34,CHI,1998,82,2284.0,764,241,107,183,290,108,48,91,181,293,665,0.4406015037593985,16,84,0.1904761904761904,277,581,0.4767641996557659,0.453,162,216,0.75
Othella Harrington,harriot01,PF,24,HOU,1998,58,903.0,350,24,73,134,207,10,27,47,112,129,266,0.4849624060150376,0,1,0.0,129,265,0.4867924528301887,0.485,92,122,0.7540983606557377
Lucious Harris,harrilu01,SG,27,NJN,1998,50,671.0,191,42,21,31,52,42,5,21,77,69,177,0.3898305084745763,12,39,0.3076923076923077,57,138,0.4130434782608695,0.424,41,55,0.7454545454545455
Hersey Hawkins,hawkihe01,SG,31,SEA,1998,82,2597.0,862,221,71,263,334,148,17,102,153,280,636,0.440251572327044,125,301,0.4152823920265781,155,335,0.4626865671641791,0.539,177,204,0.8676470588235294
Alan Henderson,hendeal01,PF,25,ATL,1998,69,2000.0,986,73,200,242,442,42,36,110,175,365,753,0.4847277556440903,3,6,0.5,362,747,0.4846050870147255,0.487,253,388,0.6520618556701031
Cedric Henderson,hendece02,SF,22,CLE,1998,82,2527.0,832,168,71,254,325,96,45,165,238,348,725,0.48,0,4,0.0,348,721,0.4826629680998613,0.48,136,190,0.7157894736842105
Mark Hendrickson,hendrma01,PF,23,SAC,1998,48,737.0,163,41,33,110,143,26,9,31,60,58,149,0.3892617449664429,0,5,0.0,58,144,0.4027777777777778,0.389,47,57,0.8245614035087719
Steve Henson,hensost01,PG,29,DET,1998,23,65.0,36,4,0,2,2,1,0,6,9,13,26,0.5,3,8,0.375,10,18,0.5555555555555556,0.558,7,7,1.0
Carl Herrera,herreca01,PF,31,SAS,1998,58,516.0,170,22,24,67,91,19,12,38,71,76,175,0.4342857142857143,0,1,0.0,76,174,0.4367816091954023,0.434,18,44,0.4090909090909091
Sean Higgins,higgise01,SF,29,POR,1998,2,12.0,0,0,0,0,0,2,0,1,3,0,5,0.0,0,2,0.0,0,3,0.0,0.0,0,0,0.0
Grant Hill,hillgr01,SF,25,DET,1998,81,3294.0,1712,551,93,530,623,143,53,285,196,615,1361,0.4518736223365173,3,21,0.1428571428571428,612,1340,0.4567164179104477,0.453,479,647,0.740340030911901
Tyrone Hill,hillty01,PF,29,MIL,1998,57,2064.0,571,88,212,396,608,67,30,106,230,208,418,0.4976076555023923,0,1,0.0,208,417,0.4988009592326139,0.498,155,255,0.6078431372549019
Fred Hoiberg,hoibefr01,SG,25,IND,1998,65,874.0,261,45,14,109,123,40,3,22,101,85,222,0.3828828828828828,32,85,0.3764705882352941,53,137,0.3868613138686131,0.455,59,69,0.855072463768116
Jerald Honeycutt,honeyje01,PF,23,MIL,1998,38,530.0,245,33,27,66,93,20,6,49,83,90,221,0.4072398190045249,29,77,0.3766233766233766,61,144,0.4236111111111111,0.473,36,58,0.6206896551724138
Jeff Hornacek,hornaje01,SG,34,UTA,1998,80,2460.0,1139,349,65,205,270,109,15,132,175,399,828,0.4818840579710144,56,127,0.4409448818897638,343,701,0.4893009985734665,0.516,285,322,0.8850931677018633
Robert Horry,horryro01,PF,27,LAL,1998,72,2192.0,536,163,186,356,542,112,94,99,238,200,420,0.4761904761904761,19,93,0.2043010752688172,181,327,0.5535168195718655,0.499,117,169,0.6923076923076923
Allan Houston,houstal01,SG,26,NYK,1998,82,2848.0,1509,212,43,231,274,63,24,200,207,571,1277,0.447141738449491,82,213,0.3849765258215962,489,1064,0.4595864661654135,0.479,285,335,0.8507462686567164
Juwan Howard,howarju01,PF,24,WAS,1998,64,2559.0,1184,208,161,288,449,82,23,185,225,463,991,0.467204843592331,0,2,0.0,463,989,0.4681496461071789,0.467,258,358,0.7206703910614525
Stephen Howard,howarst01,SF,27,SEA,1998,13,53.0,25,3,6,6,12,3,1,6,13,8,21,0.3809523809523809,0,0,0.0,8,21,0.3809523809523809,0.381,9,18,0.5
Troy Hudson,hudsotr01,PG,21,UTA,1998,8,23.0,12,4,1,1,2,2,0,1,1,6,14,0.4285714285714285,0,3,0.0,6,11,0.5454545454545454,0.429,0,0,0.0
Lindsey Hunter,hunteli01,PG,27,DET,1998,71,2505.0,862,224,61,186,247,123,10,110,174,316,826,0.3825665859564164,85,265,0.320754716981132,231,561,0.4117647058823529,0.434,145,196,0.7397959183673469
Bobby Hurley,hurlebo01,PG,26,TOT,1998,61,875.0,250,177,12,54,66,23,0,86,79,93,238,0.3907563025210084,5,22,0.2272727272727272,88,216,0.4074074074074074,0.401,59,76,0.7763157894736842
Zydrunas Ilgauskas,ilgauzy01,C,22,CLE,1998,82,2379.0,1139,71,279,444,723,52,135,146,288,454,876,0.5182648401826484,1,4,0.25,453,872,0.5194954128440367,0.519,230,302,0.7615894039735099
Allen Iverson,iversal01,PG,22,PHI,1998,80,3150.0,1758,494,86,210,296,176,25,244,200,649,1407,0.4612651030561478,70,235,0.2978723404255319,579,1172,0.4940273037542662,0.486,390,535,0.7289719626168224
Bobby Jackson,jacksbo01,PG,24,DEN,1998,68,2042.0,790,317,78,224,302,105,11,184,160,310,791,0.3919089759797724,21,81,0.2592592592592592,289,710,0.4070422535211268,0.405,149,183,0.8142076502732241
Jaren Jackson,jacksja01,SG,30,SAS,1998,82,2226.0,722,156,55,155,210,60,8,104,222,258,654,0.3944954128440367,112,297,0.3771043771043771,146,357,0.4089635854341736,0.48,94,118,0.7966101694915254
Jim Jackson,jacksji01,SG,27,TOT,1998,79,3046.0,1242,381,130,270,400,79,8,263,186,476,1107,0.4299909665763324,61,191,0.3193717277486911,415,916,0.4530567685589519,0.458,229,282,0.8120567375886525
Mark Jackson,jacksma01,PG,32,IND,1998,82,2413.0,678,713,67,255,322,84,2,174,132,249,598,0.4163879598662207,43,137,0.3138686131386861,206,461,0.4468546637744034,0.452,137,180,0.7611111111111111
Henry James,jameshe01,PF,32,CLE,1998,28,166.0,80,5,2,13,15,1,1,12,24,24,59,0.4067796610169492,11,25,0.44,13,34,0.3823529411764705,0.5,21,22,0.9545454545454546
Anthony Johnson,johnsan02,PG,23,SAC,1998,77,2266.0,574,329,51,120,171,64,6,120,188,226,609,0.3711001642036124,42,128,0.328125,184,481,0.3825363825363825,0.406,80,110,0.7272727272727273
Avery Johnson,johnsav01,PG,32,SAS,1998,75,2674.0,766,591,30,120,150,84,18,165,140,321,671,0.4783904619970194,2,13,0.1538461538461538,319,658,0.4848024316109423,0.48,122,168,0.7261904761904762
Eddie Johnson,johnsed03,SF,38,HOU,1998,75,1490.0,633,88,50,103,153,32,3,62,89,227,544,0.4172794117647059,66,198,0.3333333333333333,161,346,0.4653179190751445,0.478,113,136,0.8308823529411765
Ervin Johnson,johnser02,C,30,MIL,1998,81,2261.0,649,59,242,443,685,79,158,117,321,253,471,0.5371549893842887,0,0,0.0,253,471,0.5371549893842887,0.537,143,238,0.6008403361344538
Kevin Johnson,johnske02,PG,31,PHO,1998,50,1290.0,476,245,35,129,164,27,8,101,57,155,347,0.446685878962536,4,26,0.1538461538461538,151,321,0.470404984423676,0.452,162,186,0.8709677419354839
Larry Johnson,johnsla02,SF,28,NYK,1998,70,2412.0,1087,150,175,226,401,40,13,127,193,429,884,0.4852941176470588,15,63,0.238095238095238,414,821,0.5042630937880633,0.494,214,283,0.7561837455830389
Charles Jones,jonesch01,PF,40,HOU,1998,24,127.0,15,5,12,12,24,1,6,4,22,7,10,0.7,0,0,0.0,7,10,0.7,0.7,1,2,0.5
Dontae' Jones,jonesdo01,SF,22,BOS,1998,15,91.0,44,5,3,6,9,2,3,11,12,19,57,0.3333333333333333,6,23,0.2608695652173913,13,34,0.3823529411764705,0.386,0,0,0.0
Eddie Jones,jonesed02,SG,26,LAL,1998,80,2910.0,1349,246,85,217,302,160,55,146,164,486,1005,0.4835820895522388,143,368,0.3885869565217391,343,637,0.5384615384615384,0.555,234,306,0.7647058823529411
Popeye Jones,jonespo01,PF,27,TOR,1998,14,352.0,120,18,50,52,102,10,3,16,39,52,127,0.4094488188976378,2,3,0.6666666666666666,50,124,0.4032258064516129,0.417,14,19,0.7368421052631579
Michael Jordan,jordami01,SG,34,CHI,1998,82,3181.0,2357,283,130,345,475,141,45,185,151,881,1893,0.4653988378235605,30,126,0.238095238095238,851,1767,0.4816072439162422,0.473,565,721,0.7836338418862691
Reggie Jordan,jordare01,SG,30,MIN,1998,57,487.0,149,50,57,40,97,35,9,30,63,54,113,0.4778761061946903,0,1,0.0,54,112,0.4821428571428571,0.478,41,72,0.5694444444444444
Adam Keefe,keefead01,C,27,UTA,1998,80,2047.0,620,89,179,259,438,52,24,71,172,229,424,0.5400943396226415,0,0,0.0,229,424,0.5400943396226415,0.54,162,200,0.81
Shawn Kemp,kempsh01,PF,28,CLE,1998,80,2769.0,1442,197,219,526,745,108,90,271,310,518,1164,0.4450171821305841,2,8,0.25,516,1156,0.4463667820069204,0.446,404,556,0.7266187050359713
Tim Kempton,kemptti01,PF,34,TOT,1998,8,47.0,4,3,4,2,6,1,2,4,10,2,9,0.2222222222222222,0,0,0.0,2,9,0.2222222222222222,0.222,0,0,0.0
Steve Kerr,kerrst01,PG,32,CHI,1998,50,1119.0,376,96,14,63,77,26,5,27,71,137,302,0.4536423841059602,57,130,0.4384615384615384,80,172,0.4651162790697674,0.548,45,49,0.9183673469387756
Jerome Kersey,kerseje01,SF,35,SEA,1998,37,717.0,234,44,56,79,135,52,14,36,104,97,233,0.4163090128755364,1,10,0.1,96,223,0.4304932735426009,0.418,39,65,0.6
Jason Kidd,kiddja01,PG,24,PHO,1998,82,3118.0,954,745,108,402,510,162,26,261,142,357,859,0.4155995343422584,73,233,0.3133047210300429,284,626,0.4536741214057508,0.458,167,209,0.7990430622009569
Kerry Kittles,kittlke01,SG,23,NJN,1998,77,2814.0,1328,176,132,230,362,132,37,106,152,508,1154,0.4402079722703639,110,263,0.4182509505703422,398,891,0.44668911335578,0.488,202,250,0.808
Joe Kleine,kleinjo01,C,36,CHI,1998,46,397.0,93,30,27,50,77,4,5,28,63,39,106,0.3679245283018867,0,0,0.0,39,106,0.3679245283018867,0.368,15,18,0.8333333333333334
Brevin Knight,knighbr01,PG,22,CLE,1998,80,2483.0,723,656,67,186,253,196,18,194,271,261,592,0.4408783783783784,0,7,0.0,261,585,0.4461538461538462,0.441,201,251,0.8007968127490039
Travis Knight,knightr01,C,23,BOS,1998,74,1503.0,482,104,146,219,365,54,82,87,253,193,438,0.4406392694063927,15,55,0.2727272727272727,178,383,0.464751958224543,0.458,81,103,0.7864077669902912
Toni Kukoč,kukocto01,SF,29,CHI,1998,74,2235.0,984,314,121,206,327,76,37,154,149,383,841,0.4554102259215219,63,174,0.3620689655172414,320,667,0.47976011994003,0.493,155,219,0.7077625570776256
Christian Laettner,laettch01,PF,28,ATL,1998,74,2282.0,1020,190,142,345,487,71,73,183,246,354,730,0.4849315068493151,6,27,0.2222222222222222,348,703,0.4950213371266003,0.489,306,354,0.864406779661017
Andrew Lang,langan01,C,31,MIL,1998,57,692.0,152,16,56,97,153,18,27,33,101,54,143,0.3776223776223776,0,1,0.0,54,142,0.380281690140845,0.378,44,57,0.7719298245614035
Antonio Lang,langan02,SF,25,MIA,1998,6,29.0,12,1,2,3,5,2,0,4,3,3,5,0.6,0,0,0.0,3,5,0.6,0.6,6,8,0.75
Rusty LaRue,larueru01,PG,24,CHI,1998,14,140.0,49,5,1,7,8,3,1,6,12,20,49,0.4081632653061224,4,16,0.25,16,33,0.4848484848484848,0.449,5,8,0.625
Priest Lauderdale,laudepr01,C,24,DEN,1998,39,345.0,144,21,27,73,100,7,17,46,63,53,127,0.4173228346456692,0,0,0.0,53,127,0.4173228346456692,0.417,38,69,0.5507246376811594
Jason Lawson,lawsoja01,C,23,ORL,1998,17,80.0,26,5,8,19,27,4,4,2,14,9,15,0.6,0,0,0.0,9,15,0.6,0.6,8,10,0.8
Tim Legler,legleti01,SG,31,WAS,1998,8,76.0,9,3,2,2,4,1,0,4,11,3,19,0.1578947368421052,0,6,0.0,3,13,0.2307692307692307,0.158,3,4,0.75
Voshon Lenard,lenarvo01,SG,24,MIA,1998,81,2621.0,1020,180,72,220,292,58,16,99,219,363,854,0.4250585480093676,153,378,0.4047619047619047,210,476,0.4411764705882353,0.515,141,179,0.7877094972067039
Alton Lister,listeal01,C,39,POR,1998,7,44.0,6,1,2,9,11,1,1,2,12,3,8,0.375,0,0,0.0,3,8,0.375,0.375,0,0,0.0
Randy Livingston,livinra01,PG,22,ATL,1998,12,82.0,10,5,1,5,6,7,2,6,6,3,12,0.25,0,0,0.0,3,12,0.25,0.25,4,5,0.8
Horacio Llamas,llamaho01,C,24,PHO,1998,8,42.0,24,1,4,14,18,1,3,9,14,8,21,0.3809523809523809,1,3,0.3333333333333333,7,18,0.3888888888888889,0.405,7,10,0.7
Brad Lohaus,lohaubr01,PF,33,SAS,1998,9,102.0,19,5,3,9,12,1,2,3,10,7,21,0.3333333333333333,4,14,0.2857142857142857,3,7,0.4285714285714285,0.429,1,3,0.3333333333333333
Grant Long,longgr01,PF,31,DET,1998,40,739.0,141,25,57,93,150,29,12,22,91,50,117,0.4273504273504273,0,4,0.0,50,113,0.4424778761061947,0.427,41,57,0.7192982456140351
Luc Longley,longllu01,C,29,CHI,1998,58,1703.0,663,161,113,228,341,34,62,130,206,277,609,0.4548440065681445,0,0,0.0,277,609,0.4548440065681445,0.455,109,148,0.7364864864864865
George Lynch,lynchge01,SF,27,VAN,1998,82,1493.0,616,122,147,215,362,65,41,104,161,248,516,0.4806201550387597,9,30,0.3,239,486,0.4917695473251028,0.489,111,158,0.7025316455696202
Sam Mack,macksa01,SF,27,VAN,1998,57,1414.0,616,101,30,103,133,41,11,69,117,222,559,0.3971377459749552,110,269,0.4089219330855018,112,290,0.3862068965517241,0.496,62,77,0.8051948051948052
Don MacLean,macledo01,SF,28,NJN,1998,9,42.0,3,0,3,2,5,0,0,2,7,1,10,0.1,1,2,0.5,0,8,0.0,0.15,0,0,0.0
Gerald Madkins,madkige01,SG,28,GSW,1998,19,243.0,37,45,2,13,15,13,1,13,18,13,34,0.3823529411764705,6,15,0.4,7,19,0.3684210526315789,0.471,5,7,0.7142857142857143
Rick Mahorn,mahorri01,C,39,DET,1998,59,707.0,141,15,65,130,195,14,7,37,123,59,129,0.4573643410852713,0,0,0.0,59,129,0.4573643410852713,0.457,23,34,0.6764705882352942
Dan Majerle,majerda01,SG,32,MIA,1998,72,1928.0,519,157,48,220,268,68,15,65,139,184,439,0.4191343963553531,111,295,0.376271186440678,73,144,0.5069444444444444,0.546,40,51,0.7843137254901961
Karl Malone,malonka01,PF,34,UTA,1998,81,3030.0,2190,316,189,645,834,96,70,247,237,780,1472,0.529891304347826,2,6,0.3333333333333333,778,1466,0.5306957708049114,0.531,628,825,0.7612121212121212
Matt Maloney,malonma01,PG,26,HOU,1998,78,2217.0,669,219,16,126,142,62,5,107,99,239,586,0.4078498293515358,126,346,0.3641618497109826,113,240,0.4708333333333333,0.515,65,78,0.8333333333333334
Danny Manning,mannida01,PF,31,PHO,1998,70,1794.0,947,139,110,282,392,71,46,100,201,390,756,0.5158730158730159,0,7,0.0,390,749,0.520694259012016,0.516,167,226,0.7389380530973452
Stephon Marbury,marbust01,PG,20,MIN,1998,82,3112.0,1450,704,58,172,230,104,7,256,222,513,1237,0.4147130153597413,95,304,0.3125,418,933,0.4480171489817792,0.453,329,450,0.7311111111111112
Donyell Marshall,marshdo01,SF,24,GSW,1998,73,2611.0,1123,159,210,418,628,95,73,147,226,451,1090,0.4137614678899082,63,201,0.3134328358208955,388,889,0.4364454443194601,0.443,158,216,0.7314814814814815
Darrick Martin,martida01,PG,26,LAC,1998,82,2299.0,841,331,19,145,164,82,10,154,198,275,730,0.3767123287671233,107,293,0.3651877133105802,168,437,0.3844393592677345,0.45,184,217,0.847926267281106
Jamal Mashburn,mashbja01,SF,25,MIA,1998,48,1729.0,723,132,72,164,236,43,14,108,137,251,577,0.4350086655112651,37,122,0.3032786885245901,214,455,0.4703296703296703,0.467,184,231,0.7965367965367965
Anthony Mason,masonan01,PF,31,CHH,1998,81,3148.0,1039,342,177,649,826,68,18,146,182,389,764,0.5091623036649214,0,4,0.0,389,760,0.5118421052631579,0.509,261,402,0.6492537313432836
Tony Massenburg,masseto01,C,30,VAN,1998,61,894.0,396,21,80,152,232,25,24,60,123,148,309,0.4789644012944983,0,0,0.0,148,309,0.4789644012944983,0.479,100,137,0.7299270072992701
Vernon Maxwell,maxweve01,SG,32,TOT,1998,42,636.0,291,52,14,43,57,16,4,40,71,103,258,0.3992248062015504,37,112,0.3303571428571428,66,146,0.4520547945205479,0.471,48,60,0.8
Lee Mayberry,maybele01,PG,27,VAN,1998,79,1835.0,363,349,19,95,114,65,10,113,164,131,349,0.3753581661891118,63,180,0.35,68,169,0.4023668639053254,0.466,38,51,0.7450980392156863
Bob McCann,mccanbo01,SF,33,TOR,1998,1,5.0,0,0,0,1,1,0,0,0,1,0,1,0.0,0,0,0.0,0,1,0.0,0.0,0,0,0.0
Walter McCarty,mccarwa01,SF,23,BOS,1998,82,2340.0,788,177,141,223,364,110,44,141,274,295,730,0.4041095890410959,54,175,0.3085714285714285,241,555,0.4342342342342342,0.441,144,194,0.7422680412371134
George McCloud,mccloge01,SF,30,PHO,1998,63,1213.0,456,84,45,173,218,54,13,63,132,173,427,0.405152224824356,71,208,0.3413461538461538,102,219,0.4657534246575342,0.488,39,51,0.7647058823529411
Xavier McDaniel,mcdanxa01,SF,34,NJN,1998,20,180.0,25,9,12,19,31,3,2,8,23,10,30,0.3333333333333333,0,0,0.0,10,30,0.3333333333333333,0.333,5,8,0.625
Michael McDonald,mcdonmi01,C,28,CHH,1998,1,4.0,0,0,1,0,1,0,0,2,1,0,0,0.0,0,0,0.0,0,0,0.0,0.0,0,0,0.0
Antonio McDyess,mcdyean01,PF,23,PHO,1998,81,2441.0,1225,106,206,407,613,100,135,142,292,497,927,0.5361380798274002,0,2,0.0,497,925,0.5372972972972972,0.536,231,329,0.7021276595744681
Tracy McGrady,mcgratr01,SF,18,TOR,1998,64,1179.0,451,98,105,164,269,49,61,66,86,179,398,0.4497487437185929,14,41,0.3414634146341463,165,357,0.4621848739495798,0.467,79,111,0.7117117117117117
Jim McIlvaine,mcilvji01,C,25,SEA,1998,78,1211.0,247,19,96,163,259,24,137,54,240,101,223,0.452914798206278,0,3,0.0,101,220,0.4590909090909091,0.453,45,81,0.5555555555555556
Derrick McKey,mckeyde01,SF,31,IND,1998,57,1316.0,359,88,74,137,211,57,30,79,156,150,327,0.4587155963302752,4,17,0.2352941176470588,146,310,0.4709677419354838,0.465,55,77,0.7142857142857143
Aaron McKie,mckieaa01,SG-SF,25,TOT,1998,81,1813.0,332,175,58,173,231,101,13,76,164,139,381,0.3648293963254593,12,63,0.1904761904761904,127,318,0.3993710691823899,0.381,42,55,0.7636363636363637
Nate McMillan,mcmilna01,SG,33,SEA,1998,18,279.0,62,55,13,27,40,14,4,12,41,23,67,0.3432835820895522,15,34,0.4411764705882353,8,33,0.2424242424242424,0.455,1,1,1.0
Ron Mercer,mercero01,SG,21,BOS,1998,80,2662.0,1221,176,109,171,280,125,17,132,213,515,1145,0.4497816593886463,3,28,0.1071428571428571,512,1117,0.4583706356311549,0.451,188,224,0.8392857142857143
Marko Milič,milicma01,SF,20,PHO,1998,33,163.0,92,12,10,15,25,10,0,21,17,39,64,0.609375,3,6,0.5,36,58,0.6206896551724138,0.633,11,17,0.6470588235294118
Anthony Miller,millean01,PF,26,ATL,1998,37,228.0,79,3,30,40,70,15,3,14,41,29,52,0.5576923076923077,0,0,0.0,29,52,0.5576923076923077,0.558,21,39,0.5384615384615384
Oliver Miller,milleol01,C,27,TOR,1998,64,1628.0,401,196,146,254,400,58,72,131,184,170,369,0.4607046070460704,0,4,0.0,170,365,0.4657534246575342,0.461,61,101,0.6039603960396039
Reggie Miller,millere01,SG,32,IND,1998,81,2795.0,1578,171,46,186,232,78,11,128,148,516,1081,0.4773358001850138,164,382,0.4293193717277487,352,699,0.5035765379113019,0.553,382,440,0.8681818181818182
Chris Mills,millsch01,SF,28,NYK,1998,80,2183.0,776,133,120,288,408,45,30,107,218,292,675,0.4325925925925926,40,137,0.291970802919708,252,538,0.4684014869888476,0.462,152,189,0.8042328042328042
Terry Mills,millste01,PF,30,MIA,1998,50,782.0,212,39,34,118,152,19,9,45,129,81,206,0.3932038834951456,25,81,0.3086419753086419,56,125,0.448,0.454,25,33,0.7575757575757576
Greg Minor,minorgr01,SG,26,BOS,1998,69,1126.0,345,88,55,95,150,53,11,43,100,140,321,0.4361370716510903,6,31,0.1935483870967742,134,290,0.4620689655172413,0.445,59,86,0.686046511627907
Sam Mitchell,mitchsa01,SF,34,MIN,1998,81,2239.0,1000,107,118,267,385,64,22,66,200,371,800,0.46375,15,43,0.3488372093023256,356,757,0.4702774108322325,0.473,243,292,0.8321917808219178
Eric Montross,montrer01,C,26,TOT,1998,48,691.0,138,11,69,130,199,13,27,29,127,61,144,0.4236111111111111,0,0,0.0,61,144,0.4236111111111111,0.424,16,40,0.4
Chris Morris,morrich01,SF,32,UTA,1998,54,538.0,233,24,35,79,114,25,17,33,61,85,207,0.4106280193236715,19,62,0.3064516129032258,66,145,0.4551724137931034,0.457,44,61,0.7213114754098361
Lawrence Moten,motenla01,SG,25,WAS,1998,8,27.0,9,3,1,0,1,0,0,1,6,3,13,0.2307692307692307,0,1,0.0,3,12,0.25,0.231,3,4,0.75
Alonzo Mourning,mournal01,C,27,MIA,1998,58,1939.0,1115,52,193,365,558,40,130,179,208,403,732,0.5505464480874317,0,0,0.0,403,732,0.5505464480874317,0.551,309,465,0.6645161290322581
Chris Mullin,mullich01,SF,34,IND,1998,82,2177.0,927,186,38,211,249,95,39,117,186,333,692,0.4812138728323699,107,243,0.4403292181069959,226,449,0.5033407572383074,0.559,154,164,0.9390243902439024
Eric Murdock,murdoer01,PG,29,MIA,1998,82,1395.0,507,219,39,117,156,103,13,104,173,177,419,0.4224343675417661,28,91,0.3076923076923077,149,328,0.4542682926829268,0.456,125,156,0.8012820512820513
Lamond Murray,murrala01,SF,24,LAC,1998,79,2579.0,1220,142,172,312,484,118,54,171,193,473,984,0.4806910569105691,54,153,0.3529411764705882,419,831,0.5042117930204573,0.508,220,294,0.7482993197278912
Tracy Murray,murratr01,SF,26,WAS,1998,82,2227.0,1238,84,75,202,277,67,25,102,167,449,1007,0.4458788480635551,158,403,0.3920595533498759,291,604,0.4817880794701987,0.524,182,209,0.8708133971291866
Dikembe Mutombo,mutomdi01,C,31,ATL,1998,82,2917.0,1101,82,276,656,932,34,277,168,254,399,743,0.5370121130551817,0,0,0.0,399,743,0.5370121130551817,0.537,303,452,0.6703539823008849
Martin Müürsepp,muursma01,PF,23,DAL,1998,41,603.0,233,30,46,68,114,29,14,29,96,83,191,0.4345549738219895,16,38,0.4210526315789473,67,153,0.4379084967320261,0.476,51,67,0.7611940298507462
Pete Myers,myerspe01,SG,34,NYK,1998,9,40.0,14,3,5,5,10,4,0,4,7,5,10,0.5,0,0,0.0,5,10,0.5,0.5,4,6,0.6666666666666666
Steve Nash,nashst01,PG,23,PHO,1998,76,1664.0,691,262,32,128,160,63,4,98,145,268,584,0.4589041095890411,81,195,0.4153846153846154,187,389,0.480719794344473,0.528,74,86,0.8604651162790697
Ivano Newbill,newbiiv01,PF,27,VAN,1998,28,249.0,58,9,24,45,69,10,3,17,38,20,57,0.3508771929824561,1,1,1.0,19,56,0.3392857142857143,0.36,17,30,0.5666666666666667
Johnny Newman,newmajo01,SF,34,DEN,1998,74,2176.0,1089,138,50,91,141,77,24,147,208,344,799,0.4305381727158949,36,105,0.3428571428571428,308,694,0.4438040345821326,0.453,365,445,0.8202247191011236
Jeff Nordgaard,nordgje01,PF,24,MIL,1998,13,48.0,18,3,4,10,14,2,0,3,7,5,18,0.2777777777777778,0,0,0.0,5,18,0.2777777777777778,0.278,8,9,0.8888888888888888
Charles O'Bannon,obannch01,SG,22,DET,1998,30,234.0,64,17,14,19,33,9,1,9,15,26,69,0.3768115942028985,0,3,0.0,26,66,0.3939393939393939,0.377,12,15,0.8
Jermaine O'Neal,onealje01,PF,19,POR,1998,60,808.0,269,17,80,121,201,15,58,55,101,112,231,0.4848484848484848,0,2,0.0,112,229,0.4890829694323144,0.485,45,89,0.5056179775280899
Shaquille O'Neal,onealsh01,C,25,LAL,1998,60,2175.0,1699,142,208,473,681,39,144,175,193,670,1147,0.5841325196163906,0,0,0.0,670,1147,0.5841325196163906,0.584,359,681,0.527165932452276
Charles Oakley,oaklech01,PF,34,NYK,1998,79,2734.0,711,201,218,506,724,123,22,126,280,307,698,0.4398280802292263,0,6,0.0,307,692,0.4436416184971098,0.44,97,114,0.8508771929824561
Hakeem Olajuwon,olajuha01,C,35,HOU,1998,47,1633.0,772,143,116,344,460,84,96,126,152,306,633,0.4834123222748815,0,3,0.0,306,630,0.4857142857142857,0.483,160,212,0.7547169811320755
Brian Oliver,olivebr01,SG,29,ATL,1998,5,61.0,15,2,3,6,9,1,0,1,4,7,19,0.3684210526315789,0,0,0.0,7,19,0.3684210526315789,0.368,1,4,0.25
Jimmy Oliver,oliveji01,SG,28,WAS,1998,1,10.0,5,1,0,2,2,0,0,0,1,2,4,0.5,1,2,0.5,1,2,0.5,0.625,0,0,0.0
Kevin Ollie,ollieke01,PG,25,TOT,1998,35,430.0,123,65,9,30,39,13,0,44,31,37,98,0.3775510204081632,0,1,0.0,37,97,0.3814432989690721,0.378,49,70,0.7
Greg Ostertag,ostergr01,C,24,UTA,1998,63,1288.0,297,25,134,240,374,28,132,74,166,115,239,0.4811715481171548,0,0,0.0,115,239,0.4811715481171548,0.481,67,140,0.4785714285714286
Bo Outlaw,outlabo01,PF,26,ORL,1998,82,2953.0,783,216,255,382,637,107,181,175,260,301,543,0.5543278084714549,1,4,0.25,300,539,0.5565862708719852,0.555,180,313,0.5750798722044729
Doug Overton,overtdo01,PG,28,PHI,1998,23,277.0,62,37,2,12,14,8,1,23,34,24,63,0.3809523809523809,0,3,0.0,24,60,0.4,0.381,14,16,0.875
Billy Owens,owensbi01,SF,28,SAC,1998,78,2348.0,818,219,170,412,582,93,38,153,231,338,728,0.4642857142857143,26,70,0.3714285714285714,312,658,0.4741641337386018,0.482,116,197,0.5888324873096447
Robert Pack,packro01,PG,28,DAL,1998,12,292.0,94,42,8,26,34,20,1,38,17,33,98,0.336734693877551,3,6,0.5,30,92,0.3260869565217391,0.352,25,36,0.6944444444444444
Anthony Parker,parkean01,SG,22,PHI,1998,37,196.0,72,19,8,18,26,11,3,11,17,25,63,0.3968253968253968,9,28,0.3214285714285714,16,35,0.4571428571428571,0.468,13,20,0.65
Cherokee Parks,parksch02,C,25,MIN,1998,79,1703.0,558,53,140,297,437,36,86,66,237,224,449,0.4988864142538975,0,1,0.0,224,448,0.5,0.499,110,169,0.650887573964497
Gary Payton,paytoga01,PG,29,SEA,1998,82,3145.0,1571,679,77,299,376,185,18,229,195,579,1278,0.4530516431924882,134,397,0.3375314861460957,445,881,0.5051078320090806,0.505,279,375,0.744
Anthony Peeler,peelean01,SG,28,TOT,1998,38,1193.0,469,137,37,86,123,61,6,51,97,190,420,0.4523809523809524,53,125,0.424,137,295,0.4644067796610169,0.515,36,47,0.7659574468085106
Will Perdue,perduwi01,C,32,SAS,1998,79,1491.0,394,57,177,358,535,22,50,81,137,162,295,0.5491525423728814,0,1,0.0,162,294,0.5510204081632653,0.549,70,133,0.5263157894736842
Sam Perkins,perkisa01,PF,36,SEA,1998,81,1675.0,580,113,53,202,255,62,29,62,158,196,471,0.416135881104034,87,222,0.3918918918918919,109,249,0.4377510040160642,0.508,101,128,0.7890625
Elliot Perry,perryel01,PG,28,MIL,1998,81,1752.0,591,230,21,87,108,90,2,128,129,241,561,0.4295900178253119,17,50,0.34,224,511,0.4383561643835616,0.445,92,109,0.8440366972477065
Chuck Person,persoch01,PF,33,SAS,1998,61,1455.0,409,86,17,187,204,29,10,67,121,143,398,0.3592964824120603,95,276,0.3442028985507246,48,122,0.3934426229508196,0.479,28,37,0.7567567567567568
Wesley Person,persowe01,SG,26,CLE,1998,82,3198.0,1204,188,65,298,363,129,49,110,108,440,957,0.4597701149425287,192,447,0.4295302013422818,248,510,0.4862745098039215,0.56,132,170,0.7764705882352941
Bobby Phills,phillbo01,SG,28,CHH,1998,62,1887.0,642,187,59,157,216,81,18,108,181,246,552,0.4456521739130434,44,114,0.3859649122807017,202,438,0.4611872146118721,0.486,106,140,0.7571428571428571
Eric Piatkowski,piatker01,SG,27,LAC,1998,67,1740.0,760,85,70,166,236,51,12,80,137,257,568,0.4524647887323944,106,259,0.4092664092664093,151,309,0.4886731391585761,0.546,140,170,0.8235294117647058
Ricky Pierce,piercri01,SG,38,MIL,1998,39,442.0,151,34,19,26,45,9,0,21,35,52,143,0.3636363636363636,4,13,0.3076923076923077,48,130,0.3692307692307692,0.378,43,52,0.8269230769230769
Scottie Pippen,pippesc01,SF,32,CHI,1998,44,1652.0,841,254,53,174,227,79,43,109,116,315,704,0.4474431818181818,61,192,0.3177083333333333,254,512,0.49609375,0.491,150,193,0.7772020725388601
Scot Pollard,pollasc01,C,22,DET,1998,33,317.0,89,9,34,40,74,8,10,12,48,35,70,0.5,0,0,0.0,35,70,0.5,0.5,19,23,0.8260869565217391
Olden Polynice,polynol01,C,33,SAC,1998,70,1458.0,550,107,173,266,439,37,45,98,158,249,542,0.4594095940959409,0,1,0.0,249,541,0.4602587800369686,0.459,52,115,0.4521739130434782
Mark Pope,popema01,SF,25,IND,1998,28,193.0,39,7,9,17,26,3,6,10,36,14,41,0.3414634146341463,1,3,0.3333333333333333,13,38,0.3421052631578947,0.354,10,17,0.5882352941176471
Terry Porter,portete01,PG,34,MIN,1998,82,1786.0,777,271,37,131,168,63,16,104,103,259,577,0.4488734835355286,92,233,0.3948497854077253,167,344,0.4854651162790697,0.529,167,195,0.8564102564102564
Vitaly Potapenko,potapvi01,C,22,CLE,1998,80,1412.0,570,57,110,203,313,27,28,132,198,234,488,0.4795081967213114,0,1,0.0,234,487,0.4804928131416838,0.48,102,144,0.7083333333333334
Brent Price,pricebr01,PG,29,HOU,1998,72,1332.0,406,192,37,70,107,52,4,111,163,128,310,0.4129032258064516,73,187,0.3903743315508021,55,123,0.4471544715447154,0.531,77,98,0.7857142857142857
Mark Price,pricema01,PG,33,ORL,1998,63,1430.0,597,297,24,105,129,53,5,162,92,229,531,0.4312617702448211,52,155,0.3354838709677419,177,376,0.4707446808510638,0.48,87,103,0.8446601941747572
Theo Ratliff,ratlith01,C,24,TOT,1998,82,2447.0,809,57,221,326,547,50,258,116,292,306,597,0.5125628140703518,0,0,0.0,306,597,0.5125628140703518,0.513,197,281,0.701067615658363
Eldridge Recasner,recasel01,SG,30,ATL,1998,59,1454.0,548,117,32,110,142,41,1,91,94,206,452,0.4557522123893805,62,148,0.4189189189189189,144,304,0.4736842105263157,0.524,74,79,0.9367088607594936
Bryant Reeves,reevebr01,C,24,VAN,1998,74,2527.0,1207,155,196,389,585,39,80,156,278,492,941,0.5228480340063762,0,4,0.0,492,937,0.5250800426894343,0.523,223,316,0.7056962025316456
Khalid Reeves,reevekh01,PG,25,DAL,1998,82,1950.0,717,230,54,131,185,80,10,130,195,248,593,0.418212478920742,56,152,0.3684210526315789,192,441,0.4353741496598639,0.465,165,213,0.7746478873239436
Don Reid,reiddo01,PF,24,DET,1998,68,994.0,238,26,77,98,175,25,55,28,183,94,176,0.5340909090909091,0,0,0.0,94,176,0.5340909090909091,0.534,50,71,0.704225352112676
J.R. Reid,reidjr01,PF,29,CHH,1998,79,1109.0,384,51,72,138,210,35,19,65,172,146,318,0.4591194968553459,3,8,0.375,143,310,0.4612903225806452,0.464,89,122,0.7295081967213115
Shawn Respert,respesh01,SG,25,TOT,1998,57,911.0,339,61,37,63,100,34,1,48,75,130,293,0.4436860068259385,31,93,0.3333333333333333,99,200,0.495,0.497,48,61,0.7868852459016393
Rodrick Rhodes,rhodero01,SF,24,HOU,1998,58,1070.0,337,110,28,42,70,62,10,97,125,112,305,0.3672131147540983,2,8,0.25,110,297,0.3703703703703703,0.37,111,180,0.6166666666666667
Glen Rice,ricegl01,SF,30,CHH,1998,82,3295.0,1826,182,89,264,353,77,22,182,200,634,1386,0.4574314574314574,130,300,0.4333333333333333,504,1086,0.4640883977900552,0.504,428,504,0.8492063492063492
Pooh Richardson,richapo01,PG,31,LAC,1998,69,1252.0,289,226,17,79,96,44,3,54,71,124,333,0.3723723723723723,11,57,0.1929824561403508,113,276,0.4094202898550724,0.389,30,43,0.6976744186046512
Mitch Richmond,richmmi01,SG,32,SAC,1998,70,2569.0,1623,279,50,179,229,88,15,181,154,543,1220,0.4450819672131147,130,334,0.3892215568862275,413,886,0.4661399548532731,0.498,407,471,0.8641188959660298
Isaiah Rider,rideris01,SG,26,POR,1998,74,2786.0,1458,231,99,247,346,55,19,187,188,551,1302,0.423195084485407,135,420,0.3214285714285714,416,882,0.4716553287981859,0.475,221,267,0.8277153558052435
Eric Riley,rileyer01,C,27,DAL,1998,39,544.0,139,22,43,90,133,15,46,37,80,56,135,0.4148148148148148,0,1,0.0,56,134,0.417910447761194,0.415,27,36,0.75
Stanley Roberts,roberst01,C,27,MIN,1998,74,1328.0,457,27,109,254,363,24,72,70,226,191,386,0.4948186528497409,0,0,0.0,191,386,0.4948186528497409,0.495,75,156,0.4807692307692308
Chris Robinson,robinch01,SG,23,TOT,1998,35,414.0,162,39,9,37,46,19,4,33,50,65,174,0.3735632183908046,24,66,0.3636363636363636,41,108,0.3796296296296296,0.443,8,16,0.5
Clifford Robinson,robincl02,SF,31,PHO,1998,80,2359.0,1133,170,152,258,410,92,90,140,249,429,895,0.4793296089385475,27,84,0.3214285714285714,402,811,0.4956843403205919,0.494,248,360,0.6888888888888889
David Robinson,robinda01,C,32,SAS,1998,73,2457.0,1574,199,239,536,775,64,192,202,204,544,1065,0.5107981220657277,1,4,0.25,543,1061,0.5117813383600377,0.511,485,660,0.7348484848484849
Glenn Robinson,robingl01,SF,25,MIL,1998,56,2294.0,1308,158,82,225,307,69,34,200,164,534,1136,0.4700704225352112,25,65,0.3846153846153846,509,1071,0.4752567693744164,0.481,215,266,0.8082706766917294
James Robinson,robinja02,PG,27,LAC,1998,70,1231.0,541,135,37,74,111,37,10,97,101,195,501,0.3892215568862275,74,225,0.3288888888888889,121,276,0.4384057971014493,0.463,77,107,0.719626168224299
Larry Robinson,robinla01,SF,30,VAN,1998,6,41.0,17,1,2,10,12,4,0,2,0,6,19,0.3157894736842105,3,6,0.5,3,13,0.2307692307692307,0.395,2,2,1.0
Dennis Rodman,rodmade01,PF,36,CHI,1998,80,2856.0,375,230,421,780,1201,47,18,147,238,155,360,0.4305555555555556,4,23,0.1739130434782608,151,337,0.4480712166172106,0.436,61,111,0.5495495495495496
Carlos Rogers,rogerca01,PF,26,TOT,1998,21,376.0,112,18,35,32,67,10,8,14,35,47,91,0.5164835164835165,0,2,0.0,47,89,0.5280898876404494,0.516,18,32,0.5625
Rodney Rogers,rogerro01,SF,26,LAC,1998,76,2499.0,1149,202,155,269,424,93,38,193,242,426,935,0.4556149732620321,72,212,0.3396226415094339,354,723,0.4896265560165975,0.494,225,328,0.6859756097560976
Roy Rogers,rogerro02,PF,24,TOT,1998,15,106.0,20,2,8,9,17,3,8,5,18,9,25,0.36,0,0,0.0,9,25,0.36,0.36,2,6,0.3333333333333333
Sean Rooks,rooksse01,C,28,LAL,1998,41,425.0,139,24,46,72,118,2,23,19,68,46,101,0.4554455445544554,0,0,0.0,46,101,0.4554455445544554,0.455,47,79,0.5949367088607594
Jalen Rose,roseja01,SF,25,IND,1998,82,1706.0,771,155,28,167,195,56,14,132,171,290,607,0.4777594728171334,25,73,0.3424657534246575,265,534,0.49625468164794,0.498,166,228,0.7280701754385965
Malik Rose,rosema01,PF,23,SAS,1998,53,429.0,158,19,40,50,90,21,7,44,79,59,136,0.4338235294117647,1,3,0.3333333333333333,58,133,0.4360902255639097,0.438,39,61,0.639344262295082
Donald Royal,royaldo01,SF,31,TOT,1998,31,323.0,79,17,18,23,41,7,1,10,35,25,69,0.3623188405797101,0,0,0.0,25,69,0.3623188405797101,0.362,29,33,0.8787878787878788
Clifford Rozier,roziecl01,C,25,MIN,1998,6,30.0,6,0,3,3,6,0,0,4,7,3,6,0.5,0,0,0.0,3,6,0.5,0.5,0,1,0.0
Bryon Russell,russebr01,SF,27,UTA,1998,82,2219.0,738,101,78,248,326,90,31,81,229,226,525,0.4304761904761904,73,214,0.3411214953271028,153,311,0.4919614147909968,0.5,213,278,0.7661870503597122
Arvydas Sabonis,sabonar01,C,33,POR,1998,73,2333.0,1167,218,149,580,729,65,80,190,267,407,826,0.4927360774818402,30,115,0.2608695652173913,377,711,0.530239099859353,0.511,323,405,0.7975308641975308
Kevin Salvadori,salvake01,C,27,SAC,1998,16,87.0,5,3,5,15,20,0,11,5,12,1,13,0.0769230769230769,0,0,0.0,1,13,0.0769230769230769,0.077,3,6,0.5
Danny Schayes,schayda01,C,38,ORL,1998,74,1272.0,406,44,97,145,242,34,33,61,182,155,371,0.4177897574123989,0,0,0.0,155,371,0.4177897574123989,0.418,96,119,0.8067226890756303
Detlef Schrempf,schrede01,SF,35,SEA,1998,78,2742.0,1232,341,135,419,554,60,19,168,205,437,898,0.4866369710467706,61,147,0.4149659863945578,376,751,0.5006657789613849,0.521,297,352,0.84375
Dennis Scott,scottde01,SF,29,TOT,1998,81,2290.0,888,153,47,200,247,53,39,104,152,329,828,0.3973429951690821,125,342,0.3654970760233918,204,486,0.419753086419753,0.473,105,130,0.8076923076923077
Shawnelle Scott,scottsh01,C,25,CLE,1998,41,188.0,44,8,20,39,59,6,8,10,45,16,36,0.4444444444444444,0,0,0.0,16,36,0.4444444444444444,0.444,12,18,0.6666666666666666
Shea Seals,sealssh01,SG,22,LAL,1998,4,9.0,4,0,3,1,4,1,0,0,1,1,8,0.125,0,3,0.0,1,5,0.2,0.125,2,4,0.5
Malik Sealy,sealyma01,SF,27,DET,1998,77,1641.0,591,100,48,171,219,65,20,79,156,216,505,0.4277227722772277,9,41,0.2195121951219512,207,464,0.4461206896551724,0.437,150,182,0.8241758241758241
Rony Seikaly,seikaro01,C,32,TOT,1998,56,1636.0,746,77,146,247,393,28,43,146,164,250,579,0.4317789291882556,0,2,0.0,250,577,0.4332755632582322,0.432,246,332,0.7409638554216867
God Shammgod,shammgo01,PG,21,WAS,1998,20,146.0,61,36,2,5,7,7,1,21,27,19,58,0.3275862068965517,0,2,0.0,19,56,0.3392857142857143,0.328,23,30,0.7666666666666667
Brian Shaw,shawbr01,PG,31,TOT,1998,59,1530.0,372,261,37,178,215,49,17,99,148,154,446,0.3452914798206278,28,95,0.2947368421052631,126,351,0.358974358974359,0.377,36,52,0.6923076923076923
Dickey Simpkins,simpkdi01,PF,25,TOT,1998,40,433.0,132,33,27,50,77,9,5,32,54,48,89,0.5393258426966292,0,2,0.0,48,87,0.5517241379310345,0.539,36,70,0.5142857142857142
Reggie Slater,slatere01,PF,27,TOR,1998,78,1662.0,625,74,134,171,305,45,30,102,201,211,459,0.4596949891067538,0,0,0.0,211,459,0.4596949891067538,0.46,203,322,0.6304347826086957
Charles Smith,smithch04,SG,22,TOT,1998,34,292.0,119,21,13,14,27,12,6,27,24,49,125,0.392,15,47,0.3191489361702128,34,78,0.4358974358974359,0.452,6,11,0.5454545454545454
Joe Smith,smithjo02,PF,22,TOT,1998,79,2344.0,1155,94,199,272,471,62,51,158,263,464,1070,0.4336448598130841,0,8,0.0,464,1062,0.4369114877589454,0.434,227,293,0.7747440273037542
Michael Smith,smithmi02,PF,25,TOT,1998,48,1053.0,251,88,120,186,306,41,15,51,95,93,194,0.4793814432989691,0,1,0.0,93,193,0.4818652849740932,0.479,65,103,0.6310679611650486
Steve Smith,smithst01,SG,28,ATL,1998,73,2857.0,1464,292,133,176,309,75,29,176,219,489,1101,0.444141689373297,97,276,0.3514492753623188,392,825,0.4751515151515151,0.488,389,455,0.8549450549450549
Tony Smith,smithto02,PG,29,MIL,1998,7,80.0,19,10,4,3,7,5,2,9,7,8,24,0.3333333333333333,0,4,0.0,8,20,0.4,0.333,3,4,0.75
Rik Smits,smitsri01,C,31,IND,1998,73,2085.0,1216,101,127,378,505,40,88,134,243,514,1038,0.4951830443159923,0,3,0.0,514,1035,0.4966183574879227,0.495,188,240,0.7833333333333333
Eric Snow,snower01,PG,24,TOT,1998,64,918.0,209,177,19,62,81,60,5,63,114,79,184,0.4293478260869565,2,17,0.1176470588235294,77,167,0.4610778443113772,0.435,49,71,0.6901408450704225
Felton Spencer,spencfe01,C,30,GSW,1998,68,813.0,162,17,93,133,226,23,37,49,175,59,129,0.4573643410852713,0,0,0.0,59,129,0.4573643410852713,0.457,44,79,0.5569620253164557
Latrell Sprewell,sprewla01,SG,27,GSW,1998,14,547.0,299,68,7,44,51,19,5,44,26,110,277,0.3971119133574007,9,48,0.1875,101,229,0.4410480349344978,0.413,70,94,0.7446808510638298
Jerry Stackhouse,stackje01,SG-SF,23,TOT,1998,79,2545.0,1249,241,105,161,266,89,59,224,175,424,975,0.4348717948717949,47,195,0.241025641025641,377,780,0.4833333333333333,0.459,354,450,0.7866666666666666
John Starks,starkjo01,SG,32,NYK,1998,82,2188.0,1059,219,48,182,230,78,5,143,205,372,947,0.3928194297782471,130,398,0.3266331658291457,242,549,0.4408014571948998,0.461,185,235,0.7872340425531915
Joe Stephens,stephjo01,SF,25,HOU,1998,7,37.0,27,1,3,3,6,2,0,2,2,10,28,0.3571428571428571,3,10,0.3,7,18,0.3888888888888889,0.411,4,6,0.6666666666666666
Kebu Stewart,stewake01,PF,24,PHI,1998,15,110.0,40,2,9,22,31,5,2,8,13,12,26,0.4615384615384615,0,0,0.0,12,26,0.4615384615384615,0.462,16,25,0.64
Michael Stewart,stewami01,C,22,SAC,1998,81,1761.0,375,61,197,339,536,29,195,85,251,155,323,0.479876160990712,0,0,0.0,155,323,0.479876160990712,0.48,65,142,0.4577464788732394
Bryant Stith,stithbr01,SG,27,DEN,1998,31,718.0,235,50,15,50,65,21,8,35,52,75,225,0.3333333333333333,10,48,0.2083333333333333,65,177,0.3672316384180791,0.356,75,86,0.872093023255814
John Stockton,stockjo01,PG,35,UTA,1998,64,1858.0,770,543,35,131,166,89,10,161,138,270,511,0.5283757338551859,39,91,0.4285714285714285,231,420,0.55,0.567,191,231,0.8268398268398268
Ed Stokes,stokeed01,C,26,TOR,1998,4,17.0,3,1,1,3,4,1,2,2,4,1,3,0.3333333333333333,0,0,0.0,1,3,0.3333333333333333,0.333,1,2,0.5
Damon Stoudamire,stoudda01,PG,24,TOT,1998,71,2839.0,1225,580,87,211,298,113,7,223,150,448,1091,0.4106324472960587,91,304,0.2993421052631579,357,787,0.4536213468869123,0.452,238,287,0.8292682926829268
Erick Strickland,stricer01,SG,24,DAL,1998,67,1505.0,511,167,35,126,161,56,8,106,140,199,558,0.3566308243727598,48,163,0.294478527607362,151,395,0.3822784810126582,0.4,65,84,0.7738095238095238
Mark Strickland,stricma01,PF,27,MIA,1998,51,847.0,349,26,80,133,213,18,34,47,87,145,269,0.5390334572490706,0,1,0.0,145,268,0.5410447761194029,0.539,59,82,0.7195121951219512
Rod Strickland,stricro02,PG,31,WAS,1998,76,3020.0,1349,801,112,293,405,126,25,266,182,490,1130,0.4336283185840708,12,48,0.25,478,1082,0.4417744916820702,0.439,357,492,0.725609756097561
Derek Strong,stronde01,PF,29,ORL,1998,58,1638.0,736,51,152,275,427,31,24,74,122,259,617,0.419773095623987,0,4,0.0,259,613,0.4225122349102773,0.42,218,279,0.7813620071684588
Bob Sura,surabo01,SG,24,CLE,1998,46,942.0,267,171,25,69,94,44,7,93,113,87,231,0.3766233766233766,19,60,0.3166666666666666,68,171,0.3976608187134502,0.418,74,131,0.5648854961832062
Žan Tabak,tabakza01,C,27,TOT,1998,57,984.0,307,48,84,128,212,20,38,61,163,142,304,0.4671052631578947,0,1,0.0,142,303,0.4686468646864686,0.467,23,61,0.3770491803278688
Johnny Taylor,taylojo01,SF,23,ORL,1998,12,108.0,38,1,4,9,13,3,2,8,22,13,37,0.3513513513513513,1,2,0.5,12,35,0.3428571428571428,0.365,11,16,0.6875
Maurice Taylor,tayloma01,PF,21,LAC,1998,71,1513.0,815,53,118,178,296,34,40,107,222,321,675,0.4755555555555555,0,1,0.0,321,674,0.4762611275964392,0.476,173,244,0.7090163934426229
Carl Thomas,thomaca01,SG,28,TOT,1998,43,426.0,148,19,10,37,47,21,7,18,39,56,140,0.4,20,59,0.3389830508474576,36,81,0.4444444444444444,0.471,16,25,0.64
John Thomas,thomajo02,PF,22,TOT,1998,54,535.0,151,17,48,58,106,22,12,46,97,55,113,0.4867256637168141,0,0,0.0,55,113,0.4867256637168141,0.487,41,54,0.7592592592592593
Kurt Thomas,thomaku01,PF,25,DAL,1998,5,73.0,37,3,8,16,24,1,0,10,19,17,45,0.3777777777777777,0,0,0.0,17,45,0.3777777777777777,0.378,3,3,1.0
Tim Thomas,thomati01,SF,20,PHI,1998,77,1779.0,845,90,107,181,288,54,17,118,185,306,684,0.4473684210526316,62,171,0.3625730994152046,244,513,0.4756335282651072,0.493,171,231,0.7402597402597403
Brooks Thompson,thompbr01,PG,27,TOT,1998,30,167.0,59,27,1,14,15,10,1,16,22,23,56,0.4107142857142857,9,30,0.3,14,26,0.5384615384615384,0.491,4,8,0.5
Otis Thorpe,thorpot01,PF,35,TOT,1998,74,2197.0,752,222,151,386,537,48,30,152,238,294,624,0.4711538461538461,0,5,0.0,294,619,0.4749596122778675,0.471,164,240,0.6833333333333333
Gary Trent,trentga01,PF,23,TOT,1998,54,1360.0,630,72,123,215,338,35,27,94,161,241,505,0.4772277227722772,4,12,0.3333333333333333,237,493,0.4807302231237322,0.481,144,212,0.6792452830188679
Nick Van Exel,vanexni01,PG,26,LAL,1998,64,2053.0,881,442,31,163,194,64,6,104,120,311,743,0.4185733512786003,123,316,0.3892405063291139,188,427,0.4402810304449648,0.501,136,172,0.7906976744186046
Keith Van Horn,vanhoke01,PF,22,NJN,1998,62,2325.0,1219,106,142,266,408,64,25,164,216,446,1047,0.4259789875835721,69,224,0.3080357142857143,377,823,0.4580801944106926,0.459,258,305,0.8459016393442623
David Vaughn,vaughda02,PF,24,TOT,1998,40,489.0,162,20,53,99,152,15,10,40,83,66,148,0.4459459459459459,0,1,0.0,66,147,0.4489795918367347,0.446,30,47,0.6382978723404256
Jacque Vaughn,vaughja01,PG,22,UTA,1998,45,419.0,139,84,4,34,38,9,1,56,63,44,122,0.360655737704918,3,8,0.375,41,114,0.3596491228070175,0.373,48,68,0.7058823529411765
Loy Vaught,vaughlo01,PF,29,LAC,1998,10,265.0,75,7,16,49,65,4,2,13,33,36,84,0.4285714285714285,0,2,0.0,36,82,0.4390243902439024,0.429,3,8,0.375
Stojko Vranković,vrankst01,C,34,LAC,1998,65,996.0,195,36,71,192,263,11,66,46,130,79,186,0.4247311827956989,0,0,0.0,79,186,0.4247311827956989,0.425,37,65,0.5692307692307692
Antoine Walker,walkean02,PF,21,BOS,1998,82,3268.0,1840,273,270,566,836,142,60,292,262,722,1705,0.4234604105571847,91,292,0.3116438356164384,631,1413,0.4465675866949752,0.45,305,473,0.6448202959830867
Samaki Walker,walkesa01,PF,21,DAL,1998,41,1027.0,365,24,96,206,302,30,40,61,127,156,321,0.4859813084112149,0,1,0.0,156,320,0.4875,0.486,53,97,0.5463917525773195
Ben Wallace,wallabe01,C,23,WAS,1998,67,1124.0,205,18,112,212,324,61,72,28,116,85,164,0.5182926829268293,0,0,0.0,85,164,0.5182926829268293,0.518,35,98,0.3571428571428571
John Wallace,wallajo01,SF,23,TOR,1998,82,2361.0,1147,110,117,256,373,62,101,172,239,468,979,0.4780388151174668,1,2,0.5,467,977,0.4779938587512794,0.479,210,293,0.7167235494880546
Rasheed Wallace,wallara01,PF,23,POR,1998,77,2896.0,1124,195,132,346,478,75,88,167,268,466,875,0.5325714285714286,8,39,0.2051282051282051,458,836,0.5478468899521531,0.537,184,278,0.6618705035971223
Rex Walters,waltere01,SG,27,TOT,1998,38,235.0,80,35,5,19,24,8,1,27,28,24,53,0.4528301886792453,6,22,0.2727272727272727,18,31,0.5806451612903226,0.509,26,28,0.9285714285714286
Charlie Ward,wardch01,PG,27,NYK,1998,82,2317.0,642,466,32,242,274,144,37,175,195,235,516,0.4554263565891472,81,215,0.3767441860465116,154,301,0.5116279069767442,0.534,91,113,0.8053097345132744
Eric Washington,washier01,SG,23,DEN,1998,66,1539.0,511,78,47,80,127,53,25,72,143,201,498,0.4036144578313253,44,137,0.3211678832116788,157,361,0.4349030470914127,0.448,65,83,0.7831325301204819
Clarence Weatherspoon,weathcl01,PF,27,TOT,1998,79,2325.0,736,89,198,396,594,85,74,119,194,268,608,0.4407894736842105,0,0,0.0,268,608,0.4407894736842105,0.441,200,277,0.7220216606498195
Spud Webb,webbsp01,PG,34,ORL,1998,4,34.0,12,5,2,1,3,1,0,7,6,5,12,0.4166666666666667,0,1,0.0,5,11,0.4545454545454545,0.417,2,2,1.0
Chris Webber,webbech01,C,24,WAS,1998,71,2809.0,1555,273,176,498,674,111,124,185,269,647,1341,0.482475764354959,65,205,0.3170731707317073,582,1136,0.5123239436619719,0.507,196,333,0.5885885885885885
Bubba Wells,wellsbu01,SG,23,DAL,1998,39,395.0,128,34,22,46,68,15,4,31,40,48,116,0.4137931034482758,1,6,0.1666666666666666,47,110,0.4272727272727272,0.418,31,43,0.7209302325581395
Bill Wennington,wennibi01,C,34,CHI,1998,48,467.0,167,19,32,48,80,4,5,16,77,75,172,0.436046511627907,0,0,0.0,75,172,0.436046511627907,0.436,17,21,0.8095238095238095
David Wesley,wesleda01,PG,27,CHH,1998,81,2845.0,1054,529,49,164,213,140,30,226,229,383,864,0.443287037037037,59,170,0.3470588235294117,324,694,0.4668587896253602,0.477,229,288,0.7951388888888888
Doug West,westdo01,SG,30,MIN,1998,38,688.0,157,45,23,59,82,11,5,21,97,64,171,0.3742690058479532,0,2,0.0,64,169,0.378698224852071,0.374,29,40,0.725
Mark West,westma01,C,37,IND,1998,15,105.0,23,2,6,9,15,2,4,8,15,10,21,0.4761904761904761,0,0,0.0,10,21,0.4761904761904761,0.476,3,6,0.5
DeJuan Wheat,wheatde01,PG,24,MIN,1998,34,150.0,57,25,3,8,11,6,1,9,12,20,50,0.4,8,17,0.4705882352941176,12,33,0.3636363636363636,0.48,9,15,0.6
Donald Whiteside,whitedo01,PG,28,ATL,1998,3,16.0,2,1,0,1,1,0,0,1,0,1,2,0.5,0,1,0.0,1,1,1.0,0.5,0,2,0.0
Chris Whitney,whitnch01,PG,26,WAS,1998,82,1073.0,422,196,16,99,115,34,6,65,106,126,355,0.3549295774647887,52,169,0.3076923076923077,74,186,0.3978494623655914,0.428,118,129,0.9147286821705426
Gerald Wilkins,wilkige01,SG,34,ORL,1998,72,1252.0,380,78,16,74,90,34,6,79,78,141,434,0.3248847926267281,29,109,0.2660550458715596,112,325,0.3446153846153846,0.358,69,98,0.7040816326530612
Aaron Williams,williaa01,PF,26,SEA,1998,65,757.0,296,14,48,99,147,19,38,50,119,115,220,0.5227272727272727,0,1,0.0,115,219,0.5251141552511416,0.523,66,85,0.7764705882352941
Alvin Williams,willial02,SG,23,TOT,1998,54,1071.0,324,103,24,57,81,38,3,58,79,125,282,0.4432624113475177,9,28,0.3214285714285714,116,254,0.4566929133858268,0.459,65,90,0.7222222222222222
Brandon Williams,willibr01,SG,22,GSW,1998,9,140.0,37,3,4,11,15,6,3,9,18,16,50,0.32,3,9,0.3333333333333333,13,41,0.3170731707317073,0.35,2,4,0.5
Buck Williams,willibu01,PF,37,NYK,1998,41,738.0,202,21,78,105,183,17,15,38,93,75,149,0.5033557046979866,0,0,0.0,75,149,0.5033557046979866,0.503,52,71,0.7323943661971831
Eric Williams,willier01,SF,25,DEN,1998,4,145.0,79,12,10,11,21,4,0,9,9,24,61,0.3934426229508196,0,0,0.0,24,61,0.3934426229508196,0.393,31,45,0.6888888888888889
Herb Williams,willihe01,PF,39,NYK,1998,27,178.0,37,4,6,23,29,6,9,5,34,18,43,0.4186046511627907,0,0,0.0,18,43,0.4186046511627907,0.419,1,8,0.125
Hot Rod Williams,williho01,C,35,PHO,1998,71,1333.0,255,49,107,205,312,33,60,29,138,95,202,0.4702970297029702,0,0,0.0,95,202,0.4702970297029702,0.47,65,93,0.6989247311827957
Jayson Williams,willija01,C,29,NJN,1998,65,2343.0,837,67,443,440,883,45,49,95,236,321,645,0.4976744186046511,0,4,0.0,321,641,0.500780031201248,0.498,195,293,0.6655290102389079
Jerome Williams,willije01,PF,24,DET,1998,77,1305.0,410,48,170,209,379,51,10,60,144,151,288,0.5243055555555556,0,1,0.0,151,287,0.5261324041811847,0.524,108,166,0.6506024096385542
Lorenzo Williams,willilo01,PF,28,WAS,1998,14,111.0,26,3,16,10,26,2,3,2,17,13,17,0.7647058823529411,0,0,0.0,13,17,0.7647058823529411,0.765,0,2,0.0
Micheal Williams,willimi02,PG,31,MIN,1998,25,161.0,64,32,2,12,14,9,2,16,24,16,48,0.3333333333333333,0,4,0.0,16,44,0.3636363636363636,0.333,32,33,0.9696969696969696
Monty Williams,willimo01,SF,26,SAS,1998,72,1314.0,453,89,67,112,179,34,24,82,133,165,368,0.4483695652173913,1,2,0.5,164,366,0.448087431693989,0.45,122,182,0.6703296703296703
Scott Williams,willisc01,C,29,PHI,1998,58,801.0,237,29,87,124,211,17,21,30,132,93,213,0.4366197183098591,0,5,0.0,93,208,0.4471153846153846,0.437,51,63,0.8095238095238095
Travis Williams,willitr01,SF,28,CHH,1998,39,365.0,136,20,53,39,92,18,5,30,55,56,119,0.4705882352941176,0,1,0.0,56,118,0.4745762711864407,0.471,24,46,0.5217391304347826
Walt Williams,williwa02,SF,27,TOT,1998,59,1470.0,608,122,50,150,200,59,35,92,161,210,544,0.3860294117647059,80,219,0.365296803652968,130,325,0.4,0.46,108,125,0.864
Corliss Williamson,willico02,SF,24,SAC,1998,79,2819.0,1401,230,162,284,446,76,48,199,252,561,1134,0.4947089947089947,0,9,0.0,561,1125,0.4986666666666666,0.495,279,443,0.6297968397291196
Kevin Willis,willike02,PF,35,HOU,1998,81,2528.0,1305,78,232,447,679,55,38,170,235,531,1041,0.5100864553314121,1,7,0.1428571428571428,530,1034,0.5125725338491296,0.511,242,305,0.7934426229508197
David Wingate,wingada01,SG,34,SEA,1998,58,546.0,150,37,19,60,79,21,3,37,58,66,140,0.4714285714285714,3,7,0.4285714285714285,63,133,0.4736842105263157,0.482,15,29,0.5172413793103449
Dontonio Wingfield,wingfdo01,SF,23,POR,1998,3,9.0,1,0,2,2,4,0,0,1,2,0,3,0.0,0,0,0.0,0,3,0.0,0.0,1,2,0.5
Joe Wolf,wolfjo01,PF,33,DEN,1998,57,621.0,87,30,36,90,126,20,7,22,92,40,121,0.3305785123966942,2,10,0.2,38,111,0.3423423423423423,0.339,5,10,0.5
Lorenzen Wright,wrighlo02,C,22,LAC,1998,69,2067.0,623,55,180,426,606,55,87,81,237,241,542,0.4446494464944649,0,2,0.0,241,540,0.4462962962962963,0.445,141,214,0.6588785046728972
Sharone Wright,wrighsh01,C,25,TOR,1998,7,44.0,16,4,1,8,9,0,0,2,7,7,14,0.5,0,0,0.0,7,14,0.5,0.5,2,4,0.5
George Zídek,zidekge01,C,24,TOT,1998,12,64.0,29,2,4,13,17,0,2,4,10,7,29,0.2413793103448276,1,2,0.5,6,27,0.2222222222222222,0.259,14,16,0.875
Tariq Abdul-Wahad,abdulta01,SG,24,SAC,1999,49,1205.0,454,50,72,114,186,50,16,70,121,177,407,0.4348894348894349,6,21,0.2857142857142857,171,386,0.4430051813471503,0.442,94,136,0.6911764705882353
Shareef Abdur-Rahim,abdursh01,SF,22,VAN,1999,50,2021.0,1152,172,114,260,374,69,55,186,137,386,893,0.4322508398656215,11,36,0.3055555555555556,375,857,0.4375729288214702,0.438,369,439,0.8405466970387244
Cory Alexander,alexaco01,PG,25,DEN,1999,36,778.0,261,119,7,67,74,35,5,69,77,97,260,0.3730769230769231,30,105,0.2857142857142857,67,155,0.432258064516129,0.431,37,44,0.8409090909090909
Ray Allen,allenra02,SG,23,MIL,1999,50,1719.0,856,178,57,155,212,53,7,122,117,303,673,0.450222882615156,74,208,0.3557692307692308,229,465,0.4924731182795699,0.505,176,195,0.9025641025641026
Peter Aluma,alumape01,C,25,SAC,1999,2,5.0,2,0,1,1,2,1,1,2,4,1,2,0.5,0,0,0.0,1,2,0.5,0.5,0,0,0.0
Derek Anderson,anderde01,SG,24,CLE,1999,38,978.0,409,145,20,89,109,48,4,82,73,125,314,0.3980891719745223,21,69,0.3043478260869565,104,245,0.4244897959183673,0.432,138,165,0.8363636363636363
Kenny Anderson,anderke01,PG,28,BOS,1999,34,1010.0,412,193,24,79,103,33,2,71,78,161,357,0.4509803921568627,6,24,0.25,155,333,0.4654654654654654,0.459,84,101,0.8316831683168316
Nick Anderson,anderni01,SF,31,ORL,1999,47,1581.0,701,91,51,226,277,64,15,83,72,253,640,0.3953125,96,277,0.3465703971119133,157,363,0.4325068870523416,0.47,99,162,0.6111111111111112
Shandon Anderson,andersh01,SG,25,UTA,1999,50,1072.0,427,56,49,83,132,39,10,66,89,162,363,0.4462809917355372,14,41,0.3414634146341463,148,322,0.4596273291925465,0.466,89,125,0.712
Chris Anstey,anstech01,C,24,DAL,1999,41,470.0,134,27,35,62,97,18,13,26,98,50,139,0.3597122302158273,0,7,0.0,50,132,0.3787878787878788,0.36,34,48,0.7083333333333334
Greg Anthony,anthogr01,PG,31,POR,1999,50,806.0,319,100,14,49,63,66,3,55,75,104,251,0.4143426294820717,49,125,0.392,55,126,0.4365079365079365,0.512,62,89,0.6966292134831461
B.J. Armstrong,armstbj01,PG,31,TOT,1999,32,358.0,105,61,2,37,39,12,0,25,31,40,88,0.4545454545454545,7,15,0.4666666666666667,33,73,0.4520547945205479,0.494,18,21,0.8571428571428571
Darrell Armstrong,armstda01,PG,30,ORL,1999,50,1502.0,690,335,53,127,180,108,4,158,90,230,522,0.4406130268199233,69,189,0.365079365079365,161,333,0.4834834834834834,0.507,161,178,0.904494382022472
Keith Askins,askinke01,SF,31,MIA,1999,33,415.0,53,10,10,34,44,17,3,13,58,20,62,0.3225806451612903,8,29,0.2758620689655172,12,33,0.3636363636363636,0.387,5,8,0.625
Stacey Augmon,augmost01,SF,30,POR,1999,48,874.0,208,58,47,78,125,57,18,30,81,78,174,0.4482758620689655,0,2,0.0,78,172,0.4534883720930232,0.448,52,76,0.6842105263157895
Isaac Austin,austiis01,C,29,ORL,1999,49,1259.0,477,89,83,154,237,47,35,114,125,185,453,0.4083885209713024,2,7,0.2857142857142857,183,446,0.4103139013452915,0.411,105,157,0.6687898089171974
Anthony Avent,aventan01,PF,29,UTA,1999,5,44.0,9,1,8,4,12,2,0,7,6,4,13,0.3076923076923077,0,0,0.0,4,13,0.3076923076923077,0.308,1,2,0.5
Thurl Bailey,baileth01,PF,37,UTA,1999,43,543.0,181,26,36,58,94,9,28,27,78,78,175,0.4457142857142857,0,2,0.0,78,173,0.4508670520231214,0.446,25,34,0.7352941176470589
Toby Bailey,baileto01,SG,23,PHO,1999,27,249.0,78,13,24,30,54,9,2,11,24,34,86,0.3953488372093023,1,5,0.2,33,81,0.4074074074074074,0.401,9,13,0.6923076923076923
Mark Baker,bakerla01,PG,29,TOR,1999,1,2.0,0,0,0,0,0,0,0,1,0,0,1,0.0,0,0,0.0,0,1,0.0,0.0,0,0,0.0
Vin Baker,bakervi01,PF,27,SEA,1999,34,1162.0,468,56,86,125,211,32,34,76,121,198,437,0.4530892448512585,0,3,0.0,198,434,0.456221198156682,0.453,72,160,0.45
Charles Barkley,barklch01,PF,35,HOU,1999,42,1526.0,676,192,167,349,516,43,13,100,89,240,502,0.4780876494023904,4,25,0.16,236,477,0.4947589098532495,0.482,192,267,0.7191011235955056
Dana Barros,barroda01,PG,31,BOS,1999,50,1156.0,464,208,16,89,105,52,5,88,64,168,371,0.4528301886792453,64,160,0.4,104,211,0.4928909952606635,0.539,64,73,0.8767123287671232
Brent Barry,barrybr01,SG,27,CHI,1999,37,1181.0,412,116,39,105,144,42,11,72,98,141,356,0.3960674157303371,52,172,0.3023255813953488,89,184,0.483695652173913,0.469,78,101,0.7722772277227723
Drew Barry,barrydr01,SG,25,SEA,1999,17,183.0,37,29,3,17,20,7,1,12,24,10,32,0.3125,8,24,0.3333333333333333,2,8,0.25,0.438,9,13,0.6923076923076923
Jon Barry,barryjo01,SG,29,SAC,1999,43,736.0,213,112,25,71,96,53,5,47,61,59,138,0.427536231884058,24,79,0.3037974683544304,35,59,0.5932203389830508,0.514,71,84,0.8452380952380952
Tony Battie,battito01,C,22,BOS,1999,50,1121.0,335,53,96,204,300,29,71,45,159,147,283,0.519434628975265,0,3,0.0,147,280,0.525,0.519,41,61,0.6721311475409836
Corey Beck,beckco01,PG,27,TOT,1999,24,180.0,45,20,6,22,28,9,2,13,26,18,39,0.4615384615384615,1,1,1.0,17,38,0.4473684210526316,0.474,8,15,0.5333333333333333
Benoit Benjamin,benjabe01,C,34,PHI,1999,6,33.0,4,1,3,5,8,0,0,3,6,2,7,0.2857142857142857,0,0,0.0,2,7,0.2857142857142857,0.286,0,0,0.0
Corey Benjamin,benjaco01,PG,20,CHI,1999,31,320.0,118,10,15,25,40,11,8,21,46,44,117,0.376068376068376,3,14,0.2142857142857142,41,103,0.3980582524271844,0.389,27,40,0.675
Mario Bennett,bennema01,PF,25,CHI,1999,3,19.0,7,0,2,3,5,1,0,1,4,2,6,0.3333333333333333,0,0,0.0,2,6,0.3333333333333333,0.333,3,4,0.75
Travis Best,besttr01,PG,26,IND,1999,49,1043.0,346,169,19,61,80,42,4,62,111,127,305,0.4163934426229508,22,59,0.3728813559322034,105,246,0.4268292682926829,0.452,70,83,0.8433734939759037
Mike Bibby,bibbymi01,PG,20,VAN,1999,50,1758.0,662,325,30,106,136,78,5,146,122,260,605,0.4297520661157025,15,74,0.2027027027027027,245,531,0.4613935969868173,0.442,127,169,0.7514792899408284
Chauncey Billups,billuch01,SG,22,DEN,1999,45,1488.0,624,173,24,72,96,58,14,98,115,191,495,0.3858585858585858,85,235,0.3617021276595745,106,260,0.4076923076923077,0.472,157,172,0.9127906976744186
Mookie Blaylock,blaylmo01,PG,31,ATL,1999,48,1763.0,640,278,45,179,224,99,9,115,61,247,651,0.3794162826420891,77,251,0.3067729083665338,170,400,0.425,0.439,69,91,0.7582417582417582
Corie Blount,blounco01,PF,30,TOT,1999,34,530.0,100,12,58,93,151,19,16,21,74,36,100,0.36,0,1,0.0,36,99,0.3636363636363636,0.36,28,54,0.5185185185185185
Muggsy Bogues,boguemu01,PG,34,GSW,1999,36,714.0,183,134,16,57,73,43,1,47,44,76,154,0.4935064935064935,0,6,0.0,76,148,0.5135135135135135,0.494,31,36,0.8611111111111112
Etdrick Bohannon,bohanet01,SF,25,WAS,1999,2,4.0,0,0,0,0,0,0,0,0,0,0,0,0.0,0,0,0.0,0,0,0.0,0.0,0,0,0.0
Keith Booth,boothke01,SF,24,CHI,1999,39,432.0,120,38,25,68,93,22,11,39,60,49,151,0.3245033112582781,1,10,0.1,48,141,0.3404255319148936,0.328,21,42,0.5
Bruce Bowen,bowenbr01,SF,27,BOS,1999,30,494.0,70,28,15,37,52,21,9,13,51,26,93,0.2795698924731182,7,26,0.2692307692307692,19,67,0.2835820895522388,0.317,11,24,0.4583333333333333
Earl Boykins,boykiea01,PG,22,TOT,1999,22,221.0,65,33,7,10,17,6,0,20,20,30,79,0.379746835443038,3,18,0.1666666666666666,27,61,0.4426229508196721,0.399,2,3,0.6666666666666666
Shawn Bradley,bradlsh01,C,26,DAL,1999,49,1294.0,420,40,130,262,392,35,159,56,153,167,348,0.4798850574712643,0,4,0.0,167,344,0.4854651162790697,0.48,86,115,0.7478260869565218
Terrell Brandon,brandte01,PG,28,TOT,1999,36,1217.0,501,309,27,107,134,63,10,74,82,212,507,0.4181459566074951,12,47,0.2553191489361702,200,460,0.4347826086956521,0.43,65,78,0.8333333333333334
Chucky Brown,brownch01,PF,30,CHH,1999,48,1192.0,407,57,36,138,174,16,19,38,106,176,373,0.4718498659517426,15,40,0.375,161,333,0.4834834834834834,0.492,40,59,0.6779661016949152
Dee Brown,brownde01,PG,30,TOR,1999,49,1377.0,549,143,15,88,103,56,8,80,75,187,495,0.3777777777777777,135,349,0.3868194842406877,52,146,0.3561643835616438,0.514,40,55,0.7272727272727273
Gerald Brown,brownge02,SG,23,PHO,1999,33,236.0,80,31,5,17,22,5,1,22,21,33,89,0.3707865168539326,3,10,0.3,30,79,0.379746835443038,0.388,11,14,0.7857142857142857
P.J. Brown,brownpj01,PF,29,MIA,1999,50,1611.0,571,66,115,231,346,46,48,69,166,229,477,0.480083857442348,0,0,0.0,229,477,0.480083857442348,0.48,113,146,0.773972602739726
Randy Brown,brownra02,PG,30,CHI,1999,39,1139.0,342,149,27,105,132,68,8,80,93,132,319,0.4137931034482758,0,10,0.0,132,309,0.4271844660194174,0.414,78,103,0.7572815533980582
Rick Brunson,brunsri01,PG,26,NYK,1999,17,95.0,17,19,3,7,10,9,0,12,8,6,21,0.2857142857142857,0,5,0.0,6,16,0.375,0.286,5,18,0.2777777777777778
Kobe Bryant,bryanko01,SG,20,LAL,1999,50,1896.0,996,190,53,211,264,72,50,157,153,362,779,0.4646983311938382,27,101,0.2673267326732673,335,678,0.4941002949852507,0.482,245,292,0.839041095890411
Mark Bryant,bryanma01,PF,33,CHI,1999,45,1204.0,407,48,92,140,232,34,16,68,149,168,348,0.4827586206896552,0,1,0.0,168,347,0.484149855907781,0.483,71,110,0.6454545454545455
Jud Buechler,buechju01,SF,30,DET,1999,50,1056.0,274,57,29,104,133,37,13,21,83,100,240,0.4166666666666667,61,148,0.4121621621621621,39,92,0.4239130434782608,0.544,13,18,0.7222222222222222
Matt Bullard,bullama01,PF,31,HOU,1999,41,413.0,117,18,9,33,42,13,4,14,28,43,114,0.3771929824561403,24,62,0.3870967741935484,19,52,0.3653846153846153,0.482,7,10,0.7
Scott Burrell,burresc01,SF,28,NJN,1999,32,706.0,212,45,32,87,119,40,11,23,82,75,208,0.3605769230769231,28,72,0.3888888888888889,47,136,0.3455882352941176,0.428,34,42,0.8095238095238095
Willie Burton,burtowi01,SF,30,CHH,1999,3,18.0,4,0,4,2,6,0,0,1,2,1,7,0.1428571428571428,0,1,0.0,1,6,0.1666666666666666,0.143,2,4,0.5
Mitchell Butler,butlemi02,SG,28,CLE,1999,31,418.0,168,22,13,31,44,15,4,29,41,67,139,0.4820143884892086,11,29,0.3793103448275862,56,110,0.509090909090909,0.522,23,32,0.71875
Jason Caffey,caffeja01,PF,25,GSW,1999,35,876.0,308,18,79,126,205,24,9,75,113,123,277,0.4440433212996389,0,1,0.0,123,276,0.4456521739130434,0.444,62,98,0.6326530612244898
Marcus Camby,cambyma01,C,24,NYK,1999,46,945.0,329,12,102,151,253,29,74,39,131,136,261,0.5210727969348659,0,0,0.0,136,261,0.5210727969348659,0.521,57,103,0.5533980582524272
Elden Campbell,campbel01,C,30,TOT,1999,49,1459.0,616,69,126,271,397,39,73,80,159,222,465,0.4774193548387097,0,1,0.0,222,464,0.4784482758620689,0.477,172,269,0.6394052044609665
Antoine Carr,carran01,PF,37,HOU,1999,18,152.0,47,9,9,22,31,1,10,9,31,21,52,0.4038461538461538,0,1,0.0,21,51,0.4117647058823529,0.404,5,7,0.7142857142857143
Chris Carr,carrch01,SG,24,TOT,1999,39,445.0,207,23,23,48,71,8,2,28,45,76,205,0.3707317073170731,28,75,0.3733333333333333,48,130,0.3692307692307692,0.439,27,40,0.675
Cory Carr,carrco01,SG,23,CHI,1999,42,624.0,171,66,8,41,49,21,7,46,66,71,216,0.3287037037037037,5,30,0.1666666666666666,66,186,0.3548387096774194,0.34,24,32,0.75
Vince Carter,cartevi01,SF,22,TOR,1999,50,1760.0,913,149,94,189,283,55,77,110,140,345,766,0.4503916449086161,19,66,0.2878787878787879,326,700,0.4657142857142857,0.463,204,268,0.7611940298507462
Sam Cassell,cassesa01,PG,29,TOT,1999,8,199.0,127,36,5,10,15,9,0,20,22,39,93,0.4193548387096774,2,10,0.2,37,83,0.4457831325301205,0.43,47,50,0.94
Kelvin Cato,catoke01,C,24,POR,1999,43,545.0,151,19,49,101,150,23,56,27,100,58,129,0.4496124031007752,1,1,1.0,57,128,0.4453125,0.453,34,67,0.5074626865671642
Duane Causwell,causwdu01,C,30,MIA,1999,19,137.0,44,2,14,21,35,0,11,18,32,20,35,0.5714285714285714,0,0,0.0,20,35,0.5714285714285714,0.571,4,12,0.3333333333333333
Cedric Ceballos,cebalce01,SF,29,DAL,1999,13,352.0,163,12,23,62,85,7,5,28,23,59,140,0.4214285714285714,11,28,0.3928571428571428,48,112,0.4285714285714285,0.461,34,49,0.6938775510204082
Rex Chapman,chapmre01,SG,31,PHO,1999,38,1183.0,459,109,12,92,104,34,9,54,46,165,459,0.3594771241830065,53,151,0.3509933774834437,112,308,0.3636363636363636,0.417,76,91,0.8351648351648352
Calbert Cheaney,cheanca01,SG,27,WAS,1999,50,1266.0,385,73,33,108,141,39,16,42,146,172,415,0.4144578313253012,8,37,0.2162162162162162,164,378,0.4338624338624338,0.424,33,67,0.4925373134328358
Pete Chilcutt,chilcpe01,PF,30,VAN,1999,46,697.0,166,30,29,88,117,22,12,28,52,63,172,0.3662790697674418,26,68,0.3823529411764705,37,104,0.3557692307692308,0.442,14,17,0.8235294117647058
Chris Childs,childch01,PG,31,NYK,1999,48,1297.0,328,193,18,115,133,44,1,85,156,114,267,0.4269662921348314,36,94,0.3829787234042553,78,173,0.4508670520231214,0.494,64,78,0.8205128205128205
Doug Christie,chrisdo01,SG,28,TOR,1999,50,1768.0,760,187,59,148,207,113,26,119,111,252,650,0.3876923076923076,49,161,0.3043478260869565,203,489,0.4151329243353783,0.425,207,246,0.8414634146341463
Keon Clark,clarkke01,C,23,DEN,1999,28,409.0,93,10,36,60,96,10,31,21,52,36,80,0.45,0,1,0.0,36,79,0.4556962025316455,0.45,21,37,0.5675675675675675
Keith Closs,closske01,C,22,LAC,1999,15,87.0,32,0,5,20,25,3,9,6,14,12,23,0.5217391304347826,0,1,0.0,12,22,0.5454545454545454,0.522,8,10,0.8
John Coker,cokerjo01,C,27,WAS,1999,14,98.0,31,0,7,15,22,1,2,2,17,13,31,0.4193548387096774,0,0,0.0,13,31,0.4193548387096774,0.419,5,6,0.8333333333333334
Derrick Coleman,colemde01,PF,31,CHH,1999,37,1178.0,486,78,76,252,328,24,42,90,96,168,406,0.4137931034482758,7,33,0.2121212121212121,161,373,0.4316353887399464,0.422,143,190,0.7526315789473684
Bimbo Coles,colesbi01,PG,30,GSW,1999,48,1272.0,455,222,21,96,117,45,11,82,113,183,414,0.4420289855072464,6,25,0.24,177,389,0.455012853470437,0.449,83,101,0.8217821782178217
Marty Conlon,conloma01,C,31,MIA,1999,7,35.0,8,1,1,4,5,0,1,3,6,3,13,0.2307692307692307,0,0,0.0,3,13,0.2307692307692307,0.231,2,2,1.0
Tyrone Corbin,corbity01,SF,36,ATL,1999,47,1066.0,352,43,37,108,145,31,7,43,74,131,335,0.3910447761194029,38,119,0.3193277310924369,93,216,0.4305555555555556,0.448,52,80,0.65
James Cotton,cottoja02,SG,23,SEA,1999,10,59.0,25,0,2,8,10,3,0,3,6,6,18,0.3333333333333333,0,3,0.0,6,15,0.4,0.333,13,18,0.7222222222222222
Chris Crawford,crawfch01,PF,23,ATL,1999,42,784.0,288,24,37,53,90,10,13,48,106,110,255,0.4313725490196078,11,33,0.3333333333333333,99,222,0.4459459459459459,0.453,57,70,0.8142857142857143
Austin Croshere,croshau01,PF,23,IND,1999,27,249.0,92,10,16,29,45,7,8,23,32,32,75,0.4266666666666667,8,29,0.2758620689655172,24,46,0.5217391304347826,0.48,20,23,0.8695652173913043
John Crotty,crottjo01,PG,29,TOT,1999,27,382.0,159,63,8,23,31,11,0,33,31,51,124,0.4112903225806452,14,36,0.3888888888888889,37,88,0.4204545454545454,0.468,43,50,0.86
Terry Cummings,cummite01,PF,37,GSW,1999,50,1011.0,454,58,95,160,255,46,10,58,168,186,424,0.4386792452830189,1,1,1.0,185,423,0.4373522458628842,0.44,81,114,0.7105263157894737
William Cunningham,cunniwi01,C,24,TOT,1999,16,162.0,6,1,13,15,28,1,11,5,30,3,18,0.1666666666666666,0,0,0.0,3,18,0.1666666666666666,0.167,0,2,0.0
Bill Curley,curlebi01,PF,26,MIN,1999,35,372.0,78,14,20,31,51,17,9,10,83,29,72,0.4027777777777778,1,5,0.2,28,67,0.417910447761194,0.41,19,22,0.8636363636363636
Dell Curry,curryde01,SG,34,MIL,1999,42,864.0,423,48,18,67,85,36,3,45,42,163,336,0.4851190476190476,69,145,0.4758620689655172,94,191,0.4921465968586387,0.588,28,34,0.8235294117647058
Michael Curry,currymi01,SF,30,MIL,1999,50,1146.0,244,78,19,89,108,42,7,37,135,90,206,0.4368932038834951,1,15,0.0666666666666666,89,191,0.4659685863874345,0.439,63,79,0.7974683544303798
Erick Dampier,dampier01,C,23,GSW,1999,50,1414.0,442,54,164,218,382,26,58,92,165,161,414,0.3888888888888889,0,0,0.0,161,414,0.3888888888888889,0.389,120,204,0.5882352941176471
Antonio Daniels,daniean01,PG,23,SAS,1999,47,614.0,220,106,13,41,54,30,6,44,39,83,183,0.453551912568306,5,17,0.2941176470588235,78,166,0.4698795180722891,0.467,49,65,0.7538461538461538
Kornél Dávid,davidko01,SF,27,CHI,1999,50,902.0,308,40,70,103,173,23,17,48,88,109,243,0.448559670781893,0,1,0.0,109,242,0.4504132231404958,0.449,90,111,0.8108108108108109
Antonio Davis,davisan01,PF,30,IND,1999,49,1271.0,463,33,116,228,344,22,42,50,136,164,348,0.4712643678160919,0,0,0.0,164,348,0.4712643678160919,0.471,135,192,0.703125
Ben Davis,davisbe01,PF,26,NYK,1999,8,21.0,17,3,9,2,11,0,0,1,4,7,17,0.4117647058823529,0,0,0.0,7,17,0.4117647058823529,0.412,3,6,0.5
Dale Davis,davisda01,PF,29,IND,1999,50,1374.0,398,22,155,261,416,20,57,43,115,161,302,0.5331125827814569,0,0,0.0,161,302,0.5331125827814569,0.533,76,123,0.6178861788617886
Hubert Davis,davishu01,SG,28,DAL,1999,50,1378.0,457,89,3,83,86,21,3,57,76,174,397,0.4382871536523929,65,144,0.4513888888888889,109,253,0.4308300395256917,0.52,44,50,0.88
Mark Davis,davisma02,SF,25,MIA,1999,4,35.0,9,1,2,5,7,1,0,7,12,2,6,0.3333333333333333,0,0,0.0,2,6,0.3333333333333333,0.333,5,6,0.8333333333333334
Ricky Davis,davisri01,SG,19,CHH,1999,46,557.0,209,58,40,44,84,30,7,54,46,81,200,0.405,2,12,0.1666666666666666,79,188,0.4202127659574468,0.41,45,59,0.7627118644067796
Terry Davis,daviste01,C,31,WAS,1999,37,578.0,126,10,50,89,139,11,3,16,79,49,92,0.532608695652174,0,0,0.0,49,92,0.532608695652174,0.533,28,38,0.7368421052631579
Andrew DeClercq,declean01,C,25,TOT,1999,47,1102.0,371,31,104,151,255,50,29,54,161,138,276,0.5,0,0,0.0,138,276,0.5,0.5,95,141,0.6737588652482269
Terry Dehere,deherte01,SG-PG,27,TOT,1999,26,291.0,83,27,7,17,24,7,3,16,30,31,85,0.3647058823529411,16,39,0.4102564102564102,15,46,0.3260869565217391,0.459,5,7,0.7142857142857143
Vinny Del Negro,delnevi01,PG,32,MIL,1999,48,1093.0,281,174,14,88,102,33,3,55,62,114,270,0.4222222222222222,13,30,0.4333333333333333,101,240,0.4208333333333333,0.446,40,50,0.8
Bison Dele,delebi01,C,29,DET,1999,49,1177.0,513,71,92,180,272,38,40,111,181,216,431,0.5011600928074246,0,1,0.0,216,430,0.5023255813953489,0.501,81,118,0.6864406779661016
Tony Delk,delkto01,PG,25,GSW,1999,36,630.0,246,95,11,43,54,16,6,45,47,92,253,0.3636363636363636,16,66,0.2424242424242424,76,187,0.4064171122994652,0.395,46,71,0.647887323943662
Michael Dickerson,dickemi01,SG,23,HOU,1999,50,1558.0,547,95,26,57,83,27,11,66,90,215,462,0.4653679653679654,71,164,0.4329268292682927,144,298,0.4832214765100671,0.542,46,72,0.6388888888888888
Vlade Divac,divacvl01,C,30,SAC,1999,50,1761.0,714,215,140,361,501,44,51,131,166,262,557,0.4703770197486535,11,43,0.2558139534883721,251,514,0.4883268482490272,0.48,179,255,0.7019607843137254
Michael Doleac,doleami01,C,21,ORL,1999,49,780.0,304,20,66,82,148,19,17,26,117,125,267,0.4681647940074906,0,0,0.0,125,267,0.4681647940074906,0.468,54,80,0.675
Sherman Douglas,douglsh01,PG,32,LAC,1999,30,842.0,247,124,16,42,58,27,3,61,54,96,219,0.4383561643835616,0,11,0.0,96,208,0.4615384615384615,0.438,55,87,0.632183908045977
Bryce Drew,drewbr01,PG,24,HOU,1999,34,441.0,118,52,3,29,32,12,4,31,61,47,129,0.3643410852713178,16,49,0.3265306122448979,31,80,0.3875,0.426,8,8,1.0
Chris Dudley,dudlech02,C,33,NYK,1999,46,685.0,115,7,79,114,193,13,38,24,116,48,109,0.4403669724770642,0,0,0.0,48,109,0.4403669724770642,0.44,19,40,0.475
Joe Dumars,dumarjo01,SG,35,DET,1999,38,1116.0,428,134,12,56,68,23,2,53,51,144,350,0.4114285714285714,89,221,0.4027149321266968,55,129,0.4263565891472868,0.539,51,61,0.8360655737704918
Tim Duncan,duncati01,PF,22,SAS,1999,50,1963.0,1084,121,159,412,571,45,126,146,147,418,845,0.4946745562130177,1,7,0.1428571428571428,417,838,0.4976133651551312,0.495,247,358,0.6899441340782123
Blue Edwards,edwarbl01,SF,33,MIA,1999,24,283.0,77,30,7,26,33,17,5,21,23,32,72,0.4444444444444444,4,10,0.4,28,62,0.4516129032258064,0.472,9,13,0.6923076923076923
Howard Eisley,eisleho01,PG,26,UTA,1999,50,1038.0,368,185,12,82,94,30,2,109,122,140,314,0.445859872611465,21,50,0.42,119,264,0.4507575757575757,0.479,67,80,0.8375
Mario Elie,eliema01,SG,35,SAS,1999,47,1291.0,455,89,36,101,137,46,12,61,91,156,331,0.4712990936555891,40,107,0.3738317757009345,116,224,0.5178571428571429,0.532,103,119,0.865546218487395
Sean Elliott,elliose01,SF,30,SAS,1999,50,1509.0,561,117,35,178,213,26,17,71,104,208,507,0.4102564102564102,39,119,0.3277310924369748,169,388,0.4355670103092783,0.449,106,140,0.7571428571428571
Dale Ellis,ellisda01,SF,38,SEA,1999,48,1232.0,495,38,25,90,115,25,3,45,77,174,395,0.440506329113924,94,217,0.4331797235023041,80,178,0.449438202247191,0.559,53,70,0.7571428571428571
LaPhonso Ellis,ellisla01,PF,28,ATL,1999,20,539.0,204,18,25,84,109,8,7,34,48,80,190,0.4210526315789473,1,5,0.2,79,185,0.427027027027027,0.424,43,61,0.7049180327868853
Brian Evans,evansbr01,SF,25,TOT,1999,16,145.0,34,15,6,13,19,5,3,2,8,13,44,0.2954545454545454,4,13,0.3076923076923077,9,31,0.2903225806451613,0.341,4,4,1.0
Patrick Ewing,ewingpa01,C,36,NYK,1999,38,1300.0,657,43,74,303,377,30,100,99,105,247,568,0.4348591549295774,0,2,0.0,247,566,0.4363957597173145,0.435,163,231,0.7056277056277056
Jamie Feick,feickja01,PF-C,24,TOT,1999,28,852.0,177,24,112,176,288,25,18,34,73,67,134,0.5,0,0,0.0,67,134,0.5,0.5,43,60,0.7166666666666667
Duane Ferrell,ferredu01,SF,33,GSW,1999,8,46.0,5,0,5,1,6,1,1,1,4,1,14,0.0714285714285714,0,0,0.0,1,14,0.0714285714285714,0.071,3,4,0.75
Danny Ferry,ferryda01,PF,32,CLE,1999,50,1058.0,349,53,16,86,102,23,10,39,113,141,296,0.4763513513513513,38,97,0.3917525773195876,103,199,0.5175879396984925,0.541,29,33,0.8787878787878788
Michael Finley,finlemi01,SF,25,DAL,1999,50,2051.0,1009,218,69,194,263,66,15,107,96,389,876,0.4440639269406393,45,136,0.3308823529411764,344,740,0.4648648648648649,0.47,186,226,0.8230088495575221
Derek Fisher,fishede01,PG,24,LAL,1999,50,1131.0,296,197,21,70,91,61,1,77,95,99,263,0.376425855513308,38,97,0.3917525773195876,61,166,0.3674698795180723,0.449,60,79,0.759493670886076
Danny Fortson,fortsda01,PF,22,DEN,1999,50,1417.0,550,32,210,371,581,31,22,77,212,191,386,0.4948186528497409,0,3,0.0,191,383,0.4986945169712793,0.495,168,231,0.7272727272727273
Greg Foster,fostegr01,PF,30,UTA,1999,42,458.0,118,25,28,55,83,6,8,24,63,52,138,0.3768115942028985,1,4,0.25,51,134,0.3805970149253731,0.38,13,21,0.6190476190476191
Rick Fox,foxri01,SF,29,LAL,1999,44,944.0,394,89,26,63,89,28,10,56,114,148,330,0.4484848484848485,32,95,0.3368421052631579,116,235,0.4936170212765957,0.497,66,89,0.7415730337078652
Adonal Foyle,foylead01,C,23,GSW,1999,44,614.0,129,18,79,115,194,15,43,31,90,52,121,0.4297520661157025,0,0,0.0,52,121,0.4297520661157025,0.43,25,51,0.4901960784313725
Todd Fuller,fulleto02,C,24,UTA,1999,42,462.0,142,6,28,73,101,6,14,27,60,56,124,0.4516129032258064,0,0,0.0,56,124,0.4516129032258064,0.452,30,50,0.6
Lawrence Funderburke,fundela01,PF,28,SAC,1999,47,936.0,420,30,101,121,222,22,23,52,77,167,299,0.5585284280936454,1,5,0.2,166,294,0.564625850340136,0.56,85,120,0.7083333333333334
Kevin Garnett,garneke01,PF,22,MIN,1999,47,1780.0,977,202,166,323,489,78,83,135,152,414,900,0.46,4,14,0.2857142857142857,410,886,0.4627539503386004,0.462,145,206,0.7038834951456311
Marlon Garnett,garnema01,PG,23,BOS,1999,24,205.0,51,18,3,18,21,5,1,12,18,15,51,0.2941176470588235,6,23,0.2608695652173913,9,28,0.3214285714285714,0.353,15,20,0.75
Dean Garrett,garrede01,C,32,MIN,1999,49,1054.0,270,28,99,158,257,30,45,29,113,116,231,0.5021645021645021,0,0,0.0,116,231,0.5021645021645021,0.502,38,51,0.7450980392156863
Pat Garrity,garripa01,PF,22,PHO,1999,39,538.0,217,18,26,49,75,8,3,20,62,85,170,0.5,7,18,0.3888888888888889,78,152,0.5131578947368421,0.521,40,56,0.7142857142857143
Chris Gatling,gatlich01,C,31,TOT,1999,48,775.0,272,32,52,127,179,32,10,62,118,117,265,0.4415094339622641,1,8,0.125,116,257,0.4513618677042801,0.443,37,93,0.3978494623655914
Andrew Gaze,gazean01,SG,33,SAS,1999,19,58.0,21,6,2,3,5,2,1,4,7,8,25,0.32,5,16,0.3125,3,9,0.3333333333333333,0.42,0,0,0.0
Matt Geiger,geigema01,C,29,PHI,1999,50,1540.0,674,58,137,225,362,39,40,101,157,266,555,0.4792792792792792,1,5,0.2,265,550,0.4818181818181818,0.48,141,177,0.7966101694915254
Kendall Gill,gillke01,SF,30,NJN,1999,50,1606.0,588,123,61,183,244,134,26,71,162,236,593,0.3979763912310287,2,17,0.1176470588235294,234,576,0.40625,0.4,114,167,0.6826347305389222
Armen Gilliam,gilliar01,PF,34,MIL,1999,34,668.0,281,19,33,93,126,22,12,36,48,101,223,0.452914798206278,0,1,0.0,101,222,0.4549549549549549,0.453,79,101,0.7821782178217822
Brian Grant,grantbr01,PF,26,POR,1999,48,1525.0,550,67,173,297,470,21,34,96,136,183,382,0.4790575916230366,0,0,0.0,183,382,0.4790575916230366,0.479,184,226,0.8141592920353983
Gary Grant,grantga01,PG,33,POR,1999,2,7.0,0,3,0,0,0,1,0,0,0,0,1,0.0,0,0,0.0,0,1,0.0,0.0,0,0,0.0
Harvey Grant,grantha01,PF,33,PHI,1999,47,798.0,146,23,36,74,110,20,16,21,73,62,168,0.369047619047619,1,6,0.1666666666666666,61,162,0.3765432098765432,0.372,21,29,0.7241379310344828
Horace Grant,grantho01,PF,33,ORL,1999,50,1660.0,443,90,117,234,351,46,60,44,99,198,456,0.4342105263157895,0,2,0.0,198,454,0.4361233480176211,0.434,47,70,0.6714285714285714
Paul Grant,grantpa01,C,25,TOT,1999,6,13.0,4,0,1,0,1,1,0,2,4,2,6,0.3333333333333333,0,0,0.0,2,6,0.3333333333333333,0.333,0,0,0.0
Ed Gray,grayed01,SG,23,ATL,1999,30,337.0,146,12,7,21,28,12,1,29,30,53,182,0.2912087912087912,12,42,0.2857142857142857,41,140,0.2928571428571428,0.324,28,37,0.7567567567567568
A.C. Green,greenac01,PF,35,DAL,1999,50,924.0,246,25,82,146,228,28,8,19,69,108,256,0.421875,0,8,0.0,108,248,0.4354838709677419,0.422,30,52,0.5769230769230769
Litterial Green,greenli01,PG,28,CLE,1999,1,2.0,0,0,0,0,0,0,0,0,0,0,1,0.0,0,0,0.0,0,1,0.0,0.0,0,0,0.0
Tom Gugliotta,guglito01,PF,29,PHO,1999,43,1563.0,729,121,131,250,381,59,21,88,110,277,573,0.4834205933682373,2,7,0.2857142857142857,275,566,0.4858657243816254,0.485,173,218,0.7935779816513762
Tom Hammonds,hammoto01,PF,31,MIN,1999,49,716.0,212,20,54,82,136,8,7,32,88,82,179,0.4581005586592179,0,0,0.0,82,179,0.4581005586592179,0.458,48,75,0.64
Anfernee Hardaway,hardaan01,SG,27,ORL,1999,50,1944.0,791,266,74,210,284,111,23,150,111,301,717,0.4198047419804742,40,140,0.2857142857142857,261,577,0.4523396880415944,0.448,149,211,0.7061611374407583
Tim Hardaway,hardati01,PG,32,MIA,1999,48,1772.0,835,352,15,137,152,57,6,131,102,301,752,0.4002659574468085,112,311,0.360128617363344,189,441,0.4285714285714285,0.475,121,149,0.8120805369127517
Derek Harper,harpede01,PG,37,LAL,1999,45,1120.0,309,187,13,54,67,44,4,52,66,120,291,0.4123711340206185,43,117,0.3675213675213675,77,174,0.4425287356321839,0.486,26,32,0.8125
Ron Harper,harpero01,SG,35,CHI,1999,35,1107.0,392,115,49,131,180,60,35,65,80,147,390,0.3769230769230769,27,85,0.3176470588235294,120,305,0.3934426229508196,0.412,71,101,0.7029702970297029
Matt Harpring,harprma01,SF,22,ORL,1999,50,1114.0,408,45,88,126,214,30,6,73,112,148,320,0.4625,10,25,0.4,138,295,0.4677966101694915,0.478,102,143,0.7132867132867133
Al Harrington,harrial01,PF,18,IND,1999,21,160.0,45,5,20,19,39,4,2,11,26,18,56,0.3214285714285714,0,5,0.0,18,51,0.3529411764705882,0.321,9,15,0.6
Othella Harrington,harriot01,PF,25,HOU,1999,41,903.0,400,15,72,174,246,6,25,61,103,156,304,0.5131578947368421,0,0,0.0,156,304,0.5131578947368421,0.513,88,122,0.7213114754098361
Lucious Harris,harrilu01,SG,28,NJN,1999,36,602.0,193,31,21,46,67,18,7,18,52,73,181,0.4033149171270718,11,50,0.22,62,131,0.4732824427480916,0.434,36,48,0.75
Hersey Hawkins,hawkihe01,SG,32,SEA,1999,50,1644.0,516,123,51,150,201,80,18,80,90,171,408,0.4191176470588235,55,180,0.3055555555555556,116,228,0.5087719298245614,0.487,119,132,0.9015151515151516
Michael Hawkins,hawkimi01,PG,26,SAC,1999,24,203.0,36,27,10,15,25,3,1,13,14,14,40,0.35,5,19,0.2631578947368421,9,21,0.4285714285714285,0.413,3,3,1.0
Alan Henderson,hendeal01,SF,26,ATL,1999,38,1142.0,474,28,100,150,250,33,19,58,96,187,423,0.442080378250591,0,1,0.0,187,422,0.4431279620853081,0.442,100,149,0.6711409395973155
Cedric Henderson,hendece02,SF,23,CLE,1999,50,1517.0,454,113,45,152,197,58,24,97,136,189,453,0.4172185430463576,2,12,0.1666666666666666,187,441,0.4240362811791383,0.419,74,91,0.8131868131868132
J.R. Henderson,hendejr01,SF,22,VAN,1999,30,331.0,97,22,20,27,47,9,4,18,29,35,96,0.3645833333333333,2,5,0.4,33,91,0.3626373626373626,0.375,25,45,0.5555555555555556
Mark Hendrickson,hendrma01,PF,24,NJN,1999,22,399.0,120,13,27,41,68,12,1,15,39,39,88,0.4431818181818182,0,1,0.0,39,87,0.4482758620689655,0.443,42,50,0.84
Steve Henson,hensost01,PG,30,DET,1999,4,25.0,4,3,0,0,0,1,0,3,1,1,2,0.5,0,0,0.0,1,2,0.5,0.5,2,2,1.0
Carl Herrera,herreca01,PF,32,TOT,1999,28,307.0,65,4,25,37,62,12,7,16,41,30,76,0.3947368421052631,0,1,0.0,30,75,0.4,0.395,5,11,0.4545454545454545
Grant Hill,hillgr01,SF,26,DET,1999,50,1852.0,1053,300,65,290,355,80,27,184,114,384,802,0.4788029925187032,0,14,0.0,384,788,0.4873096446700508,0.479,285,379,0.7519788918205804
Tyrone Hill,hillty01,PF,30,TOT,1999,38,1104.0,325,35,115,172,287,34,16,59,145,122,268,0.4552238805970149,0,0,0.0,122,268,0.4552238805970149,0.455,81,150,0.54
Fred Hoiberg,hoibefr01,SG,26,IND,1999,12,87.0,19,4,2,9,11,0,0,3,11,6,21,0.2857142857142857,1,9,0.1111111111111111,5,12,0.4166666666666667,0.31,6,6,1.0
Jerald Honeycutt,honeyje01,PF,24,TOT,1999,16,102.0,30,3,3,9,12,5,2,9,16,9,32,0.28125,5,17,0.2941176470588235,4,15,0.2666666666666666,0.359,7,10,0.7
Jeff Hornacek,hornaje01,SG,35,UTA,1999,48,1435.0,587,192,33,127,160,52,14,82,95,214,449,0.4766146993318486,34,81,0.419753086419753,180,368,0.4891304347826087,0.514,125,140,0.8928571428571429
Robert Horry,horryro01,PF,28,LAL,1999,38,744.0,188,56,56,96,152,36,39,49,103,67,146,0.4589041095890411,20,45,0.4444444444444444,47,101,0.4653465346534653,0.527,34,46,0.7391304347826086
Allan Houston,houstal01,SG,27,NYK,1999,50,1815.0,813,137,20,132,152,35,9,130,115,294,703,0.4182076813655761,57,140,0.4071428571428571,237,563,0.4209591474245115,0.459,168,195,0.8615384615384616
Juwan Howard,howarju01,SF,25,WAS,1999,36,1430.0,682,107,90,203,293,42,14,95,130,286,604,0.4735099337748344,0,3,0.0,286,601,0.475873544093178,0.474,110,146,0.7534246575342466
Troy Hudson,hudsotr01,PG,22,LAC,1999,25,524.0,169,92,15,40,55,11,2,38,28,60,150,0.4,15,47,0.3191489361702128,45,103,0.4368932038834951,0.45,34,38,0.8947368421052632
Larry Hughes,hughela01,PG,20,PHI,1999,50,988.0,455,77,83,106,189,44,14,68,97,170,414,0.4106280193236715,8,52,0.1538461538461538,162,362,0.4475138121546961,0.42,107,151,0.7086092715231788
Lindsey Hunter,hunteli01,PG,28,DET,1999,49,1755.0,582,193,26,142,168,86,8,92,126,228,524,0.4351145038167939,59,153,0.3856209150326797,169,371,0.4555256064690027,0.491,67,89,0.7528089887640449
Zydrunas Ilgauskas,ilgauzy01,C,23,CLE,1999,5,171.0,76,4,17,27,44,4,7,9,24,29,57,0.5087719298245614,0,0,0.0,29,57,0.5087719298245614,0.509,18,30,0.6
Allen Iverson,iversal01,SG,23,PHI,1999,48,1990.0,1284,223,66,170,236,110,7,167,98,435,1056,0.4119318181818182,58,199,0.2914572864321608,377,857,0.439906651108518,0.439,356,474,0.7510548523206751
Bobby Jackson,jacksbo01,PG,25,MIN,1999,50,941.0,353,167,43,92,135,39,3,75,75,141,348,0.4051724137931034,10,27,0.3703703703703703,131,321,0.4080996884735202,0.42,61,79,0.7721518987341772
Jaren Jackson,jacksja01,SG,31,SAS,1999,47,861.0,301,49,21,78,99,41,9,37,63,108,284,0.380281690140845,53,147,0.3605442176870748,55,137,0.4014598540145985,0.474,32,39,0.8205128205128205
Jim Jackson,jacksji01,SG,28,POR,1999,49,1175.0,414,128,36,123,159,43,6,82,80,152,370,0.4108108108108108,25,90,0.2777777777777778,127,280,0.4535714285714285,0.445,85,101,0.8415841584158416
Mark Jackson,jacksma01,PG,33,IND,1999,49,1382.0,373,386,33,151,184,42,3,99,58,138,329,0.4194528875379939,32,103,0.3106796116504854,106,226,0.4690265486725664,0.468,65,79,0.8227848101265823
Randell Jackson,jacksra02,PF,23,WAS,1999,27,271.0,114,8,30,24,54,3,11,26,29,46,108,0.4259259259259259,1,7,0.1428571428571428,45,101,0.4455445544554455,0.431,21,32,0.65625
Sam Jacobson,jacobsa01,PG,23,LAL,1999,2,12.0,8,0,0,3,3,0,0,1,2,3,5,0.6,0,1,0.0,3,4,0.75,0.6,2,2,1.0
Jerome James,jamesje01,C,23,SAC,1999,16,42.0,24,1,6,11,17,2,6,9,11,9,24,0.375,0,0,0.0,9,24,0.375,0.375,6,12,0.5
Antawn Jamison,jamisan01,SF,22,GSW,1999,47,1058.0,449,34,131,170,301,38,16,68,102,178,394,0.4517766497461929,3,10,0.3,175,384,0.4557291666666667,0.456,90,153,0.5882352941176471
Anthony Johnson,johnsan02,PG,24,ATL,1999,49,885.0,244,107,16,59,75,35,7,65,67,91,225,0.4044444444444444,5,19,0.2631578947368421,86,206,0.4174757281553398,0.416,57,82,0.6951219512195121
Avery Johnson,johnsav01,PG,33,SAS,1999,50,1672.0,487,369,22,96,118,51,11,112,101,218,461,0.4728850325379609,1,12,0.0833333333333333,217,449,0.4832962138084632,0.474,50,88,0.5681818181818182
Eddie Johnson,johnsed03,SF,39,HOU,1999,3,18.0,12,1,0,2,2,0,0,2,3,6,13,0.4615384615384615,0,1,0.0,6,12,0.5,0.462,0,0,0.0
Ervin Johnson,johnser02,C,31,MIL,1999,50,1027.0,256,19,120,200,320,29,57,47,151,96,189,0.5079365079365079,0,0,0.0,96,189,0.5079365079365079,0.508,64,105,0.6095238095238096
Larry Johnson,johnsla02,PF,29,NYK,1999,49,1639.0,587,119,91,193,284,34,10,89,147,210,458,0.4585152838427948,33,92,0.358695652173913,177,366,0.4836065573770491,0.495,134,164,0.8170731707317073
Charles Jones,jonesch03,SG,23,CHI,1999,29,476.0,108,41,9,33,42,18,5,29,30,39,123,0.3170731707317073,19,61,0.3114754098360656,20,62,0.3225806451612903,0.394,11,22,0.5
Damon Jones,jonesda01,PG,22,TOT,1999,24,344.0,125,42,6,38,44,13,0,17,23,43,119,0.361344537815126,25,62,0.4032258064516129,18,57,0.3157894736842105,0.466,14,17,0.8235294117647058
Eddie Jones,jonesed02,SF-SG,27,TOT,1999,50,1881.0,780,186,50,144,194,125,58,93,128,260,595,0.4369747899159664,48,142,0.3380281690140845,212,453,0.4679911699779249,0.477,212,271,0.7822878228782287
Popeye Jones,jonespo01,PF,28,BOS,1999,18,206.0,54,15,28,24,52,5,0,7,31,20,51,0.392156862745098,0,1,0.0,20,50,0.4,0.392,14,17,0.8235294117647058
Adonis Jordan,jordaad01,PG,28,MIL,1999,4,18.0,6,3,0,0,0,3,0,2,0,2,4,0.5,0,2,0.0,2,2,1.0,0.5,2,4,0.5
Reggie Jordan,jordare01,SG,31,MIN,1999,27,296.0,51,41,27,32,59,12,5,14,38,15,54,0.2777777777777778,0,0,0.0,15,54,0.2777777777777778,0.278,21,38,0.5526315789473685
Adam Keefe,keefead01,PF,28,UTA,1999,44,642.0,174,28,51,91,142,16,12,33,63,56,124,0.4516129032258064,0,4,0.0,56,120,0.4666666666666667,0.452,62,89,0.6966292134831461
Shawn Kemp,kempsh01,PF,29,CLE,1999,42,1475.0,862,101,131,257,388,48,45,127,159,277,575,0.4817391304347826,1,2,0.5,276,573,0.4816753926701571,0.483,307,389,0.7892030848329049
Jonathan Kerner,kernejo01,C,24,ORL,1999,1,5.0,0,0,0,0,0,0,0,0,2,0,1,0.0,0,0,0.0,0,1,0.0,0.0,0,0,0.0
Steve Kerr,kerrst01,PG,33,SAS,1999,44,734.0,192,49,6,38,44,23,3,22,28,68,174,0.3908045977011494,25,80,0.3125,43,94,0.4574468085106383,0.463,31,35,0.8857142857142857
Jerome Kersey,kerseje01,SF,36,SAS,1999,45,699.0,145,41,42,88,130,37,14,30,92,68,200,0.34,3,14,0.2142857142857142,65,186,0.3494623655913978,0.348,6,14,0.4285714285714285
Jason Kidd,kiddja01,PG,25,PHO,1999,50,2060.0,846,539,87,252,339,114,19,150,108,310,698,0.4441260744985673,45,123,0.3658536585365853,265,575,0.4608695652173913,0.476,181,239,0.7573221757322176
Chris King,kingch01,SF,29,UTA,1999,8,42.0,4,1,1,10,11,2,1,4,8,2,7,0.2857142857142857,0,0,0.0,2,7,0.2857142857142857,0.286,0,4,0.0
Gerard King,kingge02,SF,26,SAS,1999,19,63.0,23,4,6,8,14,2,1,4,12,6,14,0.4285714285714285,0,0,0.0,6,14,0.4285714285714285,0.429,11,18,0.6111111111111112
Kerry Kittles,kittlke01,SG,24,NJN,1999,46,1570.0,592,116,52,139,191,79,26,66,82,227,613,0.3703099510603589,50,158,0.3164556962025316,177,455,0.389010989010989,0.411,88,114,0.7719298245614035
Joe Kleine,kleinjo01,C,37,PHO,1999,31,374.0,68,12,27,40,67,8,1,10,46,30,74,0.4054054054054054,0,2,0.0,30,72,0.4166666666666667,0.405,8,12,0.6666666666666666
Brevin Knight,knighbr01,PG,23,CLE,1999,39,1186.0,373,302,16,115,131,70,7,105,115,134,315,0.4253968253968254,0,5,0.0,134,310,0.432258064516129,0.425,105,141,0.7446808510638298
Negele Knight,knighne01,PG,31,TOR,1999,6,56.0,8,8,1,5,6,1,0,7,5,3,8,0.375,0,1,0.0,3,7,0.4285714285714285,0.375,2,4,0.5
Travis Knight,knightr01,C,24,LAL,1999,37,525.0,156,31,34,94,128,21,27,35,108,67,130,0.5153846153846153,0,1,0.0,67,129,0.5193798449612403,0.515,22,29,0.7586206896551724
Toni Kukoč,kukocto01,SF,30,CHI,1999,44,1654.0,828,235,65,245,310,49,11,121,82,315,750,0.42,39,137,0.2846715328467153,276,613,0.4502446982055464,0.446,159,215,0.7395348837209302
Christian Laettner,laettch01,PF,29,DET,1999,16,337.0,121,24,21,33,54,15,12,19,30,38,106,0.3584905660377358,1,3,0.3333333333333333,37,103,0.3592233009708738,0.363,44,57,0.7719298245614035
Raef LaFrentz,lafrera01,C,22,DEN,1999,12,387.0,166,8,33,58,91,9,17,9,38,59,129,0.4573643410852713,12,31,0.3870967741935484,47,98,0.4795918367346938,0.504,36,48,0.75
Andrew Lang,langan01,C,32,CHI,1999,21,386.0,80,13,33,60,93,5,12,17,43,32,99,0.3232323232323232,0,0,0.0,32,99,0.3232323232323232,0.323,16,23,0.6956521739130435
Antonio Lang,langan02,PF,26,CLE,1999,10,65.0,13,1,6,10,16,2,1,4,13,4,6,0.6666666666666666,0,0,0.0,4,6,0.6666666666666666,0.667,5,9,0.5555555555555556
Rusty LaRue,larueru01,PG,25,CHI,1999,43,732.0,203,63,9,47,56,33,3,34,66,78,217,0.3594470046082949,30,89,0.3370786516853932,48,128,0.375,0.429,17,17,1.0
Tim Legler,legleti01,SG,32,WAS,1999,30,377.0,119,21,8,32,40,4,3,14,42,51,115,0.4434782608695652,14,35,0.4,37,80,0.4625,0.504,3,6,0.5
Voshon Lenard,lenarvo01,SG,25,MIA,1999,12,190.0,82,10,4,12,16,3,1,7,18,31,79,0.3924050632911392,12,35,0.3428571428571428,19,44,0.4318181818181818,0.468,8,11,0.7272727272727273
Rashard Lewis,lewisra02,SF,19,SEA,1999,20,145.0,47,4,13,12,25,8,1,20,19,19,52,0.3653846153846153,1,6,0.1666666666666666,18,46,0.391304347826087,0.375,8,14,0.5714285714285714
Randy Livingston,livinra01,PG,23,PHO,1999,1,22.0,12,3,0,2,2,2,0,1,1,5,8,0.625,0,0,0.0,5,8,0.625,0.625,2,2,1.0
Grant Long,longgr01,PF,32,ATL,1999,50,1380.0,489,53,100,196,296,57,16,74,143,151,359,0.4206128133704735,3,18,0.1666666666666666,148,341,0.4340175953079179,0.425,184,235,0.7829787234042553
Luc Longley,longllu01,C,30,PHO,1999,39,933.0,339,45,59,162,221,23,21,53,119,140,290,0.4827586206896552,0,0,0.0,140,290,0.4827586206896552,0.483,59,76,0.7763157894736842
Felipe López,lopezfe01,SG,24,VAN,1999,47,1218.0,437,62,69,97,166,49,14,82,128,169,379,0.445910290237467,12,44,0.2727272727272727,157,335,0.4686567164179104,0.462,87,135,0.6444444444444445
Tyronn Lue,luety01,PG,21,LAL,1999,15,188.0,75,25,2,4,6,5,0,11,28,28,65,0.4307692307692308,7,16,0.4375,21,49,0.4285714285714285,0.485,12,21,0.5714285714285714
George Lynch,lynchge01,SF,28,PHI,1999,43,1315.0,356,76,110,169,279,85,22,79,142,147,349,0.4212034383954154,9,23,0.391304347826087,138,326,0.4233128834355828,0.434,53,84,0.6309523809523809
Sam Mack,macksa01,SF,28,TOT,1999,44,1083.0,472,55,14,81,95,35,4,33,94,167,384,0.4348958333333333,87,219,0.3972602739726027,80,165,0.4848484848484848,0.548,51,58,0.8793103448275862
Don MacLean,macledo01,PF,29,SEA,1999,17,365.0,185,16,18,47,65,5,5,25,34,63,159,0.3962264150943396,9,33,0.2727272727272727,54,126,0.4285714285714285,0.425,50,80,0.625
Mark Macon,maconma01,SG,29,DET,1999,7,69.0,9,4,3,2,5,5,1,6,6,4,20,0.2,1,3,0.3333333333333333,3,17,0.1764705882352941,0.225,0,0,0.0
Rick Mahorn,mahorri01,PF,40,PHI,1999,16,127.0,13,2,7,16,23,5,1,6,22,5,18,0.2777777777777778,0,0,0.0,5,18,0.2777777777777778,0.278,3,8,0.375
Dan Majerle,majerda01,SG,33,MIA,1999,48,1624.0,337,150,21,187,208,38,7,55,100,118,298,0.3959731543624161,68,203,0.334975369458128,50,95,0.5263157894736842,0.51,33,46,0.717391304347826
Karl Malone,malonka01,PF,35,UTA,1999,49,1832.0,1164,201,107,356,463,62,28,162,134,393,797,0.493099121706399,0,1,0.0,393,796,0.4937185929648241,0.493,378,480,0.7875
Matt Maloney,malonma01,PG,27,HOU,1999,15,186.0,21,21,2,8,10,4,0,14,7,5,28,0.1785714285714285,1,15,0.0666666666666666,4,13,0.3076923076923077,0.196,10,11,0.9090909090909092
Danny Manning,mannida01,PF,32,PHO,1999,50,1184.0,453,113,62,157,219,36,38,69,129,187,386,0.4844559585492228,1,9,0.1111111111111111,186,377,0.493368700265252,0.486,78,112,0.6964285714285714
Stephon Marbury,marbust01,PG,21,TOT,1999,49,1895.0,1044,437,37,105,142,59,8,164,125,378,883,0.4280860702151755,66,197,0.3350253807106599,312,686,0.4548104956268221,0.465,222,278,0.7985611510791367
Sean Marks,marksse01,PF,23,TOR,1999,8,28.0,11,0,0,1,1,1,0,3,3,5,8,0.625,0,0,0.0,5,8,0.625,0.625,1,2,0.5
Donyell Marshall,marshdo01,SF,25,GSW,1999,48,1250.0,530,66,115,227,342,47,37,80,123,208,494,0.4210526315789473,26,72,0.3611111111111111,182,422,0.4312796208530806,0.447,88,121,0.7272727272727273
Darrick Martin,martida01,PG,27,LAC,1999,37,941.0,296,144,5,43,48,43,4,67,82,102,278,0.3669064748201439,31,106,0.2924528301886792,71,172,0.4127906976744186,0.423,61,76,0.8026315789473685
Jamal Mashburn,mashbja01,SF,26,MIA,1999,24,855.0,356,75,24,122,146,20,3,60,58,134,297,0.4511784511784512,13,30,0.4333333333333333,121,267,0.4531835205992509,0.473,75,104,0.7211538461538461
Tony Massenburg,masseto01,PF,31,VAN,1999,43,1143.0,481,23,83,174,257,26,39,64,108,189,388,0.4871134020618556,0,2,0.0,189,386,0.4896373056994819,0.487,103,155,0.6645161290322581
Vernon Maxwell,maxweve01,SG,33,SAC,1999,46,1007.0,492,76,13,72,85,30,3,67,111,164,421,0.3895486935866983,80,231,0.3463203463203463,84,190,0.4421052631578947,0.485,84,114,0.7368421052631579
Lee Mayberry,maybele01,PG,28,VAN,1999,9,126.0,20,23,0,3,3,7,0,11,13,7,19,0.3684210526315789,2,10,0.2,5,9,0.5555555555555556,0.421,4,5,0.8
Kelly McCarty,mccarke01,SG,23,DEN,1999,2,4.0,4,0,2,1,3,0,0,2,0,2,3,0.6666666666666666,0,0,0.0,2,3,0.6666666666666666,0.667,0,0,0.0
Walter McCarty,mccarwa01,PF,24,BOS,1999,32,659.0,181,40,36,79,115,24,13,40,88,64,177,0.3615819209039548,13,50,0.26,51,127,0.4015748031496063,0.398,40,57,0.7017543859649122
George McCloud,mccloge01,SF,31,PHO,1999,48,1245.0,428,79,34,128,162,45,14,49,128,142,324,0.4382716049382716,69,166,0.4156626506024096,73,158,0.4620253164556962,0.545,75,87,0.8620689655172413
Jelani McCoy,mccoyje01,C,21,SEA,1999,26,331.0,133,4,27,52,79,11,20,10,42,56,76,0.7368421052631579,0,0,0.0,56,76,0.7368421052631579,0.737,21,42,0.5
Antonio McDyess,mcdyean01,C,24,DEN,1999,50,1937.0,1061,82,168,369,537,73,115,138,175,415,882,0.4705215419501133,1,9,0.1111111111111111,414,873,0.4742268041237113,0.471,230,338,0.6804733727810651
Tracy McGrady,mcgratr01,SF,19,TOR,1999,49,1106.0,458,113,120,158,278,52,66,80,94,168,385,0.4363636363636363,8,35,0.2285714285714285,160,350,0.4571428571428571,0.447,114,157,0.7261146496815286
Jim McIlvaine,mcilvji01,C,26,NJN,1999,22,269.0,48,2,31,23,54,9,32,13,59,22,51,0.4313725490196078,0,0,0.0,22,51,0.4313725490196078,0.431,4,6,0.6666666666666666
Jeff McInnis,mcinnje01,PG,24,WAS,1999,35,427.0,130,73,9,12,21,19,1,30,36,50,134,0.373134328358209,9,35,0.2571428571428571,41,99,0.4141414141414141,0.407,21,28,0.75
Derrick McKey,mckeyde01,SF,32,IND,1999,13,244.0,60,13,18,23,41,12,4,12,24,23,52,0.4423076923076923,0,1,0.0,23,51,0.4509803921568627,0.442,14,17,0.8235294117647058
Aaron McKie,mckieaa01,SG,26,PHI,1999,50,959.0,240,100,27,113,140,63,3,57,90,95,237,0.4008438818565401,6,31,0.1935483870967742,89,206,0.4320388349514563,0.414,44,62,0.7096774193548387
Roshown McLeod,mcleoro01,SF,23,ATL,1999,34,348.0,162,14,12,38,50,2,1,23,24,62,163,0.3803680981595092,1,10,0.1,61,153,0.3986928104575163,0.383,37,45,0.8222222222222222
Ron Mercer,mercero01,SG,22,BOS,1999,41,1551.0,698,104,37,118,155,67,12,89,81,305,707,0.4314002828854314,5,30,0.1666666666666666,300,677,0.4431314623338257,0.435,83,105,0.7904761904761904
Loren Meyer,meyerlo01,C,26,DEN,1999,14,70.0,16,1,4,12,16,0,3,4,22,7,28,0.25,1,5,0.2,6,23,0.2608695652173913,0.268,1,2,0.5
Marko Milič,milicma01,SG,21,PHO,1999,11,53.0,16,2,3,2,5,3,1,6,7,8,20,0.4,0,1,0.0,8,19,0.4210526315789473,0.4,0,0,0.0
Anthony Miller,millean01,PF,27,HOU,1999,29,249.0,70,7,26,41,67,7,5,9,34,28,60,0.4666666666666667,0,1,0.0,28,59,0.4745762711864407,0.467,14,22,0.6363636363636364
Brad Miller,millebr01,C,22,CHH,1999,38,469.0,238,22,35,82,117,9,18,32,65,78,138,0.5652173913043478,1,2,0.5,77,136,0.5661764705882353,0.569,81,102,0.7941176470588235
Oliver Miller,milleol01,C,28,SAC,1999,4,35.0,10,0,7,1,8,0,2,4,3,5,11,0.4545454545454545,0,0,0.0,5,11,0.4545454545454545,0.455,0,0,0.0
Reggie Miller,millere01,SG,33,IND,1999,50,1787.0,920,112,25,110,135,37,9,76,101,294,671,0.4381520119225037,106,275,0.3854545454545454,188,396,0.4747474747474747,0.517,226,247,0.9149797570850202
Chris Mills,millsch01,SF,29,GSW,1999,47,1395.0,483,103,49,188,237,39,14,58,125,186,453,0.4105960264900662,32,115,0.2782608695652174,154,338,0.4556213017751479,0.446,79,96,0.8229166666666666
Terry Mills,millste01,PF,31,MIA,1999,1,29.0,9,0,3,1,4,1,0,3,3,3,8,0.375,2,4,0.5,1,4,0.25,0.5,1,2,0.5
Greg Minor,minorgr01,SG,27,BOS,1999,44,765.0,214,50,31,86,117,20,6,38,69,85,204,0.4166666666666667,8,28,0.2857142857142857,77,176,0.4375,0.436,36,48,0.75
Sam Mitchell,mitchsa01,SF,35,MIN,1999,50,1344.0,561,98,55,127,182,35,16,34,111,213,522,0.4080459770114942,9,38,0.2368421052631578,204,484,0.4214876033057851,0.417,126,165,0.7636363636363637
Cuttino Mobley,moblecu01,PG,23,HOU,1999,49,1456.0,487,121,22,89,111,44,23,79,98,172,405,0.4246913580246914,53,148,0.3581081081081081,119,257,0.4630350194552529,0.49,90,110,0.8181818181818182
Nazr Mohammed,mohamna01,C,21,PHI,1999,26,121.0,42,2,18,19,37,5,4,12,22,15,42,0.3571428571428571,0,0,0.0,15,42,0.3571428571428571,0.357,12,21,0.5714285714285714
Eric Montross,montrer01,C,27,DET,1999,46,577.0,95,14,45,94,139,12,27,16,107,42,80,0.525,0,1,0.0,42,79,0.5316455696202531,0.525,11,32,0.34375
Mikki Moore,mooremi01,C,23,DET,1999,2,6.0,4,0,0,1,1,0,0,0,0,1,1,1.0,0,0,0.0,1,1,1.0,1.0,2,2,1.0
Chris Morris,morrich01,SF,33,PHO,1999,44,535.0,184,23,54,67,121,16,11,21,54,64,149,0.4295302013422818,16,56,0.2857142857142857,48,93,0.5161290322580645,0.483,40,46,0.8695652173913043
Alonzo Mourning,mournal01,C,28,MIA,1999,46,1753.0,924,74,166,341,507,34,180,139,161,324,634,0.5110410094637224,0,2,0.0,324,632,0.5126582278481012,0.511,276,423,0.6524822695035462
Chris Mullin,mullich01,SF,35,IND,1999,50,1179.0,507,81,25,135,160,47,13,60,101,177,371,0.477088948787062,73,157,0.464968152866242,104,214,0.4859813084112149,0.575,80,92,0.8695652173913043
Eric Murdock,murdoer01,PG,30,NJN,1999,15,401.0,119,66,3,32,35,22,2,29,35,45,114,0.3947368421052631,8,22,0.3636363636363636,37,92,0.4021739130434782,0.43,21,26,0.8076923076923077
Gheorghe Mureșan,muresgh01,C,27,NJN,1999,1,1.0,0,0,0,0,0,0,0,1,0,0,1,0.0,0,0,0.0,0,1,0.0,0.0,0,0,0.0
Lamond Murray,murrala01,SF,25,LAC,1999,50,1317.0,612,61,59,136,195,58,20,99,107,226,578,0.3910034602076124,34,103,0.3300970873786408,192,475,0.4042105263157894,0.42,126,157,0.802547770700637
Tracy Murray,murratr01,SF,27,WAS,1999,36,653.0,233,27,18,63,81,21,6,29,65,83,237,0.350210970464135,33,103,0.3203883495145631,50,134,0.373134328358209,0.42,34,42,0.8095238095238095
Dikembe Mutombo,mutomdi01,C,32,ATL,1999,50,1829.0,541,57,192,418,610,16,147,94,145,173,338,0.5118343195266272,0,0,0.0,173,338,0.5118343195266272,0.512,195,285,0.6842105263157895
Makhtar N'Diaye,ndiayma01,PF,25,VAN,1999,4,27.0,5,1,3,2,5,0,1,1,9,1,4,0.25,0,0,0.0,1,4,0.25,0.25,3,4,0.75
Steve Nash,nashst01,PG,24,DAL,1999,40,1269.0,315,219,32,82,114,37,2,83,98,114,314,0.3630573248407643,49,131,0.3740458015267175,65,183,0.3551912568306011,0.441,38,46,0.8260869565217391
Tyrone Nesby,nesbyty01,SF,23,LAC,1999,50,1288.0,503,82,57,118,175,77,20,53,143,182,405,0.4493827160493827,35,96,0.3645833333333333,147,309,0.4757281553398058,0.493,104,133,0.7819548872180451
Rasho Nesterović,nestera01,C,22,MIN,1999,2,30.0,8,1,3,5,8,0,0,1,5,3,12,0.25,0,0,0.0,3,12,0.25,0.25,2,2,1.0
Johnny Newman,newmajo01,SF,35,CLE,1999,50,949.0,303,41,15,60,75,28,12,41,126,106,251,0.4223107569721115,23,61,0.3770491803278688,83,190,0.4368421052631579,0.468,68,84,0.8095238095238095
Moochie Norris,norrimo01,PG,25,SEA,1999,12,140.0,38,24,4,16,20,7,0,16,17,13,40,0.325,6,15,0.4,7,25,0.28,0.4,6,16,0.375
Dirk Nowitzki,nowitdi01,PF,20,DAL,1999,47,958.0,385,47,41,121,162,29,27,73,105,136,336,0.4047619047619047,14,68,0.2058823529411764,122,268,0.4552238805970149,0.426,99,128,0.7734375
Charles O'Bannon,obannch01,SG,23,DET,1999,18,165.0,56,12,18,16,34,2,3,8,22,24,56,0.4285714285714285,0,1,0.0,24,55,0.4363636363636363,0.429,8,8,1.0
Jermaine O'Neal,onealje01,PF,20,POR,1999,36,311.0,90,13,42,55,97,4,14,14,41,36,83,0.4337349397590361,0,1,0.0,36,82,0.4390243902439024,0.434,18,35,0.5142857142857142
Shaquille O'Neal,onealsh01,C,26,LAL,1999,49,1705.0,1289,114,187,338,525,36,82,122,155,510,885,0.576271186440678,0,1,0.0,510,884,0.5769230769230769,0.576,269,498,0.5401606425702812
Charles Oakley,oaklech01,PF,35,TOR,1999,50,1633.0,348,168,96,278,374,46,21,96,182,140,327,0.4281345565749235,1,5,0.2,139,322,0.4316770186335403,0.43,67,83,0.8072289156626506
Hakeem Olajuwon,olajuha01,C,36,HOU,1999,50,1784.0,945,88,106,372,478,82,123,139,160,373,725,0.5144827586206897,4,13,0.3076923076923077,369,712,0.5182584269662921,0.517,195,272,0.7169117647058824
Jimmy Oliver,oliveji01,SG,29,PHO,1999,2,11.0,3,0,0,0,0,0,0,0,2,1,3,0.3333333333333333,1,1,1.0,0,2,0.0,0.5,0,0,0.0
Kevin Ollie,ollieke01,PG,26,TOT,1999,8,72.0,13,3,0,7,7,3,1,3,9,4,14,0.2857142857142857,0,0,0.0,4,14,0.2857142857142857,0.286,5,7,0.7142857142857143
Michael Olowokandi,olowomi01,C,23,LAC,1999,45,1279.0,401,25,120,237,357,27,55,85,137,172,399,0.4310776942355889,0,0,0.0,172,399,0.4310776942355889,0.431,57,118,0.4830508474576271
Greg Ostertag,ostergr01,C,25,UTA,1999,48,1340.0,273,23,105,243,348,12,131,45,140,99,208,0.4759615384615384,0,0,0.0,99,208,0.4759615384615384,0.476,75,121,0.6198347107438017
Bo Outlaw,outlabo01,PF,27,ORL,1999,31,851.0,203,56,54,113,167,40,43,58,79,84,154,0.5454545454545454,0,3,0.0,84,151,0.5562913907284768,0.545,35,81,0.4320987654320987
Doug Overton,overtdo01,PG,29,TOT,1999,24,244.0,92,23,7,14,21,5,1,20,18,36,84,0.4285714285714285,2,7,0.2857142857142857,34,77,0.4415584415584415,0.44,18,20,0.9
Billy Owens,owensbi01,SF,29,SEA,1999,21,451.0,163,38,35,45,80,12,4,33,37,65,165,0.3939393939393939,5,11,0.4545454545454545,60,154,0.3896103896103896,0.409,28,35,0.8
Robert Pack,packro01,PG,29,DAL,1999,25,468.0,222,81,9,27,36,20,1,49,41,75,174,0.4310344827586206,0,4,0.0,75,170,0.4411764705882353,0.431,72,88,0.8181818181818182
Anthony Parker,parkean01,SG,23,PHI,1999,2,3.0,2,0,0,0,0,0,0,0,0,1,1,1.0,0,0,0.0,1,1,1.0,1.0,0,0,0.0
Cherokee Parks,parksch02,C,26,VAN,1999,48,1118.0,266,36,75,168,243,28,28,49,114,118,275,0.4290909090909091,0,1,0.0,118,274,0.4306569343065693,0.429,30,55,0.5454545454545454
Andrae Patterson,pattean01,PF,23,MIN,1999,35,284.0,114,15,30,35,65,19,7,22,62,43,97,0.4432989690721649,0,5,0.0,43,92,0.4673913043478261,0.443,28,36,0.7777777777777778
Ruben Patterson,patteru01,SF,23,LAL,1999,24,144.0,65,2,17,13,30,5,3,12,16,21,51,0.4117647058823529,1,6,0.1666666666666666,20,45,0.4444444444444444,0.422,22,31,0.7096774193548387
Gary Payton,paytoga01,PG,30,SEA,1999,50,2008.0,1084,436,62,182,244,109,12,154,115,401,923,0.4344528710725894,83,281,0.295373665480427,318,642,0.4953271028037383,0.479,199,276,0.7210144927536232
Anthony Peeler,peelean01,SG,29,MIN,1999,28,810.0,270,78,30,54,84,35,6,38,60,103,272,0.3786764705882353,34,114,0.2982456140350877,69,158,0.4367088607594936,0.441,30,41,0.7317073170731707
Will Perdue,perduwi01,C,33,SAS,1999,37,445.0,90,18,33,105,138,9,10,22,63,38,60,0.6333333333333333,0,0,0.0,38,60,0.6333333333333333,0.633,14,26,0.5384615384615384
Sam Perkins,perkisa01,PF,37,IND,1999,48,789.0,238,25,36,102,138,15,14,22,74,80,200,0.4,35,90,0.3888888888888889,45,110,0.4090909090909091,0.488,43,60,0.7166666666666667
Elliot Perry,perryel01,PG,29,TOT,1999,35,290.0,98,47,7,27,34,20,0,34,25,39,103,0.3786407766990291,10,24,0.4166666666666667,29,79,0.3670886075949367,0.427,10,14,0.7142857142857143
Chuck Person,persoch01,SF,34,CHH,1999,50,990.0,303,60,17,115,132,20,8,41,90,112,289,0.3875432525951557,55,157,0.3503184713375796,57,132,0.4318181818181818,0.483,24,32,0.75
Wesley Person,persowe01,SG,27,CLE,1999,45,1342.0,503,80,19,123,142,37,16,41,52,198,437,0.4530892448512585,75,200,0.375,123,237,0.5189873417721519,0.539,32,53,0.6037735849056604
Bobby Phills,phillbo01,SG,29,CHH,1999,43,1574.0,613,149,39,135,174,60,25,92,124,215,497,0.4325955734406438,68,172,0.3953488372093023,147,325,0.4523076923076923,0.501,115,168,0.6845238095238095
Eric Piatkowski,piatker01,SG,28,LAC,1999,49,1242.0,513,53,39,101,140,44,6,53,86,180,417,0.4316546762589928,65,165,0.3939393939393939,115,252,0.4563492063492063,0.51,88,102,0.8627450980392157
Paul Pierce,piercpa01,SF,21,BOS,1999,48,1632.0,791,115,117,192,309,82,50,113,139,284,647,0.4389489953632148,84,204,0.4117647058823529,200,443,0.4514672686230248,0.504,139,195,0.7128205128205128
Scottie Pippen,pippesc01,SF,33,HOU,1999,50,2011.0,726,293,63,260,323,98,37,159,118,261,604,0.4321192052980132,72,212,0.3396226415094339,189,392,0.4821428571428571,0.492,132,183,0.7213114754098361
Scot Pollard,pollasc01,C,23,SAC,1999,16,259.0,82,4,38,44,82,8,18,5,41,33,61,0.5409836065573771,0,0,0.0,33,61,0.5409836065573771,0.541,16,23,0.6956521739130435
Olden Polynice,polynol01,C,34,SEA,1999,48,1481.0,368,43,184,241,425,20,30,49,150,169,358,0.4720670391061452,1,1,1.0,168,357,0.4705882352941176,0.473,29,94,0.3085106382978723
Mark Pope,popema01,SF,26,IND,1999,4,26.0,2,0,2,2,4,0,0,1,6,1,7,0.1428571428571428,0,4,0.0,1,3,0.3333333333333333,0.143,0,1,0.0
Terry Porter,portete01,PG,35,MIA,1999,50,1365.0,525,146,13,127,140,48,11,74,97,172,370,0.4648648648648649,58,141,0.4113475177304964,114,229,0.4978165938864629,0.543,123,148,0.831081081081081
Vitaly Potapenko,potapvi01,C,23,TOT,1999,50,1394.0,499,75,114,218,332,35,36,100,169,204,412,0.4951456310679611,0,1,0.0,204,411,0.4963503649635036,0.495,91,155,0.5870967741935483
Brent Price,pricebr01,PG,30,HOU,1999,40,806.0,292,113,18,60,78,33,1,65,90,100,207,0.4830917874396135,46,112,0.4107142857142857,54,95,0.5684210526315789,0.594,46,61,0.7540983606557377
Theo Ratliff,ratlith01,PF,25,PHI,1999,50,1627.0,560,30,139,268,407,45,149,92,180,197,419,0.4701670644391408,0,0,0.0,197,419,0.4701670644391408,0.47,166,229,0.7248908296943232
Eldridge Recasner,recasel01,PG,31,CHH,1999,44,708.0,222,91,20,57,77,17,1,58,66,82,184,0.4456521739130434,24,60,0.4,58,124,0.4677419354838709,0.511,34,39,0.8717948717948718
Bryant Reeves,reevebr01,C,25,VAN,1999,25,702.0,271,37,50,88,138,13,8,47,103,102,251,0.4063745019920319,0,1,0.0,102,250,0.408,0.406,67,116,0.5775862068965517
Khalid Reeves,reevekh01,PG,26,DET,1999,11,112.0,25,11,3,4,7,4,0,7,13,8,21,0.3809523809523809,1,3,0.3333333333333333,7,18,0.3888888888888889,0.405,8,14,0.5714285714285714
Don Reid,reiddo01,PF,25,DET,1999,47,935.0,242,33,66,104,170,27,43,36,156,97,174,0.5574712643678161,0,0,0.0,97,174,0.5574712643678161,0.557,48,79,0.6075949367088608
J.R. Reid,reidjr01,PF,30,TOT,1999,41,1029.0,369,48,45,167,212,37,10,51,135,132,277,0.4765342960288808,0,1,0.0,132,276,0.4782608695652174,0.477,105,137,0.7664233576642335
Shawn Respert,respesh01,SG,26,PHO,1999,12,99.0,37,8,2,11,13,5,0,5,10,13,36,0.3611111111111111,4,13,0.3076923076923077,9,23,0.391304347826087,0.417,7,10,0.7
Rodrick Rhodes,rhodero01,SG-SF,25,TOT,1999,13,156.0,43,11,9,8,17,5,2,20,21,13,52,0.25,1,7,0.1428571428571428,12,45,0.2666666666666666,0.26,16,25,0.64
Glen Rice,ricegl01,SF,31,LAL,1999,27,985.0,472,71,9,90,99,17,6,45,67,171,396,0.4318181818181818,53,135,0.3925925925925926,118,261,0.4521072796934866,0.499,77,90,0.8555555555555555
Pooh Richardson,richapo01,PG,32,LAC,1999,11,130.0,28,30,1,12,13,4,0,9,5,12,36,0.3333333333333333,0,6,0.0,12,30,0.4,0.333,4,4,1.0
Mitch Richmond,richmmi01,SG,33,WAS,1999,50,1912.0,983,122,30,142,172,64,10,136,121,331,803,0.4122042341220423,70,221,0.3167420814479638,261,582,0.4484536082474227,0.456,251,293,0.856655290102389
Isaiah Rider,rideris01,SG,27,POR,1999,47,1385.0,651,104,59,137,196,25,9,95,100,249,605,0.4115702479338843,42,111,0.3783783783783784,207,494,0.4190283400809717,0.446,111,147,0.7551020408163265
Eric Riley,rileyer01,C,28,BOS,1999,35,337.0,78,13,36,63,99,9,26,26,73,28,54,0.5185185185185185,0,0,0.0,28,54,0.5185185185185185,0.519,22,31,0.7096774193548387
Stanley Roberts,roberst01,C,28,HOU,1999,6,33.0,14,0,4,7,11,0,1,4,2,5,13,0.3846153846153846,0,0,0.0,5,13,0.3846153846153846,0.385,4,8,0.5
Clifford Robinson,robincl02,SF,32,PHO,1999,50,1740.0,819,128,69,158,227,75,59,88,153,299,629,0.4753577106518283,58,139,0.4172661870503597,241,490,0.4918367346938775,0.521,163,234,0.6965811965811965
David Robinson,robinda01,C,33,SAS,1999,49,1554.0,775,103,148,344,492,69,119,108,143,268,527,0.50853889943074,0,1,0.0,268,526,0.5095057034220533,0.509,239,363,0.6584022038567493
Glenn Robinson,robingl01,SF,26,MIL,1999,47,1579.0,865,100,73,203,276,46,41,106,114,347,756,0.458994708994709,31,79,0.3924050632911392,316,677,0.4667651403249631,0.479,140,161,0.8695652173913043
James Robinson,robinja02,PG,28,TOT,1999,31,506.0,183,56,18,44,62,22,8,44,60,67,185,0.3621621621621622,21,74,0.2837837837837837,46,111,0.4144144144144144,0.419,28,41,0.6829268292682927
Dennis Rodman,rodmade01,PF,37,LAL,1999,23,657.0,49,30,62,196,258,10,12,31,71,16,46,0.3478260869565217,0,2,0.0,16,44,0.3636363636363636,0.348,17,39,0.4358974358974359
Carlos Rogers,rogerca01,PF,27,POR,1999,2,8.0,5,1,0,1,1,0,0,0,2,2,2,1.0,0,0,0.0,2,2,1.0,1.0,1,4,0.25
Rodney Rogers,rogerro01,SF,27,LAC,1999,47,968.0,348,77,65,114,179,47,22,66,140,131,297,0.441077441077441,18,63,0.2857142857142857,113,234,0.4829059829059829,0.471,68,101,0.6732673267326733
Sean Rooks,rooksse01,C,29,LAL,1999,36,315.0,98,9,33,39,72,2,9,21,61,32,79,0.4050632911392405,0,2,0.0,32,77,0.4155844155844156,0.405,34,48,0.7083333333333334
Jalen Rose,roseja01,SF,26,IND,1999,49,1238.0,542,93,34,120,154,50,15,72,128,200,496,0.4032258064516129,17,65,0.2615384615384615,183,431,0.4245939675174014,0.42,125,158,0.7911392405063291
Malik Rose,rosema01,PF,24,SAS,1999,47,608.0,284,29,90,92,182,40,22,56,120,93,201,0.4626865671641791,0,1,0.0,93,200,0.465,0.463,98,146,0.6712328767123288
Bryon Russell,russebr01,SF,28,UTA,1999,50,1770.0,622,74,65,201,266,76,15,76,154,217,468,0.4636752136752137,52,147,0.3537414965986394,165,321,0.514018691588785,0.519,136,171,0.7953216374269005
Arvydas Sabonis,sabonar01,C,34,POR,1999,50,1349.0,606,119,88,305,393,34,63,85,147,232,478,0.4853556485355648,7,24,0.2916666666666667,225,454,0.4955947136563877,0.493,135,175,0.7714285714285715
Jason Sasser,sasseja01,SF,25,VAN,1999,6,39.0,11,2,2,5,7,2,0,2,4,5,11,0.4545454545454545,0,0,0.0,5,11,0.4545454545454545,0.455,1,2,0.5
Danny Schayes,schayda01,C,39,ORL,1999,19,143.0,28,4,3,11,14,1,2,8,23,11,29,0.3793103448275862,0,0,0.0,11,29,0.3793103448275862,0.379,6,8,0.75
Dwayne Schintzius,schindw01,C,30,BOS,1999,16,67.0,11,8,7,12,19,0,3,10,17,4,16,0.25,0,0,0.0,4,16,0.25,0.25,3,4,0.75
Detlef Schrempf,schrede01,SF,36,SEA,1999,50,1765.0,752,184,77,293,370,41,26,103,152,259,549,0.4717668488160291,34,86,0.3953488372093023,225,463,0.4859611231101511,0.503,200,243,0.823045267489712
Dennis Scott,scottde01,SF,30,TOT,1999,36,738.0,234,40,8,50,58,15,3,19,49,87,213,0.4084507042253521,37,97,0.3814432989690721,50,116,0.4310344827586206,0.495,23,31,0.7419354838709677
Malik Sealy,sealyma01,SF,28,MIN,1999,31,731.0,251,36,23,69,92,30,5,33,68,95,231,0.4112554112554112,6,23,0.2608695652173913,89,208,0.4278846153846153,0.424,55,61,0.9016393442622952
Rony Seikaly,seikaro01,C,33,NJN,1999,9,88.0,15,2,5,16,21,4,6,10,15,4,20,0.2,0,0,0.0,4,20,0.2,0.2,7,18,0.3888888888888889
Charles Shackleford,shackch01,C,32,CHH,1999,32,367.0,107,13,41,88,129,5,13,27,66,44,90,0.4888888888888889,0,0,0.0,44,90,0.4888888888888889,0.489,19,29,0.6551724137931034
Brian Shaw,shawbr01,PG,32,POR,1999,1,5.0,0,1,0,1,1,0,0,1,1,0,1,0.0,0,0,0.0,0,1,0.0,0.0,0,0,0.0
Casey Shaw,shawca01,C,23,PHI,1999,9,14.0,2,0,3,0,3,0,0,2,2,1,8,0.125,0,0,0.0,1,8,0.125,0.125,0,0,0.0
Jeff Sheppard,sheppje01,SG,24,ATL,1999,18,185.0,40,16,6,16,22,3,0,7,12,15,39,0.3846153846153846,2,7,0.2857142857142857,13,32,0.40625,0.41,8,13,0.6153846153846154
Miles Simon,simonmi01,SG,23,ORL,1999,5,19.0,2,0,1,1,2,1,0,3,1,1,5,0.2,0,2,0.0,1,3,0.3333333333333333,0.2,0,0,0.0
Dickey Simpkins,simpkdi01,C,26,CHI,1999,50,1448.0,456,65,110,229,339,36,13,72,128,150,324,0.4629629629629629,0,1,0.0,150,323,0.4643962848297213,0.463,156,242,0.6446280991735537
Alvin Sims,simsal01,SG,24,PHO,1999,4,25.0,11,5,3,1,4,2,0,6,2,4,10,0.4,1,1,1.0,3,9,0.3333333333333333,0.45,2,5,0.4
Brian Skinner,skinnbr01,PF,22,LAC,1999,21,258.0,86,1,20,33,53,10,13,19,20,33,71,0.4647887323943662,0,0,0.0,33,71,0.4647887323943662,0.465,20,33,0.6060606060606061
Reggie Slater,slatere01,PF,28,TOR,1999,30,263.0,115,5,36,34,70,3,3,25,50,31,81,0.382716049382716,0,0,0.0,31,81,0.382716049382716,0.383,53,85,0.6235294117647059
Charles Smith,smithch04,SG,23,LAC,1999,23,317.0,84,13,7,17,24,17,14,20,35,35,97,0.3608247422680412,7,33,0.2121212121212121,28,64,0.4375,0.397,7,16,0.4375
Joe Smith,smithjo02,C,23,MIN,1999,43,1418.0,588,68,154,200,354,32,66,66,147,223,522,0.4272030651340996,0,3,0.0,223,519,0.4296724470134875,0.427,142,188,0.7553191489361702
Michael Smith,smithmi02,PF,26,VAN,1999,48,1098.0,230,48,135,215,350,46,18,60,107,77,144,0.5347222222222222,0,1,0.0,77,143,0.5384615384615384,0.535,76,128,0.59375
Steve Smith,smithst01,SG,29,ATL,1999,36,1314.0,672,118,50,101,151,36,11,99,100,217,540,0.4018518518518518,47,139,0.3381294964028777,170,401,0.4239401496259352,0.445,191,225,0.8488888888888889
Rik Smits,smitsri01,C,32,IND,1999,49,1271.0,728,52,73,202,275,18,52,75,159,310,633,0.4897314375987361,0,2,0.0,310,631,0.491283676703645,0.49,108,132,0.8181818181818182
Eric Snow,snower01,PG,25,PHI,1999,48,1716.0,413,301,25,137,162,100,1,111,149,149,348,0.4281609195402299,5,21,0.238095238095238,144,327,0.4403669724770642,0.435,110,150,0.7333333333333333
Felton Spencer,spencfe01,C,31,GSW,1999,26,159.0,42,0,18,28,46,5,10,9,41,15,33,0.4545454545454545,0,0,0.0,15,33,0.4545454545454545,0.455,12,26,0.4615384615384615
Latrell Sprewell,sprewla01,SF,28,NYK,1999,37,1233.0,606,91,41,115,156,46,2,79,65,215,518,0.415057915057915,21,77,0.2727272727272727,194,441,0.4399092970521542,0.435,155,191,0.8115183246073299
Ryan Stack,stackry01,PF,23,CLE,1999,18,199.0,47,5,19,15,34,2,11,9,31,14,37,0.3783783783783784,0,0,0.0,14,37,0.3783783783783784,0.378,19,20,0.95
Jerry Stackhouse,stackje01,SG,24,DET,1999,42,1188.0,607,118,26,81,107,34,19,121,79,181,488,0.3709016393442623,35,126,0.2777777777777778,146,362,0.4033149171270718,0.407,210,247,0.8502024291497976
John Starks,starkjo01,SG,33,GSW,1999,50,1686.0,690,235,33,130,163,69,5,83,135,269,728,0.3695054945054945,78,269,0.2899628252788104,191,459,0.4161220043572984,0.423,74,100,0.74
Vladimir Stepania,stepavl01,C,22,SEA,1999,23,313.0,127,12,27,48,75,10,23,32,58,53,125,0.424,0,3,0.0,53,122,0.4344262295081967,0.424,21,40,0.525
Michael Stewart,stewami01,C,23,TOR,1999,42,394.0,61,5,43,56,99,4,28,12,76,22,53,0.4150943396226415,0,0,0.0,22,53,0.4150943396226415,0.415,17,25,0.68
Bryant Stith,stithbr01,SG,28,DEN,1999,46,1194.0,320,82,30,77,107,28,15,45,65,114,290,0.3931034482758621,31,106,0.2924528301886792,83,184,0.4510869565217391,0.447,61,71,0.8591549295774648
John Stockton,stockjo01,PG,36,UTA,1999,50,1410.0,553,374,31,115,146,81,13,110,107,200,410,0.4878048780487805,16,50,0.32,184,360,0.5111111111111111,0.507,137,169,0.8106508875739645
Peja Stojaković,stojape01,SF,21,SAC,1999,48,1025.0,402,72,43,100,143,41,7,53,43,141,373,0.3780160857908847,57,178,0.3202247191011236,84,195,0.4307692307692308,0.454,63,74,0.8513513513513513
Damon Stoudamire,stoudda01,PG,25,POR,1999,50,1673.0,631,312,41,126,167,49,4,110,81,249,629,0.3958664546899841,44,142,0.3098591549295774,205,487,0.4209445585215606,0.431,89,122,0.7295081967213115
Erick Strickland,stricer01,SG,25,DAL,1999,33,567.0,249,64,12,71,83,40,2,36,44,89,221,0.4027149321266968,18,59,0.3050847457627119,71,162,0.4382716049382716,0.443,53,65,0.8153846153846154
Mark Strickland,stricma01,PF,28,MIA,1999,32,357.0,119,9,26,52,78,7,8,13,28,50,101,0.495049504950495,0,1,0.0,50,100,0.5,0.495,19,26,0.7307692307692307
Rod Strickland,stricro02,PG,32,WAS,1999,44,1632.0,690,434,56,156,212,76,5,142,91,251,603,0.4162520729684908,12,42,0.2857142857142857,239,561,0.4260249554367201,0.426,176,236,0.7457627118644068
Derek Strong,stronde01,PF,30,ORL,1999,44,695.0,223,17,66,95,161,15,7,37,64,76,180,0.4222222222222222,0,2,0.0,76,178,0.4269662921348314,0.422,71,99,0.7171717171717171
Bruno Šundov,sundobr01,C,18,DAL,1999,3,11.0,4,1,0,0,0,0,0,1,4,2,7,0.2857142857142857,0,0,0.0,2,7,0.2857142857142857,0.286,0,0,0.0
Bob Sura,surabo01,PG,25,CLE,1999,50,841.0,214,152,21,81,102,46,14,67,98,70,210,0.3333333333333333,9,45,0.2,61,165,0.3696969696969697,0.355,65,103,0.6310679611650486
Johnny Taylor,taylojo01,SF,24,DEN,1999,36,724.0,207,24,30,71,101,28,17,34,97,82,198,0.4141414141414141,26,68,0.3823529411764705,56,130,0.4307692307692308,0.48,17,23,0.7391304347826086
Maurice Taylor,tayloma01,PF,22,LAC,1999,46,1505.0,773,67,100,142,242,16,29,120,179,311,675,0.4607407407407407,1,6,0.1666666666666666,310,669,0.4633781763826607,0.461,150,206,0.7281553398058253
John Thomas,thomajo02,C,23,TOR,1999,39,593.0,169,15,65,69,134,17,9,21,82,71,123,0.5772357723577236,0,1,0.0,71,122,0.5819672131147541,0.577,27,48,0.5625
Kurt Thomas,thomaku01,PF,26,NYK,1999,50,1182.0,406,55,82,204,286,45,17,73,159,170,368,0.4619565217391304,0,1,0.0,170,367,0.4632152588555858,0.462,66,108,0.6111111111111112
Tim Thomas,thomati01,SF,21,TOT,1999,50,812.0,358,46,49,77,126,26,12,46,107,132,279,0.4731182795698925,21,68,0.3088235294117647,111,211,0.5260663507109005,0.511,73,112,0.6517857142857143
Otis Thorpe,thorpot01,PF,36,WAS,1999,49,1539.0,554,101,96,238,334,42,19,88,196,240,440,0.5454545454545454,0,2,0.0,240,438,0.547945205479452,0.545,74,106,0.6981132075471698
Robert Traylor,traylro01,C,21,MIL,1999,49,786.0,259,38,80,102,182,44,44,42,140,108,201,0.5373134328358209,0,1,0.0,108,200,0.54,0.537,43,80,0.5375
Gary Trent,trentga01,PF,24,DAL,1999,45,1362.0,719,77,127,224,351,29,23,66,122,287,602,0.4767441860465116,0,5,0.0,287,597,0.4807370184254606,0.477,145,235,0.6170212765957447
Nick Van Exel,vanexni01,PG,27,DEN,1999,50,1802.0,826,368,14,99,113,40,3,121,90,306,769,0.3979193758127438,72,234,0.3076923076923077,234,535,0.4373831775700935,0.445,142,175,0.8114285714285714
Keith Van Horn,vanhoke01,PF,23,NJN,1999,42,1576.0,916,65,114,244,358,43,53,133,134,322,752,0.4281914893617021,16,53,0.3018867924528302,306,699,0.4377682403433476,0.439,256,298,0.8590604026845637
David Vaughn,vaughda02,PF,25,NJN,1999,10,103.0,34,1,13,21,34,2,8,11,22,13,24,0.5416666666666666,0,0,0.0,13,24,0.5416666666666666,0.542,8,10,0.8
Jacque Vaughn,vaughja01,PG,23,UTA,1999,19,87.0,44,12,1,10,11,5,0,14,14,11,30,0.3666666666666666,2,8,0.25,9,22,0.4090909090909091,0.4,20,24,0.8333333333333334
Loy Vaught,vaughlo01,PF,30,DET,1999,37,481.0,127,11,36,110,146,15,6,17,54,59,155,0.3806451612903225,0,1,0.0,59,154,0.3831168831168831,0.381,9,14,0.6428571428571429
Stojko Vranković,vrankst01,C,35,LAC,1999,2,12.0,2,0,4,2,6,0,0,0,2,1,4,0.25,0,0,0.0,1,4,0.25,0.25,0,0,0.0
Antoine Walker,walkean02,PF,22,BOS,1999,42,1549.0,784,130,106,253,359,63,28,119,142,303,735,0.4122448979591837,65,176,0.3693181818181818,238,559,0.4257602862254025,0.456,113,202,0.5594059405940595
Samaki Walker,walkesa01,PF,22,DAL,1999,39,568.0,229,6,46,97,143,9,16,37,87,88,190,0.4631578947368421,0,1,0.0,88,189,0.4656084656084656,0.463,53,98,0.5408163265306123
Ben Wallace,wallabe01,C,24,WAS,1999,46,1231.0,277,18,137,247,384,50,90,36,111,115,199,0.5778894472361809,0,0,0.0,115,199,0.5778894472361809,0.578,47,132,0.3560606060606061
John Wallace,wallajo01,SF,24,TOR,1999,48,812.0,411,46,54,117,171,12,43,70,92,153,354,0.4322033898305085,0,0,0.0,153,354,0.4322033898305085,0.432,105,150,0.7
Rasheed Wallace,wallara01,PF,24,POR,1999,49,1414.0,628,60,57,184,241,48,54,80,175,242,476,0.5084033613445378,13,31,0.4193548387096774,229,445,0.5146067415730337,0.522,131,179,0.7318435754189944
Rex Walters,waltere01,SG,28,MIA,1999,33,506.0,101,58,10,40,50,10,3,32,63,35,95,0.3684210526315789,12,38,0.3157894736842105,23,57,0.4035087719298245,0.432,19,23,0.8260869565217391
Charlie Ward,wardch01,PG,28,NYK,1999,50,1556.0,378,271,23,149,172,103,8,131,105,135,334,0.4041916167664671,53,149,0.3557046979865771,82,185,0.4432432432432432,0.484,55,78,0.7051282051282052
Eric Washington,washier01,SG,24,DEN,1999,38,761.0,205,30,35,54,89,25,18,34,87,73,184,0.3967391304347826,37,97,0.3814432989690721,36,87,0.4137931034482758,0.497,22,32,0.6875
Jamie Watson,watsoja01,SF,26,MIA,1999,3,18.0,2,1,0,1,1,0,0,1,1,1,2,0.5,0,0,0.0,1,2,0.5,0.5,0,0,0.0
Clarence Weatherspoon,weathcl01,SF,28,MIA,1999,49,1040.0,397,34,72,171,243,28,17,61,107,141,264,0.5340909090909091,0,0,0.0,141,264,0.5340909090909091,0.534,115,143,0.8041958041958042
Chris Webber,webbech01,PF,25,SAC,1999,42,1719.0,839,173,149,396,545,60,89,148,145,378,778,0.4858611825192802,4,34,0.1176470588235294,374,744,0.5026881720430108,0.488,79,174,0.4540229885057471
Bonzi Wells,wellsbo01,SF,22,POR,1999,7,35.0,31,3,4,5,9,1,1,6,5,11,20,0.55,1,3,0.3333333333333333,10,17,0.5882352941176471,0.575,8,18,0.4444444444444444
Bill Wennington,wennibi01,C,35,CHI,1999,38,451.0,143,18,20,59,79,13,12,17,79,62,178,0.348314606741573,1,1,1.0,61,177,0.3446327683615819,0.351,18,22,0.8181818181818182
David Wesley,wesleda01,PG,28,CHH,1999,50,1848.0,706,322,23,138,161,100,10,142,130,243,545,0.4458715596330275,61,170,0.3588235294117647,182,375,0.4853333333333333,0.502,159,191,0.8324607329842932
Doug West,westdo01,SG,31,VAN,1999,14,294.0,81,19,5,20,25,16,7,12,38,31,65,0.4769230769230769,0,2,0.0,31,63,0.492063492063492,0.477,19,25,0.76
Mark West,westma01,C,38,ATL,1999,49,499.0,60,13,49,76,125,4,22,17,81,22,59,0.3728813559322034,0,0,0.0,22,59,0.3728813559322034,0.373,16,45,0.3555555555555555
DeJuan Wheat,wheatde01,PG,25,VAN,1999,46,590.0,208,102,11,34,45,26,2,48,59,73,193,0.3782383419689119,22,60,0.3666666666666666,51,133,0.3834586466165413,0.435,40,55,0.7272727272727273
Tyson Wheeler,wheelty01,PG,23,DEN,1999,1,3.0,4,2,0,0,0,0,0,0,1,1,1,1.0,1,1,1.0,0,0,0.0,1.5,1,2,0.5
Jahidi White,whiteja01,PF,22,WAS,1999,20,191.0,49,1,23,35,58,3,11,16,39,17,32,0.53125,0,0,0.0,17,32,0.53125,0.531,15,35,0.4285714285714285
Chris Whitney,whitnch01,PG,27,WAS,1999,39,441.0,187,69,8,39,47,18,2,36,49,64,156,0.4102564102564102,32,95,0.3368421052631579,32,61,0.5245901639344263,0.513,27,31,0.8709677419354839
Dominique Wilkins,wilkido01,SF,39,ORL,1999,27,252.0,134,16,30,41,71,4,1,23,19,50,132,0.3787878787878788,5,19,0.2631578947368421,45,113,0.3982300884955752,0.398,29,42,0.6904761904761905
Gerald Wilkins,wilkige01,SG,35,ORL,1999,3,28.0,2,1,0,1,1,0,0,3,3,0,9,0.0,0,0,0.0,0,9,0.0,0.0,2,2,1.0
Aaron Williams,williaa01,PF,27,SEA,1999,40,458.0,158,22,54,74,128,14,24,30,75,52,123,0.4227642276422764,0,1,0.0,52,122,0.4262295081967213,0.423,54,74,0.7297297297297297
Alvin Williams,willial02,PG,24,TOR,1999,50,1051.0,248,130,19,63,82,51,12,56,94,95,237,0.4008438818565401,14,42,0.3333333333333333,81,195,0.4153846153846154,0.43,44,52,0.8461538461538461
Brandon Williams,willibr01,SG,23,SAS,1999,3,4.0,2,0,1,0,1,0,0,0,0,0,0,0.0,0,0,0.0,0,0,0.0,0.0,2,4,0.5
Eric Williams,willier01,SF,26,DEN,1999,38,780.0,277,37,34,47,81,27,8,49,76,80,219,0.365296803652968,6,26,0.2307692307692307,74,193,0.3834196891191709,0.379,111,139,0.7985611510791367
Herb Williams,willihe01,C,40,NYK,1999,6,34.0,10,0,3,3,6,0,2,2,2,4,8,0.5,0,0,0.0,4,8,0.5,0.5,2,2,1.0
Hot Rod Williams,williho01,C,36,DAL,1999,25,403.0,29,15,36,47,83,13,18,13,49,11,33,0.3333333333333333,0,0,0.0,11,33,0.3333333333333333,0.333,7,10,0.7
Jason Williams,willija02,PG,23,SAC,1999,50,1805.0,641,299,14,139,153,95,1,143,91,231,617,0.3743922204213938,100,323,0.3095975232198142,131,294,0.445578231292517,0.455,79,105,0.7523809523809524
Jayson Williams,willija01,C,30,NJN,1999,30,1020.0,242,33,147,213,360,24,60,46,126,97,218,0.4449541284403669,0,2,0.0,97,216,0.449074074074074,0.445,48,85,0.5647058823529412
Jerome Williams,willije01,PF,25,DET,1999,50,1154.0,355,23,158,191,349,63,7,41,108,124,248,0.5,0,0,0.0,124,248,0.5,0.5,107,159,0.6729559748427673
Micheal Williams,willimi02,PG,32,TOR,1999,2,15.0,2,0,1,0,1,0,0,1,1,1,5,0.2,0,0,0.0,1,5,0.2,0.2,0,0,0.0
Monty Williams,willimo01,SF,27,DEN,1999,1,6.0,1,0,0,0,0,0,0,0,0,0,2,0.0,0,0,0.0,0,2,0.0,0.0,1,2,0.5
Scott Williams,willisc01,C,30,TOT,1999,7,46.0,14,1,3,11,14,3,2,4,9,5,17,0.2941176470588235,0,0,0.0,5,17,0.2941176470588235,0.294,4,7,0.5714285714285714
Shammond Williams,willish01,PG,23,ATL,1999,2,4.0,3,1,0,0,0,0,0,0,0,0,1,0.0,0,0,0.0,0,1,0.0,0.0,3,4,0.75
Travis Williams,willitr01,SF,29,CHH,1999,8,62.0,15,2,6,13,19,2,1,6,10,6,13,0.4615384615384615,0,0,0.0,6,13,0.4615384615384615,0.462,3,4,0.75
Walt Williams,williwa02,SF,28,POR,1999,48,1044.0,446,80,36,107,143,37,28,63,101,147,347,0.4236311239193083,63,144,0.4375,84,203,0.4137931034482758,0.514,89,107,0.8317757009345794
Corliss Williamson,willico02,SF,25,SAC,1999,50,1374.0,659,66,85,121,206,30,8,75,118,269,555,0.4846846846846847,1,5,0.2,268,550,0.4872727272727272,0.486,120,188,0.6382978723404256
Kevin Willis,willike02,C,36,TOR,1999,42,1216.0,504,67,109,241,350,28,28,86,134,187,447,0.4183445190156599,0,2,0.0,187,445,0.4202247191011236,0.418,130,155,0.8387096774193549
David Wingate,wingada01,SG,35,NYK,1999,20,92.0,14,5,3,5,8,4,0,6,10,7,16,0.4375,0,0,0.0,7,16,0.4375,0.438,0,0,0.0
Trevor Winter,wintetr01,C,25,MIN,1999,1,5.0,0,0,1,2,3,0,0,0,5,0,0,0.0,0,0,0.0,0,0,0.0,0.0,0,0,0.0
Joe Wolf,wolfjo01,PF,34,CHH,1999,3,12.0,0,0,0,1,1,0,0,0,6,0,1,0.0,0,0,0.0,0,1,0.0,0.0,0,2,0.0
Haywoode Workman,workmha01,PG,33,MIL,1999,29,815.0,200,172,14,88,102,32,1,63,53,73,170,0.4294117647058823,17,47,0.3617021276595745,56,123,0.4552845528455284,0.479,37,47,0.7872340425531915
Lorenzen Wright,wrighlo02,C,23,LAC,1999,48,1135.0,319,33,142,219,361,26,36,48,162,119,260,0.4576923076923077,0,1,0.0,119,259,0.4594594594594595,0.458,81,117,0.6923076923076923
Korleone Young,youngko01,SF,20,DET,1999,3,15.0,13,1,2,2,4,0,0,1,3,5,10,0.5,1,4,0.25,4,6,0.6666666666666666,0.55,2,2,1.0
Tariq Abdul-Wahad,abdulta01,SG,25,TOT,2000,61,1578.0,697,98,101,190,291,59,28,106,147,274,646,0.4241486068111455,3,23,0.1304347826086956,271,623,0.434991974317817,0.426,146,193,0.7564766839378239
Shareef Abdur-Rahim,abdursh01,SF,23,VAN,2000,82,3223.0,1663,271,218,607,825,89,87,249,244,594,1277,0.4651527016444792,29,96,0.3020833333333333,565,1181,0.4784081287044877,0.477,446,551,0.809437386569873
Cory Alexander,alexaco01,PG,26,DEN,2000,29,329.0,82,58,8,34,42,24,2,28,39,28,98,0.2857142857142857,9,35,0.2571428571428571,19,63,0.3015873015873015,0.332,17,22,0.7727272727272727
Ray Allen,allenra02,SG,24,MIL,2000,82,3070.0,1809,308,83,276,359,110,19,183,187,642,1411,0.4549964564138908,172,407,0.4226044226044226,470,1004,0.4681274900398406,0.516,353,398,0.8869346733668342
Rafer Alston,alstora01,PG,23,MIL,2000,27,361.0,60,70,5,18,23,12,0,29,29,27,95,0.2842105263157894,3,14,0.2142857142857142,24,81,0.2962962962962963,0.3,3,4,0.75
John Amaechi,amaecjo01,C,29,ORL,2000,80,1684.0,836,95,62,204,266,35,37,139,161,306,700,0.4371428571428571,1,6,0.1666666666666666,305,694,0.4394812680115273,0.438,223,291,0.7663230240549829
Derek Anderson,anderde01,SG,25,LAC,2000,64,2201.0,1080,220,80,178,258,90,11,167,149,377,860,0.4383720930232558,55,178,0.3089887640449438,322,682,0.4721407624633431,0.47,271,309,0.8770226537216829
Kenny Anderson,anderke01,PG,29,BOS,2000,82,2593.0,1149,420,55,170,225,139,8,130,230,434,986,0.4401622718052738,85,220,0.3863636363636363,349,766,0.4556135770234987,0.483,196,253,0.7747035573122529
Nick Anderson,anderni01,SG,32,SAC,2000,72,2094.0,781,123,83,256,339,94,16,95,118,306,782,0.391304347826087,132,397,0.3324937027707808,174,385,0.4519480519480519,0.476,37,76,0.4868421052631579
Shandon Anderson,andersh01,SF,26,HOU,2000,82,2700.0,1009,239,91,293,384,96,32,194,182,368,778,0.4730077120822622,79,225,0.3511111111111111,289,553,0.5226039783001808,0.524,194,253,0.766798418972332
Chris Anstey,anstech01,C,25,CHI,2000,73,1007.0,439,65,90,190,280,29,25,80,180,161,364,0.4423076923076923,1,6,0.1666666666666666,160,358,0.4469273743016759,0.444,116,147,0.7891156462585034
Greg Anthony,anthogr01,PG,32,POR,2000,82,1548.0,514,208,17,116,133,59,9,85,143,169,416,0.40625,88,233,0.3776824034334764,81,183,0.4426229508196721,0.512,88,114,0.7719298245614035
B.J. Armstrong,armstbj01,PG,32,CHI,2000,27,583.0,201,78,2,45,47,7,1,40,34,83,186,0.4462365591397849,13,29,0.4482758620689655,70,157,0.445859872611465,0.481,22,25,0.88
Darrell Armstrong,armstda01,PG,31,ORL,2000,82,2590.0,1330,501,65,205,270,169,9,248,137,484,1119,0.4325290437890974,137,403,0.3399503722084367,347,716,0.4846368715083798,0.494,225,247,0.9109311740890688
Chucky Atkins,atkinch01,PG,25,ORL,2000,82,1626.0,782,306,20,106,126,52,3,142,137,314,741,0.4237516869095816,57,163,0.3496932515337423,257,578,0.444636678200692,0.462,97,133,0.7293233082706767
Stacey Augmon,augmost01,SG,31,POR,2000,59,692.0,203,53,42,74,116,27,11,38,69,83,175,0.4742857142857143,0,2,0.0,83,173,0.4797687861271676,0.474,37,55,0.6727272727272727
Isaac Austin,austiis01,C,30,WAS,2000,59,1173.0,397,74,64,218,282,17,38,107,128,151,352,0.4289772727272727,1,4,0.25,150,348,0.4310344827586206,0.43,94,137,0.6861313868613139
Anthony Avent,aventan01,PF,30,LAC,2000,49,377.0,81,11,23,51,74,16,15,24,62,29,96,0.3020833333333333,0,0,0.0,29,96,0.3020833333333333,0.302,23,32,0.71875
William Avery,averywi01,PG,20,MIN,2000,59,484.0,154,88,8,32,40,14,2,42,60,56,181,0.3093922651933701,18,63,0.2857142857142857,38,118,0.3220338983050847,0.359,24,36,0.6666666666666666
Toby Bailey,baileto01,SG,24,PHO,2000,46,449.0,163,30,26,46,72,13,4,24,55,58,140,0.4142857142857143,2,10,0.2,56,130,0.4307692307692308,0.421,45,65,0.6923076923076923
Vin Baker,bakervi01,C,28,SEA,2000,79,2849.0,1311,148,227,378,605,47,66,213,288,514,1129,0.4552701505757307,2,8,0.25,512,1121,0.4567350579839429,0.456,281,412,0.6820388349514563
Charles Barkley,barklch01,PF,36,HOU,2000,20,620.0,289,63,71,138,209,14,4,44,48,106,222,0.4774774774774775,6,26,0.2307692307692307,100,196,0.5102040816326531,0.491,71,110,0.6454545454545455
Dana Barros,barroda01,PG,32,BOS,2000,72,1139.0,517,133,13,86,99,31,4,66,80,196,435,0.4505747126436781,59,144,0.4097222222222222,137,291,0.4707903780068728,0.518,66,76,0.868421052631579
Brent Barry,barrybr01,SG,28,SEA,2000,80,2726.0,945,291,50,322,372,103,31,142,228,327,707,0.4625176803394625,164,399,0.4110275689223057,163,308,0.5292207792207793,0.579,127,157,0.8089171974522293
Drew Barry,barrydr01,PG,26,TOT,2000,16,159.0,41,33,0,12,12,2,0,13,23,15,33,0.4545454545454545,7,18,0.3888888888888889,8,15,0.5333333333333333,0.561,4,5,0.8
Jon Barry,barryjo01,SG,30,SAC,2000,62,1281.0,495,150,38,121,159,75,7,85,104,161,346,0.4653179190751445,66,154,0.4285714285714285,95,192,0.4947916666666667,0.561,107,116,0.9224137931034484
Tony Battie,battito01,C,23,BOS,2000,82,1505.0,541,63,152,258,410,47,70,67,249,219,459,0.477124183006536,1,8,0.125,218,451,0.483370288248337,0.478,102,151,0.6754966887417219
Jonathan Bender,bendejo01,SF,19,IND,2000,24,130.0,64,3,4,17,21,1,5,7,18,23,70,0.3285714285714285,2,12,0.1666666666666666,21,58,0.3620689655172414,0.343,16,24,0.6666666666666666
Benoit Benjamin,benjabe01,C,35,CLE,2000,3,8.0,2,0,0,1,1,0,1,0,1,1,3,0.3333333333333333,0,0,0.0,1,3,0.3333333333333333,0.333,0,0,0.0
Corey Benjamin,benjaco01,SG,21,CHI,2000,48,862.0,370,54,21,67,88,31,22,74,122,145,350,0.4142857142857143,31,89,0.348314606741573,114,261,0.4367816091954023,0.459,49,82,0.5975609756097561
Mario Bennett,bennema01,PF,26,LAC,2000,1,3.0,0,0,1,1,2,0,0,0,1,0,3,0.0,0,0,0.0,0,3,0.0,0.0,0,0,0.0
Travis Best,besttr01,PG,27,IND,2000,82,1691.0,733,272,16,126,142,76,5,107,204,271,561,0.483065953654189,35,93,0.3763440860215054,236,468,0.5042735042735043,0.514,156,190,0.8210526315789474
Mike Bibby,bibbymi01,PG,21,VAN,2000,82,3155.0,1190,665,73,233,306,132,15,247,171,459,1031,0.4451988360814743,77,212,0.3632075471698113,382,819,0.4664224664224664,0.483,195,250,0.78
Chauncey Billups,billuch01,SG,23,DEN,2000,13,305.0,112,39,8,26,34,10,2,24,27,34,101,0.3366336633663366,7,41,0.1707317073170731,27,60,0.45,0.371,37,44,0.8409090909090909
Mookie Blaylock,blaylmo01,PG,32,GSW,2000,73,2459.0,822,489,55,215,270,146,22,143,122,327,837,0.3906810035842294,101,301,0.335548172757475,226,536,0.4216417910447761,0.451,67,95,0.7052631578947368
Corie Blount,blounco01,PF,31,PHO,2000,38,446.0,107,10,52,61,113,15,7,28,78,44,89,0.4943820224719101,0,2,0.0,44,87,0.5057471264367817,0.494,19,33,0.5757575757575758
Muggsy Bogues,boguemu01,PG,35,TOR,2000,80,1731.0,410,299,25,110,135,65,4,59,119,157,358,0.4385474860335195,17,51,0.3333333333333333,140,307,0.4560260586319218,0.462,79,87,0.9080459770114944
Etdrick Bohannon,bohanet01,PF,26,TOT,2000,13,118.0,29,5,13,18,31,2,6,10,25,7,13,0.5384615384615384,0,0,0.0,7,13,0.5384615384615384,0.538,15,24,0.625
Calvin Booth,boothca01,C,23,WAS,2000,11,143.0,42,7,15,17,32,3,14,6,23,16,46,0.3478260869565217,0,0,0.0,16,46,0.3478260869565217,0.348,10,14,0.7142857142857143
Lazaro Borrell,borrela01,SF,27,SEA,2000,17,167.0,62,10,14,26,40,6,3,6,9,28,63,0.4444444444444444,0,3,0.0,28,60,0.4666666666666667,0.444,6,11,0.5454545454545454
Cal Bowdler,bowdlca01,SF,22,ATL,2000,46,423.0,122,14,22,63,85,14,9,21,46,49,115,0.4260869565217391,0,1,0.0,49,114,0.4298245614035088,0.426,24,38,0.631578947368421
Bruce Bowen,bowenbr01,SF,28,TOT,2000,69,878.0,196,34,27,69,96,23,15,19,118,72,194,0.3711340206185567,27,58,0.4655172413793103,45,136,0.3308823529411764,0.441,25,43,0.5813953488372093
Ryan Bowen,bowenry01,SF,24,DEN,2000,52,589.0,131,20,75,39,114,39,13,14,95,46,117,0.3931623931623931,1,9,0.1111111111111111,45,108,0.4166666666666667,0.397,38,53,0.7169811320754716
Ira Bowman,bowmair01,SG,26,PHI,2000,11,20.0,5,1,0,2,2,1,0,1,0,2,2,1.0,0,0,0.0,2,2,1.0,1.0,1,2,0.5
Earl Boykins,boykiea01,PG,23,TOT,2000,26,261.0,138,48,12,14,26,12,1,17,23,56,116,0.4827586206896552,8,20,0.4,48,96,0.5,0.517,18,23,0.782608695652174
Shawn Bradley,bradlsh01,C,27,DAL,2000,77,1901.0,647,60,160,337,497,71,190,74,260,266,555,0.4792792792792792,1,5,0.2,265,550,0.4818181818181818,0.48,114,149,0.7651006711409396
A.J. Bramlett,bramlaj01,C,23,CLE,2000,8,61.0,8,0,12,10,22,1,0,3,13,4,21,0.1904761904761904,0,0,0.0,4,21,0.1904761904761904,0.19,0,0,0.0
Elton Brand,brandel01,PF,20,CHI,2000,81,2999.0,1627,155,348,462,810,66,132,228,259,630,1306,0.4823889739663093,0,2,0.0,630,1304,0.4831288343558282,0.482,367,536,0.6847014925373134
Terrell Brandon,brandte01,PG,29,MIN,2000,71,2587.0,1212,629,44,194,238,134,30,184,158,486,1042,0.4664107485604606,53,132,0.4015151515151515,433,910,0.4758241758241758,0.492,187,208,0.8990384615384616
Chucky Brown,brownch01,PF,31,TOT,2000,63,1096.0,334,66,35,132,167,20,18,45,114,148,328,0.4512195121951219,2,10,0.2,146,318,0.4591194968553459,0.454,36,52,0.6923076923076923
Dee Brown,brownde01,PG,31,TOR,2000,38,673.0,264,86,9,45,54,24,5,39,62,93,258,0.3604651162790697,67,187,0.3582887700534759,26,71,0.3661971830985915,0.49,11,16,0.6875
Marcus Brown,brownma01,SG,25,DET,2000,6,45.0,10,3,3,4,7,0,0,3,8,4,14,0.2857142857142857,0,7,0.0,4,7,0.5714285714285714,0.286,2,2,1.0
P.J. Brown,brownpj01,PF,30,MIA,2000,80,2302.0,764,145,216,384,600,65,61,100,264,322,671,0.4798807749627422,0,1,0.0,322,670,0.4805970149253731,0.48,120,159,0.7547169811320755
Randy Brown,brownra02,PG,31,CHI,2000,59,1625.0,379,202,23,121,144,61,15,105,120,157,435,0.360919540229885,3,6,0.5,154,429,0.358974358974359,0.364,62,84,0.7380952380952381
Rick Brunson,brunsri01,PG,27,NYK,2000,37,289.0,71,49,3,24,27,9,1,31,35,29,70,0.4142857142857143,2,13,0.1538461538461538,27,57,0.4736842105263157,0.429,11,18,0.6111111111111112
Kobe Bryant,bryanko01,SG,21,LAL,2000,66,2524.0,1485,323,108,308,416,106,62,182,220,554,1183,0.4683009298393913,46,144,0.3194444444444444,508,1039,0.4889316650625601,0.488,331,403,0.8213399503722084
Mark Bryant,bryanma01,PF,34,CLE,2000,75,1712.0,424,61,126,226,352,31,31,87,250,174,346,0.5028901734104047,0,0,0.0,174,346,0.5028901734104047,0.503,76,94,0.8085106382978723
Greg Buckner,buckngr01,SG,23,DAL,2000,48,923.0,275,55,56,118,174,38,20,36,148,111,233,0.4763948497854077,10,26,0.3846153846153846,101,207,0.4879227053140096,0.498,43,63,0.6825396825396826
Jud Buechler,buechju01,SF,31,DET,2000,58,657.0,130,33,30,61,91,25,16,13,50,55,156,0.3525641025641026,18,83,0.216867469879518,37,73,0.5068493150684932,0.41,2,7,0.2857142857142857
Rodney Buford,buforro01,SG,22,MIA,2000,34,386.0,147,21,10,38,48,10,8,9,44,62,151,0.4105960264900662,7,29,0.2413793103448276,55,122,0.4508196721311475,0.434,16,22,0.7272727272727273
Matt Bullard,bullama01,PF,32,HOU,2000,56,1024.0,382,63,13,125,138,19,13,36,85,139,340,0.4088235294117647,79,177,0.4463276836158192,60,163,0.3680981595092024,0.525,25,30,0.8333333333333334
Scott Burrell,burresc01,SF,29,NJN,2000,74,1336.0,451,72,65,191,256,67,44,38,173,165,419,0.3937947494033413,82,232,0.3534482758620689,83,187,0.4438502673796791,0.492,39,50,0.78
Jason Caffey,caffeja01,PF,26,GSW,2000,71,2159.0,852,119,189,293,482,62,20,170,269,323,675,0.4785185185185185,0,2,0.0,323,673,0.4799405646359584,0.479,206,345,0.5971014492753624
Michael Cage,cagemi01,C,38,NJN,2000,20,242.0,27,9,33,48,81,8,8,4,30,12,24,0.5,0,0,0.0,12,24,0.5,0.5,3,3,1.0
Marcus Camby,cambyma01,C,25,NYK,2000,59,1548.0,601,49,174,287,461,43,116,72,204,226,471,0.4798301486199575,1,2,0.5,225,469,0.4797441364605543,0.481,148,221,0.669683257918552
Elden Campbell,campbel01,C,31,CHH,2000,78,2538.0,987,129,168,422,590,56,150,127,269,370,829,0.4463208685162846,0,6,0.0,370,823,0.4495747266099635,0.446,247,358,0.6899441340782123
Antoine Carr,carran01,SF,38,VAN,2000,21,221.0,67,7,8,24,32,3,6,9,42,28,64,0.4375,0,0,0.0,28,64,0.4375,0.438,11,14,0.7857142857142857
Chris Carr,carrch01,SF-SG,25,TOT,2000,57,1166.0,531,84,41,132,173,30,15,117,113,196,496,0.3951612903225806,32,101,0.3168316831683168,164,395,0.4151898734177215,0.427,107,125,0.856
Anthony Carter,cartean01,PG,24,MIA,2000,79,1859.0,498,378,48,151,199,93,5,173,167,201,509,0.3948919449901768,3,23,0.1304347826086956,198,486,0.4074074074074074,0.398,93,124,0.75
Vince Carter,cartevi01,SF,23,TOR,2000,82,3126.0,2107,322,150,326,476,110,92,178,263,788,1696,0.4646226415094339,95,236,0.4025423728813559,693,1460,0.4746575342465753,0.493,436,551,0.7912885662431942
Sam Cassell,cassesa01,PG,30,MIL,2000,81,2899.0,1506,729,69,232,301,102,8,267,255,545,1170,0.4658119658119658,26,90,0.2888888888888888,519,1080,0.4805555555555555,0.477,390,445,0.8764044943820225
Kelvin Cato,catoke01,C,25,HOU,2000,65,1581.0,567,26,102,287,389,33,124,71,175,216,402,0.5373134328358209,0,4,0.0,216,398,0.542713567839196,0.537,135,208,0.6490384615384616
Duane Causwell,causwdu01,C,31,MIA,2000,25,185.0,66,2,11,36,47,2,16,10,42,20,37,0.5405405405405406,0,0,0.0,20,37,0.5405405405405406,0.541,26,38,0.6842105263157895
Cedric Ceballos,cebalce01,SF,30,DAL,2000,69,2064.0,1147,90,172,290,462,56,24,125,165,447,1002,0.4461077844311377,44,134,0.3283582089552239,403,868,0.4642857142857143,0.468,209,248,0.842741935483871
John Celestand,celesjo01,PG,22,LAL,2000,16,185.0,37,20,1,10,11,7,0,16,22,15,45,0.3333333333333333,2,9,0.2222222222222222,13,36,0.3611111111111111,0.356,5,6,0.8333333333333334
Rex Chapman,chapmre01,SG,32,PHO,2000,53,957.0,348,62,10,70,80,22,1,38,70,124,320,0.3875,41,123,0.3333333333333333,83,197,0.4213197969543147,0.452,59,78,0.7564102564102564
Calbert Cheaney,cheanca01,SG,28,BOS,2000,67,1309.0,267,80,23,115,138,44,14,46,158,120,273,0.4395604395604395,18,54,0.3333333333333333,102,219,0.4657534246575342,0.473,9,21,0.4285714285714285
Pete Chilcutt,chilcpe01,PF,31,TOT,2000,56,601.0,120,27,46,85,131,15,10,20,73,53,127,0.4173228346456692,6,26,0.2307692307692307,47,101,0.4653465346534653,0.441,8,8,1.0
Chris Childs,childch01,PG,32,NYK,2000,71,1675.0,376,285,17,130,147,36,4,105,240,146,357,0.4089635854341736,37,104,0.3557692307692308,109,253,0.4308300395256917,0.461,47,59,0.7966101694915254
Doug Christie,chrisdo01,SG,29,TOR,2000,73,2264.0,903,321,63,222,285,102,43,144,167,311,764,0.4070680628272251,99,275,0.36,212,489,0.4335378323108384,0.472,182,216,0.8425925925925926
Keon Clark,clarkke01,C,24,DEN,2000,81,1850.0,694,71,162,343,505,45,114,125,231,286,528,0.5416666666666666,1,8,0.125,285,520,0.5480769230769231,0.543,121,176,0.6875
Keith Closs,closske01,C,23,LAC,2000,57,820.0,238,25,65,114,179,13,73,34,80,96,197,0.4873096446700508,0,3,0.0,96,194,0.4948453608247423,0.487,46,78,0.5897435897435898
Derrick Coleman,colemde01,PF,32,CHH,2000,74,2347.0,1239,175,124,508,632,34,130,173,195,446,979,0.4555669050051072,51,141,0.3617021276595745,395,838,0.4713603818615752,0.482,296,377,0.7851458885941645
Bimbo Coles,colesbi01,PG,31,ATL,2000,80,1924.0,645,290,30,142,172,58,11,103,178,276,607,0.4546952224052718,8,39,0.2051282051282051,268,568,0.4718309859154929,0.461,85,104,0.8173076923076923
Marty Conlon,conloma01,C,32,LAC,2000,3,9.0,2,0,1,1,2,0,0,0,1,1,2,0.5,0,0,0.0,1,2,0.5,0.5,0,0,0.0
Tyrone Corbin,corbity01,SF,37,SAC,2000,54,941.0,219,60,40,125,165,36,5,29,99,88,247,0.3562753036437247,10,44,0.2272727272727272,78,203,0.3842364532019704,0.377,33,39,0.8461538461538461
Chris Crawford,crawfch01,PF,24,ATL,2000,55,668.0,252,33,51,48,99,17,16,37,83,91,229,0.3973799126637554,7,27,0.2592592592592592,84,202,0.4158415841584158,0.413,63,81,0.7777777777777778
Austin Croshere,croshau01,PF,24,IND,2000,81,1885.0,835,89,135,381,516,44,60,121,203,288,653,0.4410413476263399,63,174,0.3620689655172414,225,479,0.4697286012526096,0.489,196,231,0.8484848484848485
John Crotty,crottjo01,PG,30,DET,2000,69,937.0,325,128,17,58,75,27,5,54,104,106,251,0.4223107569721115,33,80,0.4125,73,171,0.4269005847953216,0.488,80,93,0.8602150537634409
Terry Cummings,cummite01,PF,38,GSW,2000,22,398.0,184,21,45,62,107,13,8,27,74,76,177,0.4293785310734463,0,0,0.0,76,177,0.4293785310734463,0.429,32,39,0.8205128205128205
Vonteego Cummings,cummivo01,PG,23,GSW,2000,75,1793.0,706,247,57,127,184,91,13,132,174,265,655,0.4045801526717557,49,151,0.3245033112582781,216,504,0.4285714285714285,0.442,127,169,0.7514792899408284
Bill Curley,curlebi01,SF-PF,27,TOT,2000,28,309.0,76,14,18,32,50,13,4,21,61,29,68,0.4264705882352941,0,1,0.0,29,67,0.4328358208955223,0.426,18,25,0.72
Dell Curry,curryde01,SG,35,TOR,2000,67,1095.0,507,89,11,89,100,32,9,40,66,194,454,0.4273127753303964,95,242,0.3925619834710744,99,212,0.4669811320754717,0.532,24,32,0.75
Michael Curry,currymi01,SG,31,DET,2000,82,1611.0,506,87,21,83,104,33,5,73,209,182,379,0.4802110817941952,1,5,0.2,181,374,0.4839572192513369,0.482,141,168,0.8392857142857143
Erick Dampier,dampier01,C,24,GSW,2000,21,495.0,167,19,48,86,134,8,15,29,75,70,173,0.4046242774566474,0,0,0.0,70,173,0.4046242774566474,0.405,27,51,0.5294117647058824
Antonio Daniels,daniean01,SG,24,SAS,2000,68,1195.0,420,177,16,70,86,55,5,58,73,163,344,0.4738372093023256,22,66,0.3333333333333333,141,278,0.5071942446043165,0.506,72,101,0.7128712871287128
Kornél Dávid,davidko01,SF,28,TOT,2000,32,474.0,179,17,26,55,81,17,3,33,56,67,157,0.4267515923566879,0,3,0.0,67,154,0.435064935064935,0.427,45,56,0.8035714285714286
Antonio Davis,davisan01,C,31,TOR,2000,79,2479.0,910,105,235,461,696,38,100,121,267,313,712,0.4396067415730337,0,0,0.0,313,712,0.4396067415730337,0.44,284,371,0.7654986522911051
Baron Davis,davisba01,PG,20,CHH,2000,82,1523.0,486,309,48,117,165,97,19,140,201,182,433,0.4203233256351039,25,111,0.2252252252252252,157,322,0.4875776397515527,0.449,97,153,0.6339869281045751
Ben Davis,davisbe01,PF,27,PHO,2000,5,22.0,4,2,3,6,9,1,1,3,2,2,6,0.3333333333333333,0,0,0.0,2,6,0.3333333333333333,0.333,0,0,0.0
Dale Davis,davisda01,C,30,IND,2000,74,2127.0,743,64,256,473,729,52,94,91,203,302,602,0.5016611295681063,0,0,0.0,302,602,0.5016611295681063,0.502,139,203,0.6847290640394089
Emanual Davis,davisem01,PG,31,SEA,2000,54,701.0,217,70,15,85,100,38,5,44,72,80,220,0.3636363636363636,31,103,0.3009708737864077,49,117,0.4188034188034188,0.434,26,38,0.6842105263157895
Hubert Davis,davishu01,PG,29,DAL,2000,79,1817.0,583,141,17,117,134,24,3,70,109,217,464,0.4676724137931034,82,167,0.4910179640718562,135,297,0.4545454545454545,0.556,67,77,0.8701298701298701
Mark Davis,davisma02,SF,26,GSW,2000,23,464.0,143,38,31,53,84,25,4,40,52,56,137,0.4087591240875912,0,2,0.0,56,135,0.4148148148148148,0.409,31,47,0.6595744680851063
Ricky Davis,davisri01,SG,20,CHH,2000,48,570.0,227,62,29,54,83,30,8,46,39,94,187,0.5026737967914439,0,4,0.0,94,183,0.5136612021857924,0.503,39,51,0.7647058823529411
Todd Day,dayto01,SG,30,PHO,2000,58,941.0,396,65,31,98,129,44,22,50,127,130,330,0.3939393939393939,64,165,0.3878787878787879,66,165,0.4,0.491,72,108,0.6666666666666666
Andrew DeClercq,declean01,C,26,CLE,2000,82,1831.0,544,58,156,283,439,63,66,108,275,225,443,0.5079006772009029,0,0,0.0,225,443,0.5079006772009029,0.508,94,160,0.5875
Vinny Del Negro,delnevi01,PG,33,MIL,2000,67,1211.0,349,160,9,98,107,36,0,48,81,153,325,0.4707692307692308,8,24,0.3333333333333333,145,301,0.4817275747508305,0.483,35,39,0.8974358974358975
Tony Delk,delkto01,PG,26,SAC,2000,46,682.0,296,55,36,52,88,35,5,32,58,120,279,0.4301075268817204,9,40,0.225,111,239,0.4644351464435146,0.446,47,59,0.7966101694915254
Derrick Dial,dialde01,SG,24,SAS,2000,8,95.0,40,5,14,12,26,1,1,6,10,17,46,0.3695652173913043,3,12,0.25,14,34,0.4117647058823529,0.402,3,5,0.6
Michael Dickerson,dickemi01,SG,24,VAN,2000,82,3103.0,1496,208,78,201,279,116,45,165,226,554,1270,0.4362204724409448,119,291,0.40893470790378,435,979,0.4443309499489274,0.483,269,324,0.8302469135802469
Vlade Divac,divacvl01,C,31,SAC,2000,82,2374.0,1005,244,174,482,656,103,103,190,251,384,764,0.5026178010471204,7,26,0.2692307692307692,377,738,0.510840108401084,0.507,230,333,0.6906906906906907
Michael Doleac,doleami01,C,22,ORL,2000,81,1335.0,565,63,89,245,334,29,34,65,224,242,535,0.4523364485981308,1,2,0.5,241,533,0.4521575984990619,0.453,80,95,0.8421052631578947
Sherman Douglas,douglsh01,PG,33,NJN,2000,20,309.0,120,34,13,16,29,17,0,24,26,45,90,0.5,5,16,0.3125,40,74,0.5405405405405406,0.528,25,28,0.8928571428571429
Bryce Drew,drewbr01,PG,25,HOU,2000,72,1293.0,420,162,23,80,103,41,1,66,79,158,413,0.3825665859564164,59,163,0.3619631901840491,99,250,0.396,0.454,45,53,0.8490566037735849
Chris Dudley,dudlech02,C,34,NYK,2000,47,459.0,55,5,63,73,136,7,21,18,95,23,67,0.3432835820895522,0,0,0.0,23,67,0.3432835820895522,0.343,9,27,0.3333333333333333
Tim Duncan,duncati01,PF,23,SAS,2000,74,2875.0,1716,234,262,656,918,66,165,242,210,628,1281,0.4902419984387197,1,11,0.0909090909090909,627,1270,0.4937007874015748,0.491,459,603,0.7611940298507462
Howard Eisley,eisleho01,PG,27,UTA,2000,82,2096.0,708,347,23,147,170,59,9,132,223,282,675,0.4177777777777778,60,163,0.3680981595092024,222,512,0.43359375,0.462,84,102,0.8235294117647058
Obinna Ekezie,ekeziob01,PF,24,VAN,2000,39,351.0,125,8,34,58,92,9,4,26,61,41,88,0.4659090909090909,0,0,0.0,41,88,0.4659090909090909,0.466,43,64,0.671875
Mario Elie,eliema01,SF,36,SAS,2000,79,2217.0,590,193,48,201,249,73,9,130,156,195,457,0.4266958424507658,74,186,0.3978494623655914,121,271,0.4464944649446494,0.508,126,149,0.8456375838926175
Sean Elliott,elliose01,SF,31,SAS,2000,19,391.0,114,28,6,41,47,12,2,19,34,38,106,0.3584905660377358,13,37,0.3513513513513513,25,69,0.3623188405797101,0.42,25,32,0.78125
Dale Ellis,ellisda01,SG,39,TOT,2000,42,564.0,178,14,13,43,56,13,0,20,45,66,159,0.4150943396226415,37,100,0.37,29,59,0.4915254237288136,0.531,9,13,0.6923076923076923
LaPhonso Ellis,ellisla01,PF,29,ATL,2000,58,1309.0,487,59,98,192,290,32,25,52,133,209,464,0.4504310344827586,3,21,0.1428571428571428,206,443,0.4650112866817156,0.454,66,95,0.6947368421052632
Pervis Ellison,ellispe01,C,32,BOS,2000,30,269.0,53,13,29,38,67,10,8,13,67,19,43,0.4418604651162791,0,0,0.0,19,43,0.4418604651162791,0.442,15,21,0.7142857142857143
Evan Eschmeyer,eschmev01,C,24,NJN,2000,31,373.0,91,21,40,68,108,8,21,21,84,38,72,0.5277777777777778,0,0,0.0,38,72,0.5277777777777778,0.528,15,30,0.5
Patrick Ewing,ewingpa01,C,37,NYK,2000,62,2035.0,929,58,140,464,604,36,84,142,196,361,775,0.4658064516129032,0,2,0.0,361,773,0.4670116429495472,0.466,207,283,0.7314487632508834
Tony Farmer,farmeto01,PF,30,GSW,2000,74,1199.0,465,74,118,177,295,66,16,82,167,127,312,0.407051282051282,8,44,0.1818181818181818,119,268,0.4440298507462686,0.42,203,265,0.7660377358490567
Jamie Feick,feickja01,C,25,NJN,2000,81,2241.0,459,68,264,491,755,43,38,59,206,181,423,0.4278959810874704,3,3,1.0,178,420,0.4238095238095238,0.431,94,133,0.706766917293233
Danny Ferry,ferryda01,PF,33,CLE,2000,63,1326.0,463,67,55,183,238,22,24,55,181,189,380,0.4973684210526315,33,75,0.44,156,305,0.5114754098360655,0.541,52,57,0.912280701754386
Michael Finley,finlemi01,SF,26,DAL,2000,82,3464.0,1855,438,122,396,518,109,32,196,171,748,1636,0.4572127139364303,99,247,0.4008097165991903,649,1389,0.4672426205903527,0.487,260,317,0.8201892744479495
Derek Fisher,fishede01,PG,25,LAL,2000,78,1803.0,491,216,22,121,143,80,3,75,150,167,483,0.3457556935817805,52,166,0.3132530120481928,115,317,0.3627760252365931,0.4,105,145,0.7241379310344828
Danny Fortson,fortsda01,PF,23,BOS,2000,55,856.0,419,29,141,225,366,20,5,67,180,140,265,0.5283018867924528,0,0,0.0,140,265,0.5283018867924528,0.528,139,189,0.7354497354497355
Greg Foster,fostegr01,PF,31,SEA,2000,60,718.0,203,41,16,91,107,10,18,28,105,91,224,0.40625,3,15,0.2,88,209,0.4210526315789473,0.413,18,28,0.6428571428571429
Jeff Foster,fosteje01,C,23,IND,2000,19,86.0,43,5,12,20,32,5,1,2,18,13,23,0.5652173913043478,0,1,0.0,13,22,0.5909090909090909,0.565,17,25,0.68
Rick Fox,foxri01,SF,30,LAL,2000,82,1473.0,534,138,63,135,198,52,26,87,203,206,498,0.4136546184738955,59,181,0.3259668508287293,147,317,0.4637223974763407,0.473,63,78,0.8076923076923077
Adonal Foyle,foylead01,C,24,GSW,2000,76,1654.0,420,42,174,250,424,26,136,71,218,193,380,0.5078947368421053,0,0,0.0,193,380,0.5078947368421053,0.508,34,90,0.3777777777777777
Steve Francis,francst01,PG,22,HOU,2000,77,2776.0,1388,507,152,257,409,118,29,306,231,497,1117,0.4449418084153984,107,310,0.3451612903225806,390,807,0.483271375464684,0.493,287,365,0.7863013698630137
Todd Fuller,fulleto02,C,25,CHH,2000,41,399.0,134,5,36,74,110,9,8,27,46,51,122,0.4180327868852459,0,0,0.0,51,122,0.4180327868852459,0.418,32,53,0.6037735849056604
Lawrence Funderburke,fundela01,PF,29,SAC,2000,75,1026.0,483,33,98,136,234,32,20,40,91,184,352,0.5227272727272727,0,2,0.0,184,350,0.5257142857142857,0.523,115,163,0.7055214723926381
Kevin Garnett,garneke01,PF,23,MIN,2000,81,3243.0,1857,401,223,733,956,120,126,268,205,759,1526,0.4973787680209698,30,81,0.3703703703703703,729,1445,0.5044982698961937,0.507,309,404,0.7648514851485149
Dean Garrett,garrede01,C,33,MIN,2000,56,604.0,114,19,41,99,140,8,40,21,94,48,108,0.4444444444444444,0,0,0.0,48,108,0.4444444444444444,0.444,18,26,0.6923076923076923
Kiwane Lemorris Garris,garriki01,SG,25,ORL,2000,3,23.0,4,2,0,1,1,0,0,1,0,2,10,0.2,0,1,0.0,2,9,0.2222222222222222,0.2,0,0,0.0
Pat Garrity,garripa01,SF,23,ORL,2000,82,1479.0,675,58,44,166,210,31,19,85,197,258,585,0.441025641025641,79,197,0.4010152284263959,179,388,0.461340206185567,0.509,80,111,0.7207207207207207
Chris Gatling,gatlich01,PF,32,TOT,2000,85,1811.0,1014,71,154,348,502,82,23,169,246,365,802,0.4551122194513716,18,70,0.2571428571428571,347,732,0.4740437158469945,0.466,266,373,0.7131367292225201
Matt Geiger,geigema01,C,30,PHI,2000,65,1406.0,629,39,154,233,387,29,22,91,194,260,589,0.4414261460101867,0,4,0.0,260,585,0.4444444444444444,0.441,109,140,0.7785714285714286
Devean George,georgde01,SF,22,LAL,2000,49,345.0,155,12,29,46,75,10,4,21,54,56,144,0.3888888888888889,16,47,0.3404255319148936,40,97,0.4123711340206185,0.444,27,41,0.6585365853658537
Kendall Gill,gillke01,SF,31,NJN,2000,76,2355.0,993,210,82,201,283,139,41,89,211,396,956,0.4142259414225941,20,78,0.2564102564102564,376,878,0.428246013667426,0.425,181,255,0.7098039215686275
Armen Gilliam,gilliar01,PF,35,UTA,2000,50,782.0,333,42,72,137,209,12,16,55,83,133,305,0.4360655737704918,0,1,0.0,133,304,0.4375,0.436,67,86,0.7790697674418605
Dion Glover,glovedi01,SG,21,ATL,2000,30,446.0,195,27,15,23,38,15,4,28,28,66,171,0.3859649122807017,12,45,0.2666666666666666,54,126,0.4285714285714285,0.421,51,70,0.7285714285714285
Brian Grant,grantbr01,PF,27,POR,2000,63,1322.0,459,64,121,223,344,32,28,84,166,173,352,0.4914772727272727,1,2,0.5,172,350,0.4914285714285714,0.493,112,166,0.6746987951807228
Gary Grant,grantga01,PG,34,POR,2000,3,24.0,12,1,0,3,3,1,0,2,3,6,14,0.4285714285714285,0,0,0.0,6,14,0.4285714285714285,0.429,0,0,0.0
Horace Grant,grantho01,PF,34,SEA,2000,76,2688.0,612,188,167,424,591,55,60,61,192,266,599,0.4440734557595993,0,4,0.0,266,595,0.4470588235294118,0.444,80,111,0.7207207207207207
Devin Gray,grayde01,SF,27,HOU,2000,21,124.0,49,5,11,14,25,5,3,4,22,15,37,0.4054054054054054,0,0,0.0,15,37,0.4054054054054054,0.405,19,29,0.6551724137931034
A.C. Green,greenac01,PF,36,LAL,2000,82,1929.0,413,80,160,326,486,53,18,53,127,173,387,0.4470284237726098,1,4,0.25,172,383,0.4490861618798956,0.448,66,95,0.6947368421052632
Adrian Griffin,griffad01,SG,25,BOS,2000,72,1927.0,485,177,128,244,372,116,15,93,222,175,413,0.423728813559322,16,57,0.2807017543859649,159,356,0.446629213483146,0.443,119,158,0.7531645569620253
Tom Gugliotta,guglito01,PF,30,PHO,2000,54,1767.0,738,124,141,284,425,80,31,106,152,310,645,0.4806201550387597,1,8,0.125,309,637,0.4850863422291994,0.481,117,151,0.7748344370860927
Darvin Ham,hamda01,SF,26,MIL,2000,35,792.0,177,42,85,87,172,29,29,29,102,71,128,0.5546875,0,1,0.0,71,127,0.5590551181102362,0.555,35,78,0.4487179487179487
Richard Hamilton,hamilri01,SG,21,WAS,2000,71,1373.0,639,108,38,91,129,28,6,84,142,254,605,0.4198347107438016,28,77,0.3636363636363636,226,528,0.428030303030303,0.443,103,133,0.7744360902255639
Thomas Hamilton,hamilth01,C,24,HOU,2000,22,273.0,82,15,31,59,90,4,14,28,25,35,79,0.4430379746835443,0,0,0.0,35,79,0.4430379746835443,0.443,12,23,0.5217391304347826
Tom Hammonds,hammoto01,PF,32,MIN,2000,56,372.0,117,10,34,67,101,8,3,21,55,42,97,0.4329896907216495,0,0,0.0,42,97,0.4329896907216495,0.433,33,56,0.5892857142857143
Anfernee Hardaway,hardaan01,SG,28,PHO,2000,60,2253.0,1015,315,91,256,347,94,38,153,164,378,798,0.4736842105263157,33,102,0.3235294117647059,345,696,0.4956896551724138,0.494,226,286,0.7902097902097902
Tim Hardaway,hardati01,PG,33,MIA,2000,52,1672.0,696,385,25,125,150,49,4,119,112,246,638,0.3855799373040752,94,256,0.3671875,152,382,0.3979057591623036,0.459,110,133,0.8270676691729323
Ron Harper,harpero01,PG,36,LAL,2000,80,2042.0,557,270,96,241,337,85,39,132,164,212,531,0.3992467043314501,33,106,0.3113207547169811,179,425,0.4211764705882353,0.43,100,147,0.6802721088435374
Matt Harpring,harprma01,SF,23,ORL,2000,4,63.0,16,8,5,7,12,5,1,1,7,4,17,0.2352941176470588,2,2,1.0,2,15,0.1333333333333333,0.294,6,7,0.8571428571428571
Al Harrington,harrial01,PF,19,IND,2000,50,854.0,328,38,47,112,159,25,9,65,130,121,264,0.4583333333333333,8,34,0.2352941176470588,113,230,0.4913043478260869,0.473,78,111,0.7027027027027027
Othella Harrington,harriot01,PF,26,VAN,2000,82,2677.0,1076,97,196,367,563,36,58,217,287,420,830,0.5060240963855421,0,2,0.0,420,828,0.5072463768115942,0.506,236,298,0.7919463087248322
Lucious Harris,harrilu01,SG,29,NJN,2000,77,1510.0,513,100,53,134,187,65,6,42,98,198,463,0.427645788336933,38,115,0.3304347826086956,160,348,0.4597701149425287,0.469,79,99,0.797979797979798
Antonio Harvey,harvean01,PF,29,POR,2000,19,137.0,41,5,8,25,33,1,6,12,20,17,30,0.5666666666666667,0,0,0.0,17,30,0.5666666666666667,0.567,7,12,0.5833333333333334
Hersey Hawkins,hawkihe01,SG,33,CHI,2000,61,1622.0,480,134,31,144,175,74,15,100,146,159,375,0.424,55,141,0.3900709219858156,104,234,0.4444444444444444,0.497,107,119,0.8991596638655462
Michael Hawkins,hawkimi01,PG,27,CHH,2000,12,36.0,8,13,0,7,7,0,0,3,2,3,13,0.2307692307692307,1,5,0.2,2,8,0.25,0.269,1,2,0.5
Alan Henderson,hendeal01,PF,27,ATL,2000,82,2775.0,1083,77,265,306,571,81,54,139,233,429,930,0.4612903225806452,1,10,0.1,428,920,0.4652173913043478,0.462,224,334,0.6706586826347305
Cedric Henderson,hendece02,SF,24,CLE,2000,61,1107.0,328,55,34,106,140,39,17,68,99,129,326,0.3957055214723926,1,15,0.0666666666666666,128,311,0.4115755627009646,0.397,69,104,0.6634615384615384
Mark Hendrickson,hendrma01,PF,25,TOT,2000,15,71.0,13,6,3,10,13,2,1,3,8,5,8,0.625,0,0,0.0,5,8,0.625,0.625,3,4,0.75
Chris Herren,herrech01,PG,24,DEN,2000,45,597.0,141,111,12,40,52,15,2,42,74,45,124,0.3629032258064516,24,67,0.3582089552238806,21,57,0.3684210526315789,0.46,27,40,0.675
Grant Hill,hillgr01,SF,27,DET,2000,74,2776.0,1906,385,97,393,490,103,43,240,190,696,1422,0.4894514767932489,34,98,0.3469387755102041,662,1324,0.5,0.501,480,604,0.7947019867549668
Tyrone Hill,hillty01,PF,31,PHI,2000,68,2155.0,815,52,220,405,625,64,27,124,243,318,656,0.4847560975609756,0,1,0.0,318,655,0.4854961832061069,0.485,179,259,0.6911196911196911
Fred Hoiberg,hoibefr01,SG,27,CHI,2000,31,845.0,279,85,7,103,110,40,2,43,66,89,230,0.3869565217391304,32,94,0.3404255319148936,57,136,0.4191176470588235,0.457,69,76,0.9078947368421052
Derek Hood,hoodde01,PF,23,CHH,2000,2,4.0,0,0,0,1,1,0,0,0,0,0,3,0.0,0,0,0.0,0,3,0.0,0.0,0,0,0.0
Jeff Hornacek,hornaje01,SG,36,UTA,2000,77,2133.0,953,202,49,133,182,66,16,113,149,358,728,0.4917582417582417,66,138,0.4782608695652174,292,590,0.4949152542372881,0.537,171,180,0.95
Robert Horry,horryro01,PF,29,LAL,2000,76,1685.0,436,118,133,228,361,84,80,73,189,159,363,0.4380165289256198,29,94,0.3085106382978723,130,269,0.483271375464684,0.478,89,113,0.7876106194690266
Allan Houston,houstal01,SG,28,NYK,2000,82,3169.0,1614,224,38,233,271,65,14,186,219,614,1271,0.4830841856805665,106,243,0.4362139917695473,508,1028,0.4941634241245136,0.525,280,334,0.8383233532934131
Juwan Howard,howarju01,PF,26,WAS,2000,82,2909.0,1220,247,132,338,470,67,21,225,299,509,1108,0.4593862815884476,0,7,0.0,509,1101,0.4623069936421435,0.459,202,275,0.7345454545454545
Troy Hudson,hudsotr01,PG,23,LAC,2000,62,1592.0,545,242,28,120,148,43,0,108,65,204,541,0.377079482439926,60,193,0.310880829015544,144,348,0.4137931034482758,0.433,77,95,0.8105263157894737
Larry Hughes,hughela01,SG,21,TOT,2000,82,2324.0,1226,205,113,236,349,115,28,195,191,459,1147,0.4001743679163034,29,125,0.232,430,1022,0.4207436399217221,0.413,279,377,0.7400530503978779
Rick Hughes,hugheri02,PF,26,DAL,2000,21,224.0,82,9,24,25,49,3,1,14,30,35,72,0.4861111111111111,0,1,0.0,35,71,0.4929577464788732,0.486,12,26,0.4615384615384615
Lindsey Hunter,hunteli01,PG,29,DET,2000,82,2919.0,1043,327,35,215,250,129,22,145,216,379,892,0.4248878923766816,168,389,0.4318766066838046,211,503,0.4194831013916501,0.519,117,154,0.7597402597402597
Allen Iverson,iversal01,SG,24,PHI,2000,70,2853.0,1989,328,71,196,267,144,5,230,162,729,1733,0.4206578188113098,89,261,0.3409961685823754,640,1472,0.4347826086956521,0.446,442,620,0.7129032258064516
Bobby Jackson,jacksbo01,PG,26,MIN,2000,73,1034.0,369,172,50,103,153,48,7,58,114,140,346,0.4046242774566474,13,46,0.2826086956521739,127,300,0.4233333333333333,0.423,76,98,0.7755102040816326
Jaren Jackson,jacksja01,SG,32,SAS,2000,81,1691.0,513,118,34,147,181,54,7,66,157,186,488,0.3811475409836065,108,306,0.3529411764705882,78,182,0.4285714285714285,0.492,33,51,0.6470588235294118
Jermaine Jackson,jacksje01,SG,23,DET,2000,7,73.0,7,4,1,10,11,3,0,7,7,1,11,0.0909090909090909,0,1,0.0,1,10,0.1,0.091,5,8,0.625
Jim Jackson,jacksji01,SF,29,ATL,2000,79,2767.0,1317,230,101,293,394,57,10,185,167,507,1235,0.4105263157894737,117,303,0.3861386138613861,390,932,0.4184549356223176,0.458,186,212,0.8773584905660378
Mark Jackson,jacksma01,PG,34,IND,2000,81,2190.0,660,650,63,233,296,76,10,174,111,246,570,0.431578947368421,89,221,0.4027149321266968,157,349,0.4498567335243553,0.51,79,98,0.8061224489795918
Randell Jackson,jacksra02,PF,24,DAL,2000,1,1.0,0,0,0,0,0,0,0,0,0,0,0,0.0,0,0,0.0,0,0,0.0,0.0,0,0,0.0
Sam Jacobson,jacobsa01,PG,24,TOT,2000,52,681.0,255,32,25,46,71,30,3,33,113,108,212,0.5094339622641509,9,24,0.375,99,188,0.526595744680851,0.531,30,41,0.7317073170731707
Tim James,jamesti01,SF,23,MIA,2000,4,23.0,11,2,3,1,4,0,3,2,1,5,14,0.3571428571428571,0,0,0.0,5,14,0.3571428571428571,0.357,1,3,0.3333333333333333
Antawn Jamison,jamisan01,SF,23,GSW,2000,43,1556.0,841,90,172,187,359,30,15,113,115,356,756,0.4708994708994709,2,7,0.2857142857142857,354,749,0.472630173564753,0.472,127,208,0.6105769230769231
Harold Jamison,jamisha01,PF,23,MIA,2000,12,74.0,18,4,16,5,21,2,1,4,17,7,20,0.35,0,0,0.0,7,20,0.35,0.35,4,18,0.2222222222222222
Anthony Johnson,johnsan02,PG,25,TOT,2000,56,637.0,154,72,21,30,51,33,4,32,58,62,164,0.3780487804878049,2,11,0.1818181818181818,60,153,0.392156862745098,0.384,28,39,0.717948717948718
Avery Johnson,johnsav01,PG,34,SAS,2000,82,2571.0,919,491,33,125,158,76,18,140,150,402,850,0.4729411764705882,1,9,0.1111111111111111,401,841,0.4768133174791914,0.474,114,155,0.7354838709677419
DeMarco Johnson,johnsde02,PF,24,NYK,2000,5,37.0,6,0,3,4,7,1,0,3,5,3,9,0.3333333333333333,0,0,0.0,3,9,0.3333333333333333,0.333,0,0,0.0
Ervin Johnson,johnser02,C,32,MIL,2000,80,2129.0,383,44,233,415,648,81,127,80,298,144,279,0.5161290322580645,0,1,0.0,144,278,0.5179856115107914,0.516,95,157,0.6050955414012739
Kevin Johnson,johnske02,PG,33,PHO,2000,6,113.0,40,24,0,16,16,2,0,7,6,16,28,0.5714285714285714,1,1,1.0,15,27,0.5555555555555556,0.589,7,7,1.0
Larry Johnson,johnsla02,PF,30,NYK,2000,70,2281.0,750,175,87,293,380,42,7,94,205,282,652,0.4325153374233129,58,174,0.3333333333333333,224,478,0.4686192468619247,0.477,128,167,0.7664670658682635
Charles Jones,jonesch03,PG,24,LAC,2000,56,662.0,188,94,17,45,62,30,5,28,46,66,201,0.3283582089552239,39,118,0.3305084745762712,27,83,0.3253012048192771,0.425,17,23,0.7391304347826086
Damon Jones,jonesda01,PG,23,TOT,2000,55,612.0,233,96,12,43,55,18,1,40,34,80,208,0.3846153846153846,41,114,0.3596491228070175,39,94,0.4148936170212766,0.483,32,48,0.6666666666666666
Eddie Jones,jonesed02,SG,28,CHH,2000,72,2807.0,1446,305,81,262,343,192,49,160,176,478,1119,0.4271671134941912,128,341,0.375366568914956,350,778,0.4498714652956298,0.484,362,419,0.863961813842482
Jumaine Jones,jonesju01,SF,20,PHI,2000,33,138.0,57,5,16,22,38,6,5,14,10,22,58,0.3793103448275862,2,4,0.5,20,54,0.3703703703703703,0.397,11,18,0.6111111111111112
Popeye Jones,jonespo01,PF,29,DEN,2000,40,330.0,104,19,41,62,103,3,6,13,50,44,104,0.4230769230769231,2,3,0.6666666666666666,42,101,0.4158415841584158,0.433,14,19,0.7368421052631579
Reggie Jordan,jordare01,PG,32,WAS,2000,36,243.0,41,32,16,25,41,12,2,19,29,17,53,0.320754716981132,0,1,0.0,17,52,0.3269230769230769,0.321,7,13,0.5384615384615384
Adam Keefe,keefead01,C,29,UTA,2000,62,604.0,135,34,45,91,136,17,13,46,90,53,130,0.4076923076923077,0,1,0.0,53,129,0.4108527131782946,0.408,29,36,0.8055555555555556
Shawn Kemp,kempsh01,C,30,CLE,2000,82,2492.0,1463,138,231,494,725,100,96,291,371,484,1160,0.4172413793103448,2,6,0.3333333333333333,482,1154,0.4176776429809358,0.418,493,635,0.7763779527559055
Steve Kerr,kerrst01,PG,34,SAS,2000,32,268.0,89,12,3,16,19,4,0,7,14,32,74,0.4324324324324324,16,31,0.5161290322580645,16,43,0.3720930232558139,0.541,9,11,0.8181818181818182
Jerome Kersey,kerseje01,SF,37,SAS,2000,72,1310.0,321,69,58,167,225,67,47,51,161,146,354,0.4124293785310734,0,9,0.0,146,345,0.4231884057971014,0.412,29,41,0.7073170731707317
Lari Ketner,ketnela01,PF,22,TOT,2000,22,132.0,34,1,12,22,34,4,3,10,20,13,32,0.40625,0,0,0.0,13,32,0.40625,0.406,8,12,0.6666666666666666
Jason Kidd,kiddja01,PG,26,PHO,2000,67,2616.0,959,678,96,387,483,134,28,226,148,350,855,0.4093567251461988,56,166,0.3373493975903614,294,689,0.4267053701015965,0.442,203,245,0.8285714285714286
Gerard King,kingge02,SF,27,WAS,2000,62,1060.0,327,49,84,166,250,34,15,41,132,139,277,0.5018050541516246,0,0,0.0,139,277,0.5018050541516246,0.502,49,66,0.7424242424242424
Kerry Kittles,kittlke01,SG,25,NJN,2000,62,1896.0,807,142,46,179,225,79,19,56,120,305,698,0.4369627507163324,96,240,0.4,209,458,0.4563318777292576,0.506,101,127,0.7952755905511811
Joe Kleine,kleinjo01,C,38,POR,2000,7,31.0,11,2,0,6,6,1,0,2,7,4,11,0.3636363636363636,0,0,0.0,4,11,0.3636363636363636,0.364,3,3,1.0
Brevin Knight,knighbr01,PG,24,CLE,2000,65,1754.0,602,458,38,155,193,107,21,157,185,230,558,0.4121863799283154,2,10,0.2,228,548,0.4160583941605839,0.414,140,184,0.7608695652173914
Travis Knight,knightr01,C,25,LAL,2000,63,410.0,109,23,46,83,129,6,23,26,88,46,118,0.3898305084745763,0,0,0.0,46,118,0.3898305084745763,0.39,17,28,0.6071428571428571
Toni Kukoč,kukocto01,SF,31,TOT,2000,56,1784.0,830,265,75,198,273,77,28,146,112,297,728,0.4079670329670329,44,168,0.2619047619047619,253,560,0.4517857142857143,0.438,192,265,0.7245283018867924
Christian Laettner,laettch01,C,30,DET,2000,82,2443.0,1002,186,175,378,553,83,45,186,326,379,801,0.4731585518102372,7,24,0.2916666666666667,372,777,0.4787644787644787,0.478,237,292,0.8116438356164384
Raef LaFrentz,lafrera01,C,23,DEN,2000,81,2435.0,1006,97,170,471,641,42,180,96,292,392,879,0.4459613196814562,60,183,0.3278688524590163,332,696,0.4770114942528735,0.48,162,236,0.6864406779661016
Andrew Lang,langan01,C,33,NYK,2000,19,244.0,59,3,16,44,60,8,6,5,31,28,64,0.4375,0,0,0.0,28,64,0.4375,0.438,3,7,0.4285714285714285
Antonio Lang,langan02,SF,27,TOT,2000,10,38.0,6,2,0,5,5,4,1,2,8,1,6,0.1666666666666666,0,0,0.0,1,6,0.1666666666666666,0.167,4,5,0.8
Trajan Langdon,langdtr01,SG,23,CLE,2000,10,145.0,49,11,4,11,15,5,0,6,16,15,40,0.375,8,19,0.4210526315789473,7,21,0.3333333333333333,0.475,11,11,1.0
Rusty LaRue,larueru01,PG,26,CHI,2000,4,129.0,37,11,1,9,10,7,0,7,9,15,43,0.3488372093023256,2,14,0.1428571428571428,13,29,0.4482758620689655,0.372,5,7,0.7142857142857143
Tim Legler,legleti01,SG,33,GSW,2000,23,284.0,77,24,4,19,23,4,1,6,33,28,78,0.358974358974359,7,21,0.3333333333333333,21,57,0.3684210526315789,0.404,14,18,0.7777777777777778
Voshon Lenard,lenarvo01,SG,26,MIA,2000,53,1434.0,629,136,37,116,153,41,15,80,127,228,560,0.4071428571428571,89,228,0.3903508771929824,139,332,0.4186746987951807,0.487,84,106,0.7924528301886793
Quincy Lewis,lewisqu01,SG,22,UTA,2000,74,896.0,283,40,46,67,113,24,15,46,158,111,298,0.3724832214765101,23,63,0.365079365079365,88,235,0.3744680851063829,0.411,38,52,0.7307692307692307
Rashard Lewis,lewisra02,SF,20,SEA,2000,82,1575.0,674,70,127,209,336,62,36,78,163,275,566,0.4858657243816254,40,120,0.3333333333333333,235,446,0.5269058295964125,0.521,84,123,0.6829268292682927
Randy Livingston,livinra01,PG,24,PHO,2000,79,1081.0,381,170,25,105,130,49,13,92,129,155,373,0.4155495978552279,19,55,0.3454545454545454,136,318,0.4276729559748428,0.441,52,62,0.8387096774193549
Grant Long,longgr01,PF,33,VAN,2000,42,920.0,203,43,86,148,234,45,10,49,108,74,167,0.4431137724550898,0,4,0.0,74,163,0.4539877300613497,0.443,55,71,0.7746478873239436
Luc Longley,longllu01,C,31,PHO,2000,72,1417.0,452,77,100,223,323,22,42,136,221,186,399,0.4661654135338345,0,0,0.0,186,399,0.4661654135338345,0.466,80,97,0.8247422680412371
Felipe López,lopezfe01,SG,25,VAN,2000,65,781.0,292,44,59,65,124,32,17,53,94,111,261,0.425287356321839,3,18,0.1666666666666666,108,243,0.4444444444444444,0.431,67,109,0.6146788990825688
Tyronn Lue,luety01,PG,22,LAL,2000,8,146.0,48,17,2,10,12,3,0,9,17,19,39,0.4871794871794871,4,8,0.5,15,31,0.4838709677419355,0.538,6,8,0.75
George Lynch,lynchge01,SF,29,PHI,2000,75,2416.0,722,136,216,366,582,119,38,120,231,297,644,0.4611801242236025,15,36,0.4166666666666667,282,608,0.4638157894736842,0.473,113,183,0.6174863387978142
Todd MacCulloch,maccuto01,C,24,PHI,2000,56,528.0,206,13,48,98,146,11,37,26,94,89,161,0.5527950310559007,0,0,0.0,89,161,0.5527950310559007,0.553,28,54,0.5185185185185185
Sam Mack,macksa01,SF,29,GSW,2000,23,333.0,114,24,7,32,39,18,1,19,45,37,122,0.3032786885245901,21,64,0.328125,16,58,0.2758620689655172,0.389,19,20,0.95
Don MacLean,macledo01,PF,30,PHO,2000,16,143.0,42,8,6,17,23,2,1,8,24,18,49,0.3673469387755102,2,6,0.3333333333333333,16,43,0.3720930232558139,0.388,4,6,0.6666666666666666
Corey Maggette,maggeco01,SF,20,ORL,2000,77,1370.0,646,61,123,180,303,24,26,138,169,224,469,0.4776119402985074,2,11,0.1818181818181818,222,458,0.4847161572052402,0.48,196,261,0.7509578544061303
Dan Majerle,majerda01,SG,34,MIA,2000,69,2308.0,506,206,27,306,333,89,17,62,156,170,422,0.4028436018957346,110,304,0.3618421052631579,60,118,0.5084745762711864,0.533,56,69,0.8115942028985508
Karl Malone,malonka01,PF,36,UTA,2000,82,2947.0,2095,304,169,610,779,79,71,231,229,752,1476,0.5094850948509485,2,8,0.25,750,1468,0.510899182561308,0.51,589,739,0.79702300405954
Matt Maloney,malonma01,PG,28,CHI,2000,51,1175.0,327,138,10,54,64,32,3,63,42,114,318,0.3584905660377358,62,174,0.3563218390804598,52,144,0.3611111111111111,0.456,37,45,0.8222222222222222
Danny Manning,mannida01,PF,33,MIL,2000,72,1217.0,333,73,50,158,208,62,29,55,183,149,339,0.43952802359882,1,4,0.25,148,335,0.4417910447761194,0.441,34,52,0.6538461538461539
Stephon Marbury,marbust01,PG,22,NJN,2000,74,2881.0,1640,622,61,179,240,112,15,270,195,569,1317,0.4320425208807896,66,233,0.2832618025751073,503,1084,0.4640221402214022,0.457,436,536,0.8134328358208955
Shawn Marion,mariosh01,SF,21,PHO,2000,51,1260.0,520,69,105,227,332,38,53,51,113,222,471,0.4713375796178344,4,22,0.1818181818181818,218,449,0.4855233853006681,0.476,72,85,0.8470588235294118
Sean Marks,marksse01,PF,24,TOR,2000,5,12.0,8,0,0,2,2,1,1,3,3,2,6,0.3333333333333333,0,1,0.0,2,5,0.4,0.333,4,4,1.0
Donny Marshall,marshdo02,SF,27,CLE,2000,6,39.0,11,0,0,1,1,2,0,3,7,3,11,0.2727272727272727,0,3,0.0,3,8,0.375,0.273,5,6,0.8333333333333334
Donyell Marshall,marshdo01,PF,26,GSW,2000,64,2071.0,910,167,189,448,637,68,68,123,180,331,840,0.394047619047619,49,138,0.3550724637681159,282,702,0.4017094017094017,0.423,199,255,0.7803921568627451
Darrick Martin,martida01,PG,28,SAC,2000,71,893.0,402,122,7,37,44,28,2,62,89,133,350,0.38,38,124,0.3064516129032258,95,226,0.4203539823008849,0.434,98,119,0.8235294117647058
Jamal Mashburn,mashbja01,SF,27,MIA,2000,76,2828.0,1328,298,64,317,381,79,14,180,215,515,1158,0.4447322970639032,112,278,0.4028776978417266,403,880,0.4579545454545454,0.493,186,239,0.7782426778242678
Anthony Mason,masonan01,SF,33,CHH,2000,82,3133.0,948,367,145,554,699,74,29,160,220,317,661,0.4795763993948563,0,1,0.0,317,660,0.4803030303030303,0.48,314,421,0.7458432304038005
Tony Massenburg,masseto01,PF,32,HOU,2000,10,109.0,46,3,7,20,27,2,5,9,13,16,36,0.4444444444444444,0,0,0.0,16,36,0.4444444444444444,0.444,14,16,0.875
Vernon Maxwell,maxweve01,SG,34,SEA,2000,47,989.0,513,75,15,64,79,38,9,53,83,169,490,0.3448979591836735,67,223,0.3004484304932735,102,267,0.3820224719101123,0.413,108,148,0.7297297297297297
Walter McCarty,mccarwa01,PF,25,BOS,2000,61,879.0,229,70,33,77,110,24,23,67,83,78,230,0.3391304347826087,34,110,0.3090909090909091,44,120,0.3666666666666666,0.413,39,54,0.7222222222222222
George McCloud,mccloge01,SF,32,DEN,2000,78,2118.0,787,246,72,213,285,48,26,134,180,266,638,0.4169278996865204,107,283,0.3780918727915194,159,355,0.447887323943662,0.501,148,181,0.8176795580110497
Jelani McCoy,mccoyje01,C,22,SEA,2000,58,746.0,249,24,54,125,179,15,46,45,127,102,177,0.576271186440678,0,0,0.0,102,177,0.576271186440678,0.576,45,91,0.4945054945054945
Antonio McDyess,mcdyean01,PF,25,DEN,2000,81,2698.0,1551,159,234,451,685,69,139,230,316,614,1211,0.5070189925681255,0,2,0.0,614,1209,0.5078577336641853,0.507,323,516,0.625968992248062
Tracy McGrady,mcgratr01,SF,20,TOR,2000,79,2462.0,1213,263,188,313,501,90,151,160,201,459,1018,0.4508840864440078,18,65,0.2769230769230769,441,953,0.4627492130115425,0.46,277,392,0.7066326530612245
Jim McIlvaine,mcilvji01,C,27,NJN,2000,66,1048.0,157,36,106,124,230,26,117,38,205,64,154,0.4155844155844156,0,0,0.0,64,154,0.4155844155844156,0.416,29,56,0.5178571428571429
Jeff McInnis,mcinnje01,PG,25,LAC,2000,25,597.0,180,89,18,54,72,15,2,27,55,80,186,0.4301075268817204,7,21,0.3333333333333333,73,165,0.4424242424242424,0.449,13,17,0.7647058823529411
Derrick McKey,mckeyde01,SF,33,IND,2000,32,634.0,139,35,29,106,135,29,13,19,81,43,108,0.3981481481481481,10,23,0.4347826086956521,33,85,0.388235294117647,0.444,43,56,0.7678571428571429
Aaron McKie,mckieaa01,SG,27,PHI,2000,82,1952.0,653,240,47,199,246,108,18,113,194,244,593,0.4114671163575042,44,121,0.3636363636363636,200,472,0.423728813559322,0.449,121,146,0.8287671232876712
Roshown McLeod,mcleoro01,SF,24,ATL,2000,44,860.0,318,52,41,97,138,16,5,59,84,131,332,0.394578313253012,2,13,0.1538461538461538,129,319,0.4043887147335423,0.398,54,70,0.7714285714285715
Ron Mercer,mercero01,SG,23,TOT,2000,68,2377.0,1148,158,64,186,250,75,23,151,151,460,1080,0.4259259259259259,15,48,0.3125,445,1032,0.4312015503875969,0.433,213,270,0.7888888888888889
Andre Miller,millean02,PG,23,CLE,2000,82,2093.0,914,476,85,195,280,84,17,166,194,339,755,0.4490066225165562,10,49,0.2040816326530612,329,706,0.4660056657223796,0.456,226,292,0.773972602739726
Anthony Miller,millean01,PF,28,HOU,2000,35,476.0,130,16,49,115,164,11,10,19,68,52,97,0.5360824742268041,0,0,0.0,52,97,0.5360824742268041,0.536,26,51,0.5098039215686274
Brad Miller,millebr01,C,23,CHH,2000,55,961.0,423,45,113,180,293,23,35,48,111,135,293,0.4607508532423208,0,2,0.0,135,291,0.4639175257731959,0.461,153,195,0.7846153846153846
Oliver Miller,milleol01,C,29,PHO,2000,51,1088.0,323,68,87,174,261,42,80,74,132,137,233,0.5879828326180258,0,0,0.0,137,233,0.5879828326180258,0.588,49,73,0.6712328767123288
Reggie Miller,millere01,SG,34,IND,2000,81,2987.0,1470,187,50,189,239,85,25,129,126,466,1041,0.4476464937560038,165,404,0.4084158415841584,301,637,0.4725274725274725,0.527,373,406,0.91871921182266
Chris Mills,millsch01,SF,30,GSW,2000,20,649.0,322,47,46,77,123,18,4,25,60,123,292,0.4212328767123288,8,30,0.2666666666666666,115,262,0.4389312977099237,0.435,68,84,0.8095238095238095
Terry Mills,millste01,PF,32,DET,2000,82,1842.0,548,85,50,340,390,38,24,46,242,214,488,0.4385245901639344,95,242,0.3925619834710744,119,246,0.483739837398374,0.536,25,34,0.7352941176470589
Jason Miskiri,miskija01,PG,24,CHH,2000,1,3.0,0,1,0,0,0,0,0,0,2,0,1,0.0,0,1,0.0,0,0,0.0,0.0,0,0,0.0
Sam Mitchell,mitchsa01,SF,36,MIN,2000,66,1227.0,427,111,28,110,138,27,14,44,116,168,376,0.4468085106382978,10,23,0.4347826086956521,158,353,0.4475920679886686,0.46,81,92,0.8804347826086957
Cuttino Mobley,moblecu01,SG,24,HOU,2000,81,2496.0,1277,208,59,229,288,87,32,186,171,437,1016,0.4301181102362205,104,292,0.3561643835616438,333,724,0.4599447513812155,0.481,299,353,0.8470254957507082
Nazr Mohammed,mohamna01,C,22,PHI,2000,28,190.0,54,2,16,34,50,4,12,18,29,21,54,0.3888888888888889,0,0,0.0,21,54,0.3888888888888889,0.389,12,22,0.5454545454545454
Eric Montross,montrer01,C,28,DET,2000,51,332.0,40,7,18,54,72,6,9,22,81,17,55,0.3090909090909091,0,0,0.0,17,55,0.3090909090909091,0.309,6,12,0.5
Mikki Moore,mooremi01,C,24,DET,2000,29,488.0,228,17,44,68,112,9,31,23,104,87,140,0.6214285714285714,0,0,0.0,87,140,0.6214285714285714,0.621,54,68,0.7941176470588235
Alonzo Mourning,mournal01,C,29,MIA,2000,79,2748.0,1718,123,215,538,753,40,294,217,308,652,1184,0.5506756756756757,0,4,0.0,652,1180,0.5525423728813559,0.551,414,582,0.711340206185567
Chris Mullin,mullich01,SG,36,IND,2000,47,582.0,242,37,14,62,76,28,9,28,60,80,187,0.427807486631016,45,110,0.4090909090909091,35,77,0.4545454545454545,0.548,37,41,0.902439024390244
Eric Murdock,murdoer01,PG,31,LAC,2000,40,693.0,225,108,15,62,77,47,5,58,67,79,205,0.3853658536585366,16,42,0.3809523809523809,63,163,0.3865030674846625,0.424,51,80,0.6375
Gheorghe Mureșan,muresgh01,C,28,NJN,2000,30,267.0,105,9,24,44,68,0,12,16,52,41,90,0.4555555555555555,0,0,0.0,41,90,0.4555555555555555,0.456,23,38,0.6052631578947368
Lamond Murray,murrala01,SF,26,CLE,2000,74,2365.0,1175,132,127,296,423,105,36,184,208,460,1019,0.451422963689892,51,139,0.3669064748201439,409,880,0.4647727272727273,0.476,204,268,0.7611940298507462
Tracy Murray,murratr01,SF,28,WAS,2000,80,1831.0,813,72,63,208,271,45,24,84,185,290,670,0.4328358208955223,113,263,0.4296577946768061,177,407,0.4348894348894349,0.517,120,141,0.851063829787234
Dikembe Mutombo,mutomdi01,C,33,ATL,2000,82,2984.0,942,105,304,853,1157,27,269,174,248,322,573,0.5619546247818499,0,0,0.0,322,573,0.5619546247818499,0.562,298,421,0.7078384798099763
Steve Nash,nashst01,PG,25,DAL,2000,56,1532.0,481,272,34,87,121,37,3,102,122,173,363,0.4765840220385675,60,149,0.4026845637583892,113,214,0.5280373831775701,0.559,75,85,0.8823529411764706
Tyrone Nesby,nesbyty01,SG,24,LAC,2000,73,2317.0,973,121,82,193,275,75,31,102,205,364,915,0.3978142076502732,94,281,0.3345195729537366,270,634,0.4258675078864353,0.449,151,191,0.7905759162303665
Rasho Nesterović,nestera01,C,23,MIN,2000,82,1723.0,471,93,135,244,379,21,85,71,262,206,433,0.4757505773672055,0,2,0.0,206,431,0.4779582366589327,0.476,59,103,0.5728155339805825
Johnny Newman,newmajo01,SF,36,NJN,2000,82,1763.0,820,65,39,115,154,53,11,89,207,278,623,0.4462279293739968,72,190,0.3789473684210526,206,433,0.4757505773672055,0.504,192,229,0.8384279475982532
Moochie Norris,norrimo01,PG,26,HOU,2000,30,502.0,207,94,16,52,68,23,1,30,32,69,159,0.4339622641509434,12,29,0.4137931034482758,57,130,0.4384615384615384,0.472,57,73,0.7808219178082192
Dirk Nowitzki,nowitdi01,PF,21,DAL,2000,82,2938.0,1435,203,102,430,532,63,68,141,256,515,1118,0.4606440071556351,116,306,0.3790849673202614,399,812,0.4913793103448275,0.513,289,348,0.8304597701149425
Jermaine O'Neal,onealje01,C,21,POR,2000,70,859.0,273,18,97,132,229,11,55,47,127,108,222,0.4864864864864865,0,1,0.0,108,221,0.4886877828054298,0.486,57,98,0.5816326530612245
Shaquille O'Neal,onealsh01,C,27,LAL,2000,79,3163.0,2344,299,336,742,1078,36,239,223,255,956,1665,0.5741741741741742,0,1,0.0,956,1664,0.5745192307692307,0.574,432,824,0.5242718446601942
Charles Oakley,oaklech01,PF,36,TOR,2000,80,2431.0,548,253,117,423,540,102,45,154,294,234,560,0.4178571428571428,14,41,0.3414634146341463,220,519,0.4238921001926782,0.43,66,85,0.7764705882352941
Lamar Odom,odomla01,SF,20,LAC,2000,76,2767.0,1259,317,159,436,595,91,95,258,291,449,1024,0.4384765625,59,164,0.3597560975609756,390,860,0.4534883720930232,0.467,302,420,0.719047619047619
Hakeem Olajuwon,olajuha01,C,37,HOU,2000,44,1049.0,455,61,65,209,274,41,70,73,88,193,421,0.4584323040380047,0,2,0.0,193,419,0.4606205250596659,0.458,69,112,0.6160714285714286
Kevin Ollie,ollieke01,PG,27,PHI,2000,40,290.0,72,46,4,27,31,10,0,10,27,22,49,0.4489795918367347,0,0,0.0,22,49,0.4489795918367347,0.449,28,37,0.7567567567567568
Michael Olowokandi,olowomi01,C,24,LAC,2000,80,2493.0,783,38,194,462,656,35,140,177,304,330,756,0.4365079365079365,0,0,0.0,330,756,0.4365079365079365,0.437,123,189,0.6507936507936508
Greg Ostertag,ostergr01,C,26,UTA,2000,81,1606.0,367,18,172,310,482,20,172,79,196,124,267,0.4644194756554307,0,1,0.0,124,266,0.4661654135338345,0.464,119,187,0.6363636363636364
Bo Outlaw,outlabo01,PF,28,ORL,2000,82,2326.0,490,245,202,323,525,113,148,133,203,204,339,0.6017699115044248,0,3,0.0,204,336,0.6071428571428571,0.602,82,162,0.5061728395061729
Doug Overton,overtdo01,PG,30,BOS,2000,48,432.0,152,53,14,19,33,10,0,20,46,61,154,0.3961038961038961,10,28,0.3571428571428571,51,126,0.4047619047619047,0.429,20,21,0.9523809523809524
Billy Owens,owensbi01,PF-SF,30,TOT,2000,62,1305.0,374,97,99,202,301,33,21,85,166,150,358,0.4189944134078212,11,34,0.3235294117647059,139,324,0.4290123456790123,0.434,63,106,0.5943396226415094
Robert Pack,packro01,PG,30,DAL,2000,29,665.0,259,168,7,35,42,31,3,76,44,96,230,0.417391304347826,4,11,0.3636363636363636,92,219,0.4200913242009132,0.426,63,78,0.8076923076923077
Scott Padgett,padgesc01,PF,23,UTA,2000,47,432.0,120,25,24,64,88,14,8,22,55,44,140,0.3142857142857143,13,44,0.2954545454545454,31,96,0.3229166666666667,0.361,19,27,0.7037037037037037
Milt Palacio,palacmi01,PG,21,VAN,2000,53,394.0,108,48,17,34,51,20,0,44,32,43,98,0.4387755102040816,0,2,0.0,43,96,0.4479166666666667,0.439,22,37,0.5945945945945946
Anthony Parker,parkean01,SG,24,ORL,2000,16,185.0,57,10,5,22,27,8,4,11,13,24,57,0.4210526315789473,1,14,0.0714285714285714,23,43,0.5348837209302325,0.43,8,11,0.7272727272727273
Cherokee Parks,parksch02,C,27,VAN,2000,56,808.0,168,35,55,128,183,29,45,28,115,72,145,0.496551724137931,0,1,0.0,72,144,0.5,0.497,24,37,0.6486486486486487
Andrae Patterson,pattean01,PF,24,MIN,2000,5,20.0,6,1,1,1,2,1,0,1,4,3,4,0.75,0,0,0.0,3,4,0.75,0.75,0,0,0.0
Ruben Patterson,patteru01,SF,24,SEA,2000,81,2097.0,942,126,218,216,434,94,40,144,190,354,661,0.5355521936459909,12,27,0.4444444444444444,342,634,0.5394321766561514,0.545,222,321,0.6915887850467289
Gary Payton,paytoga01,PG,31,SEA,2000,82,3425.0,1982,732,100,429,529,153,18,224,178,747,1666,0.4483793517406962,177,520,0.3403846153846154,570,1146,0.4973821989528796,0.502,311,423,0.735224586288416
Anthony Peeler,peelean01,SG,30,MIN,2000,82,2073.0,804,195,58,174,232,62,10,85,171,316,725,0.4358620689655172,85,255,0.3333333333333333,231,470,0.4914893617021276,0.494,87,109,0.7981651376146789
Will Perdue,perduwi01,C,34,CHI,2000,67,1012.0,168,65,88,174,262,14,42,78,126,59,168,0.3511904761904761,0,0,0.0,59,168,0.3511904761904761,0.351,50,105,0.4761904761904761
Sam Perkins,perkisa01,PF,38,IND,2000,81,1620.0,537,68,64,225,289,31,33,63,136,184,441,0.4172335600907029,89,218,0.4082568807339449,95,223,0.4260089686098655,0.518,80,97,0.8247422680412371
Elliot Perry,perryel01,PG,30,NJN,2000,60,803.0,317,139,13,48,61,39,1,60,47,128,294,0.4353741496598639,11,39,0.282051282051282,117,255,0.4588235294117647,0.454,50,62,0.8064516129032258
Chuck Person,persoch01,SF,35,SEA,2000,37,340.0,102,22,6,47,53,5,2,12,56,37,123,0.3008130081300813,24,95,0.2526315789473684,13,28,0.4642857142857143,0.398,4,8,0.5
Wesley Person,persowe01,SG,28,CLE,2000,79,2056.0,727,146,44,223,267,40,19,60,119,280,654,0.4281345565749235,106,250,0.424,174,404,0.4306930693069307,0.509,61,77,0.7922077922077922
Bobby Phills,phillbo01,SG,30,CHH,2000,28,825.0,381,79,17,54,71,41,8,48,72,152,335,0.4537313432835821,30,91,0.3296703296703296,122,244,0.5,0.499,47,65,0.7230769230769231
Eric Piatkowski,piatker01,SF,29,LAC,2000,75,1712.0,654,81,74,148,222,44,13,57,140,238,573,0.4153577661431064,93,243,0.382716049382716,145,330,0.4393939393939394,0.497,85,100,0.85
Paul Pierce,piercpa01,SF,22,BOS,2000,73,2583.0,1427,221,83,313,396,152,62,178,237,486,1099,0.4422202001819836,96,280,0.3428571428571428,390,819,0.4761904761904761,0.486,359,450,0.7977777777777778
Scottie Pippen,pippesc01,SF,34,POR,2000,82,2749.0,1022,406,114,399,513,117,41,208,208,388,860,0.4511627906976744,86,263,0.3269961977186312,302,597,0.5058626465661642,0.501,160,223,0.7174887892376681
Scot Pollard,pollasc01,C,24,SAC,2000,76,1336.0,412,43,168,236,404,55,59,50,213,149,283,0.5265017667844523,0,0,0.0,149,283,0.5265017667844523,0.527,114,159,0.7169811320754716
Olden Polynice,polynol01,C,35,UTA,2000,82,1819.0,435,37,166,287,453,30,84,70,260,203,398,0.5100502512562815,1,2,0.5,202,396,0.51010101010101,0.511,28,90,0.3111111111111111
Terry Porter,portete01,PG,36,SAS,2000,68,1613.0,641,221,24,167,191,50,9,100,79,207,463,0.4470842332613391,90,207,0.4347826086956521,117,256,0.45703125,0.544,137,170,0.8058823529411765
James Posey,poseyja01,SF,23,DEN,2000,81,2052.0,662,146,85,232,317,98,33,95,207,230,536,0.4291044776119403,82,220,0.3727272727272727,148,316,0.4683544303797468,0.506,120,150,0.8
Vitaly Potapenko,potapvi01,C,24,BOS,2000,79,1797.0,723,77,182,317,499,41,29,145,239,307,615,0.4991869918699187,0,1,0.0,307,614,0.5,0.499,109,160,0.68125
Brent Price,pricebr01,PG,31,VAN,2000,41,424.0,141,69,8,29,37,17,1,47,63,41,119,0.3445378151260504,25,68,0.3676470588235294,16,51,0.3137254901960784,0.45,34,39,0.8717948717948718
Laron Profit,profila01,SG,22,WAS,2000,33,225.0,49,25,2,24,26,7,4,19,26,21,59,0.3559322033898305,3,17,0.1764705882352941,18,42,0.4285714285714285,0.381,4,10,0.4
Aleksandar Radojević,radojal01,C,23,TOR,2000,3,24.0,7,1,2,6,8,2,1,5,5,2,7,0.2857142857142857,0,0,0.0,2,7,0.2857142857142857,0.286,3,6,0.5
Theo Ratliff,ratlith01,PF,26,PHI,2000,57,1795.0,676,36,140,295,435,32,171,108,185,247,491,0.5030549898167006,0,0,0.0,247,491,0.5030549898167006,0.503,182,236,0.7711864406779662
Eldridge Recasner,recasel01,PG,32,CHH,2000,7,28.0,7,5,0,4,4,0,0,0,1,3,7,0.4285714285714285,1,4,0.25,2,3,0.6666666666666666,0.5,0,0,0.0
Bryant Reeves,reevebr01,C,26,VAN,2000,69,1773.0,611,82,126,264,390,33,38,119,245,252,562,0.4483985765124555,0,4,0.0,252,558,0.4516129032258064,0.448,107,165,0.6484848484848484
Khalid Reeves,reevekh01,PG,27,CHI,2000,3,48.0,11,13,2,2,4,2,0,6,8,3,12,0.25,0,3,0.0,3,9,0.3333333333333333,0.25,5,5,1.0
Don Reid,reiddo01,PF,26,TOT,2000,38,498.0,144,11,31,71,102,24,31,23,118,60,112,0.5357142857142857,0,0,0.0,60,112,0.5357142857142857,0.536,24,34,0.7058823529411765
J.R. Reid,reidjr01,PF,31,MIL,2000,34,602.0,150,18,29,88,117,19,5,20,81,53,127,0.4173228346456692,1,7,0.1428571428571428,52,120,0.4333333333333333,0.421,43,56,0.7678571428571429
Rodrick Rhodes,rhodero01,SF,26,DAL,2000,1,8.0,0,0,1,0,1,2,0,2,0,0,3,0.0,0,0,0.0,0,3,0.0,0.0,0,0,0.0
Glen Rice,ricegl01,SF,32,LAL,2000,80,2530.0,1272,176,56,271,327,47,12,114,179,421,980,0.4295918367346938,84,229,0.3668122270742358,337,751,0.4487350199733688,0.472,346,396,0.8737373737373737
Mitch Richmond,richmmi01,SG,34,WAS,2000,74,2397.0,1285,185,37,176,213,110,13,154,191,447,1049,0.4261201143946616,93,241,0.3858921161825726,354,808,0.4381188118811881,0.47,298,340,0.8764705882352941
Isaiah Rider,rideris01,SG,28,ATL,2000,60,2084.0,1158,219,63,195,258,41,6,168,132,449,1072,0.4188432835820895,56,180,0.3111111111111111,393,892,0.4405829596412556,0.445,204,260,0.7846153846153846
Stanley Roberts,roberst01,C,29,PHI,2000,5,51.0,10,3,6,9,15,1,1,2,15,5,16,0.3125,0,1,0.0,5,15,0.3333333333333333,0.313,0,3,0.0
Ryan Robertson,roberry01,SG,23,SAC,2000,1,25.0,5,0,0,0,0,0,0,0,0,2,6,0.3333333333333333,0,2,0.0,2,4,0.5,0.333,1,1,1.0
Clifford Robinson,robincl02,SF,33,PHO,2000,80,2839.0,1478,224,105,254,359,90,61,166,239,530,1142,0.4640980735551663,120,324,0.3703703703703703,410,818,0.5012224938875306,0.517,298,381,0.7821522309711286
David Robinson,robinda01,C,34,SAS,2000,80,2557.0,1427,142,193,577,770,97,183,164,247,528,1031,0.5121241513094084,0,2,0.0,528,1029,0.5131195335276968,0.512,371,511,0.726027397260274
Eddie Robinson,robined01,SF,23,CHH,2000,67,1112.0,471,32,54,130,184,48,25,39,67,212,386,0.5492227979274611,0,4,0.0,212,382,0.5549738219895288,0.549,47,64,0.734375
Glenn Robinson,robingl01,SF,27,MIL,2000,81,2909.0,1693,193,107,378,485,78,41,223,212,690,1461,0.4722792607802875,86,237,0.3628691983122363,604,1224,0.4934640522875817,0.502,227,283,0.8021201413427562
Dennis Rodman,rodmade01,PF,38,DAL,2000,12,389.0,34,14,48,123,171,2,1,19,41,12,31,0.3870967741935484,0,1,0.0,12,30,0.4,0.387,10,14,0.7142857142857143
Carlos Rogers,rogerca01,C,28,HOU,2000,53,1101.0,422,42,98,177,275,14,34,63,77,170,324,0.5246913580246914,1,14,0.0714285714285714,169,310,0.5451612903225806,0.526,81,137,0.5912408759124088
Rodney Rogers,rogerro01,PF,28,PHO,2000,82,2286.0,1130,170,138,309,447,94,47,163,290,428,881,0.4858115777525539,115,262,0.4389312977099237,313,619,0.505654281098546,0.551,159,249,0.6385542168674698
Roy Rogers,rogerro02,PF,26,DEN,2000,40,355.0,89,9,33,47,80,2,38,10,36,35,88,0.3977272727272727,0,1,0.0,35,87,0.4022988505747126,0.398,19,41,0.4634146341463415
Sean Rooks,rooksse01,C,30,DAL,2000,71,1001.0,309,68,82,166,248,29,52,70,169,122,283,0.431095406360424,0,0,0.0,122,283,0.431095406360424,0.431,65,89,0.7303370786516854
Jalen Rose,roseja01,SF,27,IND,2000,80,2978.0,1457,320,42,345,387,84,49,188,234,563,1196,0.4707357859531773,77,196,0.3928571428571428,486,1000,0.486,0.503,254,307,0.8273615635179153
Malik Rose,rosema01,PF,25,SAS,2000,74,1341.0,496,47,133,202,335,35,52,99,232,176,385,0.4571428571428571,1,3,0.3333333333333333,175,382,0.4581151832460733,0.458,143,198,0.7222222222222222
Michael Ruffin,ruffimi01,PF,23,CHI,2000,71,975.0,159,44,117,133,250,26,26,59,170,58,138,0.4202898550724637,0,0,0.0,58,138,0.4202898550724637,0.42,43,88,0.4886363636363636
Bryon Russell,russebr01,SF,29,UTA,2000,82,2900.0,1159,158,99,328,427,128,23,101,255,408,914,0.4463894967177242,106,268,0.3955223880597014,302,646,0.4674922600619195,0.504,237,316,0.75
Arvydas Sabonis,sabonar01,C,35,POR,2000,66,1688.0,778,118,97,416,513,43,78,97,184,302,598,0.5050167224080268,7,19,0.3684210526315789,295,579,0.5094991364421416,0.511,167,198,0.8434343434343434
John Salley,sallejo01,C,35,LAL,2000,45,303.0,71,26,20,45,65,8,14,18,67,25,69,0.3623188405797101,0,0,0.0,25,69,0.3623188405797101,0.362,21,28,0.75
Detlef Schrempf,schrede01,SF,37,POR,2000,77,1662.0,574,197,79,253,332,37,17,100,182,187,433,0.4318706697459584,21,52,0.4038461538461538,166,381,0.4356955380577428,0.456,179,215,0.8325581395348837
Dennis Scott,scottde01,SF,31,VAN,2000,66,1263.0,369,69,16,90,106,28,9,30,104,125,333,0.3753753753753753,71,189,0.3756613756613756,54,144,0.375,0.482,48,57,0.8421052631578947
Malik Sealy,sealyma01,SF,29,MIN,2000,82,2392.0,929,197,119,233,352,76,19,110,197,371,780,0.4756410256410256,10,35,0.2857142857142857,361,745,0.4845637583892617,0.482,177,218,0.8119266055045872
Brian Shaw,shawbr01,SG,33,LAL,2000,74,1249.0,305,201,45,171,216,35,14,75,105,123,322,0.3819875776397515,18,58,0.3103448275862069,105,264,0.3977272727272727,0.41,41,54,0.7592592592592593
Dickey Simpkins,simpkdi01,PF,27,CHI,2000,69,1651.0,287,100,124,248,372,22,22,128,217,111,274,0.4051094890510949,0,1,0.0,111,273,0.4065934065934066,0.405,65,120,0.5416666666666666
Brian Skinner,skinnbr01,PF,23,LAC,2000,33,775.0,179,11,63,138,201,16,44,37,75,68,134,0.5074626865671642,0,0,0.0,68,134,0.5074626865671642,0.507,43,65,0.6615384615384615
Joe Smith,smithjo02,C,24,MIN,2000,78,1975.0,774,88,186,298,484,45,85,119,302,289,623,0.463884430176565,1,1,1.0,288,622,0.4630225080385852,0.465,195,258,0.7558139534883721
Michael Smith,smithmi02,SF,27,WAS,2000,46,1145.0,289,56,121,210,331,27,23,45,127,108,192,0.5625,0,1,0.0,108,191,0.5654450261780105,0.563,73,101,0.7227722772277227
Steve Smith,smithst01,SG,30,POR,2000,82,2689.0,1225,209,123,190,313,71,31,117,214,420,900,0.4666666666666667,96,241,0.3983402489626556,324,659,0.4916540212443095,0.52,289,340,0.85
Rik Smits,smitsri01,C,33,IND,2000,79,1852.0,1018,85,94,307,401,20,100,108,249,431,890,0.4842696629213483,0,1,0.0,431,889,0.484814398200225,0.484,156,211,0.7393364928909952
Eric Snow,snower01,PG,26,PHI,2000,82,2866.0,651,624,42,219,261,140,8,162,243,257,597,0.4304857621440536,11,45,0.2444444444444444,246,552,0.4456521739130434,0.44,126,177,0.711864406779661
Felton Spencer,spencfe01,C,32,SAS,2000,26,149.0,50,3,15,24,39,6,8,9,32,15,33,0.4545454545454545,0,0,0.0,15,33,0.4545454545454545,0.455,20,30,0.6666666666666666
Latrell Sprewell,sprewla01,SF,29,NYK,2000,82,3276.0,1524,332,49,300,349,109,22,226,184,568,1305,0.4352490421455938,44,127,0.3464566929133858,524,1178,0.4448217317487266,0.452,344,397,0.8664987405541562
Ryan Stack,stackry01,PF,24,CLE,2000,25,198.0,52,5,15,30,45,4,11,17,47,17,51,0.3333333333333333,0,1,0.0,17,50,0.34,0.333,18,27,0.6666666666666666
Jerry Stackhouse,stackje01,SG,25,DET,2000,82,3148.0,1939,365,118,197,315,103,36,311,188,619,1447,0.4277816171389081,83,288,0.2881944444444444,536,1159,0.4624676445211389,0.456,618,758,0.8153034300791556
John Starks,starkjo01,SG,34,TOT,2000,37,1190.0,515,181,10,91,101,42,4,67,102,203,542,0.3745387453874538,59,171,0.3450292397660818,144,371,0.3881401617250674,0.429,50,59,0.847457627118644
Vladimir Stepania,stepavl01,C,23,SEA,2000,30,202.0,75,3,21,26,47,10,11,22,44,29,79,0.3670886075949367,0,6,0.0,29,73,0.3972602739726027,0.367,17,36,0.4722222222222222
Joe Stephens,stephjo01,SF,27,VAN,2000,13,181.0,41,11,13,23,36,7,3,6,9,19,51,0.3725490196078431,0,8,0.0,19,43,0.4418604651162791,0.373,3,4,0.75
Michael Stewart,stewami01,C,24,TOR,2000,42,389.0,58,6,33,61,94,5,19,17,81,20,53,0.3773584905660377,0,0,0.0,20,53,0.3773584905660377,0.377,18,32,0.5625
Bryant Stith,stithbr01,SG,29,DEN,2000,45,691.0,253,61,23,61,84,18,12,33,56,86,189,0.455026455026455,17,56,0.3035714285714285,69,133,0.518796992481203,0.5,64,77,0.8311688311688312
John Stockton,stockjo01,PG,37,UTA,2000,82,2432.0,990,703,45,170,215,143,15,179,192,363,725,0.5006896551724138,43,121,0.3553719008264462,320,604,0.5298013245033113,0.53,221,257,0.8599221789883269
Peja Stojaković,stojape01,SF,22,SAC,2000,74,1749.0,877,106,74,202,276,52,7,88,97,321,717,0.4476987447698745,100,267,0.3745318352059925,221,450,0.4911111111111111,0.517,135,153,0.8823529411764706
Damon Stoudamire,stoudda01,PG,26,POR,2000,78,2372.0,974,405,61,182,243,77,1,149,173,386,894,0.4317673378076063,80,212,0.3773584905660377,306,682,0.4486803519061583,0.477,122,145,0.8413793103448276
Erick Strickland,stricer01,SG,26,DAL,2000,68,2025.0,867,211,69,254,323,105,13,102,190,316,730,0.4328767123287671,73,186,0.3924731182795699,243,544,0.4466911764705882,0.483,162,195,0.8307692307692308
Mark Strickland,stricma01,SF,29,MIA,2000,58,663.0,284,22,44,96,140,15,18,24,68,122,224,0.5446428571428571,0,0,0.0,122,224,0.5446428571428571,0.545,40,56,0.7142857142857143
Rod Strickland,stricro02,PG,33,WAS,2000,69,2188.0,869,519,73,186,259,94,18,187,147,327,762,0.4291338582677165,1,21,0.0476190476190476,326,741,0.4399460188933873,0.43,214,305,0.7016393442622951
Derek Strong,stronde01,PF,31,ORL,2000,20,148.0,54,4,11,33,44,5,2,12,15,21,48,0.4375,1,4,0.25,20,44,0.4545454545454545,0.448,11,14,0.7857142857142857
Bruno Šundov,sundobr01,C,19,DAL,2000,14,61.0,26,2,5,7,12,2,2,4,16,12,31,0.3870967741935484,0,0,0.0,12,31,0.3870967741935484,0.387,2,2,1.0
Bob Sura,surabo01,SG,26,CLE,2000,73,2216.0,1009,284,50,238,288,91,19,148,201,356,815,0.4368098159509202,122,332,0.3674698795180723,234,483,0.484472049689441,0.512,175,251,0.6972111553784861
Wally Szczerbiak,szczewa02,SF,22,MIN,2000,73,2171.0,845,201,89,183,272,58,23,83,175,342,669,0.5112107623318386,28,78,0.358974358974359,314,591,0.5313028764805414,0.532,133,161,0.8260869565217391
Žan Tabak,tabakza01,C,29,IND,2000,18,114.0,37,4,16,16,32,3,9,11,13,16,34,0.4705882352941176,0,0,0.0,16,34,0.4705882352941176,0.471,5,8,0.625
Johnny Taylor,taylojo01,SF,25,TOT,2000,6,34.0,11,1,2,4,6,1,1,2,5,5,14,0.3571428571428571,1,1,1.0,4,13,0.3076923076923077,0.393,0,0,0.0
Maurice Taylor,tayloma01,PF,23,LAC,2000,62,2227.0,1060,101,96,304,400,51,48,169,217,458,988,0.4635627530364372,1,8,0.125,457,980,0.4663265306122449,0.464,143,201,0.7114427860696517
Jason Terry,terryja01,PG,22,ATL,2000,81,1888.0,657,346,24,142,166,90,10,156,133,249,600,0.415,46,157,0.2929936305732484,203,443,0.4582392776523702,0.453,113,140,0.8071428571428572
Jamel Thomas,thomaja01,SF,26,TOT,2000,7,46.0,17,6,1,4,5,1,0,5,2,8,18,0.4444444444444444,0,3,0.0,8,15,0.5333333333333333,0.444,1,1,1.0
John Thomas,thomajo02,C,24,TOR,2000,55,477.0,114,9,37,38,75,12,14,14,106,49,107,0.4579439252336448,0,1,0.0,49,106,0.4622641509433962,0.458,16,41,0.3902439024390244
Kenny Thomas,thomake01,PF,22,HOU,2000,72,1797.0,594,113,147,290,437,54,22,112,167,212,531,0.3992467043314501,32,122,0.2622950819672131,180,409,0.4400977995110024,0.429,138,209,0.6602870813397129
Kurt Thomas,thomaku01,PF,27,NYK,2000,80,1971.0,641,82,144,361,505,51,42,105,278,270,535,0.5046728971962616,1,3,0.3333333333333333,269,532,0.5056390977443609,0.506,100,128,0.78125
Tim Thomas,thomati01,SF,22,MIL,2000,80,2093.0,945,113,100,232,332,59,31,129,227,347,753,0.4608233731739707,63,182,0.3461538461538461,284,571,0.4973730297723292,0.503,188,243,0.7736625514403292
Otis Thorpe,thorpot01,PF,37,MIA,2000,51,777.0,279,33,56,110,166,26,9,59,136,125,243,0.51440329218107,0,3,0.0,125,240,0.5208333333333334,0.514,29,48,0.6041666666666666
Robert Traylor,traylro01,PF,22,MIL,2000,44,447.0,157,20,50,65,115,25,25,27,79,58,122,0.4754098360655737,0,4,0.0,58,118,0.4915254237288136,0.475,41,68,0.6029411764705882
Gary Trent,trentga01,SF,25,DAL,2000,11,301.0,151,22,20,32,52,8,3,25,28,70,142,0.4929577464788732,0,2,0.0,70,140,0.5,0.493,11,21,0.5238095238095238
Mirsad Türkcan,turkcmi01,PF,23,TOT,2000,17,90.0,33,5,13,20,33,3,1,8,14,14,38,0.3684210526315789,0,6,0.0,14,32,0.4375,0.368,5,8,0.625
Wayne Turner,turnewa01,PG,23,BOS,2000,3,41.0,4,5,1,2,3,0,0,3,4,1,6,0.1666666666666666,0,0,0.0,1,6,0.1666666666666666,0.167,2,6,0.3333333333333333
Nick Van Exel,vanexni01,PG,28,DEN,2000,79,2950.0,1275,714,34,277,311,68,11,221,148,473,1213,0.3899422918384171,133,401,0.3316708229426434,340,812,0.4187192118226601,0.445,196,240,0.8166666666666667
Keith Van Horn,vanhoke01,PF,24,NJN,2000,80,2782.0,1535,158,200,476,676,64,60,245,258,559,1257,0.4447096260938743,84,228,0.3684210526315789,475,1029,0.4616132167152575,0.478,333,393,0.8473282442748091
Jacque Vaughn,vaughja01,PG,24,UTA,2000,78,884.0,289,121,11,54,65,32,0,77,92,109,262,0.416030534351145,14,34,0.4117647058823529,95,228,0.4166666666666667,0.443,57,76,0.75
Loy Vaught,vaughlo01,PF,31,DET,2000,43,292.0,75,11,26,65,91,6,4,11,45,32,89,0.3595505617977528,0,3,0.0,32,86,0.3720930232558139,0.36,11,16,0.6875
Fred Vinson,vinsofr01,SG,29,SEA,2000,8,40.0,13,0,0,1,1,3,0,4,2,5,17,0.2941176470588235,2,7,0.2857142857142857,3,10,0.3,0.353,1,2,0.5
Antoine Walker,walkean02,PF,23,BOS,2000,82,3003.0,1680,305,199,453,652,117,32,259,263,648,1506,0.4302788844621514,73,285,0.256140350877193,575,1221,0.4709254709254709,0.455,311,445,0.698876404494382
Samaki Walker,walkesa01,PF,23,SAS,2000,71,980.0,360,38,77,195,272,10,35,64,108,137,305,0.4491803278688525,0,0,0.0,137,305,0.4491803278688525,0.449,86,126,0.6825396825396826
Ben Wallace,wallabe01,PF,25,ORL,2000,81,1959.0,390,67,211,454,665,72,130,67,162,168,334,0.5029940119760479,0,0,0.0,168,334,0.5029940119760479,0.503,54,114,0.4736842105263157
John Wallace,wallajo01,SF,25,NYK,2000,60,798.0,392,22,42,93,135,10,14,63,103,155,332,0.466867469879518,0,3,0.0,155,329,0.4711246200607902,0.467,82,102,0.803921568627451
Rasheed Wallace,wallara01,PF,25,POR,2000,81,2845.0,1325,142,129,437,566,87,107,157,216,542,1045,0.5186602870813397,8,50,0.16,534,995,0.5366834170854271,0.522,233,331,0.7039274924471299
Rex Walters,waltere01,PG,29,MIA,2000,33,389.0,93,65,8,28,36,6,0,29,44,38,91,0.4175824175824176,5,20,0.25,33,71,0.4647887323943662,0.445,12,16,0.75
Charlie Ward,wardch01,PG,29,NYK,2000,72,1986.0,528,300,22,206,228,95,16,102,176,189,447,0.4228187919463087,102,264,0.3863636363636363,87,183,0.4754098360655737,0.537,48,58,0.8275862068965517
Clarence Weatherspoon,weathcl01,PF,29,MIA,2000,78,1615.0,565,93,128,321,449,51,49,100,165,215,419,0.513126491646778,0,0,0.0,215,419,0.513126491646778,0.513,135,183,0.7377049180327869
Chris Webber,webbech01,PF,26,SAC,2000,75,2880.0,1834,345,189,598,787,120,128,218,264,748,1548,0.483204134366925,27,95,0.2842105263157894,721,1453,0.4962147281486579,0.492,311,414,0.751207729468599
Bonzi Wells,wellsbo01,SF,23,POR,2000,66,1162.0,580,97,78,104,182,69,12,97,153,236,480,0.4916666666666666,20,53,0.3773584905660377,216,427,0.5058548009367682,0.513,88,129,0.6821705426356589
Bill Wennington,wennibi01,C,36,SAC,2000,7,57.0,14,1,5,14,19,2,2,1,13,6,19,0.3157894736842105,0,0,0.0,6,19,0.3157894736842105,0.316,2,2,1.0
David Wesley,wesleda01,PG,29,CHH,2000,82,2760.0,1116,463,39,186,225,109,11,159,186,407,955,0.4261780104712042,88,248,0.3548387096774194,319,707,0.4512022630834512,0.472,214,275,0.7781818181818182
Doug West,westdo01,SG,32,VAN,2000,38,581.0,152,43,18,53,71,12,8,19,80,59,145,0.4068965517241379,0,3,0.0,59,142,0.4154929577464789,0.407,34,40,0.85
Mark West,westma01,C,39,PHO,2000,22,127.0,15,2,6,25,31,2,4,6,23,5,12,0.4166666666666667,0,0,0.0,5,12,0.4166666666666667,0.417,5,8,0.625
Jahidi White,whiteja01,C,23,WAS,2000,80,1537.0,569,15,202,351,553,31,83,94,234,228,450,0.5066666666666667,0,0,0.0,228,450,0.5066666666666667,0.507,113,211,0.5355450236966824
Chris Whitney,whitnch01,PG,28,WAS,2000,82,1627.0,642,313,20,114,134,55,5,107,166,217,521,0.4165067178502879,96,255,0.3764705882352941,121,266,0.4548872180451128,0.509,112,132,0.8484848484848485
Aaron Williams,williaa01,PF,28,WAS,2000,81,1545.0,616,58,159,250,409,41,92,80,234,235,450,0.5222222222222223,0,3,0.0,235,447,0.5257270693512305,0.522,146,201,0.7263681592039801
Alvin Williams,willial02,PG,25,TOR,2000,55,779.0,292,126,27,58,85,34,11,47,78,114,287,0.397212543554007,16,55,0.2909090909090909,98,232,0.4224137931034483,0.425,48,65,0.7384615384615385
Eric Williams,willier01,SF,27,BOS,2000,68,1378.0,489,93,55,101,156,44,16,66,165,165,386,0.4274611398963731,25,72,0.3472222222222222,140,314,0.445859872611465,0.46,134,169,0.7928994082840237
Jason Williams,willija02,PG,24,SAC,2000,81,2760.0,999,589,22,208,230,117,8,296,140,363,973,0.3730729701952723,145,505,0.2871287128712871,218,468,0.4658119658119658,0.448,128,170,0.7529411764705882
Jerome Williams,willije01,PF,26,DET,2000,82,2102.0,689,68,277,512,789,95,21,105,196,257,456,0.5635964912280702,0,3,0.0,257,453,0.5673289183222958,0.564,175,284,0.6161971830985915
Lorenzo Williams,willilo01,PF,30,WAS,2000,8,76.0,14,1,12,13,25,3,6,3,13,7,9,0.7777777777777778,0,0,0.0,7,9,0.7777777777777778,0.778,0,0,0.0
Monty Williams,willimo01,SF,28,ORL,2000,75,1501.0,651,106,96,154,250,46,17,109,187,263,538,0.4888475836431227,2,5,0.4,261,533,0.4896810506566604,0.491,123,166,0.7409638554216867
Scott Williams,willisc01,C,31,MIL,2000,68,1488.0,520,28,177,271,448,40,66,65,230,213,426,0.5,0,0,0.0,213,426,0.5,0.5,94,129,0.7286821705426356
Shammond Williams,willish01,PG,24,SEA,2000,43,517.0,225,78,12,40,52,18,0,40,39,84,225,0.3733333333333333,24,81,0.2962962962962963,60,144,0.4166666666666667,0.427,33,51,0.6470588235294118
Walt Williams,williwa02,SF,29,HOU,2000,76,1859.0,827,157,69,237,306,49,44,113,190,312,681,0.4581497797356828,102,261,0.3908045977011494,210,420,0.5,0.533,101,123,0.8211382113821138
Corliss Williamson,willico02,SF,26,SAC,2000,76,1707.0,785,82,122,168,290,38,19,110,192,311,622,0.5,0,0,0.0,311,622,0.5,0.5,163,212,0.7688679245283019
Kevin Willis,willike02,PF,37,TOR,2000,79,1679.0,604,49,201,281,482,36,48,98,256,236,569,0.4147627416520211,1,3,0.3333333333333333,235,566,0.4151943462897526,0.416,131,164,0.7987804878048781
Dedric Willoughby,willode01,PG,25,CHI,2000,25,508.0,190,66,11,40,51,23,2,37,32,61,179,0.3407821229050279,29,98,0.2959183673469387,32,81,0.3950617283950617,0.422,39,51,0.7647058823529411
David Wingate,wingada01,SG,36,NYK,2000,7,32.0,2,3,1,1,2,1,2,2,7,1,9,0.1111111111111111,0,0,0.0,1,9,0.1111111111111111,0.111,0,0,0.0
Haywoode Workman,workmha01,PG,34,TOT,2000,36,350.0,86,61,1,25,26,20,0,18,37,31,90,0.3444444444444444,14,43,0.3255813953488372,17,47,0.3617021276595745,0.422,10,15,0.6666666666666666
Metta World Peace,artesro01,SF,20,CHI,2000,72,2238.0,866,202,62,246,308,119,39,166,159,309,759,0.4071146245059288,60,191,0.3141361256544502,249,568,0.4383802816901408,0.447,188,279,0.6738351254480287
Lorenzen Wright,wrighlo02,C,24,ATL,2000,75,1205.0,448,21,117,188,305,29,40,66,203,180,361,0.4986149584487535,1,3,0.3333333333333333,179,358,0.5,0.5,87,135,0.6444444444444445
Tim Young,youngti01,C,23,GSW,2000,25,137.0,54,5,13,22,35,2,1,9,18,13,39,0.3333333333333333,0,0,0.0,13,39,0.3333333333333333,0.333,28,36,0.7777777777777778
Mahmoud Abdul-Rauf,abdulma02,PG,31,VAN,2001,41,486.0,266,76,5,20,25,9,1,26,50,120,246,0.4878048780487805,4,14,0.2857142857142857,116,232,0.5,0.496,22,29,0.7586206896551724
Tariq Abdul-Wahad,abdulta01,SG,26,DEN,2001,29,420.0,111,22,14,45,59,14,13,34,54,43,111,0.3873873873873873,4,10,0.4,39,101,0.3861386138613861,0.405,21,36,0.5833333333333334
Shareef Abdur-Rahim,abdursh01,SF,24,VAN,2001,81,3241.0,1663,250,175,560,735,90,77,231,238,604,1280,0.471875,12,64,0.1875,592,1216,0.4868421052631579,0.477,443,531,0.8342749529190208
Cory Alexander,alexaco01,PG,27,ORL,2001,26,227.0,52,36,0,25,25,16,0,25,29,18,56,0.3214285714285714,4,16,0.25,14,40,0.35,0.357,12,18,0.6666666666666666
Courtney Alexander,alexaco02,PG,23,TOT,2001,65,1382.0,618,62,42,101,143,45,5,75,139,239,573,0.4171029668411867,17,46,0.3695652173913043,222,527,0.4212523719165085,0.432,123,150,0.82
Ray Allen,allenra02,SG,25,MIL,2001,82,3129.0,1806,374,101,327,428,124,20,204,192,628,1309,0.479755538579068,202,467,0.4325481798715203,426,842,0.505938242280285,0.557,348,392,0.8877551020408163
Rafer Alston,alstora01,PG,24,MIL,2001,37,288.0,77,68,4,27,31,13,0,20,27,30,84,0.3571428571428571,8,30,0.2666666666666666,22,54,0.4074074074074074,0.405,9,13,0.6923076923076923
John Amaechi,amaecjo01,C,30,ORL,2001,82,1710.0,650,74,77,191,268,28,29,124,175,237,592,0.4003378378378378,0,7,0.0,237,585,0.4051282051282051,0.4,176,279,0.6308243727598566
Derek Anderson,anderde01,SG,26,SAS,2001,82,2859.0,1269,301,75,288,363,120,14,165,188,413,993,0.4159113796576032,101,253,0.3992094861660079,312,740,0.4216216216216216,0.467,342,402,0.8507462686567164
Kenny Anderson,anderke01,PG,30,BOS,2001,33,849.0,246,134,16,57,73,44,2,52,62,88,227,0.3876651982378855,11,33,0.3333333333333333,77,194,0.3969072164948453,0.412,59,71,0.8309859154929577
Nick Anderson,anderni01,SG,33,SAC,2001,21,169.0,38,13,3,22,25,10,4,7,13,14,57,0.2456140350877192,10,39,0.2564102564102564,4,18,0.2222222222222222,0.333,0,0,0.0
Shandon Anderson,andersh01,SG,27,HOU,2001,82,2396.0,710,189,72,261,333,82,40,131,202,263,590,0.4457627118644068,46,170,0.2705882352941176,217,420,0.5166666666666667,0.485,138,188,0.7340425531914894
Greg Anthony,anthogr01,PG,33,POR,2001,58,856.0,282,82,21,40,61,40,3,43,63,97,253,0.383399209486166,65,159,0.4088050314465409,32,94,0.3404255319148936,0.512,23,35,0.6571428571428571
Darrell Armstrong,armstda01,PG,32,ORL,2001,75,2767.0,1189,524,94,249,343,135,13,200,155,413,1002,0.4121756487025948,143,403,0.3548387096774194,270,599,0.4507512520868113,0.484,220,249,0.8835341365461847
Chucky Atkins,atkinch01,PG,26,DET,2001,81,2363.0,971,330,28,145,173,67,5,149,184,380,952,0.3991596638655462,121,339,0.3569321533923303,259,613,0.4225122349102773,0.463,90,130,0.6923076923076923
Stacey Augmon,augmost01,SG,32,POR,2001,66,1182.0,311,98,60,99,159,48,21,48,105,127,266,0.4774436090225564,0,4,0.0,127,262,0.4847328244274809,0.477,57,87,0.6551724137931034
Isaac Austin,austiis01,C,31,VAN,2001,52,845.0,226,58,50,172,222,20,23,54,94,96,270,0.3555555555555555,6,24,0.25,90,246,0.3658536585365853,0.367,28,40,0.7
William Avery,averywi01,PG,21,MIN,2001,55,463.0,154,75,5,24,29,13,4,45,48,55,144,0.3819444444444444,16,59,0.2711864406779661,39,85,0.4588235294117647,0.438,28,36,0.7777777777777778
Dalibor Bagarić,bagarda01,C,20,CHI,2001,35,259.0,47,10,22,34,56,9,16,21,44,17,65,0.2615384615384615,0,1,0.0,17,64,0.265625,0.262,13,28,0.4642857142857143
Vin Baker,bakervi01,PF,29,SEA,2001,76,2129.0,927,90,179,251,430,38,73,158,264,347,822,0.4221411192214112,1,16,0.0625,346,806,0.4292803970223325,0.423,232,321,0.7227414330218068
Erick Barkley,barkler01,PG,22,POR,2001,8,38.0,19,6,0,3,3,2,0,5,2,8,22,0.3636363636363636,3,8,0.375,5,14,0.3571428571428571,0.432,0,0,0.0
Dana Barros,barroda01,PG,33,DET,2001,60,1079.0,478,110,6,88,94,30,2,60,63,183,412,0.4441747572815534,44,105,0.419047619047619,139,307,0.4527687296416938,0.498,68,80,0.85
Brent Barry,barrybr01,SG,29,SEA,2001,67,1778.0,589,225,33,178,211,80,14,86,126,198,401,0.4937655860349127,109,229,0.4759825327510917,89,172,0.5174418604651163,0.63,84,103,0.8155339805825242
Jon Barry,barryjo01,SG,31,SAC,2001,62,1010.0,316,130,16,78,94,28,6,53,66,103,255,0.403921568627451,46,132,0.3484848484848485,57,123,0.4634146341463415,0.494,64,73,0.8767123287671232
Tony Battie,battito01,C,24,BOS,2001,40,845.0,260,16,73,160,233,27,60,37,126,108,201,0.5373134328358209,0,3,0.0,108,198,0.5454545454545454,0.537,44,69,0.6376811594202898
Raja Bell,bellra01,SG,24,PHI,2001,5,30.0,5,0,0,1,1,1,0,2,1,2,7,0.2857142857142857,1,3,0.3333333333333333,1,4,0.25,0.357,0,0,0.0
Jonathan Bender,bendejo01,SF,20,IND,2001,59,574.0,193,32,14,60,74,7,28,42,73,66,186,0.3548387096774194,11,41,0.2682926829268293,55,145,0.3793103448275862,0.384,50,68,0.7352941176470589
Corey Benjamin,benjaco01,PG,22,CHI,2001,65,857.0,307,69,38,62,100,28,16,63,128,115,302,0.3807947019867549,21,81,0.2592592592592592,94,221,0.4253393665158371,0.416,56,83,0.6746987951807228
David Benoit,benoida01,SF,32,UTA,2001,49,446.0,178,22,20,61,81,6,6,28,75,71,147,0.4829931972789115,5,13,0.3846153846153846,66,134,0.4925373134328358,0.5,31,39,0.7948717948717948
Travis Best,besttr01,PG,28,IND,2001,77,2457.0,918,473,38,184,222,110,11,127,246,347,788,0.4403553299492386,37,97,0.3814432989690721,310,691,0.4486251808972503,0.464,187,226,0.827433628318584
Mike Bibby,bibbymi01,PG,22,VAN,2001,82,3190.0,1301,685,47,257,304,107,12,248,148,525,1157,0.4537597234226447,108,285,0.3789473684210526,417,872,0.4782110091743119,0.5,143,188,0.7606382978723404
Chauncey Billups,billuch01,SG,24,MIN,2001,77,1790.0,713,260,32,126,158,51,11,111,178,248,587,0.4224872231686541,73,194,0.3762886597938144,175,393,0.4452926208651399,0.485,144,171,0.8421052631578947
Mookie Blaylock,blaylmo01,PG,33,GSW,2001,69,2352.0,760,462,71,201,272,163,20,128,134,317,801,0.3957553058676654,73,225,0.3244444444444444,244,576,0.4236111111111111,0.441,53,76,0.6973684210526315
Corie Blount,blounco01,PF,32,TOT,2001,68,1305.0,313,59,181,219,400,42,22,73,165,130,294,0.4421768707482993,2,8,0.25,128,286,0.4475524475524475,0.446,51,83,0.6144578313253012
Mark Blount,blounma01,C,25,BOS,2001,64,1098.0,248,32,97,134,231,39,76,62,183,101,200,0.505,0,0,0.0,101,200,0.505,0.505,46,66,0.696969696969697
Muggsy Bogues,boguemu01,PG,36,TOR,2001,3,34.0,0,5,0,3,3,2,0,4,3,0,2,0.0,0,1,0.0,0,1,0.0,0.0,0,0,0.0
Etdrick Bohannon,bohanet01,PF,27,CLE,2001,6,19.0,8,0,3,4,7,0,2,1,4,2,4,0.5,0,0,0.0,2,4,0.5,0.5,4,4,1.0
Calvin Booth,boothca01,C,24,TOT,2001,55,933.0,293,42,77,169,246,29,111,53,146,120,252,0.4761904761904761,0,0,0.0,120,252,0.4761904761904761,0.476,53,78,0.6794871794871795
Cal Bowdler,bowdlca01,SF,23,ATL,2001,44,375.0,140,4,30,47,77,10,21,11,45,53,114,0.4649122807017544,1,5,0.2,52,109,0.4770642201834862,0.469,33,40,0.825
Bruce Bowen,bowenbr01,SF,29,MIA,2001,82,2685.0,623,132,45,200,245,83,53,74,269,211,581,0.3631669535283993,103,307,0.3355048859934853,108,274,0.3941605839416058,0.452,98,161,0.6086956521739131
Ryan Bowen,bowenry01,SF,25,DEN,2001,57,696.0,191,30,62,51,113,37,12,24,95,80,144,0.5555555555555556,4,11,0.3636363636363636,76,133,0.5714285714285714,0.569,27,44,0.6136363636363636
Ira Bowman,bowmair01,PG,27,ATL,2001,3,19.0,0,7,1,1,2,0,0,1,0,0,2,0.0,0,0,0.0,0,2,0.0,0.0,0,0,0.0
Earl Boykins,boykiea01,PG,24,LAC,2001,10,149.0,65,32,4,7,11,5,0,9,9,25,63,0.3968253968253968,1,8,0.125,24,55,0.4363636363636363,0.405,14,17,0.8235294117647058
Shawn Bradley,bradlsh01,C,28,DAL,2001,82,2001.0,579,38,160,448,608,36,228,88,256,219,447,0.4899328859060403,1,6,0.1666666666666666,218,441,0.4943310657596372,0.491,140,178,0.7865168539325843
Elton Brand,brandel01,PF,21,CHI,2001,74,2906.0,1490,240,285,461,746,71,118,219,243,578,1215,0.4757201646090535,0,2,0.0,578,1213,0.4765045342126958,0.476,334,472,0.7076271186440678
Terrell Brandon,brandte01,PG,30,MIN,2001,78,2821.0,1250,583,60,238,298,161,21,155,138,511,1134,0.4506172839506173,33,91,0.3626373626373626,478,1043,0.4582933844678811,0.465,195,224,0.8705357142857143
Chucky Brown,brownch01,SF,32,TOT,2001,26,339.0,102,11,8,46,54,9,7,8,37,40,95,0.4210526315789473,0,3,0.0,40,92,0.4347826086956521,0.421,22,34,0.6470588235294118
Dee Brown,brownde01,PG,32,ORL,2001,7,155.0,48,12,0,11,11,4,0,7,10,16,44,0.3636363636363636,12,32,0.375,4,12,0.3333333333333333,0.5,4,5,0.8
P.J. Brown,brownpj01,C,31,CHH,2001,80,2811.0,676,127,257,485,742,78,92,108,260,249,561,0.4438502673796791,0,4,0.0,249,557,0.4470377019748653,0.444,178,209,0.8516746411483254
Randy Brown,brownra02,PG,32,BOS,2001,54,1238.0,223,154,23,76,99,62,10,56,132,100,237,0.4219409282700422,0,3,0.0,100,234,0.4273504273504273,0.422,23,40,0.575
Rick Brunson,brunsri01,PG,28,TOT,2001,22,208.0,46,31,5,16,21,8,1,17,21,18,54,0.3333333333333333,2,14,0.1428571428571428,16,40,0.4,0.352,8,15,0.5333333333333333
Kobe Bryant,bryanko01,SG,22,LAL,2001,68,2783.0,1938,338,104,295,399,114,43,220,222,701,1510,0.4642384105960265,61,200,0.305,640,1310,0.4885496183206106,0.484,475,557,0.8527827648114902
Mark Bryant,bryanma01,PF,35,DAL,2001,18,101.0,19,3,4,17,21,1,2,5,29,8,20,0.4,0,0,0.0,8,20,0.4,0.4,3,5,0.6
Greg Buckner,buckngr01,SG,24,DAL,2001,37,820.0,229,49,60,97,157,33,9,27,118,84,192,0.4375,2,7,0.2857142857142857,82,185,0.4432432432432432,0.443,59,81,0.7283950617283951
Jud Buechler,buechju01,SF,32,DET,2001,57,737.0,193,39,20,74,94,21,10,25,83,76,164,0.4634146341463415,32,77,0.4155844155844156,44,87,0.5057471264367817,0.561,9,12,0.75
Rodney Buford,buforro01,SF,23,PHI,2001,47,573.0,248,17,16,58,74,17,6,29,68,104,241,0.4315352697095436,16,38,0.4210526315789473,88,203,0.4334975369458128,0.465,24,29,0.8275862068965517
Matt Bullard,bullama01,PF,33,HOU,2001,61,1000.0,354,42,22,108,130,10,9,12,76,129,305,0.4229508196721311,86,213,0.4037558685446009,43,92,0.4673913043478261,0.564,10,14,0.7142857142857143
Scott Burrell,burresc01,SF,30,CHH,2001,4,41.0,17,1,1,2,3,3,0,0,8,7,15,0.4666666666666667,2,6,0.3333333333333333,5,9,0.5555555555555556,0.533,1,4,0.25
Jason Caffey,caffeja01,PF,27,MIL,2001,70,1460.0,500,53,135,218,353,38,25,77,184,179,367,0.4877384196185286,0,0,0.0,179,367,0.4877384196185286,0.488,142,211,0.6729857819905213
Marcus Camby,cambyma01,C,26,NYK,2001,63,2127.0,759,52,196,527,723,66,136,63,205,304,580,0.5241379310344828,1,8,0.125,303,572,0.5297202797202797,0.525,150,225,0.6666666666666666
Elden Campbell,campbel01,PF,32,CHH,2001,78,2337.0,1022,104,157,451,608,60,140,144,280,367,834,0.4400479616306954,0,6,0.0,367,828,0.4432367149758454,0.44,288,406,0.7093596059113301
Brian Cardinal,cardibr01,PF,23,DET,2001,15,126.0,31,3,8,15,23,7,2,9,27,10,31,0.3225806451612903,0,5,0.0,10,26,0.3846153846153846,0.323,11,18,0.6111111111111112
Chris Carr,carrch01,SG,26,BOS,2001,35,309.0,169,11,11,33,44,4,3,19,45,53,112,0.4732142857142857,17,37,0.4594594594594595,36,75,0.48,0.549,46,60,0.7666666666666667
Anthony Carter,cartean01,PG,25,MIA,2001,72,1630.0,461,268,46,134,180,73,10,119,154,195,480,0.40625,6,40,0.15,189,440,0.4295454545454545,0.413,65,103,0.6310679611650486
Vince Carter,cartevi01,SF,24,TOR,2001,75,2979.0,2070,291,176,240,416,114,82,167,205,762,1656,0.4601449275362319,162,397,0.4080604534005038,600,1259,0.4765687053216839,0.509,384,502,0.7649402390438247
Sam Cassell,cassesa01,PG,31,MIL,2001,76,2709.0,1381,580,46,244,290,88,8,220,214,537,1132,0.4743816254416961,30,98,0.3061224489795918,507,1034,0.4903288201160541,0.488,277,323,0.8575851393188855
Kelvin Cato,catoke01,C,26,HOU,2001,35,624.0,165,11,47,94,141,13,31,25,89,64,111,0.5765765765765766,0,0,0.0,64,111,0.5765765765765766,0.577,37,57,0.6491228070175439
Duane Causwell,causwdu01,C,32,MIA,2001,31,384.0,76,5,23,60,83,8,18,23,67,32,85,0.3764705882352941,0,0,0.0,32,85,0.3764705882352941,0.376,12,25,0.48
Cedric Ceballos,cebalce01,SF,31,TOT,2001,40,559.0,261,20,34,72,106,16,7,32,61,101,229,0.4410480349344978,22,73,0.3013698630136986,79,156,0.5064102564102564,0.489,37,43,0.8604651162790697
Calbert Cheaney,cheanca01,SG,29,DEN,2001,9,153.0,21,9,5,15,20,4,2,5,14,10,30,0.3333333333333333,0,0,0.0,10,30,0.3333333333333333,0.333,1,2,0.5
Chris Childs,childch01,PG,33,TOT,2001,77,1859.0,362,355,24,178,202,59,15,156,242,135,335,0.4029850746268656,32,106,0.3018867924528302,103,229,0.4497816593886463,0.451,60,71,0.8450704225352113
Doug Christie,chrisdo01,SG,30,SAC,2001,81,2939.0,996,289,95,260,355,183,45,154,224,311,788,0.3946700507614213,94,250,0.376,217,538,0.4033457249070632,0.454,280,312,0.8974358974358975
Keon Clark,clarkke01,PF,25,TOT,2001,81,1720.0,640,72,136,298,434,32,154,90,244,249,519,0.4797687861271676,0,1,0.0,249,518,0.4806949806949807,0.48,142,240,0.5916666666666667
Mateen Cleaves,cleavma01,PG,23,DET,2001,78,1268.0,422,207,26,106,132,49,1,139,153,160,400,0.4,5,17,0.2941176470588235,155,383,0.4046997389033943,0.406,97,137,0.708029197080292
John Coker,cokerjo01,C,29,GSW,2001,6,32.0,2,2,3,2,5,1,0,2,4,1,8,0.125,0,0,0.0,1,8,0.125,0.125,0,0,0.0
Derrick Coleman,colemde01,PF,33,CHH,2001,34,683.0,277,39,46,138,184,10,21,42,53,97,255,0.3803921568627451,20,51,0.392156862745098,77,204,0.3774509803921568,0.42,63,92,0.6847826086956522
Bimbo Coles,colesbi01,PG,32,CLE,2001,47,804.0,232,138,9,39,48,27,6,59,87,91,239,0.3807531380753138,2,16,0.125,89,223,0.3991031390134529,0.385,48,56,0.8571428571428571
Jason Collier,collija02,C,23,HOU,2001,23,222.0,71,6,12,25,37,2,3,11,27,27,71,0.380281690140845,0,1,0.0,27,70,0.3857142857142857,0.38,17,24,0.7083333333333334
Sean Colson,colsose01,PG,25,TOT,2001,13,44.0,15,10,2,4,6,1,0,2,6,6,24,0.25,1,5,0.2,5,19,0.2631578947368421,0.271,2,4,0.5
Tyrone Corbin,corbity01,SF,38,TOR,2001,15,117.0,20,4,3,10,13,2,0,3,18,9,38,0.2368421052631578,0,5,0.0,9,33,0.2727272727272727,0.237,2,4,0.5
Chris Crawford,crawfch01,PF,25,ATL,2001,47,901.0,318,37,28,82,110,21,16,62,117,122,270,0.4518518518518518,6,22,0.2727272727272727,116,248,0.4677419354838709,0.463,68,83,0.8192771084337349
Jamal Crawford,crawfja01,PG,20,CHI,2001,61,1050.0,282,141,9,80,89,43,14,85,68,107,304,0.3519736842105263,41,117,0.3504273504273504,66,187,0.3529411764705882,0.419,27,34,0.7941176470588235
Austin Croshere,croshau01,PF,25,IND,2001,81,1874.0,822,92,123,264,387,36,50,136,180,276,701,0.3937232524964336,70,207,0.3381642512077294,206,494,0.4170040485829959,0.444,200,231,0.8658008658008658
John Crotty,crottjo01,PG,31,UTA,2001,31,264.0,65,34,13,15,28,6,0,19,32,22,65,0.3384615384615385,4,7,0.5714285714285714,18,58,0.3103448275862069,0.369,17,19,0.8947368421052632
Vonteego Cummings,cummivo01,PG,24,GSW,2001,66,1495.0,483,227,47,90,137,67,14,91,160,178,517,0.344294003868472,48,143,0.3356643356643357,130,374,0.3475935828877005,0.391,79,116,0.6810344827586207
Bill Curley,curlebi01,PF,28,TOT,2001,20,192.0,63,3,21,16,37,7,9,16,45,25,47,0.5319148936170213,1,2,0.5,24,45,0.5333333333333333,0.543,12,19,0.631578947368421
Dell Curry,curryde01,SG,36,TOR,2001,71,956.0,429,75,16,69,85,27,8,39,66,162,382,0.4240837696335078,62,145,0.4275862068965517,100,237,0.4219409282700422,0.505,43,51,0.8431372549019608
Michael Curry,currymi01,SG,32,DET,2001,68,1485.0,356,132,21,100,121,27,3,61,173,145,319,0.4545454545454545,4,9,0.4444444444444444,141,310,0.4548387096774193,0.461,62,73,0.8493150684931506
Erick Dampier,dampier01,C,25,GSW,2001,43,1038.0,319,59,97,153,250,17,58,82,123,126,314,0.4012738853503185,0,2,0.0,126,312,0.4038461538461538,0.401,67,126,0.5317460317460317
Antonio Daniels,daniean01,PG,25,SAS,2001,79,2060.0,745,304,26,137,163,61,14,109,120,275,588,0.467687074829932,74,183,0.4043715846994535,201,405,0.4962962962962963,0.531,121,156,0.7756410256410257
Kornél Dávid,davidko01,SF,29,TOT,2001,27,209.0,62,7,15,37,52,6,4,11,28,25,51,0.4901960784313725,0,0,0.0,25,51,0.4901960784313725,0.49,12,13,0.9230769230769232
Antonio Davis,davisan01,C,32,TOR,2001,78,2729.0,1069,106,274,513,787,22,151,135,230,375,866,0.4330254041570439,0,1,0.0,375,865,0.4335260115606936,0.433,319,423,0.7541371158392435
Baron Davis,davisba01,PG,21,CHH,2001,82,3192.0,1131,598,129,279,408,170,36,226,267,409,957,0.4273772204806687,85,274,0.3102189781021898,324,683,0.4743777452415813,0.472,228,337,0.6765578635014837
Dale Davis,davisda01,C,31,POR,2001,81,2162.0,580,103,233,373,606,44,76,67,199,242,487,0.4969199178644763,0,4,0.0,242,483,0.5010351966873706,0.497,96,152,0.631578947368421
Emanual Davis,davisem01,SG,32,SEA,2001,62,1290.0,361,137,28,126,154,64,12,77,101,133,318,0.4182389937106918,50,127,0.3937007874015748,83,191,0.4345549738219895,0.497,45,55,0.8181818181818182
Hubert Davis,davishu01,PG,30,TOT,2001,66,1692.0,524,110,28,111,139,35,1,81,121,196,433,0.4526558891454965,78,171,0.4561403508771929,118,262,0.4503816793893129,0.543,54,62,0.8709677419354839
Ricky Davis,davisri01,SG,21,MIA,2001,7,70.0,32,11,1,6,7,5,2,5,7,12,29,0.4137931034482758,1,1,1.0,11,28,0.3928571428571428,0.431,7,8,0.875
Terry Davis,daviste01,PF,33,DEN,2001,19,228.0,33,7,24,29,53,1,1,5,34,12,25,0.48,0,0,0.0,12,25,0.48,0.48,9,22,0.4090909090909091
Todd Day,dayto01,SG,31,MIN,2001,31,345.0,132,28,10,27,37,10,7,24,52,44,118,0.3728813559322034,26,69,0.3768115942028985,18,49,0.3673469387755102,0.483,18,23,0.782608695652174
Andrew DeClercq,declean01,C,27,ORL,2001,67,903.0,261,32,91,145,236,41,33,51,198,107,193,0.5544041450777202,0,0,0.0,107,193,0.5544041450777202,0.554,47,82,0.573170731707317
Vinny Del Negro,delnevi01,PG,34,TOT,2001,65,922.0,254,126,12,70,82,26,3,34,78,106,234,0.452991452991453,1,13,0.0769230769230769,105,221,0.4751131221719457,0.455,41,44,0.9318181818181818
Tony Delk,delkto01,SG,27,PHO,2001,82,2288.0,1005,160,76,185,261,75,17,101,171,383,923,0.4149512459371614,54,168,0.3214285714285714,329,755,0.4357615894039735,0.444,185,235,0.7872340425531915
Derrick Dial,dialde01,SG,25,SAS,2001,33,207.0,86,21,12,26,38,4,6,12,22,36,83,0.4337349397590361,2,10,0.2,34,73,0.4657534246575342,0.446,12,21,0.5714285714285714
Michael Dickerson,dickemi01,SG,25,VAN,2001,70,2618.0,1142,233,70,159,229,62,27,162,207,425,1020,0.4166666666666667,86,230,0.3739130434782609,339,790,0.4291139240506329,0.459,206,270,0.762962962962963
Vlade Divac,divacvl01,C,32,SAC,2001,81,2420.0,974,231,207,466,673,87,93,192,242,364,755,0.4821192052980132,4,14,0.2857142857142857,360,741,0.48582995951417,0.485,242,350,0.6914285714285714
Michael Doleac,doleami01,C,23,ORL,2001,77,1398.0,490,65,70,203,273,37,41,59,239,220,527,0.4174573055028463,0,3,0.0,220,524,0.4198473282442748,0.417,50,59,0.847457627118644
Keyon Dooling,doolike01,PG,20,LAC,2001,76,1237.0,449,177,8,81,89,41,11,94,107,148,362,0.4088397790055249,28,80,0.35,120,282,0.425531914893617,0.448,125,179,0.6983240223463687
Sherman Douglas,douglsh01,PG,34,NJN,2001,59,1094.0,338,144,21,53,74,36,4,79,93,122,303,0.4026402640264026,8,40,0.2,114,263,0.4334600760456273,0.416,86,115,0.7478260869565218
Bryce Drew,drewbr01,PG,26,CHI,2001,48,1305.0,302,185,12,57,69,32,3,68,99,124,327,0.3792048929663608,40,105,0.3809523809523809,84,222,0.3783783783783784,0.44,14,19,0.7368421052631579
Chris Dudley,dudlech02,C,35,PHO,2001,53,613.0,72,18,64,119,183,14,29,26,111,29,73,0.3972602739726027,0,0,0.0,29,73,0.3972602739726027,0.397,14,36,0.3888888888888889
Tim Duncan,duncati01,PF,24,SAS,2001,82,3174.0,1820,245,259,738,997,70,192,242,247,702,1406,0.4992887624466572,7,27,0.2592592592592592,695,1379,0.5039883973894126,0.502,409,662,0.6178247734138973
Tyus Edney,edneyty01,PG,27,IND,2001,24,263.0,106,54,5,19,24,17,0,25,17,35,91,0.3846153846153846,1,6,0.1666666666666666,34,85,0.4,0.39,35,39,0.8974358974358975
Kevin Edwards,edwarke01,SG,35,VAN,2001,46,634.0,160,52,23,59,82,29,8,37,46,56,170,0.3294117647058823,5,19,0.2631578947368421,51,151,0.3377483443708609,0.344,43,53,0.8113207547169812
Howard Eisley,eisleho01,SG,28,DAL,2001,82,2426.0,741,295,23,174,197,99,12,102,218,265,675,0.3925925925925926,107,269,0.3977695167286245,158,406,0.3891625615763547,0.472,104,126,0.8253968253968254
Obinna Ekezie,ekeziob01,PF,25,TOT,2001,33,281.0,101,9,31,47,78,5,5,14,48,32,81,0.3950617283950617,0,0,0.0,32,81,0.3950617283950617,0.395,37,53,0.6981132075471698
Khalid El-Amin,elamikh01,PG,21,CHI,2001,50,936.0,314,145,21,60,81,48,2,54,99,115,311,0.3697749196141479,28,84,0.3333333333333333,87,227,0.3832599118942731,0.415,56,72,0.7777777777777778
Mario Elie,eliema01,SG,37,PHO,2001,68,1506.0,299,131,38,117,155,58,12,60,112,104,246,0.4227642276422764,36,100,0.36,68,146,0.4657534246575342,0.496,55,69,0.7971014492753623
Sean Elliott,elliose01,SF,32,SAS,2001,52,1229.0,409,81,17,153,170,23,25,51,80,147,339,0.4336283185840708,55,129,0.4263565891472868,92,210,0.4380952380952381,0.515,60,84,0.7142857142857143
LaPhonso Ellis,ellisla01,PF,30,MIN,2001,82,1948.0,772,93,199,295,494,67,74,108,290,298,642,0.4641744548286604,7,22,0.3181818181818182,291,620,0.4693548387096774,0.47,169,214,0.7897196261682243
Pervis Ellison,ellispe01,C,33,SEA,2001,9,40.0,6,3,2,10,12,0,2,3,13,2,7,0.2857142857142857,0,0,0.0,2,7,0.2857142857142857,0.286,2,2,1.0
Evan Eschmeyer,eschmev01,C,25,NJN,2001,74,1331.0,251,40,135,231,366,41,58,53,220,92,200,0.46,0,0,0.0,92,200,0.46,0.46,67,102,0.6568627450980392
Patrick Ewing,ewingpa01,C,38,SEA,2001,79,2107.0,760,92,124,461,585,53,91,151,229,294,684,0.4298245614035088,0,2,0.0,294,682,0.4310850439882698,0.43,172,251,0.6852589641434262
Jamie Feick,feickja01,C,26,NJN,2001,6,149.0,22,5,12,44,56,8,3,7,15,8,23,0.3478260869565217,0,0,0.0,8,23,0.3478260869565217,0.348,6,12,0.5
Danny Ferry,ferryda01,SF,34,SAS,2001,80,1688.0,448,71,55,168,223,28,21,50,169,178,375,0.4746666666666667,70,156,0.4487179487179487,108,219,0.4931506849315068,0.568,22,30,0.7333333333333333
Michael Finley,finlemi01,SF,27,DAL,2001,82,3443.0,1765,360,109,316,425,118,32,190,174,711,1552,0.4581185567010309,91,263,0.3460076045627376,620,1289,0.4809930178432893,0.487,252,325,0.7753846153846153
Derek Fisher,fishede01,PG,26,LAL,2001,20,709.0,229,87,5,54,59,39,2,29,50,77,187,0.4117647058823529,25,63,0.3968253968253968,52,124,0.4193548387096774,0.479,50,62,0.8064516129032258
Marcus Fizer,fizerma01,PF,22,CHI,2001,72,1580.0,683,76,76,237,313,30,19,124,175,278,646,0.4303405572755417,10,39,0.2564102564102564,268,607,0.4415156507413509,0.438,117,161,0.7267080745341615
Danny Fortson,fortsda01,PF,24,GSW,2001,6,203.0,100,5,29,69,98,2,0,10,22,29,50,0.58,0,0,0.0,29,50,0.58,0.58,42,54,0.7777777777777778
Greg Foster,fostegr01,C,32,LAL,2001,62,451.0,125,32,29,83,112,9,12,25,76,56,133,0.4210526315789473,3,9,0.3333333333333333,53,124,0.4274193548387097,0.432,10,14,0.7142857142857143
Jeff Foster,fosteje01,C,24,IND,2001,71,1152.0,249,33,144,245,389,39,28,52,152,100,213,0.4694835680751174,2,7,0.2857142857142857,98,206,0.4757281553398058,0.474,47,91,0.5164835164835165
Rick Fox,foxri01,SF,31,LAL,2001,82,2291.0,787,262,80,245,325,70,29,136,225,287,646,0.4442724458204334,118,300,0.3933333333333333,169,346,0.4884393063583815,0.536,95,122,0.7786885245901639
Adonal Foyle,foylead01,C,25,GSW,2001,58,1457.0,342,48,156,249,405,31,156,79,136,156,375,0.416,0,0,0.0,156,375,0.416,0.416,30,68,0.4411764705882353
Steve Francis,francst01,PG,23,HOU,2001,80,3194.0,1591,517,190,363,553,141,31,265,274,550,1219,0.4511894995898277,133,336,0.3958333333333333,417,883,0.4722536806342016,0.506,358,438,0.817351598173516
Todd Fuller,fulleto02,C,26,MIA,2001,10,77.0,28,1,7,11,18,3,2,3,10,10,35,0.2857142857142857,0,0,0.0,10,35,0.2857142857142857,0.286,8,8,1.0
Lawrence Funderburke,fundela01,PF,30,SAC,2001,59,698.0,288,17,74,122,196,9,13,32,44,120,242,0.4958677685950413,0,0,0.0,120,242,0.4958677685950413,0.496,48,77,0.6233766233766234
Rubén Garcés,garceru01,PF,27,TOT,2001,13,73.0,16,5,16,13,29,3,2,5,14,7,22,0.3181818181818182,0,0,0.0,7,22,0.3181818181818182,0.318,2,8,0.25
Chris Garner,garnech01,PG,25,GSW,2001,8,149.0,19,18,2,10,12,7,1,9,18,7,37,0.1891891891891892,0,7,0.0,7,30,0.2333333333333333,0.189,5,6,0.8333333333333334
Kevin Garnett,garneke01,PF,24,MIN,2001,81,3202.0,1784,401,219,702,921,111,145,230,204,704,1475,0.4772881355932203,19,66,0.2878787878787879,685,1409,0.4861603974449964,0.484,357,467,0.7644539614561028
Dean Garrett,garrede01,C,34,MIN,2001,70,831.0,177,24,65,152,217,26,49,25,93,75,156,0.4807692307692308,0,0,0.0,75,156,0.4807692307692308,0.481,27,39,0.6923076923076923
Pat Garrity,garripa01,SF,24,ORL,2001,76,1579.0,628,51,51,159,210,40,15,68,241,223,576,0.3871527777777778,97,224,0.4330357142857143,126,352,0.3579545454545454,0.471,85,98,0.8673469387755102
Chris Gatling,gatlich01,PF,33,CLE,2001,74,1670.0,842,61,99,292,391,52,27,119,185,329,733,0.4488403819918145,28,92,0.3043478260869565,301,641,0.469578783151326,0.468,156,228,0.6842105263157895
Matt Geiger,geigema01,C,31,PHI,2001,35,542.0,213,14,50,89,139,12,8,25,73,88,224,0.3928571428571428,0,2,0.0,88,222,0.3963963963963964,0.393,37,54,0.6851851851851852
Devean George,georgde01,SF,23,LAL,2001,59,593.0,182,19,35,75,110,15,15,34,87,64,207,0.3091787439613526,15,68,0.2205882352941176,49,139,0.3525179856115107,0.345,39,55,0.7090909090909091
Eddie Gill,gilled01,PG,22,NJN,2001,8,152.0,39,24,0,9,9,4,1,10,9,16,41,0.3902439024390244,3,9,0.3333333333333333,13,32,0.40625,0.427,4,5,0.8
Kendall Gill,gillke01,SG,32,NJN,2001,31,892.0,283,87,32,99,131,47,7,48,64,107,323,0.3312693498452012,4,14,0.2857142857142857,103,309,0.3333333333333333,0.337,65,90,0.7222222222222222
Dion Glover,glovedi01,SG,22,ATL,2001,57,929.0,338,69,39,92,131,49,10,54,92,141,336,0.4196428571428571,9,46,0.1956521739130435,132,290,0.4551724137931034,0.433,47,69,0.6811594202898551
Anthony Goldwire,goldwan01,PG,29,DEN,2001,20,201.0,82,34,1,11,12,9,0,15,13,30,80,0.375,9,34,0.2647058823529412,21,46,0.4565217391304347,0.431,13,17,0.7647058823529411
Steve Goodrich,goodrst01,PF,24,CHI,2001,12,133.0,19,6,7,14,21,2,1,8,14,7,18,0.3888888888888889,1,3,0.3333333333333333,6,15,0.4,0.417,4,7,0.5714285714285714
Brian Grant,grantbr01,C,28,MIA,2001,82,2771.0,1250,101,217,501,718,60,71,170,293,484,1010,0.4792079207920792,0,1,0.0,484,1009,0.4796828543111992,0.479,282,354,0.7966101694915254
Gary Grant,grantga01,PG,35,POR,2001,4,17.0,10,1,0,0,0,0,0,0,1,5,7,0.7142857142857143,0,0,0.0,5,7,0.7142857142857143,0.714,0,0,0.0
Horace Grant,grantho01,PF,35,LAL,2001,77,2390.0,657,121,220,325,545,51,61,48,181,263,569,0.4622144112478031,0,3,0.0,263,566,0.4646643109540636,0.462,131,169,0.7751479289940828
A.C. Green,greenac01,PF,37,MIA,2001,82,1411.0,367,39,107,206,313,30,8,45,119,144,324,0.4444444444444444,0,6,0.0,144,318,0.4528301886792453,0.444,79,111,0.7117117117117117
Adrian Griffin,griffad01,SF,26,BOS,2001,44,377.0,93,27,27,60,87,18,5,18,45,33,97,0.3402061855670103,9,26,0.3461538461538461,24,71,0.3380281690140845,0.387,18,24,0.75
Tom Gugliotta,guglito01,PF,31,PHO,2001,57,1159.0,362,55,76,179,255,47,21,51,110,149,380,0.3921052631578947,3,12,0.25,146,368,0.3967391304347826,0.396,61,77,0.7922077922077922
A.J. Guyton,guytoaj01,PG,22,CHI,2001,33,630.0,198,64,10,26,36,9,5,24,35,78,192,0.40625,27,69,0.391304347826087,51,123,0.4146341463414634,0.477,15,18,0.8333333333333334
Darvin Ham,hamda01,SF,27,MIL,2001,29,540.0,109,25,56,65,121,17,21,33,85,39,80,0.4875,2,3,0.6666666666666666,37,77,0.4805194805194805,0.5,29,49,0.5918367346938775
Richard Hamilton,hamilri01,SF,22,WAS,2001,78,2519.0,1411,224,75,163,238,75,10,201,203,547,1249,0.4379503602882306,40,146,0.273972602739726,507,1103,0.4596554850407978,0.454,277,319,0.8683385579937304
Zendon Hamilton,hamilze01,C,25,LAC,2001,3,19.0,9,0,3,5,8,0,0,2,4,2,9,0.2222222222222222,0,0,0.0,2,9,0.2222222222222222,0.222,5,8,0.625
Tom Hammonds,hammoto01,PF,33,MIN,2001,7,30.0,7,1,2,2,4,0,0,3,8,3,10,0.3,0,0,0.0,3,10,0.3,0.3,1,2,0.5
Anfernee Hardaway,hardaan01,SG,29,PHO,2001,4,112.0,39,15,5,13,18,6,1,3,6,15,36,0.4166666666666667,2,8,0.25,13,28,0.4642857142857143,0.444,7,11,0.6363636363636364
Tim Hardaway,hardati01,PG,34,MIA,2001,77,2613.0,1150,483,26,178,204,90,6,189,155,408,1042,0.3915547024952015,189,517,0.3655705996131528,219,525,0.4171428571428571,0.482,145,181,0.8011049723756906
Ron Harper,harpero01,PG,37,LAL,2001,47,1139.0,307,113,46,120,166,39,25,62,70,127,271,0.4686346863468634,19,72,0.2638888888888889,108,199,0.542713567839196,0.504,34,48,0.7083333333333334
Matt Harpring,harprma01,SG,24,CLE,2001,56,1615.0,623,102,90,152,242,42,17,90,161,238,524,0.4541984732824427,13,52,0.25,225,472,0.4766949152542373,0.467,134,165,0.8121212121212121
Al Harrington,harrial01,PF,20,IND,2001,78,1892.0,586,130,119,262,381,63,18,148,223,241,543,0.4438305709023941,1,7,0.1428571428571428,240,536,0.4477611940298507,0.445,103,157,0.6560509554140127
Othella Harrington,harriot01,C,27,TOT,2001,74,1815.0,665,56,139,249,388,34,45,145,237,247,507,0.4871794871794871,0,3,0.0,247,504,0.490079365079365,0.487,171,224,0.7633928571428571
Lucious Harris,harrilu01,SG,30,NJN,2001,73,2071.0,683,135,71,217,288,74,16,64,127,265,624,0.4246794871794871,46,132,0.3484848484848485,219,492,0.4451219512195122,0.462,107,139,0.7697841726618705
Jason Hart,hartja01,PG,22,MIL,2001,1,10.0,2,1,0,0,0,0,0,2,0,1,1,1.0,0,0,0.0,1,1,1.0,1.0,0,0,0.0
Antonio Harvey,harvean01,PF,30,POR,2001,12,72.0,31,4,5,9,14,1,6,3,10,13,28,0.4642857142857143,0,0,0.0,13,28,0.4642857142857143,0.464,5,6,0.8333333333333334
Donnell Harvey,harvedo01,PF,20,DAL,2001,18,65.0,22,2,6,14,20,3,1,7,15,8,14,0.5714285714285714,0,0,0.0,8,14,0.5714285714285714,0.571,6,16,0.375
Hersey Hawkins,hawkihe01,SG,34,CHH,2001,59,681.0,183,72,17,63,80,33,9,19,45,56,137,0.4087591240875912,17,46,0.3695652173913043,39,91,0.4285714285714285,0.471,54,63,0.8571428571428571
Michael Hawkins,hawkimi01,PG,28,CLE,2001,10,76.0,8,13,2,3,5,2,0,6,13,3,9,0.3333333333333333,2,4,0.5,1,5,0.2,0.444,0,0,0.0
Alan Henderson,hendeal01,PF,28,ATL,2001,73,1810.0,769,50,180,226,406,51,29,126,164,298,671,0.4441132637853949,0,1,0.0,298,670,0.444776119402985,0.444,173,271,0.6383763837638377
Cedric Henderson,hendece02,SF,25,CLE,2001,55,961.0,235,79,19,71,90,29,23,63,101,102,262,0.3893129770992366,1,8,0.125,101,254,0.3976377952755905,0.391,30,46,0.6521739130434783
Chris Herren,herrech01,PG,25,BOS,2001,25,408.0,83,56,4,17,21,14,0,20,43,29,96,0.3020833333333333,16,55,0.2909090909090909,13,41,0.3170731707317073,0.385,9,12,0.75
Grant Hill,hillgr01,SF,28,ORL,2001,4,133.0,55,25,8,17,25,5,2,11,9,19,43,0.4418604651162791,1,1,1.0,18,42,0.4285714285714285,0.453,16,26,0.6153846153846154
Tyrone Hill,hillty01,PF,32,PHI,2001,76,2363.0,728,48,239,448,687,37,27,127,242,278,587,0.4735945485519591,0,1,0.0,278,586,0.4744027303754266,0.474,172,273,0.63003663003663
Fred Hoiberg,hoibefr01,SG,28,CHI,2001,74,2247.0,673,263,21,287,308,98,12,74,155,217,495,0.4383838383838384,103,250,0.412,114,245,0.4653061224489795,0.542,136,157,0.8662420382165605
Robert Horry,horryro01,PF,30,LAL,2001,79,1587.0,407,128,93,203,296,54,54,79,210,147,380,0.3868421052631579,54,156,0.3461538461538461,93,224,0.4151785714285714,0.458,59,83,0.7108433734939759
Eddie House,houseed01,PG,22,MIA,2001,50,550.0,251,52,5,37,42,13,0,35,58,104,247,0.4210526315789473,19,55,0.3454545454545454,85,192,0.4427083333333333,0.46,24,35,0.6857142857142857
Allan Houston,houstal01,SG,29,NYK,2001,78,2858.0,1459,173,20,263,283,52,10,161,190,542,1208,0.4486754966887417,96,252,0.3809523809523809,446,956,0.4665271966527197,0.488,279,307,0.9087947882736156
Juwan Howard,howarju01,PF,27,TOT,2001,81,2974.0,1462,224,171,401,572,75,37,242,292,583,1218,0.4786535303776683,0,3,0.0,583,1215,0.479835390946502,0.479,296,383,0.7728459530026109
Troy Hudson,hudsotr01,PG,24,ORL,2001,75,1008.0,357,162,38,67,105,37,3,92,82,125,372,0.336021505376344,22,109,0.2018348623853211,103,263,0.3916349809885932,0.366,85,104,0.8173076923076923
Larry Hughes,hughela01,SG,22,GSW,2001,50,1846.0,823,223,76,200,276,96,29,152,147,308,805,0.3826086956521739,14,75,0.1866666666666666,294,730,0.4027397260273972,0.391,193,252,0.7658730158730159
Lindsey Hunter,hunteli01,PG,30,MIL,2001,82,2002.0,825,222,32,137,169,102,12,68,172,298,783,0.3805874840357598,152,407,0.3734643734643734,146,376,0.3882978723404255,0.478,77,96,0.8020833333333334
Zydrunas Ilgauskas,ilgauzy01,C,25,CLE,2001,24,616.0,281,18,65,95,160,15,37,60,78,114,234,0.4871794871794871,0,2,0.0,114,232,0.4913793103448275,0.487,53,78,0.6794871794871795
Allen Iverson,iversal01,SG,25,PHI,2001,71,2979.0,2207,325,50,223,273,178,20,237,147,762,1813,0.4202978488692774,98,306,0.3202614379084967,664,1507,0.4406104844061048,0.447,585,719,0.8136300417246175
Bobby Jackson,jacksbo01,PG,27,SAC,2001,79,1648.0,566,161,74,172,246,87,7,103,139,231,526,0.4391634980988593,39,104,0.375,192,422,0.4549763033175355,0.476,65,88,0.7386363636363636
Jaren Jackson,jacksja01,SG,33,SAS,2001,16,114.0,39,7,1,11,12,5,0,3,13,16,40,0.4,7,18,0.3888888888888889,9,22,0.4090909090909091,0.488,0,2,0.0
Jim Jackson,jacksji01,SF,30,TOT,2001,56,1690.0,643,163,53,171,224,53,10,130,139,239,632,0.3781645569620253,26,80,0.325,213,552,0.3858695652173913,0.399,139,169,0.8224852071005917
Marc Jackson,jacksma02,C,26,GSW,2001,48,1410.0,633,59,119,242,361,34,27,93,138,237,508,0.4665354330708661,5,23,0.217391304347826,232,485,0.4783505154639175,0.471,154,192,0.8020833333333334
Mark Jackson,jacksma01,PG,35,TOT,2001,83,2588.0,631,661,63,242,305,84,7,175,139,244,583,0.41852487135506,70,207,0.3381642512077294,174,376,0.4627659574468085,0.479,73,93,0.7849462365591398
Stephen Jackson,jacksst02,SF,22,NJN,2001,77,1660.0,635,140,41,167,208,86,14,130,166,243,572,0.4248251748251748,52,155,0.3354838709677419,191,417,0.4580335731414868,0.47,97,135,0.7185185185185186
Sam Jacobson,jacobsa01,PG,25,MIN,2001,14,59.0,20,4,3,3,6,3,0,0,19,9,18,0.5,0,0,0.0,9,18,0.5,0.5,2,3,0.6666666666666666
Tim James,jamesti01,SF,24,CHH,2001,30,197.0,45,8,15,20,35,2,5,8,27,16,52,0.3076923076923077,1,3,0.3333333333333333,15,49,0.3061224489795918,0.317,12,14,0.8571428571428571
Antawn Jamison,jamisan01,SF,24,GSW,2001,82,3394.0,2044,164,280,435,715,114,28,199,225,800,1812,0.4415011037527593,62,205,0.3024390243902439,738,1607,0.4592408214063472,0.459,382,534,0.7153558052434457
Anthony Johnson,johnsan02,PG,26,TOT,2001,53,511.0,130,78,10,34,44,23,6,34,62,53,152,0.3486842105263157,1,5,0.2,52,147,0.3537414965986394,0.352,23,33,0.696969696969697
Avery Johnson,johnsav01,PG,35,SAS,2001,55,1290.0,310,237,21,64,85,33,4,60,90,134,300,0.4466666666666666,1,6,0.1666666666666666,133,294,0.4523809523809524,0.448,41,60,0.6833333333333333
DerMarr Johnson,johnsde03,SF,20,ATL,2001,78,1313.0,397,64,56,122,178,43,30,93,134,146,390,0.3743589743589743,41,127,0.3228346456692913,105,263,0.3992395437262357,0.427,64,87,0.735632183908046
Ervin Johnson,johnser02,C,33,MIL,2001,82,1981.0,266,40,205,408,613,44,97,47,257,108,198,0.5454545454545454,0,0,0.0,108,198,0.5454545454545454,0.545,50,93,0.5376344086021505
Larry Johnson,johnsla02,PF,31,NYK,2001,65,2105.0,645,127,90,273,363,39,29,97,209,246,598,0.411371237458194,51,163,0.3128834355828221,195,435,0.4482758620689655,0.454,102,128,0.796875
Damon Jones,jonesda01,PG,24,VAN,2001,71,1415.0,461,224,16,108,124,36,1,76,58,170,416,0.4086538461538461,84,231,0.3636363636363636,86,185,0.4648648648648649,0.51,37,52,0.7115384615384616
Eddie Jones,jonesed02,SG,29,MIA,2001,63,2282.0,1094,171,75,217,292,110,58,135,183,388,871,0.4454649827784156,90,238,0.3781512605042016,298,633,0.4707740916271722,0.497,228,270,0.8444444444444444
Jumaine Jones,jonesju01,SF,21,PHI,2001,65,866.0,304,32,63,126,189,30,15,39,68,122,275,0.4436363636363636,20,60,0.3333333333333333,102,215,0.4744186046511628,0.48,40,53,0.7547169811320755
Popeye Jones,jonespo01,PF,30,WAS,2001,45,638.0,162,31,83,137,220,19,8,21,95,60,153,0.392156862745098,1,6,0.1666666666666666,59,147,0.4013605442176871,0.395,41,55,0.7454545454545455
Garth Joseph,josepga01,C,27,TOT,2001,4,16.0,2,1,2,0,2,0,1,2,1,1,5,0.2,0,0,0.0,1,5,0.2,0.2,0,2,0.0
Adam Keefe,keefead01,PF,30,GSW,2001,67,836.0,168,36,90,119,209,28,20,40,102,64,159,0.4025157232704403,1,3,0.3333333333333333,63,156,0.4038461538461538,0.406,39,63,0.6190476190476191
Shawn Kemp,kempsh01,PF,31,POR,2001,68,1083.0,441,65,63,196,259,45,23,99,184,168,413,0.4067796610169492,4,11,0.3636363636363636,164,402,0.4079601990049751,0.412,101,131,0.7709923664122137
Steve Kerr,kerrst01,PG,35,SAS,2001,55,650.0,181,57,6,29,35,16,1,21,30,67,159,0.4213836477987421,33,77,0.4285714285714285,34,82,0.4146341463414634,0.525,14,15,0.9333333333333332
Jerome Kersey,kerseje01,SF,38,MIL,2001,22,243.0,72,15,8,37,45,14,8,6,36,32,69,0.463768115942029,0,1,0.0,32,68,0.4705882352941176,0.464,8,16,0.5
Lari Ketner,ketnela01,PF,23,IND,2001,3,7.0,0,1,0,0,0,0,0,2,0,0,0,0.0,0,0,0.0,0,0,0.0,0.0,0,0,0.0
Jason Kidd,kiddja01,PG,27,PHO,2001,77,3065.0,1299,753,91,403,494,166,23,286,171,451,1097,0.4111212397447584,69,232,0.2974137931034483,382,865,0.4416184971098266,0.443,328,403,0.8138957816377171
Gerard King,kingge02,SF,28,WAS,2001,45,706.0,216,31,39,90,129,14,11,47,94,90,176,0.5113636363636364,0,0,0.0,90,176,0.5113636363636364,0.511,36,45,0.8
Brevin Knight,knighbr01,PG,25,TOT,2001,53,1457.0,333,311,23,145,168,101,4,91,155,139,371,0.3746630727762803,1,10,0.1,138,361,0.3822714681440443,0.376,54,66,0.8181818181818182
Travis Knight,knightr01,C,26,NYK,2001,45,256.0,29,5,19,34,53,5,11,10,47,10,53,0.1886792452830188,0,1,0.0,10,52,0.1923076923076923,0.189,9,18,0.5
Toni Kukoč,kukocto01,SF,32,TOT,2001,65,1597.0,721,199,66,193,259,48,11,111,98,275,582,0.4725085910652921,70,157,0.445859872611465,205,425,0.4823529411764706,0.533,101,160,0.63125
Christian Laettner,laettch01,C-PF,31,TOT,2001,78,1663.0,728,124,118,247,365,71,46,137,242,277,551,0.5027223230490018,4,13,0.3076923076923077,273,538,0.5074349442379182,0.506,170,204,0.8333333333333334
Raef LaFrentz,lafrera01,C,24,DEN,2001,78,2457.0,1008,107,173,434,607,37,206,97,290,387,812,0.4766009852216749,51,139,0.3669064748201439,336,673,0.4992570579494799,0.508,183,262,0.6984732824427481
Trajan Langdon,langdtr01,SG,24,CLE,2001,65,1116.0,389,81,12,77,89,38,9,52,114,135,313,0.4313099041533546,51,124,0.4112903225806452,84,189,0.4444444444444444,0.513,68,76,0.8947368421052632
Dan Langhi,langhda01,SF,23,HOU,2001,33,241.0,90,4,13,28,41,7,1,8,16,37,99,0.3737373737373737,0,1,0.0,37,98,0.3775510204081632,0.374,16,29,0.5517241379310345
Voshon Lenard,lenarvo01,SG,27,DEN,2001,80,2331.0,972,190,47,184,231,65,18,102,170,336,846,0.3971631205673759,147,382,0.3848167539267015,189,464,0.4073275862068966,0.484,153,192,0.796875
Quincy Lewis,lewisqu01,SF,23,UTA,2001,35,402.0,124,18,14,33,47,10,10,17,78,50,123,0.4065040650406504,9,25,0.36,41,98,0.4183673469387755,0.443,15,21,0.7142857142857143
Rashard Lewis,lewisra02,PF,21,SEA,2001,78,2720.0,1151,125,143,398,541,91,45,129,191,426,887,0.4802705749718151,123,285,0.431578947368421,303,602,0.5033222591362126,0.55,176,213,0.8262910798122066
Randy Livingston,livinra01,PG,25,GSW,2001,2,7.0,0,1,0,1,1,0,0,0,0,0,2,0.0,0,1,0.0,0,1,0.0,0.0,0,0,0.0
Art Long,longar01,PF,28,SAC,2001,9,20.0,0,1,2,6,8,0,3,2,5,0,4,0.0,0,0,0.0,0,4,0.0,0.0,0,2,0.0
Grant Long,longgr01,PF,34,VAN,2001,66,1507.0,396,83,76,198,274,72,15,62,160,140,319,0.438871473354232,4,15,0.2666666666666666,136,304,0.4473684210526316,0.445,112,157,0.7133757961783439
Luc Longley,longllu01,C,32,NYK,2001,25,301.0,49,7,26,40,66,3,9,22,51,18,54,0.3333333333333333,0,0,0.0,18,54,0.3333333333333333,0.333,13,17,0.7647058823529411
Felipe López,lopezfe01,SG-PG,26,TOT,2001,70,1565.0,550,107,55,179,234,62,30,83,156,211,478,0.4414225941422594,19,52,0.3653846153846153,192,426,0.4507042253521127,0.461,109,156,0.6987179487179487
Tyronn Lue,luety01,PG,23,LAL,2001,38,468.0,130,45,5,27,32,19,0,27,54,50,117,0.4273504273504273,11,34,0.3235294117647059,39,83,0.4698795180722891,0.474,19,24,0.7916666666666666
George Lynch,lynchge01,SF,30,PHI,2001,82,2649.0,686,139,200,390,590,99,30,109,222,274,616,0.4448051948051948,15,57,0.2631578947368421,259,559,0.4633273703041144,0.457,123,171,0.7192982456140351
Todd MacCulloch,maccuto01,C,25,PHI,2001,63,597.0,260,10,69,99,168,7,19,27,96,109,185,0.5891891891891892,0,0,0.0,109,185,0.5891891891891892,0.589,42,66,0.6363636363636364
Don MacLean,macledo01,SF,31,MIA,2001,8,76.0,31,4,7,11,18,5,1,10,9,10,20,0.5,2,2,1.0,8,18,0.4444444444444444,0.55,9,12,0.75
Mark Madsen,madsema01,PF,25,LAL,2001,70,641.0,137,24,74,78,152,8,8,27,111,55,113,0.4867256637168141,1,1,1.0,54,112,0.4821428571428571,0.491,26,37,0.7027027027027027
Corey Maggette,maggeco01,SF,21,LAC,2001,69,1359.0,690,82,88,203,291,35,9,106,140,225,487,0.4620123203285421,17,56,0.3035714285714285,208,431,0.482598607888631,0.479,223,288,0.7743055555555556
Jamaal Magloire,magloja01,C,22,CHH,2001,74,1095.0,339,27,103,192,295,18,78,61,139,122,271,0.4501845018450184,0,2,0.0,122,269,0.4535315985130111,0.45,95,145,0.6551724137931034
Dan Majerle,majerda01,SG,35,MIA,2001,53,1306.0,267,88,20,146,166,53,15,35,98,87,259,0.3359073359073359,57,181,0.3149171270718232,30,78,0.3846153846153846,0.446,36,44,0.8181818181818182
Karl Malone,malonka01,PF,37,UTA,2001,81,2895.0,1878,361,114,555,669,93,62,244,216,670,1345,0.4981412639405204,2,5,0.4,668,1340,0.4985074626865671,0.499,536,676,0.7928994082840237
Matt Maloney,malonma01,PG,29,ATL,2001,55,1403.0,369,154,14,103,117,56,5,70,94,146,348,0.4195402298850574,51,142,0.3591549295774648,95,206,0.4611650485436893,0.493,26,34,0.7647058823529411
Danny Manning,mannida01,PF,34,UTA,2001,82,1305.0,603,92,66,148,214,47,29,96,219,247,500,0.494,7,28,0.25,240,472,0.5084745762711864,0.501,102,140,0.7285714285714285
Stephon Marbury,marbust01,PG,23,NJN,2001,67,2557.0,1598,506,53,152,205,79,5,197,150,563,1277,0.4408770555990603,110,335,0.3283582089552239,453,942,0.4808917197452229,0.484,362,458,0.7903930131004366
Shawn Marion,mariosh01,SF,22,PHO,2001,79,2857.0,1369,160,220,628,848,132,108,129,211,557,1160,0.4801724137931034,21,82,0.2560975609756097,536,1078,0.4972170686456401,0.489,234,289,0.8096885813148789
Donyell Marshall,marshdo01,SF,27,UTA,2001,81,2326.0,1100,133,172,394,566,85,78,128,196,427,849,0.502944640753828,41,128,0.3203125,386,721,0.5353675450762829,0.527,205,273,0.7509157509157509
Darrick Martin,martida01,PG,29,SAC,2001,31,176.0,103,14,2,14,16,7,0,10,27,29,76,0.3815789473684211,14,27,0.5185185185185185,15,49,0.3061224489795918,0.474,31,35,0.8857142857142857
Kenyon Martin,martike01,PF,23,NJN,2001,68,2272.0,814,131,137,365,502,78,113,138,281,346,777,0.4453024453024453,1,11,0.0909090909090909,345,766,0.4503916449086161,0.446,121,192,0.6302083333333334
Jamal Mashburn,mashbja01,SF,28,CHH,2001,76,2989.0,1528,411,92,484,576,85,13,211,185,573,1388,0.4128242074927954,103,289,0.356401384083045,470,1099,0.4276615104640582,0.45,279,364,0.7664835164835165
Anthony Mason,masonan01,PF,34,MIA,2001,80,3254.0,1290,248,169,601,770,80,25,179,231,460,954,0.4821802935010482,0,0,0.0,460,954,0.4821802935010482,0.482,370,474,0.7805907172995781
Desmond Mason,masonde01,SF,23,SEA,2001,78,1522.0,463,63,72,177,249,39,20,53,146,189,439,0.4305239179954442,18,67,0.2686567164179104,171,372,0.4596774193548387,0.451,67,91,0.7362637362637363
Tony Massenburg,masseto01,PF,33,VAN,2001,52,823.0,233,9,75,135,210,10,28,48,122,92,199,0.4623115577889447,0,0,0.0,92,199,0.4623115577889447,0.462,49,70,0.7
Vernon Maxwell,maxweve01,PG,35,TOT,2001,43,660.0,201,49,4,62,66,21,3,35,64,73,223,0.3273542600896861,34,111,0.3063063063063063,39,112,0.3482142857142857,0.404,21,32,0.65625
Walter McCarty,mccarwa01,PF,26,BOS,2001,60,478.0,131,39,24,57,81,14,7,20,82,45,126,0.3571428571428571,19,56,0.3392857142857143,26,70,0.3714285714285714,0.433,22,28,0.7857142857142857
Dan McClintock,mcclida01,C,23,DEN,2001,6,58.0,18,1,10,7,17,0,2,3,11,9,18,0.5,0,0,0.0,9,18,0.5,0.5,0,5,0.0
George McCloud,mccloge01,SF,33,DEN,2001,76,2007.0,729,279,55,169,224,53,27,117,165,250,655,0.3816793893129771,77,234,0.329059829059829,173,421,0.4109263657957244,0.44,152,181,0.8397790055248618
Jelani McCoy,mccoyje01,C,23,SEA,2001,70,1143.0,317,57,92,159,251,18,49,75,141,138,264,0.5227272727272727,0,0,0.0,138,264,0.5227272727272727,0.523,41,93,0.4408602150537634
Antonio McDyess,mcdyean01,PF,26,DEN,2001,70,2555.0,1458,146,240,605,845,43,102,162,220,577,1165,0.4952789699570815,0,0,0.0,577,1165,0.4952789699570815,0.495,304,434,0.7004608294930875
Tracy McGrady,mcgratr01,SG,21,ORL,2001,77,3087.0,2065,352,192,388,580,116,118,198,160,788,1724,0.45707656612529,59,166,0.3554216867469879,729,1558,0.4679075738125802,0.474,430,587,0.7325383304940375
Jim McIlvaine,mcilvji01,C,28,NJN,2001,18,193.0,28,4,8,27,35,7,15,9,35,10,28,0.3571428571428571,0,0,0.0,10,28,0.3571428571428571,0.357,8,12,0.6666666666666666
Jeff McInnis,mcinnje01,PG,26,LAC,2001,81,2831.0,1046,447,41,179,220,75,7,113,199,432,933,0.4630225080385852,52,144,0.3611111111111111,380,789,0.4816223067173637,0.491,130,161,0.8074534161490683
Derrick McKey,mckeyde01,SF,34,IND,2001,66,987.0,145,74,49,127,176,48,13,47,136,60,136,0.4411764705882353,4,20,0.2,56,116,0.4827586206896552,0.456,21,27,0.7777777777777778
Aaron McKie,mckieaa01,SG,28,PHI,2001,76,2394.0,878,377,33,278,311,106,8,203,178,338,714,0.4733893557422969,53,170,0.3117647058823529,285,544,0.5238970588235294,0.511,149,194,0.7680412371134021
Roshown McLeod,mcleoro01,SF,25,TOT,2001,35,922.0,337,58,38,82,120,23,8,58,90,145,332,0.4367469879518072,2,22,0.0909090909090909,143,310,0.4612903225806452,0.44,45,51,0.8823529411764706
Paul McPherson,mcphepa01,PG,22,TOT,2001,55,595.0,262,38,40,39,79,25,4,47,80,109,216,0.5046296296296297,2,12,0.1666666666666666,107,204,0.5245098039215687,0.509,42,58,0.7241379310344828
Stanislav Medvedenko,medvest01,PF,21,LAL,2001,7,39.0,32,2,1,8,9,1,1,3,9,12,25,0.48,1,1,1.0,11,24,0.4583333333333333,0.5,7,12,0.5833333333333334
Ron Mercer,mercero01,SG,24,CHI,2001,61,2535.0,1202,201,72,164,236,78,27,129,148,500,1121,0.4460303300624442,14,46,0.3043478260869565,486,1075,0.4520930232558139,0.452,188,228,0.8245614035087719
Chris Mihm,mihmch01,C,21,CLE,2001,59,1166.0,446,16,106,174,280,20,53,80,156,173,391,0.4424552429667519,0,1,0.0,173,390,0.4435897435897435,0.442,100,126,0.7936507936507936
Darius Miles,milesda01,SF,19,LAC,2001,81,2133.0,761,99,127,350,477,51,125,147,191,318,630,0.5047619047619047,1,19,0.0526315789473684,317,611,0.5188216039279869,0.506,124,238,0.5210084033613446
Andre Miller,millean02,PG,24,CLE,2001,82,2848.0,1296,657,94,266,360,119,28,265,229,452,999,0.4524524524524524,17,64,0.265625,435,935,0.46524064171123,0.461,375,450,0.8333333333333334
Anthony Miller,millean01,PF,29,TOT,2001,4,11.0,2,0,0,2,2,0,0,1,1,1,2,0.5,0,0,0.0,1,2,0.5,0.5,0,0,0.0
Brad Miller,millebr01,C,24,CHI,2001,57,1434.0,505,107,144,275,419,33,38,73,176,168,386,0.4352331606217616,1,5,0.2,167,381,0.4383202099737532,0.437,168,226,0.7433628318584071
Mike Miller,millemi01,SF,20,ORL,2001,82,2390.0,975,140,66,261,327,51,19,97,200,368,845,0.4355029585798816,148,364,0.4065934065934066,220,481,0.4573804573804574,0.523,91,128,0.7109375
Reggie Miller,millere01,SG,35,IND,2001,81,3181.0,1527,260,38,247,285,81,15,133,162,517,1176,0.439625850340136,170,464,0.3663793103448275,347,712,0.4873595505617977,0.512,323,348,0.9281609195402298
Chris Mills,millsch01,SF,31,GSW,2001,15,493.0,180,18,24,69,93,9,5,20,43,71,191,0.3717277486910995,7,25,0.28,64,166,0.3855421686746988,0.39,31,36,0.8611111111111112
Terry Mills,millste01,PF,33,IND,2001,14,113.0,25,5,4,17,21,3,1,10,20,11,34,0.3235294117647059,3,17,0.1764705882352941,8,17,0.4705882352941176,0.368,0,0,0.0
Sam Mitchell,mitchsa01,SF,37,MIN,2001,82,983.0,285,57,28,95,123,26,10,36,117,118,289,0.4083044982698962,9,43,0.2093023255813953,109,246,0.4430894308943089,0.424,40,55,0.7272727272727273
Cuttino Mobley,moblecu01,SG,25,HOU,2001,79,3002.0,1538,195,83,314,397,84,26,165,169,527,1214,0.4341021416803954,90,252,0.3571428571428571,437,962,0.4542619542619542,0.471,394,474,0.8312236286919831
Nazr Mohammed,mohamna01,C,23,TOT,2001,58,912.0,441,19,115,192,307,29,35,64,113,176,369,0.4769647696476964,0,1,0.0,176,368,0.4782608695652174,0.477,89,126,0.7063492063492064
Jérôme Moïso,moisoje01,C,22,BOS,2001,24,135.0,35,3,12,30,42,3,4,18,29,12,30,0.4,0,1,0.0,12,29,0.4137931034482758,0.4,11,26,0.4230769230769231
Eric Montross,montrer01,C,29,TOT,2001,54,649.0,120,19,52,121,173,11,26,41,115,56,138,0.4057971014492754,0,0,0.0,56,138,0.4057971014492754,0.406,8,31,0.2580645161290322
Mikki Moore,mooremi01,C,25,DET,2001,81,1154.0,359,33,121,195,316,24,61,74,202,132,268,0.4925373134328358,0,1,0.0,132,267,0.4943820224719101,0.493,95,130,0.7307692307692307
Hanno Möttölä,mottoha01,SF,24,ATL,2001,73,989.0,319,25,49,125,174,11,9,67,163,123,277,0.4440433212996389,0,3,0.0,123,274,0.4489051094890511,0.444,73,90,0.8111111111111111
Alonzo Mourning,mournal01,C,30,MIA,2001,13,306.0,177,12,35,66,101,4,31,28,24,73,141,0.5177304964539007,0,1,0.0,73,140,0.5214285714285715,0.518,31,55,0.5636363636363636
Chris Mullin,mullich01,SF,37,GSW,2001,20,374.0,115,19,10,31,41,16,10,19,28,36,106,0.3396226415094339,19,52,0.3653846153846153,17,54,0.3148148148148148,0.429,24,28,0.8571428571428571
Lamond Murray,murrala01,SF,27,CLE,2001,78,2225.0,998,124,104,236,340,83,27,141,173,391,925,0.4227027027027027,61,165,0.3696969696969697,330,760,0.4342105263157895,0.456,155,211,0.7345971563981043
Tracy Murray,murratr01,SF,29,TOT,2001,51,588.0,257,23,22,59,81,12,7,26,53,94,248,0.3790322580645161,36,103,0.3495145631067961,58,145,0.4,0.452,33,42,0.7857142857142857
Dikembe Mutombo,mutomdi01,C,34,TOT,2001,75,2591.0,749,76,307,708,1015,29,203,144,204,269,556,0.4838129496402877,0,0,0.0,269,556,0.4838129496402877,0.484,211,291,0.7250859106529209
Mamadou N'Diaye,ndiayma02,C,25,TOR,2001,3,10.0,4,0,1,1,2,0,0,0,3,1,4,0.25,0,0,0.0,1,4,0.25,0.25,2,2,1.0
Lee Nailon,nailole01,SF,25,CHH,2001,42,469.0,164,24,29,63,92,9,5,27,60,66,136,0.4852941176470588,0,1,0.0,66,135,0.4888888888888889,0.485,32,43,0.7441860465116279
Eduardo Nájera,najered01,PF,24,DAL,2001,40,431.0,131,27,41,54,95,13,8,17,48,58,111,0.5225225225225225,1,3,0.3333333333333333,57,108,0.5277777777777778,0.527,14,33,0.4242424242424242
Steve Nash,nashst01,PG,26,DAL,2001,70,2387.0,1092,509,46,177,223,72,5,205,158,386,792,0.4873737373737373,89,219,0.4063926940639269,297,573,0.518324607329843,0.544,231,258,0.8953488372093024
Tyrone Nesby,nesbyty01,SF-SG,25,TOT,2001,62,1556.0,512,76,51,122,173,51,20,65,155,189,530,0.3566037735849056,49,180,0.2722222222222222,140,350,0.4,0.403,85,106,0.8018867924528302
Rasho Nesterović,nestera01,C,24,MIN,2001,73,1233.0,328,45,99,187,286,25,63,55,189,147,319,0.4608150470219436,0,1,0.0,147,318,0.4622641509433962,0.461,34,65,0.5230769230769231
Ira Newble,newblir01,SF,26,SAS,2001,27,184.0,54,6,13,22,35,2,4,7,18,21,55,0.3818181818181818,4,9,0.4444444444444444,17,46,0.3695652173913043,0.418,8,16,0.5
Johnny Newman,newmajo01,SG,37,NJN,2001,82,2049.0,895,115,34,142,176,63,10,106,229,291,695,0.418705035971223,59,176,0.3352272727272727,232,519,0.4470134874759152,0.461,254,297,0.8552188552188552
Moochie Norris,norrimo01,PG,27,HOU,2001,82,1654.0,544,283,44,154,198,69,2,107,84,184,413,0.4455205811138014,25,89,0.2808988764044944,159,324,0.4907407407407407,0.476,151,194,0.7783505154639175
Dirk Nowitzki,nowitdi01,PF,22,DAL,2001,82,3125.0,1784,173,119,635,754,79,101,156,245,591,1247,0.4739374498797113,151,390,0.3871794871794872,440,857,0.5134189031505251,0.534,451,538,0.8382899628252788
Jermaine O'Neal,onealje01,C,22,IND,2001,81,2641.0,1041,98,249,545,794,49,228,161,280,404,868,0.4654377880184331,0,5,0.0,404,863,0.4681344148319815,0.465,233,388,0.6005154639175257
Shaquille O'Neal,onealsh01,C,28,LAL,2001,74,2924.0,2125,277,291,649,940,47,204,218,256,813,1422,0.5717299578059072,0,2,0.0,813,1420,0.5725352112676056,0.572,499,972,0.5133744855967078
Charles Oakley,oaklech01,PF,37,TOR,2001,78,2767.0,748,264,142,599,741,76,48,139,258,305,786,0.3880407124681934,11,49,0.2244897959183673,294,737,0.3989145183175034,0.395,127,152,0.8355263157894737
Lamar Odom,odomla01,PF,21,LAC,2001,76,2836.0,1304,392,110,482,592,74,122,264,236,481,1046,0.4598470363288719,80,253,0.3162055335968379,401,793,0.5056746532156369,0.498,262,386,0.6787564766839378
Hakeem Olajuwon,olajuha01,C,38,HOU,2001,58,1545.0,689,72,124,307,431,70,88,81,141,283,568,0.4982394366197183,0,1,0.0,283,567,0.4991181657848324,0.498,123,198,0.6212121212121212
Kevin Ollie,ollieke01,PG,28,TOT,2001,70,925.0,216,146,16,79,95,30,1,49,84,76,192,0.3958333333333333,1,3,0.3333333333333333,75,189,0.3968253968253968,0.398,63,89,0.7078651685393258
Michael Olowokandi,olowomi01,C,25,LAC,2001,82,2127.0,701,46,168,357,525,30,108,169,250,308,708,0.4350282485875706,0,0,0.0,308,708,0.4350282485875706,0.435,85,156,0.5448717948717948
Greg Ostertag,ostergr01,C,27,UTA,2001,81,1491.0,363,22,164,251,415,22,142,63,215,139,281,0.494661921708185,1,2,0.5,138,279,0.4946236559139785,0.496,84,151,0.5562913907284768
Bo Outlaw,outlabo01,PF,29,ORL,2001,80,2534.0,582,225,211,408,619,105,137,141,241,226,368,0.6141304347826086,1,2,0.5,225,366,0.6147540983606558,0.615,129,225,0.5733333333333334
Doug Overton,overtdo01,PG,31,TOT,2001,21,475.0,125,72,4,35,39,8,0,31,37,52,139,0.3741007194244604,11,36,0.3055555555555556,41,103,0.3980582524271844,0.414,10,16,0.625
Billy Owens,owensbi01,PF,31,DET,2001,45,793.0,198,55,84,121,205,32,12,39,93,88,230,0.3826086956521739,3,20,0.15,85,210,0.4047619047619047,0.389,19,40,0.475
Olumide Oyedeji,oyedeol01,C,19,SEA,2001,30,221.0,45,2,24,43,67,7,10,11,40,18,37,0.4864864864864865,0,0,0.0,18,37,0.4864864864864865,0.486,9,12,0.75
Robert Pack,packro01,PG,31,DEN,2001,74,1260.0,479,293,30,107,137,65,1,135,114,181,426,0.4248826291079812,12,31,0.3870967741935484,169,395,0.4278481012658228,0.439,105,137,0.7664233576642335
Scott Padgett,padgesc01,PF,24,UTA,2001,27,127.0,56,5,19,20,39,6,3,10,21,18,43,0.4186046511627907,5,9,0.5555555555555556,13,34,0.3823529411764705,0.477,15,20,0.75
Milt Palacio,palacmi01,PG,22,BOS,2001,58,1141.0,342,151,25,77,102,48,0,80,83,126,267,0.4719101123595505,12,36,0.3333333333333333,114,231,0.4935064935064935,0.494,78,92,0.8478260869565217
Andy Panko,pankoan01,SF,23,ATL,2001,1,1.0,0,0,0,0,0,0,0,0,0,0,0,0.0,0,0,0.0,0,0,0.0,0.0,0,0,0.0
Cherokee Parks,parksch02,C,28,TOT,2001,65,1054.0,299,46,71,158,229,25,36,41,122,134,274,0.4890510948905109,0,6,0.0,134,268,0.5,0.489,31,44,0.7045454545454546
Ruben Patterson,patteru01,SF,25,SEA,2001,76,2059.0,988,161,183,199,382,103,45,155,176,370,749,0.4939919893190921,2,36,0.0555555555555555,368,713,0.5161290322580645,0.495,246,361,0.6814404432132964
Gary Payton,paytoga01,PG,32,SEA,2001,79,3244.0,1823,642,73,288,361,127,26,209,184,725,1591,0.4556882463859208,102,272,0.375,623,1319,0.4723275208491281,0.488,271,354,0.7655367231638418
Anthony Peeler,peelean01,SG,31,MIN,2001,75,2126.0,791,192,44,148,192,91,18,105,166,308,732,0.4207650273224044,100,256,0.390625,208,476,0.4369747899159664,0.489,75,87,0.8620689655172413
Mike Penberthy,penbemi01,PG,26,LAL,2001,53,851.0,267,71,10,53,63,22,2,34,57,92,222,0.4144144144144144,55,139,0.39568345323741,37,83,0.4457831325301205,0.538,28,31,0.9032258064516128
Will Perdue,perduwi01,C,35,POR,2001,13,58.0,14,2,6,12,18,3,2,0,8,6,9,0.6666666666666666,0,0,0.0,6,9,0.6666666666666666,0.667,2,4,0.5
Sam Perkins,perkisa01,PF,39,IND,2001,64,999.0,242,41,32,136,168,33,18,19,61,86,226,0.3805309734513274,38,110,0.3454545454545454,48,116,0.4137931034482758,0.465,32,38,0.8421052631578947
Elliot Perry,perryel01,PG,31,TOT,2001,49,499.0,147,79,9,37,46,22,1,38,29,65,140,0.4642857142857143,1,5,0.2,64,135,0.4740740740740741,0.468,16,22,0.7272727272727273
Wesley Person,persowe01,SG,29,CLE,2001,44,958.0,314,64,11,119,130,27,11,40,62,128,292,0.4383561643835616,34,84,0.4047619047619047,94,208,0.4519230769230769,0.497,24,30,0.8
Morris Peterson,petermo01,SG,23,TOR,2001,80,1809.0,747,105,112,147,259,63,20,78,164,290,673,0.4309063893016345,63,165,0.3818181818181818,227,508,0.4468503937007874,0.478,104,145,0.7172413793103448
Eric Piatkowski,piatker01,SG,30,LAC,2001,81,2144.0,860,96,54,187,241,46,19,76,123,291,672,0.4330357142857143,120,297,0.404040404040404,171,375,0.456,0.522,158,181,0.8729281767955801
Paul Pierce,piercpa01,SF,23,BOS,2001,82,3120.0,2071,253,94,428,522,138,69,262,251,687,1513,0.4540647719762062,147,384,0.3828125,540,1129,0.4782993799822852,0.503,550,738,0.7452574525745257
Scottie Pippen,pippesc01,SF,35,POR,2001,64,2133.0,721,294,70,263,333,94,35,154,158,269,596,0.4513422818791946,64,186,0.3440860215053763,205,410,0.5,0.505,119,161,0.7391304347826086
Scot Pollard,pollasc01,C,25,SAC,2001,77,1658.0,498,47,173,292,465,48,97,66,206,185,395,0.4683544303797468,0,2,0.0,185,393,0.4707379134860051,0.468,128,171,0.7485380116959064
Olden Polynice,polynol01,C,36,UTA,2001,81,1619.0,429,31,157,221,378,27,77,78,241,206,415,0.4963855421686747,0,1,0.0,206,414,0.4975845410628019,0.496,17,65,0.2615384615384615
Mark Pope,popema01,PF,28,MIL,2001,63,942.0,151,38,56,91,147,16,26,17,140,62,142,0.4366197183098591,5,24,0.2083333333333333,57,118,0.4830508474576271,0.454,22,35,0.6285714285714286
Chris Porter,portech01,SF,22,GSW,2001,51,1147.0,440,61,89,100,189,45,6,59,111,173,445,0.3887640449438202,0,5,0.0,173,440,0.3931818181818182,0.389,94,141,0.6666666666666666
Terry Porter,portete01,PG,37,SAS,2001,80,1678.0,573,251,24,177,201,52,11,104,88,197,440,0.4477272727272727,87,205,0.424390243902439,110,235,0.4680851063829787,0.547,92,116,0.7931034482758621
James Posey,poseyja01,SF,24,DEN,2001,82,2255.0,666,163,125,306,431,93,40,102,226,243,590,0.411864406779661,65,217,0.2995391705069124,178,373,0.4772117962466488,0.467,115,141,0.8156028368794326
Lavor Postell,postela01,SG,22,NYK,2001,26,169.0,59,5,8,17,25,4,2,17,12,17,54,0.3148148148148148,3,11,0.2727272727272727,14,43,0.3255813953488372,0.343,22,27,0.8148148148148148
Vitaly Potapenko,potapvi01,C,25,BOS,2001,82,1901.0,611,64,206,289,495,52,23,105,228,248,521,0.4760076775431862,0,0,0.0,248,521,0.4760076775431862,0.476,115,158,0.7278481012658228
Brent Price,pricebr01,PG,32,VAN,2001,6,30.0,13,5,1,3,4,2,0,4,8,3,11,0.2727272727272727,1,4,0.25,2,7,0.2857142857142857,0.318,6,7,0.8571428571428571
Laron Profit,profila01,PG,23,WAS,2001,35,605.0,152,89,18,46,64,36,11,46,43,56,142,0.3943661971830985,7,26,0.2692307692307692,49,116,0.4224137931034483,0.419,33,45,0.7333333333333333
Joel Przybilla,przybjo01,C,21,MIL,2001,33,270.0,27,2,29,42,71,3,30,13,56,12,35,0.3428571428571428,0,0,0.0,12,35,0.3428571428571428,0.343,3,11,0.2727272727272727
Theo Ratliff,ratlith01,C,27,PHI,2001,50,1800.0,621,58,125,288,413,30,187,126,165,228,457,0.4989059080962801,0,0,0.0,228,457,0.4989059080962801,0.499,165,217,0.7603686635944701
Eldridge Recasner,recasel01,PG,33,CHH,2001,43,403.0,103,39,13,37,50,6,1,27,30,38,114,0.3333333333333333,13,39,0.3333333333333333,25,75,0.3333333333333333,0.39,14,18,0.7777777777777778
Michael Redd,reddmi01,SG,21,MIL,2001,6,35.0,13,1,3,1,4,1,0,1,2,5,19,0.2631578947368421,0,3,0.0,5,16,0.3125,0.263,3,6,0.5
Bryant Reeves,reevebr01,C,27,VAN,2001,75,1832.0,622,80,132,320,452,43,54,90,243,254,552,0.4601449275362319,1,4,0.25,253,548,0.4616788321167883,0.461,113,142,0.795774647887324
Don Reid,reiddo01,PF,27,ORL,2001,65,764.0,210,21,84,158,242,23,54,48,190,82,145,0.5655172413793104,0,0,0.0,82,145,0.5655172413793104,0.566,46,75,0.6133333333333333
J.R. Reid,reidjr01,PF,32,CLE,2001,6,39.0,10,1,5,3,8,2,1,1,4,2,5,0.4,0,0,0.0,2,5,0.4,0.4,6,8,0.75
Glen Rice,ricegl01,SF,33,NYK,2001,75,2212.0,899,89,61,246,307,41,13,96,179,331,752,0.4401595744680851,82,211,0.3886255924170616,249,541,0.4602587800369686,0.495,155,182,0.8516483516483516
Quentin Richardson,richaqu01,SG,20,LAC,2001,76,1358.0,613,62,105,152,257,42,7,64,98,232,525,0.4419047619047619,50,151,0.3311258278145695,182,374,0.4866310160427807,0.49,99,158,0.6265822784810127
Mitch Richmond,richmmi01,SG,35,WAS,2001,37,1216.0,598,111,15,94,109,43,7,84,86,205,504,0.4067460317460317,45,133,0.3383458646616541,160,371,0.431266846361186,0.451,143,160,0.89375
Isaiah Rider,rideris01,SG,29,LAL,2001,67,1206.0,507,111,44,112,156,27,7,98,105,201,472,0.4258474576271186,34,92,0.3695652173913043,167,380,0.4394736842105263,0.462,71,83,0.8554216867469879
Terrance Roberson,roberte01,SF,24,CHH,2001,3,13.0,0,1,0,1,1,0,0,2,3,0,2,0.0,0,1,0.0,0,1,0.0,0.0,0,0,0.0
Clifford Robinson,robincl02,PF,34,PHO,2001,82,2751.0,1345,237,105,229,334,87,82,186,258,501,1186,0.4224283305227655,90,249,0.3614457831325301,411,937,0.4386339381003202,0.46,253,357,0.7086834733893558
David Robinson,robinda01,C,35,SAS,2001,80,2371.0,1151,116,208,483,691,80,197,122,212,400,823,0.4860267314702308,0,1,0.0,400,822,0.48661800486618,0.486,351,470,0.7468085106382979
Eddie Robinson,robined01,SF,24,CHH,2001,67,1201.0,498,59,60,138,198,50,32,43,66,216,407,0.5307125307125307,2,4,0.5,214,403,0.5310173697270472,0.533,64,88,0.7272727272727273
Glenn Robinson,robingl01,SF,28,MIL,2001,76,2813.0,1674,252,124,402,526,86,62,219,191,684,1460,0.4684931506849315,55,184,0.2989130434782608,629,1276,0.4929467084639498,0.487,251,306,0.8202614379084967
Jamal Robinson,robinja03,SF,27,MIA,2001,6,72.0,6,2,3,8,11,6,0,3,7,3,22,0.1363636363636363,0,2,0.0,3,20,0.15,0.136,0,0,0.0
James Robinson,robinja02,PG,30,ORL,2001,6,50.0,10,0,0,8,8,4,1,4,5,4,11,0.3636363636363636,2,5,0.4,2,6,0.3333333333333333,0.455,0,0,0.0
Larry Robinson,robinla01,PG-SG,33,TOT,2001,34,632.0,199,36,23,64,87,28,2,25,46,67,184,0.3641304347826087,44,116,0.3793103448275862,23,68,0.3382352941176471,0.484,21,24,0.875
Carlos Rogers,rogerca01,C,29,HOU,2001,39,544.0,179,9,48,91,139,10,18,17,33,75,110,0.6818181818181818,0,1,0.0,75,109,0.6880733944954128,0.682,29,52,0.5576923076923077
Rodney Rogers,rogerro01,SF,29,PHO,2001,82,2183.0,998,180,94,265,359,97,47,157,269,377,876,0.430365296803653,56,189,0.2962962962962963,321,687,0.4672489082969432,0.462,188,247,0.7611336032388664
Sean Rooks,rooksse01,C,31,LAC,2001,82,1553.0,446,77,91,212,303,34,64,73,197,169,395,0.4278481012658228,1,2,0.5,168,393,0.4274809160305343,0.429,107,143,0.7482517482517482
Jalen Rose,roseja01,SF,28,IND,2001,72,2943.0,1478,435,37,322,359,65,43,211,230,567,1242,0.4565217391304347,59,174,0.3390804597701149,508,1068,0.4756554307116105,0.48,285,344,0.8284883720930233
Malik Rose,rosema01,PF,26,SAS,2001,57,1219.0,437,48,95,213,308,59,40,74,148,160,368,0.4347826086956521,3,17,0.1764705882352941,157,351,0.4472934472934473,0.439,114,160,0.7125
Michael Ruffin,ruffimi01,PF,24,CHI,2001,45,879.0,119,39,101,161,262,30,38,46,131,40,90,0.4444444444444444,0,0,0.0,40,90,0.4444444444444444,0.444,39,77,0.5064935064935064
Bryon Russell,russebr01,SF,30,UTA,2001,78,2473.0,933,160,94,236,330,96,20,113,229,308,700,0.44,95,230,0.4130434782608695,213,470,0.4531914893617021,0.508,222,285,0.7789473684210526
Arvydas Sabonis,sabonar01,C,36,POR,2001,61,1299.0,616,91,51,280,331,40,62,85,137,247,516,0.4786821705426357,1,15,0.0666666666666666,246,501,0.4910179640718562,0.48,121,156,0.7756410256410257
Soumaila Samake,samakso01,C,22,NJN,2001,34,226.0,46,1,22,31,53,2,14,4,23,18,48,0.375,0,0,0.0,18,48,0.375,0.375,10,24,0.4166666666666667
Pepe Sánchez,sanchpe01,PG,23,TOT,2001,29,150.0,20,41,3,12,15,11,1,6,21,9,28,0.3214285714285714,0,1,0.0,9,27,0.3333333333333333,0.321,2,2,1.0
Daniel Santiago,santida01,C,24,PHO,2001,54,581.0,170,11,35,67,102,17,21,47,101,64,134,0.4776119402985074,0,0,0.0,64,134,0.4776119402985074,0.478,42,61,0.6885245901639344
Detlef Schrempf,schrede01,SF,38,POR,2001,26,397.0,104,44,17,61,78,7,3,28,43,39,95,0.4105263157894737,3,8,0.375,36,87,0.4137931034482758,0.426,23,27,0.8518518518518519
Shawnelle Scott,scottsh01,C,28,SAS,2001,27,144.0,43,4,23,27,50,5,6,11,23,17,41,0.4146341463414634,0,0,0.0,17,41,0.4146341463414634,0.415,9,22,0.4090909090909091
Brian Shaw,shawbr01,SG,34,LAL,2001,80,1833.0,421,258,48,256,304,49,27,97,159,164,411,0.3990267639902676,42,135,0.3111111111111111,122,276,0.4420289855072464,0.45,51,64,0.796875
Brian Skinner,skinnbr01,PF,24,LAC,2001,39,584.0,160,18,55,113,168,14,11,32,61,64,161,0.3975155279503105,0,0,0.0,64,161,0.3975155279503105,0.398,32,59,0.5423728813559322
Reggie Slater,slatere01,PF,30,MIN,2001,55,686.0,254,26,78,108,186,18,9,43,126,90,175,0.5142857142857142,0,0,0.0,90,175,0.5142857142857142,0.514,74,110,0.6727272727272727
Jabari Smith,smithja01,C,23,SAC,2001,9,66.0,26,6,1,7,8,4,0,3,7,11,22,0.5,0,0,0.0,11,22,0.5,0.5,4,6,0.6666666666666666
Joe Smith,smithjo02,PF,25,DET,2001,69,1941.0,847,79,160,331,491,47,50,88,258,308,765,0.4026143790849673,0,5,0.0,308,760,0.4052631578947368,0.403,231,287,0.8048780487804879
Michael Smith,smithmi02,PF,28,WAS,2001,79,1610.0,301,101,172,390,562,57,37,62,156,106,218,0.4862385321100917,0,1,0.0,106,217,0.488479262672811,0.486,89,154,0.577922077922078
Mike Smith,smithmi03,SF,24,WAS,2001,17,180.0,51,10,10,12,22,5,3,7,8,19,59,0.3220338983050847,3,18,0.1666666666666666,16,41,0.3902439024390244,0.347,10,16,0.625
Steve Smith,smithst01,SG,31,POR,2001,81,2542.0,1105,213,87,185,272,48,24,137,203,359,788,0.4555837563451776,78,230,0.3391304347826087,281,558,0.503584229390681,0.505,309,347,0.8904899135446686
Tony Smith,smithto02,SG,32,ATL,2001,6,78.0,17,10,2,1,3,7,0,9,12,8,23,0.3478260869565217,0,2,0.0,8,21,0.3809523809523809,0.348,1,2,0.5
Eric Snow,snower01,PG,27,PHI,2001,50,1740.0,491,369,27,139,166,77,7,124,123,182,435,0.4183908045977011,5,19,0.2631578947368421,177,416,0.4254807692307692,0.424,122,154,0.7922077922077922
Felton Spencer,spencfe01,C,33,NYK,2001,18,113.0,39,2,16,19,35,2,2,11,24,12,20,0.6,0,0,0.0,12,20,0.6,0.6,15,25,0.6
Latrell Sprewell,sprewla01,SF,30,NYK,2001,77,3017.0,1364,269,49,298,347,106,28,218,159,524,1219,0.4298605414273995,41,135,0.3037037037037037,483,1084,0.4455719557195572,0.447,275,351,0.7834757834757835
Jerry Stackhouse,stackje01,SG,26,DET,2001,80,3215.0,2380,410,99,216,315,97,54,326,160,774,1927,0.4016606123508043,166,473,0.3509513742071881,608,1454,0.4181568088033012,0.445,666,810,0.8222222222222222
John Starks,starkjo01,SG,35,UTA,2001,75,2122.0,699,178,29,125,154,73,10,94,217,273,686,0.3979591836734694,64,182,0.3516483516483517,209,504,0.4146825396825397,0.445,89,111,0.8018018018018018
Vladimir Stepania,stepavl01,C,24,NJN,2001,29,280.0,82,16,35,74,109,10,11,19,47,28,88,0.3181818181818182,1,4,0.25,27,84,0.3214285714285714,0.324,25,34,0.7352941176470589
DeShawn Stevenson,stevede01,SG,19,UTA,2001,40,293.0,89,18,9,19,28,10,2,28,29,31,91,0.3406593406593406,1,12,0.0833333333333333,30,79,0.379746835443038,0.346,26,38,0.6842105263157895
Michael Stewart,stewami01,C,25,TOR,2001,26,123.0,33,2,16,13,29,4,3,5,19,11,34,0.3235294117647059,0,0,0.0,11,34,0.3235294117647059,0.324,11,18,0.6111111111111112
Bryant Stith,stithbr01,SG,30,BOS,2001,78,2504.0,756,168,65,219,284,93,14,90,182,245,611,0.4009819967266775,91,242,0.3760330578512397,154,369,0.4173441734417344,0.475,175,207,0.8454106280193237
John Stockton,stockjo01,PG,38,UTA,2001,82,2397.0,944,713,54,173,227,132,21,203,194,328,651,0.5038402457757296,61,132,0.4621212121212121,267,519,0.5144508670520231,0.551,227,278,0.8165467625899281
Peja Stojaković,stojape01,SF,23,SAC,2001,75,2905.0,1529,164,93,341,434,91,13,146,144,559,1189,0.4701429772918419,144,360,0.4,415,829,0.5006031363088058,0.531,267,312,0.8557692307692307
Damon Stoudamire,stoudda01,PG,27,POR,2001,82,2655.0,1066,468,69,234,303,106,8,191,202,406,935,0.4342245989304812,82,219,0.3744292237442922,324,716,0.4525139664804469,0.478,172,207,0.8309178743961353
Erick Strickland,stricer01,PG,27,TOT,2001,50,830.0,260,95,18,110,128,44,2,48,88,81,267,0.3033707865168539,30,95,0.3157894736842105,51,172,0.2965116279069767,0.36,68,79,0.8607594936708861
Mark Strickland,stricma01,SF,30,TOT,2001,55,719.0,252,24,54,107,161,16,22,34,72,103,239,0.4309623430962343,1,2,0.5,102,237,0.430379746835443,0.433,45,70,0.6428571428571429
Rod Strickland,stricro02,PG,34,TOT,2001,54,1371.0,498,303,36,104,140,53,5,107,76,182,429,0.4242424242424242,4,17,0.2352941176470588,178,412,0.4320388349514563,0.429,130,173,0.7514450867052023
Derek Strong,stronde01,PF,32,LAC,2001,28,491.0,118,7,34,74,108,14,1,22,30,45,117,0.3846153846153846,0,1,0.0,45,116,0.3879310344827586,0.385,28,37,0.7567567567567568
Bruno Šundov,sundobr01,C,20,IND,2001,11,120.0,43,2,4,19,23,2,4,3,21,20,41,0.4878048780487805,0,4,0.0,20,37,0.5405405405405406,0.488,3,5,0.6
Bob Sura,surabo01,SG,27,GSW,2001,53,1684.0,586,242,54,173,227,54,8,160,127,202,518,0.3899613899613899,47,172,0.2732558139534883,155,346,0.4479768786127168,0.435,135,189,0.7142857142857143
Stromile Swift,swiftst01,PF,21,VAN,2001,80,1312.0,391,28,109,175,284,62,82,64,160,153,339,0.4513274336283185,0,4,0.0,153,335,0.4567164179104477,0.451,85,141,0.6028368794326241
Wally Szczerbiak,szczewa02,SF,23,MIN,2001,82,2856.0,1145,260,133,314,447,59,33,138,226,469,920,0.5097826086956522,26,77,0.3376623376623376,443,843,0.5255041518386714,0.524,181,208,0.8701923076923077
Žan Tabak,tabakza01,C,30,IND,2001,55,777.0,216,33,65,148,213,10,30,57,125,98,186,0.5268817204301075,0,0,0.0,98,186,0.5268817204301075,0.527,20,47,0.425531914893617
Dragan Tarlać,tarladr01,C,27,CHI,2001,43,598.0,103,31,37,85,122,7,19,38,95,39,99,0.3939393939393939,0,0,0.0,39,99,0.3939393939393939,0.394,25,33,0.7575757575757576
Maurice Taylor,tayloma01,SF,24,HOU,2001,69,1972.0,899,104,109,269,378,28,38,125,208,390,797,0.4893350062735257,0,4,0.0,390,793,0.4918032786885246,0.489,119,162,0.7345679012345679
Jason Terry,terryja01,SG,23,ATL,2001,82,3089.0,1619,403,42,227,269,104,12,239,204,596,1367,0.4359912216532553,124,314,0.3949044585987261,472,1053,0.4482431149097816,0.481,303,358,0.8463687150837989
Jamel Thomas,thomaja01,SF,27,NJN,2001,5,56.0,13,0,4,5,9,3,0,6,6,6,19,0.3157894736842105,1,3,0.3333333333333333,5,16,0.3125,0.342,0,0,0.0
Kenny Thomas,thomake01,PF,23,HOU,2001,74,1820.0,528,77,122,295,417,40,43,116,178,206,465,0.443010752688172,25,92,0.2717391304347826,181,373,0.485254691689008,0.47,91,126,0.7222222222222222
Kurt Thomas,thomaku01,PF,28,NYK,2001,77,2125.0,800,63,172,343,515,61,69,99,287,314,614,0.511400651465798,1,3,0.3333333333333333,313,611,0.5122749590834698,0.512,171,210,0.8142857142857143
Tim Thomas,thomati01,PF,23,MIL,2001,76,2086.0,954,138,79,234,313,78,45,114,194,326,758,0.4300791556728232,107,260,0.4115384615384615,219,498,0.4397590361445783,0.501,195,253,0.7707509881422925
Otis Thorpe,thorpot01,PF,38,CHH,2001,49,647.0,138,29,50,95,145,12,7,32,108,59,131,0.4503816793893129,0,0,0.0,59,131,0.4503816793893129,0.45,20,24,0.8333333333333334
Robert Traylor,traylro01,C,23,CLE,2001,70,1212.0,402,63,124,176,300,49,76,98,204,161,324,0.4969135802469135,0,2,0.0,161,322,0.5,0.497,80,141,0.5673758865248227
Gary Trent,trentga01,PF,26,DAL,2001,33,319.0,133,10,39,53,92,13,8,22,52,57,130,0.4384615384615384,0,1,0.0,57,129,0.4418604651162791,0.438,19,36,0.5277777777777778
Jake Tsakalidis,tsakaja01,C,21,PHO,2001,57,947.0,256,19,83,159,242,10,55,66,137,101,215,0.4697674418604651,0,0,0.0,101,215,0.4697674418604651,0.47,54,91,0.5934065934065934
Hedo Türkoğlu,turkohe01,SF,21,SAC,2001,74,1245.0,391,69,49,161,210,52,24,55,139,138,335,0.4119402985074626,28,86,0.3255813953488372,110,249,0.4417670682730923,0.454,87,112,0.7767857142857143
Nick Van Exel,vanexni01,PG,29,DEN,2001,71,2688.0,1259,600,44,197,241,61,18,165,109,460,1112,0.4136690647482014,135,358,0.3770949720670391,325,754,0.4310344827586206,0.474,204,249,0.8192771084337349
Keith Van Horn,vanhoke01,SF,25,NJN,2001,49,1733.0,831,82,78,269,347,40,20,103,150,308,708,0.4350282485875706,65,170,0.3823529411764705,243,538,0.4516728624535316,0.481,150,186,0.8064516129032258
David Vanterpool,vanteda01,PG,27,WAS,2001,22,411.0,122,66,15,22,37,23,3,37,44,46,110,0.4181818181818181,0,6,0.0,46,104,0.4423076923076923,0.418,30,50,0.6
Jacque Vaughn,vaughja01,PG,25,UTA,2001,82,1620.0,498,323,18,132,150,48,3,129,145,170,393,0.4325699745547073,30,78,0.3846153846153846,140,315,0.4444444444444444,0.471,128,164,0.7804878048780488
Loy Vaught,vaughlo01,PF,32,TOT,2001,51,549.0,168,23,51,122,173,21,7,26,74,80,169,0.4733727810650887,0,0,0.0,80,169,0.4733727810650887,0.473,8,10,0.8
Jake Voskuhl,voskuja01,C,23,CHI,2001,16,143.0,30,5,12,22,34,5,6,12,38,11,25,0.44,0,0,0.0,11,25,0.44,0.44,8,14,0.5714285714285714
Antoine Walker,walkean02,PF,24,BOS,2001,81,3396.0,1892,445,151,568,719,138,49,301,251,711,1720,0.4133720930232558,221,603,0.3665008291873963,490,1117,0.4386750223813787,0.478,249,348,0.7155172413793104
Samaki Walker,walkesa01,PF,24,SAS,2001,61,963.0,321,29,67,176,243,10,41,68,103,121,252,0.4801587301587302,1,3,0.3333333333333333,120,249,0.4819277108433735,0.482,78,124,0.6290322580645161
Ben Wallace,wallabe01,C,26,DET,2001,80,2760.0,511,123,303,749,1052,107,186,117,192,215,439,0.489749430523918,1,4,0.25,214,435,0.4919540229885057,0.491,80,238,0.3361344537815126
John Wallace,wallajo01,SF,26,DET,2001,40,527.0,237,23,25,58,83,13,16,36,72,100,236,0.423728813559322,2,15,0.1333333333333333,98,221,0.4434389140271493,0.428,35,45,0.7777777777777778
Rasheed Wallace,wallara01,PF,26,POR,2001,77,2940.0,1477,212,147,455,602,90,135,158,206,590,1178,0.5008488964346349,52,162,0.3209876543209876,538,1016,0.5295275590551181,0.523,245,320,0.765625
Charlie Ward,wardch01,PG,30,NYK,2001,61,1492.0,433,273,32,127,159,70,10,112,132,155,373,0.4155495978552279,67,175,0.3828571428571428,88,198,0.4444444444444444,0.505,56,70,0.8
Clarence Weatherspoon,weathcl01,PF,30,CLE,2001,82,2774.0,924,103,223,573,796,85,105,112,171,347,692,0.5014450867052023,0,0,0.0,347,692,0.5014450867052023,0.501,230,291,0.7903780068728522
Chris Webber,webbech01,PF,27,SAC,2001,70,2836.0,1898,294,179,598,777,93,118,195,226,786,1635,0.4807339449541284,2,28,0.0714285714285714,784,1607,0.4878655880522713,0.481,324,461,0.702819956616052
Bonzi Wells,wellsbo01,SF,24,POR,2001,75,1995.0,950,208,120,247,367,94,20,169,203,387,726,0.5330578512396694,17,50,0.34,370,676,0.5473372781065089,0.545,159,240,0.6625
David Wesley,wesleda01,SG,30,CHH,2001,82,3106.0,1414,361,64,160,224,128,16,171,220,523,1239,0.4221146085552865,97,258,0.375968992248062,426,981,0.4342507645259938,0.461,271,339,0.799410029498525
Doug West,westdo01,SG,33,VAN,2001,15,171.0,28,14,4,11,15,3,4,4,21,11,38,0.2894736842105263,0,2,0.0,11,36,0.3055555555555556,0.289,6,7,0.8571428571428571
Jahidi White,whiteja01,C,24,WAS,2001,68,1609.0,583,20,178,343,521,32,111,136,211,203,408,0.4975490196078431,0,1,0.0,203,407,0.4987714987714988,0.498,177,312,0.5673076923076923
Chris Whitney,whitnch01,PG,29,WAS,2001,59,1532.0,558,248,12,94,106,55,3,103,150,182,470,0.3872340425531915,93,248,0.375,89,222,0.4009009009009009,0.486,101,113,0.8938053097345132
Aaron Williams,williaa01,PF,29,NJN,2001,82,2336.0,838,88,211,379,590,59,113,132,319,297,650,0.4569230769230769,0,2,0.0,297,648,0.4583333333333333,0.457,244,310,0.7870967741935484
Alvin Williams,willial02,SG,26,TOR,2001,82,2394.0,802,407,50,162,212,123,26,103,171,330,767,0.4302477183833116,33,108,0.3055555555555556,297,659,0.4506828528072837,0.452,109,145,0.7517241379310344
Eric Williams,willier01,SF,28,BOS,2001,81,1745.0,535,112,64,143,207,64,13,76,179,162,448,0.3616071428571428,46,139,0.3309352517985611,116,309,0.3754045307443365,0.413,165,231,0.7142857142857143
Jason Williams,willija02,PG,25,SAC,2001,77,2290.0,720,416,19,166,185,94,9,160,114,281,690,0.4072463768115942,98,311,0.315112540192926,183,379,0.4828496042216358,0.478,60,76,0.7894736842105263
Jerome Williams,willije01,PF,27,TOT,2001,59,1182.0,372,45,133,249,382,57,20,63,124,136,294,0.4625850340136054,0,3,0.0,136,291,0.4673539518900343,0.463,100,135,0.7407407407407407
Monty Williams,willimo01,SF,29,ORL,2001,82,1211.0,410,79,86,157,243,29,16,85,136,162,364,0.445054945054945,1,13,0.0769230769230769,161,351,0.4586894586894587,0.446,85,133,0.6390977443609023
Scott Williams,willisc01,C,32,MIL,2001,66,1272.0,403,35,97,267,364,48,32,41,178,171,361,0.4736842105263157,1,4,0.25,170,357,0.4761904761904761,0.475,60,70,0.8571428571428571
Shammond Williams,willish01,PG,25,SEA,2001,69,1238.0,467,190,34,98,132,31,4,82,83,161,368,0.4375,61,133,0.4586466165413533,100,235,0.425531914893617,0.52,84,96,0.875
Walt Williams,williwa02,SF,30,HOU,2001,72,1583.0,599,97,31,214,245,30,28,73,153,202,513,0.3937621832358674,98,248,0.3951612903225806,104,265,0.3924528301886792,0.489,97,126,0.7698412698412699
Corliss Williamson,willico02,SF,27,TOT,2001,69,1686.0,801,61,110,211,321,50,21,110,185,325,647,0.5023183925811437,0,2,0.0,325,645,0.5038759689922481,0.502,151,237,0.6371308016877637
Kevin Willis,willike02,C,38,TOT,2001,78,1830.0,722,50,177,355,532,57,52,87,216,304,690,0.4405797101449275,1,6,0.1666666666666666,303,684,0.4429824561403508,0.441,113,147,0.7687074829931972
David Wingate,wingada01,SG,37,SEA,2001,1,9.0,6,2,0,0,0,0,0,0,1,3,3,1.0,0,0,0.0,3,3,1.0,1.0,0,0,0.0
Rubén Wolkowyski,wolkoru01,PF,27,SEA,2001,34,305.0,75,3,12,34,46,6,18,12,38,25,79,0.3164556962025316,0,2,0.0,25,77,0.3246753246753247,0.316,25,34,0.7352941176470589
Metta World Peace,artesro01,SF,21,CHI,2001,76,2363.0,907,228,59,235,294,152,45,159,254,327,815,0.4012269938650307,43,148,0.2905405405405405,284,667,0.4257871064467766,0.428,210,280,0.75
Lorenzen Wright,wrighlo02,C,25,ATL,2001,71,1988.0,881,87,180,355,535,42,63,125,232,363,811,0.4475955610357583,0,2,0.0,363,809,0.4487021013597033,0.448,155,216,0.7175925925925926
Wang Zhizhi,zhizhwa01,C,23,DAL,2001,5,38.0,24,0,1,6,7,0,0,1,8,8,19,0.4210526315789473,0,2,0.0,8,17,0.4705882352941176,0.421,8,10,0.8
Tariq Abdul-Wahad,abdulta01,SG,27,TOT,2002,24,441.0,135,24,41,43,84,20,10,27,56,55,147,0.3741496598639456,1,2,0.5,54,145,0.3724137931034483,0.378,24,33,0.7272727272727273
Shareef Abdur-Rahim,abdursh01,PF,25,ATL,2002,77,2980.0,1636,239,198,498,696,98,81,250,214,598,1297,0.4610639938319198,21,70,0.3,577,1227,0.4702526487367563,0.469,419,523,0.8011472275334608
Courtney Alexander,alexaco02,SG,24,WAS,2002,56,1325.0,549,86,43,105,148,35,7,60,113,223,474,0.4704641350210971,5,18,0.2777777777777778,218,456,0.4780701754385965,0.476,98,121,0.8099173553719008
Victor Alexander,alexavi01,C,32,DET,2002,15,97.0,40,6,7,22,29,0,1,5,6,18,51,0.3529411764705882,0,2,0.0,18,49,0.3673469387755102,0.353,4,8,0.5
Malik Allen,allenma01,PF,23,MIA,2002,12,161.0,52,5,15,23,38,3,8,2,16,22,51,0.4313725490196078,0,1,0.0,22,50,0.44,0.431,8,10,0.8
Ray Allen,allenra02,SG,26,MIL,2002,69,2525.0,1503,271,81,231,312,88,18,159,157,530,1148,0.4616724738675958,229,528,0.4337121212121212,301,620,0.4854838709677419,0.561,214,245,0.8734693877551021
Rafer Alston,alstora01,PG,25,MIL,2002,50,600.0,177,143,10,62,72,32,2,40,42,66,191,0.3455497382198952,27,71,0.380281690140845,39,120,0.325,0.416,18,29,0.6206896551724138
John Amaechi,amaecjo01,PF,31,UTA,2002,54,586.0,175,29,52,57,109,7,10,55,64,54,166,0.3253012048192771,0,0,0.0,54,166,0.3253012048192771,0.325,67,105,0.638095238095238
Chris Andersen,anderch01,C,23,DEN,2002,24,262.0,72,7,38,38,76,7,28,13,35,25,74,0.3378378378378378,0,4,0.0,25,70,0.3571428571428571,0.338,22,28,0.7857142857142857
Derek Anderson,anderde01,SG,27,POR,2002,70,1860.0,757,216,47,142,189,68,8,87,113,247,612,0.4035947712418301,85,228,0.3728070175438596,162,384,0.421875,0.473,178,208,0.8557692307692307
Kenny Anderson,anderke01,PG,31,BOS,2002,76,2430.0,731,403,57,218,275,141,10,119,210,312,716,0.435754189944134,9,33,0.2727272727272727,303,683,0.4436310395314787,0.442,98,132,0.7424242424242424
Nick Anderson,anderni01,SG,34,MEM,2002,15,219.0,60,14,1,32,33,6,6,14,17,21,76,0.2763157894736842,13,48,0.2708333333333333,8,28,0.2857142857142857,0.362,5,9,0.5555555555555556
Shandon Anderson,andersh01,SG,28,NYK,2002,82,1596.0,411,76,57,192,249,48,15,97,134,149,373,0.3994638069705093,39,141,0.2765957446808511,110,232,0.4741379310344827,0.452,74,107,0.6915887850467289
Greg Anthony,anthogr01,PG,34,TOT,2002,60,1514.0,474,282,22,110,132,77,5,94,114,183,475,0.3852631578947368,48,163,0.294478527607362,135,312,0.4326923076923077,0.436,60,91,0.6593406593406593
Gilbert Arenas,arenagi01,PG,20,GSW,2002,47,1155.0,511,174,41,91,132,69,11,97,115,174,384,0.453125,39,113,0.3451327433628318,135,271,0.4981549815498155,0.504,124,160,0.775
Brandon Armstrong,armstbr01,SG,21,NJN,2002,35,196.0,64,8,10,6,16,7,1,8,26,27,85,0.3176470588235294,5,17,0.2941176470588235,22,68,0.3235294117647059,0.347,5,10,0.5
Darrell Armstrong,armstda01,PG,33,ORL,2002,82,2730.0,1015,453,83,236,319,157,10,175,166,347,828,0.4190821256038647,139,398,0.3492462311557789,208,430,0.4837209302325581,0.503,182,205,0.8878048780487805
Carlos Arroyo,arroyca01,PG,22,TOT,2002,37,371.0,111,70,12,28,40,11,1,23,30,49,111,0.4414414414414414,0,2,0.0,49,109,0.4495412844036697,0.441,13,18,0.7222222222222222
Chucky Atkins,atkinch01,PG,27,DET,2002,79,2285.0,957,263,31,127,158,72,11,128,177,368,790,0.4658227848101265,138,336,0.4107142857142857,230,454,0.5066079295154186,0.553,83,120,0.6916666666666667
Stacey Augmon,augmost01,SG,33,CHH,2002,77,1319.0,357,103,59,166,225,56,12,54,115,140,328,0.4268292682926829,0,3,0.0,140,325,0.4307692307692308,0.427,77,101,0.7623762376237624
Isaac Austin,austiis01,C,32,MEM,2002,21,307.0,76,13,11,60,71,9,5,11,36,36,92,0.391304347826087,0,3,0.0,36,89,0.4044943820224719,0.391,4,4,1.0
William Avery,averywi01,PG,22,MIN,2002,28,258.0,71,36,4,20,24,7,0,19,17,26,90,0.2888888888888888,6,35,0.1714285714285714,20,55,0.3636363636363636,0.322,13,19,0.6842105263157895
Dalibor Bagarić,bagarda01,C,21,CHI,2002,50,638.0,185,23,55,107,162,17,24,46,108,72,178,0.4044943820224719,0,1,0.0,72,177,0.4067796610169492,0.404,41,70,0.5857142857142857
Vin Baker,bakervi01,C,30,SEA,2002,55,1710.0,774,72,168,182,350,22,36,127,197,315,649,0.485362095531587,1,8,0.125,314,641,0.4898595943837753,0.486,143,226,0.6327433628318584
Erick Barkley,barkler01,PG,23,POR,2002,19,228.0,58,34,5,13,18,17,1,12,29,24,68,0.3529411764705882,1,7,0.1428571428571428,23,61,0.3770491803278688,0.36,9,10,0.9
Dana Barros,barroda01,PG,34,DET,2002,29,582.0,193,78,1,56,57,14,2,33,37,74,192,0.3854166666666667,24,71,0.3380281690140845,50,121,0.4132231404958678,0.448,21,27,0.7777777777777778
Brent Barry,barrybr01,SG,30,SEA,2002,81,3040.0,1164,426,58,383,441,147,37,165,182,401,790,0.5075949367088608,164,387,0.4237726098191214,237,403,0.5880893300248139,0.611,198,234,0.8461538461538461
Jon Barry,barryjo01,SG,32,DET,2002,82,1985.0,739,274,42,192,234,94,20,111,134,255,522,0.4885057471264368,121,258,0.4689922480620155,134,264,0.5075757575757576,0.604,108,116,0.9310344827586208
Mengke Bateer,bateeme01,C,26,DEN,2002,27,408.0,139,22,32,64,96,10,5,32,94,53,132,0.4015151515151515,4,12,0.3333333333333333,49,120,0.4083333333333333,0.417,29,37,0.7837837837837838
Tony Battie,battito01,C,25,BOS,2002,74,1819.0,510,35,184,297,481,60,67,51,219,211,390,0.541025641025641,0,2,0.0,211,388,0.5438144329896907,0.541,88,130,0.676923076923077
Shane Battier,battish01,SF,23,MEM,2002,78,3097.0,1125,216,180,238,418,121,81,155,215,412,961,0.4287200832466181,103,276,0.3731884057971014,309,685,0.4510948905109489,0.482,198,283,0.6996466431095406
Charlie Bell,bellch01,SG,22,TOT,2002,7,44.0,8,2,2,3,5,0,0,5,3,3,11,0.2727272727272727,0,6,0.0,3,5,0.6,0.273,2,2,1.0
Raja Bell,bellra01,SG,25,PHI,2002,74,890.0,254,71,31,80,111,21,4,48,109,103,240,0.4291666666666666,12,44,0.2727272727272727,91,196,0.4642857142857143,0.454,36,48,0.75
Jonathan Bender,bendejo01,SF,21,IND,2002,78,1647.0,581,62,64,180,244,19,49,96,147,198,460,0.4304347826086956,45,125,0.36,153,335,0.4567164179104477,0.479,140,181,0.7734806629834254
Travis Best,besttr01,PG,29,TOT,2002,74,1747.0,581,324,20,131,151,89,7,99,173,228,518,0.4401544401544401,21,59,0.3559322033898305,207,459,0.4509803921568627,0.46,104,116,0.896551724137931
Mike Bibby,bibbymi01,PG,23,SAC,2002,80,2659.0,1098,403,37,185,222,87,15,134,133,446,985,0.4527918781725888,51,138,0.3695652173913043,395,847,0.4663518299881936,0.479,155,193,0.8031088082901554
Chauncey Billups,billuch01,PG,25,MIN,2002,82,2355.0,1027,450,35,191,226,66,17,138,169,348,823,0.4228432563791008,124,315,0.3936507936507936,224,508,0.4409448818897638,0.498,207,234,0.8846153846153846
Mookie Blaylock,blaylmo01,PG,34,GSW,2002,35,599.0,119,114,8,44,52,24,4,37,20,50,146,0.3424657534246575,15,42,0.3571428571428571,35,104,0.3365384615384615,0.394,4,8,0.5
Corie Blount,blounco01,PF,33,PHI,2002,72,1426.0,259,44,149,219,368,49,26,52,176,115,251,0.4581673306772908,0,1,0.0,115,250,0.46,0.458,29,45,0.6444444444444445
Mark Blount,blounma01,C,26,BOS,2002,44,415.0,94,10,26,59,85,16,19,23,59,32,76,0.4210526315789473,0,0,0.0,32,76,0.4210526315789473,0.421,30,37,0.8108108108108109
Calvin Booth,boothca01,C,25,SEA,2002,15,279.0,93,16,20,34,54,6,13,16,47,35,82,0.4268292682926829,0,0,0.0,35,82,0.4268292682926829,0.427,23,24,0.9583333333333334
Ruben Boumtje-Boumtje,boumtru01,C,23,POR,2002,33,245.0,39,4,21,34,55,3,16,14,38,13,32,0.40625,0,0,0.0,13,32,0.40625,0.406,13,25,0.52
Cal Bowdler,bowdlca01,PF,24,ATL,2002,52,585.0,162,11,38,72,110,18,15,11,64,61,174,0.3505747126436782,1,5,0.2,60,169,0.3550295857988165,0.353,39,47,0.8297872340425532
Bruce Bowen,bowenbr01,SF,30,SAS,2002,59,1699.0,412,88,42,120,162,62,25,66,116,155,398,0.3894472361809045,56,148,0.3783783783783784,99,250,0.396,0.46,46,96,0.4791666666666667
Ryan Bowen,bowenry01,SF,26,DEN,2002,75,1686.0,364,52,134,165,299,75,41,41,171,147,307,0.4788273615635179,1,12,0.0833333333333333,146,295,0.4949152542372881,0.48,69,92,0.75
Ira Bowman,bowmair01,SG,28,PHI,2002,3,29.0,10,1,0,1,1,2,0,0,3,5,7,0.7142857142857143,0,1,0.0,5,6,0.8333333333333334,0.714,0,0,0.0
Earl Boykins,boykiea01,PG,25,LAC,2002,68,761.0,280,145,27,27,54,20,2,44,44,110,275,0.4,13,42,0.3095238095238095,97,233,0.4163090128755364,0.424,47,61,0.7704918032786885
Michael Bradley,bradlmi01,PF,22,TOR,2002,26,118.0,30,3,7,17,24,0,6,6,10,13,25,0.52,0,2,0.0,13,23,0.5652173913043478,0.52,4,8,0.5
Shawn Bradley,bradlsh01,C,29,DAL,2002,53,757.0,215,20,53,123,176,28,64,25,128,78,163,0.4785276073619632,0,1,0.0,78,162,0.4814814814814814,0.479,59,64,0.921875
Elton Brand,brandel01,PF,22,LAC,2002,80,3020.0,1453,191,396,529,925,80,163,173,254,532,1010,0.5267326732673268,0,0,0.0,532,1010,0.5267326732673268,0.527,389,524,0.7423664122137404
Terrell Brandon,brandte01,PG,31,MIN,2002,32,962.0,397,264,17,76,93,52,6,43,49,155,365,0.4246575342465753,4,23,0.1739130434782608,151,342,0.4415204678362573,0.43,83,84,0.988095238095238
Jamison Brewer,breweja01,SG,21,IND,2002,13,43.0,4,9,2,6,8,2,0,3,3,2,5,0.4,0,1,0.0,2,4,0.5,0.4,0,0,0.0
Primož Brezec,brezepr01,C,22,IND,2002,22,160.0,43,6,16,12,28,0,7,6,28,14,29,0.4827586206896552,0,0,0.0,14,29,0.4827586206896552,0.483,15,25,0.6
Chucky Brown,brownch01,SF,33,SAC,2002,18,92.0,21,6,10,23,33,2,4,5,12,10,27,0.3703703703703703,0,0,0.0,10,27,0.3703703703703703,0.37,1,2,0.5
Damone Brown,brownda02,SF,22,PHI,2002,17,67.0,23,2,2,2,4,1,1,9,11,8,21,0.3809523809523809,0,1,0.0,8,20,0.4,0.381,7,8,0.875
Dee Brown,brownde01,PG,33,ORL,2002,7,65.0,7,2,0,9,9,3,1,4,4,3,20,0.15,1,12,0.0833333333333333,2,8,0.25,0.175,0,0,0.0
Ernest Brown,browner01,C,22,MIA,2002,3,21.0,3,0,1,5,6,0,1,3,4,1,6,0.1666666666666666,0,0,0.0,1,6,0.1666666666666666,0.167,1,4,0.25
Kedrick Brown,brownke01,SF,20,BOS,2002,29,245.0,63,15,11,39,50,18,7,7,18,23,70,0.3285714285714285,5,27,0.1851851851851851,18,43,0.4186046511627907,0.364,12,20,0.6
Kwame Brown,brownkw01,PF,19,WAS,2002,57,817.0,258,43,63,135,198,16,26,43,105,94,243,0.3868312757201646,0,1,0.0,94,242,0.3884297520661157,0.387,70,99,0.7070707070707071
P.J. Brown,brownpj01,C,32,CHH,2002,80,2563.0,669,107,273,513,786,59,78,85,222,250,527,0.4743833017077798,0,0,0.0,250,527,0.4743833017077798,0.474,169,197,0.8578680203045685
Randy Brown,brownra02,PG,33,BOS,2002,1,6.0,0,2,0,0,0,0,1,0,1,0,1,0.0,0,0,0.0,0,1,0.0,0.0,0,0,0.0
Tierre Brown,brownti01,SG,22,HOU,2002,40,403.0,123,70,12,30,42,19,3,40,26,49,115,0.4260869565217391,4,12,0.3333333333333333,45,103,0.4368932038834951,0.443,21,28,0.75
Rick Brunson,brunsri01,PG,29,POR,2002,59,520.0,125,114,23,45,68,25,2,47,51,45,113,0.3982300884955752,6,11,0.5454545454545454,39,102,0.3823529411764705,0.425,29,41,0.7073170731707317
Kobe Bryant,bryanko01,SG,23,LAL,2002,80,3063.0,2019,438,112,329,441,118,35,223,228,749,1597,0.4690043832185347,33,132,0.25,716,1465,0.4887372013651877,0.479,488,589,0.8285229202037352
Mark Bryant,bryanma01,PF,36,SAS,2002,30,206.0,56,10,25,19,44,7,2,6,38,25,55,0.4545454545454545,0,0,0.0,25,55,0.4545454545454545,0.455,6,8,0.75
Greg Buckner,buckngr01,SG,25,DAL,2002,44,885.0,253,48,67,106,173,31,19,27,124,104,198,0.5252525252525253,5,16,0.3125,99,182,0.5439560439560439,0.538,40,58,0.6896551724137931
Jud Buechler,buechju01,SF,33,TOT,2002,66,684.0,111,32,29,87,116,21,8,15,53,44,118,0.3728813559322034,21,60,0.35,23,58,0.396551724137931,0.462,2,4,0.5
Rodney Buford,buforro01,SG,24,MEM,2002,63,1769.0,591,71,52,220,272,42,12,63,110,258,593,0.4350758853288364,17,70,0.2428571428571428,241,523,0.4608030592734226,0.449,58,80,0.725
Matt Bullard,bullama01,PF,34,CHH,2002,31,350.0,105,16,10,37,47,2,2,12,29,39,115,0.3391304347826087,16,57,0.2807017543859649,23,58,0.396551724137931,0.409,11,12,0.9166666666666666
Mitchell Butler,butlemi02,SG,31,POR,2002,11,90.0,29,5,6,8,14,0,1,5,10,10,23,0.4347826086956521,1,3,0.3333333333333333,9,20,0.45,0.457,8,12,0.6666666666666666
Jason Caffey,caffeja01,PF,28,MIL,2002,23,283.0,99,12,24,26,50,4,5,19,39,36,72,0.5,0,1,0.0,36,71,0.5070422535211268,0.5,27,43,0.627906976744186
Marcus Camby,cambyma01,C,27,NYK,2002,29,1007.0,322,33,89,233,322,34,50,42,107,130,290,0.4482758620689655,0,1,0.0,130,289,0.4498269896193771,0.448,62,99,0.6262626262626263
Elden Campbell,campbel01,PF,33,CHH,2002,77,2156.0,1074,102,133,397,530,60,137,138,264,384,794,0.4836272040302267,0,2,0.0,384,792,0.4848484848484848,0.484,306,384,0.796875
Brian Cardinal,cardibr01,PF,24,DET,2002,8,43.0,17,2,2,4,6,1,0,0,5,6,13,0.4615384615384615,3,7,0.4285714285714285,3,6,0.5,0.577,2,2,1.0
Anthony Carter,cartean01,PG,26,MIA,2002,46,1050.0,198,214,19,98,117,50,3,72,85,89,260,0.3423076923076923,1,19,0.0526315789473684,88,241,0.3651452282157676,0.344,19,36,0.5277777777777778
Vince Carter,cartevi01,SG,25,TOR,2002,60,2385.0,1484,239,138,175,313,94,43,154,191,559,1307,0.4276970160673297,121,313,0.3865814696485623,438,994,0.4406438631790744,0.474,245,307,0.7980456026058632
Sam Cassell,cassesa01,PG,32,MIL,2002,74,2605.0,1461,493,54,258,312,90,12,177,208,554,1197,0.4628237259816207,71,204,0.3480392156862745,483,993,0.486404833836858,0.492,282,328,0.8597560975609756
Kelvin Cato,catoke01,C,27,HOU,2002,75,1917.0,493,29,176,349,525,40,95,53,208,190,326,0.5828220858895705,0,1,0.0,190,325,0.5846153846153846,0.583,113,194,0.5824742268041238
Tyson Chandler,chandty01,C,19,CHI,2002,71,1389.0,436,54,114,229,343,28,93,99,179,151,304,0.4967105263157895,0,0,0.0,151,304,0.4967105263157895,0.497,134,222,0.6036036036036037
Calbert Cheaney,cheanca01,SG,30,DEN,2002,68,1631.0,494,110,57,183,240,34,21,70,156,224,466,0.4806866952789699,0,4,0.0,224,462,0.4848484848484848,0.481,46,67,0.6865671641791045
Chris Childs,childch01,PG,34,TOR,2002,69,1576.0,285,351,18,136,154,56,5,123,177,97,296,0.3277027027027027,33,120,0.275,64,176,0.3636363636363636,0.383,58,71,0.8169014084507042
Doug Christie,chrisdo01,SG,31,SAC,2002,81,2798.0,972,340,74,300,374,160,25,164,209,338,735,0.4598639455782313,90,256,0.3515625,248,479,0.5177453027139874,0.521,206,242,0.8512396694214877
Keon Clark,clarkke01,C,26,TOR,2002,81,2185.0,915,88,182,421,603,58,122,140,258,380,775,0.4903225806451612,0,5,0.0,380,770,0.4935064935064935,0.49,155,230,0.6739130434782609
Speedy Claxton,claxtsp01,PG,23,PHI,2002,67,1528.0,480,198,46,114,160,95,6,95,145,181,452,0.4004424778761062,4,33,0.1212121212121212,177,419,0.4224343675417661,0.405,114,136,0.8382352941176471
Mateen Cleaves,cleavma01,PG,24,SAC,2002,32,153.0,70,25,1,7,8,7,0,27,9,30,68,0.4411764705882353,2,8,0.25,28,60,0.4666666666666667,0.456,8,9,0.8888888888888888
Derrick Coleman,colemde01,PF,34,PHI,2002,58,2080.0,875,98,167,342,509,42,51,119,158,331,735,0.4503401360544217,28,83,0.3373493975903614,303,652,0.4647239263803681,0.469,185,227,0.8149779735682819
Bimbo Coles,colesbi01,PG,33,CLE,2002,47,693.0,149,107,12,43,55,13,4,31,59,56,146,0.3835616438356164,4,20,0.2,52,126,0.4126984126984127,0.397,33,37,0.8918918918918919
Jason Collier,collija02,C,24,HOU,2002,25,365.0,106,9,31,51,82,6,4,13,40,41,95,0.431578947368421,0,1,0.0,41,94,0.4361702127659574,0.432,24,32,0.75
Jarron Collins,collija03,C,23,UTA,2002,70,1440.0,450,58,138,158,296,29,22,56,234,158,343,0.4606413994169096,0,1,0.0,158,342,0.4619883040935672,0.461,134,181,0.7403314917127072
Jason Collins,collija04,C,23,NJN,2002,77,1407.0,350,81,132,169,301,29,47,72,173,117,278,0.420863309352518,1,2,0.5,116,276,0.4202898550724637,0.423,115,164,0.7012195121951219
Chris Crawford,crawfch01,PF,26,ATL,2002,7,131.0,53,5,9,16,25,2,5,10,21,21,45,0.4666666666666667,0,1,0.0,21,44,0.4772727272727273,0.467,11,15,0.7333333333333333
Jamal Crawford,crawfja01,PG,21,CHI,2002,23,481.0,214,55,5,29,34,18,5,32,18,89,187,0.4759358288770053,26,58,0.4482758620689655,63,129,0.4883720930232558,0.545,10,13,0.7692307692307693
Joe Crispin,crispjo01,PG,22,TOT,2002,21,156.0,79,26,2,9,11,5,0,10,10,26,68,0.3823529411764705,15,39,0.3846153846153846,11,29,0.3793103448275862,0.493,12,13,0.9230769230769232
Austin Croshere,croshau01,PF,26,IND,2002,76,1286.0,516,77,74,220,294,26,29,67,106,185,448,0.4129464285714285,49,145,0.3379310344827586,136,303,0.4488448844884488,0.468,97,114,0.8508771929824561
John Crotty,crottjo01,PG,32,UTA,2002,41,802.0,284,141,16,59,75,19,1,51,77,98,208,0.4711538461538461,31,69,0.4492753623188406,67,139,0.4820143884892086,0.546,57,66,0.8636363636363636
Vonteego Cummings,cummivo01,PG,25,PHI,2002,58,501.0,192,60,14,38,52,18,5,36,53,78,187,0.4171122994652406,12,46,0.2608695652173913,66,141,0.4680851063829787,0.449,24,32,0.75
Dell Curry,curryde01,SG,37,TOR,2002,56,886.0,360,61,23,58,81,22,6,41,50,141,347,0.4063400576368876,45,131,0.3435114503816794,96,216,0.4444444444444444,0.471,33,37,0.8918918918918919
Eddy Curry,curryed01,C,19,CHI,2002,72,1150.0,483,25,111,161,272,16,53,69,173,189,377,0.5013262599469496,0,0,0.0,189,377,0.5013262599469496,0.501,105,160,0.65625
Michael Curry,currymi01,SG,33,DET,2002,82,1912.0,329,127,15,153,168,47,10,60,207,125,276,0.4528985507246377,7,26,0.2692307692307692,118,250,0.472,0.466,72,91,0.7912087912087912
Samuel Dalembert,dalemsa01,C,20,PHI,2002,34,177.0,51,5,25,43,68,6,13,14,30,22,50,0.44,0,0,0.0,22,50,0.44,0.44,7,18,0.3888888888888889
Erick Dampier,dampier01,C,26,GSW,2002,73,1740.0,554,87,167,220,387,17,167,156,235,209,480,0.4354166666666667,0,0,0.0,209,480,0.4354166666666667,0.435,136,211,0.6445497630331753
Antonio Daniels,daniean01,SG,26,SAS,2002,82,2175.0,753,228,23,153,176,48,12,70,104,269,612,0.4395424836601307,57,196,0.2908163265306122,212,416,0.5096153846153846,0.486,158,210,0.7523809523809524
Antonio Davis,davisan01,PF,33,TOR,2002,77,2978.0,1113,155,254,486,740,54,83,159,225,410,963,0.4257528556593977,0,1,0.0,410,962,0.4261954261954262,0.426,293,358,0.8184357541899442
Baron Davis,davisba01,PG,22,CHH,2002,82,3318.0,1484,698,93,256,349,172,47,246,241,559,1341,0.4168530947054437,170,478,0.3556485355648535,389,863,0.4507531865585168,0.48,196,338,0.5798816568047337
Dale Davis,davisda01,C,32,POR,2002,78,2447.0,742,96,262,426,688,62,83,62,193,296,580,0.5103448275862069,0,0,0.0,296,580,0.5103448275862069,0.51,150,212,0.7075471698113207
Emanual Davis,davisem01,PG,33,ATL,2002,28,774.0,185,68,19,55,74,27,5,52,68,70,198,0.3535353535353535,29,85,0.3411764705882353,41,113,0.3628318584070796,0.427,16,18,0.8888888888888888
Hubert Davis,davishu01,SG,31,WAS,2002,51,1231.0,365,107,7,70,77,28,3,44,58,146,326,0.4478527607361963,57,126,0.4523809523809524,89,200,0.445,0.535,16,21,0.7619047619047619
Ricky Davis,davisri01,SF,22,CLE,2002,82,1954.0,959,178,63,180,243,69,23,148,145,376,781,0.4814340588988476,11,35,0.3142857142857143,365,746,0.4892761394101876,0.488,196,248,0.7903225806451613
Andrew DeClercq,declean01,C,28,ORL,2002,61,633.0,162,22,74,89,163,23,24,34,130,67,149,0.4496644295302013,0,0,0.0,67,149,0.4496644295302013,0.45,28,50,0.56
Vinny Del Negro,delnevi01,PG,35,PHO,2002,2,6.0,2,2,0,0,0,0,0,0,0,1,4,0.25,0,0,0.0,1,4,0.25,0.25,0,0,0.0
Tony Delk,delkto01,SG,28,TOT,2002,63,1447.0,597,132,58,145,203,53,10,59,98,226,588,0.3843537414965986,67,214,0.3130841121495327,159,374,0.4251336898395721,0.441,78,97,0.8041237113402062
Derrick Dial,dialde01,SG,26,TOT,2002,32,299.0,101,35,14,42,56,10,4,16,13,41,120,0.3416666666666667,1,11,0.0909090909090909,40,109,0.3669724770642202,0.346,18,24,0.75
Michael Dickerson,dickemi01,SG,26,MEM,2002,4,124.0,43,9,3,9,12,3,1,8,12,15,48,0.3125,8,21,0.3809523809523809,7,27,0.2592592592592592,0.396,5,6,0.8333333333333334
DeSagana Diop,diopde01,C,20,CLE,2002,18,109.0,25,5,5,12,17,1,10,12,19,12,29,0.4137931034482758,0,0,0.0,12,29,0.4137931034482758,0.414,1,5,0.2
Vlade Divac,divacvl01,C,33,SAC,2002,80,2420.0,888,297,205,466,671,79,94,158,229,338,716,0.4720670391061452,3,13,0.2307692307692307,335,703,0.476529160739687,0.474,209,340,0.6147058823529412
Michael Doleac,doleami01,C,24,CLE,2002,42,705.0,194,25,47,121,168,15,11,37,98,78,187,0.4171122994652406,0,0,0.0,78,187,0.4171122994652406,0.417,38,46,0.8260869565217391
Keyon Dooling,doolike01,PG,21,LAC,2002,14,155.0,58,12,0,3,3,4,3,10,20,22,57,0.3859649122807017,4,14,0.2857142857142857,18,43,0.4186046511627907,0.421,10,12,0.8333333333333334
Bryce Drew,drewbr01,PG,27,CHH,2002,61,774.0,210,101,14,58,72,32,2,33,49,78,182,0.4285714285714285,31,73,0.4246575342465753,47,109,0.4311926605504587,0.514,23,29,0.7931034482758621
Predrag Drobnjak,drobnpr01,C,26,SEA,2002,64,1174.0,437,51,75,144,219,20,31,51,109,191,414,0.4613526570048309,0,2,0.0,191,412,0.4635922330097087,0.461,55,73,0.7534246575342466
Chris Dudley,dudlech02,C,36,POR,2002,43,327.0,48,13,27,53,80,3,14,14,42,20,50,0.4,0,2,0.0,20,48,0.4166666666666667,0.4,8,15,0.5333333333333333
Tim Duncan,duncati01,PF,25,SAS,2002,82,3329.0,2089,307,268,774,1042,61,203,263,217,764,1504,0.5079787234042553,1,10,0.1,763,1494,0.5107095046854083,0.508,560,701,0.7988587731811697
Howard Eisley,eisleho01,PG,29,NYK,2002,39,609.0,171,100,9,40,49,24,3,53,55,59,175,0.3371428571428571,14,58,0.2413793103448276,45,117,0.3846153846153846,0.377,39,49,0.7959183673469388
Obinna Ekezie,ekeziob01,PF,26,LAC,2002,29,152.0,54,3,12,22,34,2,6,10,16,13,39,0.3333333333333333,0,0,0.0,13,39,0.3333333333333333,0.333,28,40,0.7
LaPhonso Ellis,ellisla01,SF,31,MIA,2002,66,1684.0,469,56,107,180,287,30,37,73,196,189,452,0.4181415929203539,38,124,0.3064516129032258,151,328,0.4603658536585366,0.46,53,84,0.6309523809523809
Evan Eschmeyer,eschmev01,C,26,DAL,2002,31,299.0,62,9,35,63,98,10,9,16,60,21,50,0.42,0,0,0.0,21,50,0.42,0.42,20,33,0.6060606060606061
Maurice Evans,evansma01,SG,23,MIN,2002,10,45.0,21,4,3,1,4,0,0,2,9,9,19,0.4736842105263157,0,3,0.0,9,16,0.5625,0.474,3,4,0.75
Patrick Ewing,ewingpa01,C,39,ORL,2002,65,901.0,390,35,60,203,263,22,45,65,129,148,333,0.4444444444444444,0,1,0.0,148,332,0.4457831325301205,0.444,94,134,0.7014925373134329
Danny Ferry,ferryda01,SF,35,SAS,2002,50,799.0,229,48,15,75,90,16,9,22,70,76,177,0.4293785310734463,43,99,0.4343434343434343,33,78,0.4230769230769231,0.551,34,36,0.9444444444444444
Michael Finley,finlemi01,SF,28,DAL,2002,69,2754.0,1424,230,90,270,360,65,25,117,144,569,1228,0.4633550488599348,76,224,0.3392857142857143,493,1004,0.4910358565737052,0.494,210,251,0.8366533864541833
Derek Fisher,fishede01,PG,27,LAL,2002,70,1974.0,786,181,15,131,146,66,9,62,121,274,666,0.4114114114114114,144,349,0.4126074498567335,130,317,0.4100946372239747,0.52,94,111,0.8468468468468469
Marcus Fizer,fizerma01,PF,23,CHI,2002,76,1963.0,938,120,128,299,427,49,24,131,186,371,848,0.4375,7,41,0.1707317073170731,364,807,0.4510532837670384,0.442,189,283,0.6678445229681979
Isaac Fontaine,fontais01,SG,26,MEM,2002,6,75.0,11,4,0,5,5,0,0,4,6,3,14,0.2142857142857142,1,5,0.2,2,9,0.2222222222222222,0.25,4,6,0.6666666666666666
Alton Ford,fordal02,PF,20,PHO,2002,53,452.0,164,7,32,75,107,6,7,32,99,61,118,0.5169491525423728,0,0,0.0,61,118,0.5169491525423728,0.517,42,57,0.7368421052631579
Joseph Forte,fortejo01,SG,20,BOS,2002,8,39.0,6,6,1,5,6,2,0,3,1,1,12,0.0833333333333333,0,3,0.0,1,9,0.1111111111111111,0.083,4,4,1.0
Danny Fortson,fortsda01,PF,25,GSW,2002,77,2216.0,864,127,290,609,899,44,17,160,255,309,722,0.4279778393351801,1,4,0.25,308,718,0.4289693593314763,0.429,245,308,0.7954545454545454
Greg Foster,fostegr01,PF,33,MIL,2002,6,24.0,7,1,0,8,8,0,0,0,4,2,9,0.2222222222222222,0,4,0.0,2,5,0.4,0.222,3,4,0.75
Jeff Foster,fosteje01,C,25,IND,2002,82,1786.0,467,70,206,350,556,71,38,79,232,177,394,0.449238578680203,2,15,0.1333333333333333,175,379,0.4617414248021108,0.452,111,182,0.6098901098901099
Antonis Fotsis,fotsian01,PF,20,MEM,2002,28,320.0,108,10,25,37,62,9,11,21,22,42,104,0.4038461538461538,7,23,0.3043478260869565,35,81,0.4320987654320987,0.438,17,20,0.85
Tremaine Fowlkes,fowlktr01,SF,25,LAC,2002,22,343.0,74,17,32,32,64,11,1,13,39,25,64,0.390625,0,0,0.0,25,64,0.390625,0.391,24,31,0.7741935483870968
Rick Fox,foxri01,SF,32,LAL,2002,82,2289.0,645,283,90,299,389,67,21,132,244,255,605,0.4214876033057851,65,208,0.3125,190,397,0.4785894206549118,0.475,70,85,0.8235294117647058
Adonal Foyle,foylead01,C,26,GSW,2002,79,1485.0,379,41,150,234,384,36,168,76,179,171,385,0.4441558441558441,0,0,0.0,171,385,0.4441558441558441,0.444,37,93,0.3978494623655914
Steve Francis,francst01,PG,24,HOU,2002,57,2343.0,1234,362,102,299,401,71,25,221,172,420,1007,0.4170804369414101,68,210,0.3238095238095238,352,797,0.4416562107904642,0.451,326,422,0.7725118483412322
Lawrence Funderburke,fundela01,PF,31,SAC,2002,56,722.0,264,32,76,122,198,11,18,33,65,115,245,0.4693877551020408,0,3,0.0,115,242,0.4752066115702479,0.469,34,56,0.6071428571428571
Kevin Garnett,garneke01,PF,25,MIN,2002,81,3175.0,1714,422,243,738,981,96,126,229,184,659,1401,0.470378301213419,37,116,0.3189655172413793,622,1285,0.4840466926070039,0.484,359,448,0.8013392857142857
Dean Garrett,garrede01,C,35,TOT,2002,34,183.0,36,5,16,41,57,7,10,10,32,18,55,0.3272727272727272,0,0,0.0,18,55,0.3272727272727272,0.327,0,3,0.0
Pat Garrity,garripa01,PF,25,ORL,2002,80,2406.0,884,99,77,261,338,61,28,68,230,327,767,0.4263363754889178,169,396,0.4267676767676767,158,371,0.4258760107816711,0.537,61,73,0.8356164383561644
Pau Gasol,gasolpa01,PF,21,MEM,2002,82,3007.0,1441,223,238,492,730,41,169,224,195,551,1064,0.5178571428571429,1,5,0.2,550,1059,0.5193578847969783,0.518,338,477,0.7085953878406709
Chris Gatling,gatlich01,PF,34,MIA,2002,54,809.0,345,25,71,135,206,17,11,58,109,131,293,0.447098976109215,1,8,0.125,130,285,0.4561403508771929,0.449,82,117,0.7008547008547008
Matt Geiger,geigema01,C,32,PHI,2002,4,36.0,3,0,3,3,6,0,2,2,2,1,8,0.125,0,0,0.0,1,8,0.125,0.125,1,2,0.5
Devean George,georgde01,SF,24,LAL,2002,82,1759.0,581,111,78,225,303,71,42,66,190,215,523,0.4110898661567878,66,178,0.3707865168539326,149,345,0.4318840579710145,0.474,85,126,0.6746031746031746
Eddie Gill,gilled01,PG,23,MEM,2002,23,384.0,116,49,7,21,28,11,3,34,38,39,92,0.4239130434782608,7,22,0.3181818181818182,32,70,0.4571428571428571,0.462,31,39,0.7948717948717948
Kendall Gill,gillke01,SG,33,MIA,2002,65,1410.0,372,100,29,155,184,44,8,55,140,162,422,0.3838862559241706,6,44,0.1363636363636363,156,378,0.4126984126984127,0.391,42,62,0.6774193548387096
Dion Glover,glovedi01,SG,23,ATL,2002,55,1156.0,492,84,36,133,169,45,14,76,89,192,456,0.4210526315789473,30,91,0.3296703296703296,162,365,0.4438356164383562,0.454,78,103,0.7572815533980582
Steve Goodrich,goodrst01,SF,25,NJN,2002,9,50.0,5,5,1,4,5,1,2,3,10,2,10,0.2,0,0,0.0,2,10,0.2,0.2,1,2,0.5
Brian Grant,grantbr01,PF,29,MIA,2002,72,2256.0,673,137,168,407,575,48,31,122,236,286,610,0.4688524590163934,0,2,0.0,286,608,0.4703947368421052,0.469,101,119,0.8487394957983193
Horace Grant,grantho01,C,36,ORL,2002,76,2210.0,608,104,159,322,481,57,49,51,118,264,515,0.512621359223301,0,0,0.0,264,515,0.512621359223301,0.513,80,111,0.7207207207207207
Adrian Griffin,griffad01,SG,27,DAL,2002,58,1383.0,415,106,68,161,229,75,12,42,142,179,359,0.4986072423398329,16,54,0.2962962962962963,163,305,0.5344262295081967,0.521,41,49,0.8367346938775511
Eddie Griffin,griffed01,PF,19,HOU,2002,73,1896.0,642,53,117,299,416,17,134,47,117,244,666,0.3663663663663664,90,273,0.3296703296703296,154,393,0.3918575063613231,0.434,64,86,0.7441860465116279
Tom Gugliotta,guglito01,PF,32,PHO,2002,44,1129.0,285,77,59,162,221,39,30,61,116,127,301,0.4219269102990033,3,9,0.3333333333333333,124,292,0.4246575342465753,0.427,28,37,0.7567567567567568
A.J. Guyton,guytoaj01,PG,23,CHI,2002,45,607.0,244,81,12,32,44,10,7,37,23,88,244,0.360655737704918,46,123,0.3739837398373983,42,121,0.3471074380165289,0.455,22,27,0.8148148148148148
Darvin Ham,hamda01,SF,28,MIL,2002,70,1208.0,303,73,91,111,202,25,37,83,175,120,211,0.5687203791469194,1,7,0.1428571428571428,119,204,0.5833333333333334,0.571,62,123,0.5040650406504065
Richard Hamilton,hamilri01,SG,23,WAS,2002,63,2203.0,1260,171,73,143,216,38,14,132,136,472,1084,0.4354243542435424,16,42,0.3809523809523809,456,1042,0.437619961612284,0.443,300,337,0.8902077151335311
Tang Hamilton,hamilta01,SF,23,MIA,2002,9,98.0,20,5,6,12,18,4,0,2,10,10,19,0.5263157894736842,0,1,0.0,10,18,0.5555555555555556,0.526,0,1,0.0
Zendon Hamilton,hamilze01,PF,26,DEN,2002,54,848.0,324,14,110,143,253,21,18,60,104,103,245,0.4204081632653061,0,0,0.0,103,245,0.4204081632653061,0.42,118,181,0.6519337016574586
Anfernee Hardaway,hardaan01,SG,30,PHO,2002,80,2462.0,959,324,98,252,350,122,32,189,184,389,931,0.4178302900107411,23,83,0.2771084337349397,366,848,0.4316037735849056,0.43,158,195,0.8102564102564103
Tim Hardaway,hardati01,PG,35,TOT,2002,68,1601.0,652,278,14,110,124,57,10,111,109,226,620,0.364516129032258,123,354,0.3474576271186441,103,266,0.3872180451127819,0.464,77,97,0.7938144329896907
Matt Harpring,harprma01,SF,25,PHI,2002,81,2541.0,958,107,203,370,573,70,5,127,201,386,838,0.4606205250596659,21,69,0.3043478260869565,365,769,0.4746423927178153,0.473,165,222,0.7432432432432432
Al Harrington,harrial01,PF,21,IND,2002,44,1313.0,576,54,96,180,276,41,21,78,166,230,484,0.4752066115702479,1,3,0.3333333333333333,229,481,0.4760914760914761,0.476,115,144,0.7986111111111112
Othella Harrington,harriot01,PF,28,NYK,2002,77,1563.0,596,37,125,224,349,30,36,95,250,237,450,0.5266666666666666,0,2,0.0,237,448,0.5290178571428571,0.527,122,172,0.7093023255813954
Lucious Harris,harrilu01,SG,31,NJN,2002,74,1553.0,675,116,49,158,207,53,6,61,99,249,537,0.4636871508379888,44,118,0.3728813559322034,205,419,0.4892601431980907,0.505,133,158,0.8417721518987342
Jason Hart,hartja01,PG,23,SAS,2002,10,92.0,26,12,4,9,13,7,1,8,16,10,19,0.5263157894736842,0,2,0.0,10,17,0.5882352941176471,0.526,6,6,1.0
Antonio Harvey,harvean01,PF,31,SEA,2002,5,47.0,9,5,5,4,9,1,3,3,8,4,12,0.3333333333333333,0,0,0.0,4,12,0.3333333333333333,0.333,1,2,0.5
Donnell Harvey,harvedo01,PF,21,TOT,2002,47,841.0,270,37,80,147,227,21,24,33,115,108,217,0.4976958525345622,0,0,0.0,108,217,0.4976958525345622,0.498,54,90,0.6
Trenton Hassell,hassetr01,SG,22,CHI,2002,78,2237.0,681,172,65,190,255,55,44,101,184,267,628,0.4251592356687898,60,165,0.3636363636363636,207,463,0.4470842332613391,0.473,87,114,0.7631578947368421
Kirk Haston,hastoki01,PF,22,CHH,2002,15,77.0,26,5,5,15,20,0,1,3,9,11,39,0.282051282051282,0,3,0.0,11,36,0.3055555555555556,0.282,4,8,0.5
Brendan Haywood,haywobr01,C,22,WAS,2002,62,1266.0,315,29,143,179,322,21,91,50,158,109,221,0.4932126696832579,0,0,0.0,109,221,0.4932126696832579,0.493,97,160,0.60625
Alan Henderson,hendeal01,PF,29,ATL,2002,26,422.0,143,11,31,66,97,11,15,21,40,59,116,0.5086206896551724,1,1,1.0,58,115,0.5043478260869565,0.513,24,45,0.5333333333333333
Cedric Henderson,hendece02,SF,26,GSW,2002,12,70.0,36,4,1,2,3,6,2,8,4,15,31,0.4838709677419355,2,4,0.5,13,27,0.4814814814814814,0.516,4,7,0.5714285714285714
Grant Hill,hillgr01,SF,29,ORL,2002,14,512.0,235,64,29,96,125,8,4,37,40,83,195,0.4256410256410256,0,2,0.0,83,193,0.4300518134715025,0.426,69,80,0.8625
Tyrone Hill,hillty01,PF,33,CLE,2002,26,810.0,209,23,79,195,274,17,13,48,102,71,182,0.3901098901098901,0,1,0.0,71,181,0.3922651933701657,0.39,67,103,0.6504854368932039
Fred Hoiberg,hoibefr01,SG,29,CHI,2002,79,1408.0,345,136,18,192,210,61,5,32,87,121,291,0.415807560137457,24,92,0.2608695652173913,97,199,0.4874371859296482,0.457,79,94,0.8404255319148937
Robert Horry,horryro01,PF,31,LAL,2002,81,2140.0,550,232,130,349,479,77,89,88,208,183,460,0.3978260869565217,76,203,0.3743842364532019,107,257,0.4163424124513619,0.48,108,138,0.782608695652174
Eddie House,houseed01,PG,23,MIA,2002,64,1230.0,514,123,17,93,110,43,5,80,98,209,524,0.3988549618320611,54,157,0.3439490445859872,155,367,0.4223433242506812,0.45,42,49,0.8571428571428571
Allan Houston,houstal01,SG,30,NYK,2002,77,2914.0,1567,190,37,215,252,54,10,170,182,568,1301,0.436587240584166,136,346,0.3930635838150289,432,955,0.4523560209424084,0.489,295,339,0.8702064896755162
Juwan Howard,howarju01,PF,28,TOT,2002,81,2635.0,1185,169,223,389,612,46,47,152,265,462,1005,0.4597014925373134,0,2,0.0,462,1003,0.46061814556331,0.46,261,343,0.760932944606414
Troy Hudson,hudsotr01,PG,25,ORL,2002,81,1854.0,950,255,30,115,145,57,6,163,119,354,815,0.4343558282208589,66,187,0.3529411764705882,288,628,0.4585987261146497,0.475,176,201,0.8756218905472637
Larry Hughes,hughela01,SG,23,GSW,2002,73,2049.0,895,316,83,162,245,113,23,171,150,343,810,0.4234567901234567,18,93,0.1935483870967742,325,717,0.4532775453277545,0.435,191,259,0.7374517374517374
Lindsey Hunter,hunteli01,PG,31,LAL,2002,82,1616.0,473,129,18,103,121,66,19,55,120,187,490,0.3816326530612245,79,208,0.3798076923076923,108,282,0.3829787234042553,0.462,20,40,0.5
Steven Hunter,huntest01,C,20,ORL,2002,53,516.0,189,5,40,57,97,5,43,16,81,67,147,0.4557823129251701,0,0,0.0,67,147,0.4557823129251701,0.456,55,94,0.5851063829787234
Zydrunas Ilgauskas,ilgauzy01,C,26,CLE,2002,62,1329.0,690,70,136,198,334,17,84,94,187,241,567,0.4250440917107583,0,5,0.0,241,562,0.4288256227758007,0.425,208,276,0.7536231884057971
Allen Iverson,iversal01,SG,26,PHI,2002,60,2622.0,1883,331,44,225,269,168,13,237,102,665,1669,0.3984421809466746,78,268,0.291044776119403,587,1401,0.4189864382583869,0.422,475,585,0.811965811965812
Bobby Jackson,jacksbo01,PG,28,SAC,2002,81,1750.0,896,164,82,169,251,73,11,93,145,334,754,0.4429708222811671,79,219,0.3607305936073059,255,535,0.4766355140186916,0.495,149,184,0.8097826086956522
Jaren Jackson,jacksja01,SG,34,ORL,2002,9,144.0,39,8,1,16,17,5,0,8,13,15,37,0.4054054054054054,7,20,0.35,8,17,0.4705882352941176,0.5,2,4,0.5
Jermaine Jackson,jacksje01,SG,25,TOR,2002,24,280.0,57,57,3,24,27,9,1,14,24,20,42,0.4761904761904761,1,2,0.5,19,40,0.475,0.488,16,24,0.6666666666666666
Jim Jackson,jacksji01,SF,31,MIA,2002,55,1825.0,589,140,54,236,290,42,14,106,145,238,538,0.4423791821561338,38,81,0.4691358024691358,200,457,0.437636761487965,0.478,75,87,0.8620689655172413
Marc Jackson,jacksma02,C,27,TOT,2002,39,495.0,186,14,48,80,128,11,6,30,69,60,164,0.3658536585365853,0,1,0.0,60,163,0.3680981595092024,0.366,66,80,0.825
Mark Jackson,jacksma01,PG,36,NYK,2002,82,2367.0,686,605,56,253,309,74,1,150,162,260,592,0.4391891891891892,79,195,0.4051282051282051,181,397,0.4559193954659949,0.506,87,110,0.7909090909090909
Stephen Jackson,jacksst02,SF,23,SAS,2002,23,227.0,89,11,3,23,26,15,3,23,29,34,91,0.3736263736263736,9,36,0.25,25,55,0.4545454545454545,0.423,12,17,0.7058823529411765
Jerome James,jamesje01,C,26,SEA,2002,56,949.0,298,24,89,143,232,25,86,74,174,134,273,0.4908424908424908,0,0,0.0,134,273,0.4908424908424908,0.491,30,60,0.5
Mike James,jamesmi01,PG,26,MIA,2002,15,119.0,42,19,2,12,14,6,1,13,17,15,43,0.3488372093023256,8,21,0.3809523809523809,7,22,0.3181818181818182,0.442,4,7,0.5714285714285714
Tim James,jamesti01,SF,25,PHI,2002,9,41.0,12,1,5,2,7,0,1,3,5,5,13,0.3846153846153846,0,0,0.0,5,13,0.3846153846153846,0.385,2,6,0.3333333333333333
Antawn Jamison,jamisan01,SF,25,GSW,2002,82,3033.0,1619,161,211,345,556,70,45,161,187,614,1375,0.4465454545454545,68,210,0.3238095238095238,546,1165,0.4686695278969957,0.471,323,440,0.7340909090909091
Harold Jamison,jamisha01,PF,25,LAC,2002,25,176.0,54,6,24,15,39,5,1,6,23,22,43,0.5116279069767442,0,0,0.0,22,43,0.5116279069767442,0.512,10,15,0.6666666666666666
Richard Jefferson,jefferi01,SF,21,NJN,2002,79,1917.0,742,140,85,208,293,64,48,107,211,270,591,0.4568527918781725,13,56,0.2321428571428571,257,535,0.4803738317757009,0.468,189,265,0.7132075471698113
Anthony Johnson,johnsan02,SG,27,NJN,2002,34,366.0,94,48,10,19,29,31,1,20,30,37,90,0.4111111111111111,4,12,0.3333333333333333,33,78,0.4230769230769231,0.433,16,25,0.64
Avery Johnson,johnsav01,PG,36,TOT,2002,68,1352.0,535,286,14,55,69,40,9,76,86,207,432,0.4791666666666667,0,5,0.0,207,427,0.4847775175644028,0.479,121,163,0.7423312883435583
DerMarr Johnson,johnsde03,SF,21,ATL,2002,72,1727.0,602,81,59,188,247,62,56,102,163,214,540,0.3962962962962963,89,247,0.3603238866396761,125,293,0.4266211604095563,0.479,85,105,0.8095238095238095
Ervin Johnson,johnser02,C,34,MIL,2002,81,1660.0,208,27,142,324,466,37,82,52,219,89,193,0.4611398963730569,0,1,0.0,89,192,0.4635416666666667,0.461,30,66,0.4545454545454545
Joe Johnson,johnsjo02,SG,20,TOT,2002,77,1916.0,581,179,75,182,257,59,20,71,114,251,584,0.4297945205479452,38,130,0.2923076923076923,213,454,0.4691629955947136,0.462,41,53,0.7735849056603774
Alvin Jones,jonesal01,C,23,PHI,2002,23,126.0,26,3,13,23,36,3,9,11,35,8,20,0.4,0,0,0.0,8,20,0.4,0.4,10,20,0.5
Damon Jones,jonesda01,PG,25,DET,2002,67,1083.0,340,140,13,90,103,23,1,61,83,114,284,0.4014084507042254,69,186,0.3709677419354839,45,98,0.4591836734693877,0.523,43,59,0.7288135593220338
Eddie Jones,jonesed02,SG,30,MIA,2002,81,3156.0,1480,262,61,317,378,117,77,148,258,517,1198,0.4315525876460768,149,382,0.3900523560209424,368,816,0.4509803921568627,0.494,297,355,0.8366197183098592
Jumaine Jones,jonesju01,PF,22,CLE,2002,81,2142.0,671,116,125,365,490,75,46,79,184,287,640,0.4484375,52,168,0.3095238095238095,235,472,0.4978813559322034,0.489,45,68,0.6617647058823529
Popeye Jones,jonespo01,PF,31,WAS,2002,79,1920.0,554,127,233,345,578,50,19,88,209,222,508,0.437007874015748,4,11,0.3636363636363636,218,497,0.4386317907444668,0.441,106,130,0.8153846153846154
Michael Jordan,jordami01,SF,38,WAS,2002,60,2093.0,1375,310,50,289,339,85,26,162,119,551,1324,0.4161631419939577,10,53,0.1886792452830188,541,1271,0.4256490952006294,0.42,263,333,0.7897897897897898
Shawn Kemp,kempsh01,PF,32,POR,2002,75,1232.0,454,52,90,198,288,43,33,81,184,175,407,0.42997542997543,0,4,0.0,175,403,0.43424317617866,0.43,104,131,0.7938931297709924
Steve Kerr,kerrst01,PG,36,POR,2002,65,775.0,269,63,6,54,60,13,1,24,49,102,217,0.4700460829493088,26,66,0.3939393939393939,76,151,0.5033112582781457,0.53,39,40,0.975
Jason Kidd,kiddja01,PG,28,NJN,2002,82,3056.0,1208,808,130,465,595,175,20,286,136,445,1138,0.39103690685413,117,364,0.3214285714285714,328,774,0.4237726098191214,0.442,201,247,0.8137651821862348
Andrei Kirilenko,kirilan01,SF,20,UTA,2002,82,2151.0,880,94,149,253,402,116,159,108,156,285,633,0.4502369668246445,25,100,0.25,260,533,0.4878048780487805,0.47,285,371,0.7681940700808625
Kerry Kittles,kittlke01,SG,27,NJN,2002,82,2601.0,1102,216,68,207,275,130,31,109,108,438,940,0.4659574468085106,98,242,0.4049586776859504,340,698,0.4871060171919771,0.518,128,172,0.7441860465116279
Brevin Knight,knighbr01,PG,26,MEM,2002,53,1151.0,371,302,11,98,109,79,7,111,135,141,334,0.4221556886227545,2,8,0.25,139,326,0.4263803680981595,0.425,87,115,0.7565217391304347
Travis Knight,knightr01,C,27,NYK,2002,49,429.0,98,8,48,56,104,11,10,27,95,41,113,0.3628318584070796,0,0,0.0,41,113,0.3628318584070796,0.363,16,21,0.7619047619047619
Toni Kukoč,kukocto01,SF,33,ATL,2002,59,1494.0,584,210,43,175,218,48,17,113,91,211,504,0.4186507936507936,53,171,0.3099415204678362,158,333,0.4744744744744745,0.471,109,153,0.7124183006535948
Christian Laettner,laettch01,PF,32,WAS,2002,57,1441.0,404,151,74,227,301,60,25,85,129,168,362,0.4640883977900552,2,10,0.2,166,352,0.4715909090909091,0.467,66,76,0.868421052631579
Raef LaFrentz,lafrera01,C,25,TOT,2002,78,2455.0,1051,89,176,403,579,55,213,94,281,421,920,0.4576086956521739,104,268,0.3880597014925373,317,652,0.4861963190184049,0.514,105,151,0.695364238410596
Trajan Langdon,langdtr01,SG,25,CLE,2002,44,477.0,209,60,13,42,55,13,5,40,49,70,176,0.3977272727272727,27,74,0.3648648648648648,43,102,0.4215686274509804,0.474,42,46,0.9130434782608696
Dan Langhi,langhda01,SF,24,HOU,2002,34,434.0,107,14,22,45,67,8,5,9,25,49,125,0.392,1,4,0.25,48,121,0.396694214876033,0.396,8,11,0.7272727272727273
Rusty LaRue,larueru01,PG,28,UTA,2002,33,542.0,193,71,11,38,49,17,7,43,58,73,185,0.3945945945945946,17,50,0.34,56,135,0.4148148148148148,0.441,30,35,0.8571428571428571
Voshon Lenard,lenarvo01,SG,28,DEN,2002,71,1665.0,813,130,38,145,183,59,25,91,105,315,769,0.4096228868660598,89,240,0.3708333333333333,226,529,0.4272211720226843,0.467,94,120,0.7833333333333333
Quincy Lewis,lewisqu01,SG,24,UTA,2002,36,490.0,144,36,10,33,43,23,9,32,89,64,143,0.4475524475524475,3,18,0.1666666666666666,61,125,0.488,0.458,13,20,0.65
Rashard Lewis,lewisra02,SF,22,SEA,2002,71,2585.0,1195,123,139,359,498,104,40,97,174,455,972,0.4681069958847736,123,316,0.3892405063291139,332,656,0.5060975609756098,0.531,162,200,0.81
Randy Livingston,livinra01,PG,26,SEA,2002,13,176.0,41,26,9,16,25,9,2,2,11,15,54,0.2777777777777778,1,8,0.125,14,46,0.3043478260869565,0.287,10,11,0.9090909090909092
Art Long,longar01,PF,29,SEA,2002,63,989.0,285,41,107,144,251,22,28,63,180,120,244,0.4918032786885246,0,0,0.0,120,244,0.4918032786885246,0.492,45,85,0.5294117647058824
Grant Long,longgr01,PF,35,MEM,2002,66,1868.0,417,136,31,200,231,63,12,103,123,164,385,0.4259740259740259,3,17,0.1764705882352941,161,368,0.4375,0.43,86,123,0.6991869918699187
Felipe López,lopezfe01,SG,27,MIN,2002,67,581.0,169,39,29,51,80,18,1,36,73,59,156,0.3782051282051282,14,33,0.4242424242424242,45,123,0.3658536585365853,0.423,37,55,0.6727272727272727
Tyronn Lue,luety01,PG,24,WAS,2002,71,1458.0,555,246,14,108,122,49,0,96,120,222,520,0.4269230769230769,63,141,0.4468085106382978,159,379,0.4195250659630606,0.488,48,63,0.7619047619047619
George Lynch,lynchge01,SF,31,CHH,2002,45,893.0,172,54,70,116,186,40,14,41,75,73,198,0.3686868686868687,1,6,0.1666666666666666,72,192,0.375,0.371,25,40,0.625
Todd MacCulloch,maccuto01,C,26,NJN,2002,62,1502.0,604,78,157,221,378,24,89,66,181,247,465,0.5311827956989247,0,0,0.0,247,465,0.5311827956989247,0.531,110,164,0.6707317073170732
Sam Mack,macksa01,SF,31,MIA,2002,12,159.0,40,4,2,12,14,5,1,7,17,14,49,0.2857142857142857,7,28,0.25,7,21,0.3333333333333333,0.357,5,7,0.7142857142857143
Mark Madsen,madsema01,PF,26,LAL,2002,59,650.0,167,44,89,73,162,16,13,22,104,66,146,0.4520547945205479,0,2,0.0,66,144,0.4583333333333333,0.452,35,54,0.6481481481481481
Corey Maggette,maggeco01,SG,22,LAC,2002,63,1615.0,717,112,54,177,231,41,19,116,155,235,530,0.4433962264150943,46,139,0.3309352517985611,189,391,0.4833759590792839,0.487,201,251,0.8007968127490039
Jamaal Magloire,magloja01,C,23,CHH,2002,82,1549.0,699,31,153,308,461,27,86,118,201,228,414,0.5507246376811594,0,1,0.0,228,413,0.5520581113801453,0.551,243,333,0.7297297297297297
Dan Majerle,majerda01,SG,36,PHO,2002,65,1180.0,300,90,28,148,176,48,15,35,104,99,289,0.3425605536332179,79,235,0.3361702127659574,20,54,0.3703703703703703,0.479,23,39,0.5897435897435898
Karl Malone,malonka01,PF,38,UTA,2002,80,3040.0,1788,341,142,544,686,152,59,263,229,635,1399,0.4538956397426733,9,25,0.36,626,1374,0.4556040756914119,0.457,509,639,0.7965571205007824
Danny Manning,mannida01,PF,35,DAL,2002,41,552.0,165,30,25,83,108,21,21,25,80,71,149,0.4765100671140939,1,7,0.1428571428571428,70,142,0.4929577464788732,0.48,22,33,0.6666666666666666
Stephon Marbury,marbust01,PG,24,PHO,2002,82,3187.0,1674,666,75,191,266,77,13,284,186,625,1413,0.4423213021939136,71,248,0.2862903225806452,554,1165,0.4755364806866953,0.467,353,452,0.7809734513274337
Shawn Marion,mariosh01,SF,23,PHO,2002,81,3109.0,1547,162,211,592,803,149,86,144,214,654,1395,0.4688172043010752,48,122,0.3934426229508196,606,1273,0.4760408483896308,0.486,191,226,0.8451327433628318
Sean Marks,marksse01,C,26,MIA,2002,21,319.0,96,8,19,56,75,5,10,19,40,38,88,0.4318181818181818,0,0,0.0,38,88,0.4318181818181818,0.432,20,34,0.5882352941176471
Donny Marshall,marshdo02,SF,29,NJN,2002,20,118.0,30,5,8,13,21,3,0,2,14,8,29,0.2758620689655172,2,4,0.5,6,25,0.24,0.31,12,18,0.6666666666666666
Donyell Marshall,marshdo01,SF,28,UTA,2002,58,1750.0,859,101,158,285,443,50,67,124,150,343,661,0.518910741301059,13,42,0.3095238095238095,330,619,0.5331179321486268,0.529,160,226,0.7079646017699115
Darrick Martin,martida01,PG,30,DAL,2002,3,22.0,1,3,0,1,1,2,0,1,4,0,10,0.0,0,2,0.0,0,8,0.0,0.0,1,2,0.5
Kenyon Martin,martike01,PF,24,NJN,2002,73,2504.0,1086,192,113,275,388,90,121,172,261,445,962,0.4625779625779626,15,67,0.2238805970149253,430,895,0.4804469273743016,0.47,181,267,0.6779026217228464
Jamal Mashburn,mashbja01,SF,29,CHH,2002,40,1601.0,858,171,31,211,242,45,6,110,80,303,744,0.407258064516129,41,112,0.3660714285714285,262,632,0.4145569620253164,0.435,211,241,0.8755186721991701
Anthony Mason,masonan01,PF,35,MIL,2002,82,3143.0,787,346,124,522,646,57,22,130,187,316,626,0.5047923322683706,1,1,1.0,315,625,0.504,0.506,154,221,0.6968325791855203
Desmond Mason,masonde01,SF,24,SEA,2002,75,2420.0,931,104,92,259,351,67,27,104,170,357,769,0.4642392717815344,16,59,0.2711864406779661,341,710,0.4802816901408451,0.475,201,237,0.8481012658227848
Tony Massenburg,masseto01,PF,34,MEM,2002,73,1247.0,403,26,100,224,324,30,31,65,174,159,349,0.4555873925501432,1,1,1.0,158,348,0.4540229885057471,0.457,84,117,0.717948717948718
Walter McCarty,mccarwa01,PF,27,BOS,2002,56,718.0,212,41,32,96,128,18,7,22,83,80,180,0.4444444444444444,39,99,0.3939393939393939,41,81,0.5061728395061729,0.553,13,19,0.6842105263157895
Amal McCaskill,mccasam01,C,28,SAS,2002,27,153.0,52,4,16,20,36,6,10,14,23,20,49,0.4081632653061224,0,0,0.0,20,49,0.4081632653061224,0.408,12,26,0.4615384615384615
George McCloud,mccloge01,SF,34,DEN,2002,69,1830.0,604,204,67,184,251,58,19,144,175,206,576,0.3576388888888889,60,222,0.2702702702702703,146,354,0.4124293785310734,0.41,132,163,0.8098159509202454
Jelani McCoy,mccoyje01,C,24,LAL,2002,21,104.0,26,7,8,17,25,0,5,8,14,12,21,0.5714285714285714,0,0,0.0,12,21,0.5714285714285714,0.571,2,8,0.25
Antonio McDyess,mcdyean01,PF,27,DEN,2002,10,236.0,113,18,18,37,55,10,8,20,20,43,75,0.5733333333333334,0,0,0.0,43,75,0.5733333333333334,0.573,27,33,0.8181818181818182
Tracy McGrady,mcgratr01,SG,22,ORL,2002,76,2912.0,1948,400,150,447,597,119,73,189,139,715,1586,0.4508196721311475,103,283,0.3639575971731448,612,1303,0.4696853415195702,0.483,415,555,0.7477477477477478
Jeff McInnis,mcinnje01,PG,27,LAC,2002,81,3030.0,1184,500,45,168,213,63,6,147,202,463,1121,0.4130240856378234,75,234,0.3205128205128205,388,887,0.4374295377677565,0.446,183,219,0.8356164383561644
Derrick McKey,mckeyde01,SF,35,PHI,2002,41,784.0,119,45,48,79,127,41,4,22,90,52,122,0.4262295081967213,5,12,0.4166666666666667,47,110,0.4272727272727272,0.447,10,14,0.7142857142857143
Aaron McKie,mckieaa01,SG,29,PHI,2002,48,1471.0,587,179,26,166,192,56,14,93,74,220,490,0.4489795918367347,51,128,0.3984375,169,362,0.4668508287292817,0.501,96,122,0.7868852459016393
Stanislav Medvedenko,medvest01,C,22,LAL,2002,71,729.0,331,43,85,73,158,29,11,42,119,145,304,0.4769736842105263,0,4,0.0,145,300,0.4833333333333333,0.477,41,62,0.6612903225806451
Ron Mercer,mercero01,SG,25,TOT,2002,53,1716.0,735,128,50,128,178,32,13,88,108,311,784,0.3966836734693877,18,62,0.2903225806451613,293,722,0.4058171745152354,0.408,95,119,0.7983193277310925
Chris Mihm,mihmch01,C,22,CLE,2002,74,1659.0,569,24,133,259,392,18,89,97,260,221,526,0.4201520912547528,3,7,0.4285714285714285,218,519,0.420038535645472,0.423,124,179,0.6927374301675978
Darius Miles,milesda01,SF,20,LAC,2002,82,2227.0,779,184,109,344,453,71,103,160,184,309,642,0.4813084112149532,3,19,0.1578947368421052,306,623,0.4911717495987159,0.484,158,255,0.6196078431372549
Andre Miller,millean02,PG,25,CLE,2002,81,3023.0,1335,882,108,271,379,126,34,245,228,474,1045,0.4535885167464115,22,87,0.2528735632183908,452,958,0.4718162839248434,0.464,365,447,0.8165548098434005
Brad Miller,millebr01,C,25,TOT,2002,76,2263.0,1032,152,252,369,621,76,41,115,244,366,733,0.4993178717598908,3,7,0.4285714285714285,363,726,0.5,0.501,297,383,0.7754569190600522
Mike Miller,millemi01,SF,21,ORL,2002,63,2123.0,956,198,49,224,273,47,23,108,145,351,802,0.4376558603491272,116,303,0.3828382838283828,235,499,0.4709418837675351,0.51,138,181,0.7624309392265194
Reggie Miller,millere01,SG,36,IND,2002,79,2889.0,1304,253,23,196,219,88,10,120,143,414,913,0.4534501642935378,180,443,0.4063205417607223,234,470,0.4978723404255319,0.552,296,325,0.9107692307692308
Chris Mills,millsch01,SF,32,GSW,2002,66,1237.0,489,72,51,139,190,31,13,56,120,178,427,0.4168618266978923,48,127,0.3779527559055118,130,300,0.4333333333333333,0.473,85,107,0.794392523364486
Sam Mitchell,mitchsa01,SF,38,MIN,2002,74,726.0,244,45,18,64,82,12,4,26,79,98,227,0.4317180616740088,10,35,0.2857142857142857,88,192,0.4583333333333333,0.454,38,49,0.7755102040816326
Cuttino Mobley,moblecu01,SG,26,HOU,2002,74,3116.0,1606,187,63,237,300,109,37,180,189,595,1358,0.4381443298969072,149,377,0.3952254641909814,446,981,0.454638124362895,0.493,267,314,0.8503184713375797
Nazr Mohammed,mohamna01,C,24,ATL,2002,82,2168.0,795,33,242,409,651,63,61,118,252,329,713,0.4614305750350631,0,1,0.0,329,712,0.4620786516853932,0.461,137,222,0.6171171171171171
Jérôme Moïso,moisoje01,C,23,CHH,2002,15,76.0,16,4,4,21,25,3,2,8,12,8,20,0.4,0,0,0.0,8,20,0.4,0.4,0,0,0.0
Eric Montross,montrer01,C,30,TOR,2002,49,655.0,116,16,36,104,140,12,23,25,92,53,132,0.4015151515151515,0,1,0.0,53,131,0.4045801526717557,0.402,10,31,0.3225806451612903
Mikki Moore,mooremi01,C,26,DET,2002,30,217.0,79,11,22,31,53,7,9,14,35,29,61,0.4754098360655737,1,2,0.5,28,59,0.4745762711864407,0.484,20,26,0.7692307692307693
Terence Morris,morrite01,SF,23,HOU,2002,68,1110.0,255,64,77,134,211,21,27,45,72,111,289,0.3840830449826989,15,78,0.1923076923076923,96,211,0.4549763033175355,0.41,18,28,0.6428571428571429
Hanno Möttölä,mottoha01,C,25,ATL,2002,82,1371.0,396,50,81,187,268,20,19,70,174,169,384,0.4401041666666667,1,13,0.0769230769230769,168,371,0.4528301886792453,0.441,57,76,0.75
Alonzo Mourning,mournal01,C,31,MIA,2002,75,2455.0,1178,87,182,450,632,27,186,182,258,447,866,0.5161662817551963,1,3,0.3333333333333333,446,863,0.5168018539976825,0.517,283,431,0.6566125290023201
Troy Murphy,murphtr01,PF,21,GSW,2002,82,1448.0,480,70,99,223,322,36,21,84,217,178,423,0.4208037825059101,3,9,0.3333333333333333,175,414,0.4227053140096618,0.424,121,156,0.7756410256410257
Lamond Murray,murrala01,SF,28,CLE,2002,71,2312.0,1176,157,81,291,372,70,43,141,148,430,986,0.4361054766734279,101,238,0.4243697478991596,329,748,0.4398395721925133,0.487,215,263,0.8174904942965779
Tracy Murray,murratr01,SF,30,TOR,2002,40,473.0,227,19,18,35,53,11,8,25,38,85,207,0.4106280193236715,40,104,0.3846153846153846,45,103,0.4368932038834951,0.507,17,21,0.8095238095238095
Dikembe Mutombo,mutomdi01,C,35,PHI,2002,80,2907.0,920,83,254,609,863,29,190,156,242,321,641,0.500780031201248,0,0,0.0,321,641,0.500780031201248,0.501,278,364,0.7637362637362637
Mamadou N'Diaye,ndiayma02,C,26,TOR,2002,5,46.0,20,0,6,5,11,0,2,1,6,6,10,0.6,0,0,0.0,6,10,0.6,0.6,8,10,0.8
Lee Nailon,nailole01,SF,26,CHH,2002,79,1912.0,851,94,103,188,291,59,17,96,175,369,764,0.4829842931937173,1,2,0.5,368,762,0.4829396325459317,0.484,112,150,0.7466666666666667
Eduardo Nájera,najered01,PF,25,DAL,2002,62,1357.0,400,38,149,193,342,56,30,40,156,150,300,0.5,0,2,0.0,150,298,0.5033557046979866,0.5,100,148,0.6756756756756757
Steve Nash,nashst01,PG,27,DAL,2002,82,2837.0,1466,634,50,204,254,53,4,229,164,525,1088,0.4825367647058823,156,343,0.4548104956268221,369,745,0.4953020134228187,0.554,260,293,0.8873720136518771
Tyrone Nesby,nesbyty01,SF,26,WAS,2002,70,1498.0,443,91,105,213,318,61,22,49,164,183,421,0.4346793349168646,13,47,0.2765957446808511,170,374,0.4545454545454545,0.45,64,93,0.6881720430107527
Rasho Nesterović,nestera01,C,25,MIN,2002,82,2218.0,687,75,200,334,534,45,109,94,262,324,657,0.4931506849315068,0,1,0.0,324,656,0.4939024390243902,0.493,39,71,0.5492957746478874
Ira Newble,newblir01,SF,27,ATL,2002,42,1273.0,338,45,80,142,222,38,20,49,117,131,263,0.4980988593155893,1,7,0.1428571428571428,130,256,0.5078125,0.5,75,88,0.8522727272727273
Johnny Newman,newmajo01,SF,38,DAL,2002,47,724.0,198,14,9,40,49,29,4,21,88,67,148,0.4527027027027027,22,57,0.3859649122807017,45,91,0.4945054945054945,0.527,42,58,0.7241379310344828
Moochie Norris,norrimo01,PG,28,HOU,2002,82,2249.0,665,403,73,173,246,81,4,156,130,251,631,0.3977812995245642,36,134,0.2686567164179104,215,497,0.4325955734406438,0.426,127,169,0.7514792899408284
Dirk Nowitzki,nowitdi01,C,23,DAL,2002,76,2891.0,1779,186,120,635,755,83,77,145,222,600,1258,0.4769475357710652,139,350,0.3971428571428571,461,908,0.5077092511013216,0.532,440,516,0.8527131782945736
Jermaine O'Neal,onealje01,PF,23,IND,2002,72,2707.0,1371,118,188,569,757,45,166,174,269,543,1133,0.4792586054721977,1,14,0.0714285714285714,542,1119,0.484361036639857,0.48,284,413,0.6876513317191283
Shaquille O'Neal,onealsh01,C,29,LAL,2002,67,2422.0,1822,200,235,480,715,41,137,171,199,712,1229,0.5793327908868999,0,1,0.0,712,1228,0.5798045602605864,0.579,398,717,0.5550906555090656
Charles Oakley,oaklech01,PF,38,CHI,2002,57,1383.0,216,114,72,271,343,49,11,87,175,97,263,0.3688212927756654,1,6,0.1666666666666666,96,257,0.3735408560311284,0.371,21,28,0.75
Lamar Odom,odomla01,SF,22,LAC,2002,29,999.0,379,171,31,145,176,23,36,97,91,151,360,0.4194444444444444,16,84,0.1904761904761904,135,276,0.4891304347826087,0.442,61,93,0.6559139784946236
Hakeem Olajuwon,olajuha01,C,39,TOR,2002,61,1378.0,435,66,98,268,366,74,90,98,147,194,418,0.4641148325358851,0,2,0.0,194,416,0.4663461538461538,0.464,47,84,0.5595238095238095
Dean Oliver,olivede01,PG,23,GSW,2002,20,139.0,42,21,0,8,8,3,0,11,16,17,46,0.3695652173913043,2,13,0.1538461538461538,15,33,0.4545454545454545,0.391,6,9,0.6666666666666666
Kevin Ollie,ollieke01,PG,29,TOT,2002,81,1723.0,462,291,25,159,184,62,2,106,97,137,353,0.3881019830028329,1,2,0.5,136,351,0.3874643874643874,0.39,187,227,0.8237885462555066
Michael Olowokandi,olowomi01,C,26,LAC,2002,80,2568.0,885,90,164,547,711,55,145,175,217,384,886,0.4334085778781038,0,0,0.0,384,886,0.4334085778781038,0.433,117,188,0.6223404255319149
Greg Ostertag,ostergr01,C,28,UTA,2002,74,1107.0,245,50,125,188,313,15,109,51,152,91,201,0.4527363184079602,0,0,0.0,91,201,0.4527363184079602,0.453,63,130,0.4846153846153846
Bo Outlaw,outlabo01,PF,30,TOT,2002,83,1928.0,376,127,147,217,364,70,92,96,205,166,299,0.5551839464882943,1,2,0.5,165,297,0.5555555555555556,0.557,43,102,0.4215686274509804
Doug Overton,overtdo01,PG,32,LAC,2002,18,130.0,39,13,1,11,12,3,1,12,10,14,44,0.3181818181818182,7,27,0.2592592592592592,7,17,0.4117647058823529,0.398,4,7,0.5714285714285714
Olumide Oyedeji,oyedeol01,C,20,SEA,2002,36,221.0,55,4,27,52,79,4,2,14,36,22,41,0.5365853658536586,0,0,0.0,22,41,0.5365853658536586,0.537,11,18,0.6111111111111112
Robert Pack,packro01,PG,32,MIN,2002,16,252.0,62,49,7,16,23,13,0,20,32,25,68,0.3676470588235294,1,4,0.25,24,64,0.375,0.375,11,15,0.7333333333333333
Scott Padgett,padgesc01,PF,25,UTA,2002,75,1295.0,500,82,111,174,285,43,13,69,140,188,395,0.4759493670886076,49,113,0.4336283185840708,139,282,0.4929078014184397,0.538,75,102,0.7352941176470589
Milt Palacio,palacmi01,PG-SG,23,TOT,2002,69,790.0,231,83,11,62,73,30,4,40,61,82,214,0.3831775700934579,13,41,0.3170731707317073,69,173,0.3988439306358382,0.414,54,74,0.7297297297297297
Tony Parker,parketo01,PG,19,SAS,2002,77,2267.0,705,334,33,164,197,89,7,151,166,268,639,0.4194053208137715,61,189,0.3227513227513227,207,450,0.46,0.467,108,160,0.675
Cherokee Parks,parksch02,C,29,SAS,2002,42,234.0,63,10,24,34,58,7,8,14,34,30,83,0.3614457831325301,0,0,0.0,30,83,0.3614457831325301,0.361,3,8,0.375
Ruben Patterson,patteru01,SF,26,POR,2002,75,1765.0,839,107,155,143,298,79,37,114,140,319,619,0.5153473344103393,9,36,0.25,310,583,0.5317324185248714,0.523,192,274,0.7007299270072993
Gary Payton,paytoga01,PG,33,SEA,2002,82,3301.0,1815,737,80,316,396,131,26,209,179,737,1578,0.4670468948035488,74,236,0.3135593220338983,663,1342,0.4940387481371088,0.49,267,335,0.7970149253731343
Anthony Peeler,peelean01,SG,32,MIN,2002,82,2060.0,737,177,37,169,206,61,11,76,137,288,684,0.4210526315789473,111,283,0.392226148409894,177,401,0.4413965087281795,0.502,50,58,0.8620689655172413
Mike Penberthy,penbemi01,PG,27,LAL,2002,3,12.0,5,2,0,2,2,2,0,0,0,1,2,0.5,0,0,0.0,1,2,0.5,0.5,3,4,0.75
Elliot Perry,perryel01,PG,32,MEM,2002,2,48.0,11,7,0,4,4,3,0,7,6,5,10,0.5,0,0,0.0,5,10,0.5,0.5,1,2,0.5
Wesley Person,persowe01,SG,30,CLE,2002,78,2793.0,1176,173,50,244,294,77,37,74,93,467,944,0.4947033898305085,143,322,0.4440993788819876,324,622,0.5209003215434084,0.57,99,124,0.7983870967741935
Morris Peterson,petermo01,SF,24,TOR,2002,63,1988.0,883,153,91,132,223,73,11,86,174,336,768,0.4375,84,231,0.3636363636363636,252,537,0.4692737430167598,0.492,127,169,0.7514792899408284
Eric Piatkowski,piatker01,SG,31,LAC,2002,71,1718.0,626,112,43,141,184,41,12,64,110,207,471,0.4394904458598726,111,238,0.4663865546218487,96,233,0.4120171673819742,0.557,101,113,0.8938053097345132
Paul Pierce,piercpa01,SG,24,BOS,2002,82,3302.0,2144,261,81,485,566,154,86,241,237,707,1598,0.4424280350438047,210,520,0.4038461538461538,497,1078,0.461038961038961,0.508,520,643,0.8087091757387247
Scottie Pippen,pippesc01,SF,36,POR,2002,62,1996.0,659,363,77,244,321,101,35,171,162,246,599,0.4106844741235392,54,177,0.3050847457627119,192,422,0.4549763033175355,0.456,113,146,0.773972602739726
Scot Pollard,pollasc01,C,26,SAC,2002,80,1881.0,509,53,188,377,565,70,76,68,202,197,358,0.5502793296089385,0,0,0.0,197,358,0.5502793296089385,0.55,115,166,0.6927710843373494
Mark Pope,popema01,PF,29,MIL,2002,45,426.0,87,17,20,53,73,11,11,15,47,36,91,0.3956043956043956,4,25,0.16,32,66,0.4848484848484848,0.418,11,21,0.5238095238095238
Terry Porter,portete01,PG,38,SAS,2002,72,1294.0,399,205,12,152,164,45,16,85,89,136,321,0.4236760124610592,59,142,0.4154929577464789,77,179,0.4301675977653631,0.516,68,83,0.8192771084337349
James Posey,poseyja01,SF,25,DEN,2002,73,2238.0,782,180,109,320,429,114,39,127,224,277,736,0.3763586956521739,67,237,0.2827004219409282,210,499,0.4208416833667334,0.422,161,203,0.7931034482758621
Lavor Postell,postela01,SG,23,NYK,2002,23,179.0,93,5,2,14,16,6,0,11,7,28,84,0.3333333333333333,6,26,0.2307692307692307,22,58,0.3793103448275862,0.369,31,41,0.7560975609756098
Vitaly Potapenko,potapvi01,C,26,BOS,2002,79,1343.0,363,30,167,180,347,37,18,63,174,137,301,0.4551495016611295,0,0,0.0,137,301,0.4551495016611295,0.455,89,120,0.7416666666666667
Brent Price,pricebr01,PG,33,SAC,2002,20,89.0,31,9,4,4,8,3,1,10,13,9,27,0.3333333333333333,4,15,0.2666666666666666,5,12,0.4166666666666667,0.407,9,13,0.6923076923076923
Joel Przybilla,przybjo01,C,22,MIL,2002,71,1128.0,190,21,78,205,283,20,118,43,199,76,142,0.5352112676056338,0,1,0.0,76,141,0.5390070921985816,0.535,38,90,0.4222222222222222
Vladimir Radmanović,radmavl01,PF,21,SEA,2002,61,1230.0,407,81,45,185,230,56,24,72,119,146,354,0.4124293785310734,66,157,0.4203821656050955,80,197,0.4060913705583756,0.506,49,72,0.6805555555555556
Zach Randolph,randoza01,PF,20,POR,2002,41,238.0,114,13,31,38,69,7,4,15,29,48,107,0.4485981308411215,0,0,0.0,48,107,0.4485981308411215,0.449,18,27,0.6666666666666666
Theo Ratliff,ratlith01,C,28,ATL,2002,3,82.0,26,1,5,11,16,1,8,7,8,10,20,0.5,0,0,0.0,10,20,0.5,0.5,6,11,0.5454545454545454
Željko Rebrača,rebraze01,C,29,DET,2002,74,1179.0,513,38,84,206,290,28,73,84,192,189,374,0.5053475935828877,0,0,0.0,189,374,0.5053475935828877,0.505,135,175,0.7714285714285715
Eldridge Recasner,recasel01,PG-SG,34,TOT,2002,6,33.0,5,5,0,0,0,1,0,1,4,2,6,0.3333333333333333,0,1,0.0,2,5,0.4,0.333,1,1,1.0
Michael Redd,reddmi01,SG,22,MIL,2002,67,1417.0,767,91,77,147,224,42,7,57,96,294,609,0.4827586206896552,88,198,0.4444444444444444,206,411,0.5012165450121655,0.555,91,115,0.7913043478260869
Don Reid,reiddo01,PF,28,ORL,2002,68,714.0,224,27,65,111,176,20,44,54,180,90,190,0.4736842105263157,0,0,0.0,90,190,0.4736842105263157,0.474,44,68,0.6470588235294118
Glen Rice,ricegl01,SF,34,HOU,2002,20,606.0,172,31,5,42,47,12,3,24,34,65,167,0.3892215568862275,18,64,0.28125,47,103,0.4563106796116505,0.443,24,30,0.8
Jason Richardson,richaja01,SG,21,GSW,2002,80,2629.0,1151,236,124,216,340,106,31,160,195,464,1090,0.4256880733944954,82,246,0.3333333333333333,382,844,0.45260663507109,0.463,141,210,0.6714285714285714
Norm Richardson,richano01,SG,22,TOT,2002,11,67.0,30,2,3,5,8,0,0,3,5,10,26,0.3846153846153846,4,8,0.5,6,18,0.3333333333333333,0.462,6,9,0.6666666666666666
Quentin Richardson,richaqu01,SG,21,LAC,2002,81,2152.0,1076,128,113,221,334,78,21,102,142,400,926,0.4319654427645788,133,349,0.3810888252148997,267,577,0.462738301559792,0.504,143,187,0.7647058823529411
Mitch Richmond,richmmi01,SG,36,LAL,2002,64,709.0,260,57,14,80,94,18,6,40,61,100,247,0.4048582995951417,18,62,0.2903225806451613,82,185,0.4432432432432432,0.441,42,44,0.9545454545454546
Isaiah Rider,rideris01,SG,30,DEN,2002,10,173.0,93,12,10,23,33,3,2,14,11,37,81,0.4567901234567901,6,15,0.4,31,66,0.4696969696969697,0.494,13,17,0.7647058823529411
Clifford Robinson,robincl02,PF,35,DET,2002,80,2855.0,1166,202,79,307,386,89,95,151,243,454,1069,0.4246959775491113,115,304,0.3782894736842105,339,765,0.4431372549019607,0.478,143,206,0.6941747572815534
David Robinson,robinda01,C,36,SAS,2002,78,2303.0,951,94,191,456,647,86,140,104,193,341,672,0.5074404761904762,0,0,0.0,341,672,0.5074404761904762,0.507,269,395,0.6810126582278481
Eddie Robinson,robined01,SF,25,CHI,2002,29,653.0,262,37,24,54,78,23,11,36,35,112,247,0.4534412955465587,2,5,0.4,110,242,0.4545454545454545,0.457,36,48,0.75
Glenn Robinson,robingl01,SF,29,MIL,2002,66,2346.0,1366,168,70,336,406,97,41,174,173,536,1147,0.4673060156931125,58,178,0.3258426966292135,478,969,0.4932920536635707,0.493,236,282,0.8368794326241135
Larry Robinson,robinla01,SG,34,NYK,2002,2,10.0,3,0,0,2,2,0,0,0,1,1,4,0.25,1,2,0.5,0,2,0.0,0.375,0,0,0.0
Carlos Rogers,rogerca01,C,30,IND,2002,22,168.0,59,3,14,24,38,5,6,5,17,24,43,0.5581395348837209,1,6,0.1666666666666666,23,37,0.6216216216216216,0.57,10,19,0.5263157894736842
Rodney Rogers,rogerro01,SF,30,TOT,2002,77,1880.0,917,112,129,219,348,66,29,108,226,356,756,0.4708994708994709,88,235,0.3744680851063829,268,521,0.5143953934740882,0.529,117,149,0.785234899328859
Sean Rooks,rooksse01,C,32,LAC,2002,61,728.0,183,25,32,92,124,12,21,20,114,81,194,0.4175257731958763,0,0,0.0,81,194,0.4175257731958763,0.418,21,29,0.7241379310344828
Jalen Rose,roseja01,SF,29,TOT,2002,83,3153.0,1696,355,43,330,373,78,45,201,251,663,1458,0.4547325102880658,89,246,0.3617886178861789,574,1212,0.4735973597359736,0.485,281,335,0.8388059701492537
Malik Rose,rosema01,PF,27,SAS,2002,82,1725.0,772,61,172,320,492,70,42,140,208,293,633,0.4628751974723539,1,12,0.0833333333333333,292,621,0.4702093397745571,0.464,185,257,0.7198443579766537
Michael Ruffin,ruffimi01,PF,25,PHI,2002,15,169.0,16,5,23,28,51,5,8,11,23,7,26,0.2692307692307692,0,0,0.0,7,26,0.2692307692307692,0.269,2,8,0.25
Bryon Russell,russebr01,SG,31,UTA,2002,66,1998.0,636,136,79,216,295,64,19,110,205,222,584,0.3801369863013699,77,226,0.3407079646017699,145,358,0.4050279329608938,0.446,115,140,0.8214285714285714
Daniel Santiago,santida01,C,25,PHO,2002,3,24.0,8,2,0,7,7,0,1,2,4,4,8,0.5,0,0,0.0,4,8,0.5,0.5,0,0,0.0
Jeryl Sasser,sasseje01,SG,22,ORL,2002,7,36.0,10,2,3,4,7,3,0,2,3,3,14,0.2142857142857142,0,0,0.0,3,14,0.2142857142857142,0.214,4,5,0.8
Kenny Satterfield,satteke01,PG,20,DEN,2002,36,560.0,189,108,17,35,52,31,1,53,43,73,199,0.3668341708542713,7,27,0.2592592592592592,66,172,0.3837209302325581,0.384,36,46,0.782608695652174
Brian Scalabrine,scalabr01,PF,23,NJN,2002,28,290.0,60,21,12,39,51,9,2,24,39,23,67,0.3432835820895522,3,10,0.3,20,57,0.3508771929824561,0.366,11,15,0.7333333333333333
Shawnelle Scott,scottsh01,C,29,DEN,2002,21,252.0,82,8,53,50,103,3,6,15,49,37,75,0.4933333333333333,0,0,0.0,37,75,0.4933333333333333,0.493,8,20,0.4
Ansu Sesay,sesayan01,SF,25,SEA,2002,9,142.0,58,8,7,13,20,3,2,2,18,22,44,0.5,0,0,0.0,22,44,0.5,0.5,14,20,0.7
Brian Shaw,shawbr01,PG,35,LAL,2002,58,631.0,169,89,19,93,112,25,3,32,43,61,173,0.3526011560693641,29,88,0.3295454545454545,32,85,0.3764705882352941,0.436,18,26,0.6923076923076923
Bobby Simmons,simmobo01,SF,21,WAS,2002,30,343.0,112,17,25,27,52,13,5,14,31,43,95,0.4526315789473684,4,14,0.2857142857142857,39,81,0.4814814814814814,0.474,22,30,0.7333333333333333
Dickey Simpkins,simpkdi01,PF,29,ATL,2002,1,3.0,0,1,0,0,0,0,0,0,0,0,0,0.0,0,0,0.0,0,0,0.0,0.0,0,0,0.0
Brian Skinner,skinnbr01,PF,25,CLE,2002,65,1107.0,224,17,93,188,281,24,61,42,130,88,162,0.5432098765432098,0,0,0.0,88,162,0.5432098765432098,0.543,48,79,0.6075949367088608
Reggie Slater,slatere01,PF,31,TOT,2002,8,47.0,21,1,5,4,9,1,1,1,3,7,15,0.4666666666666667,0,0,0.0,7,15,0.4666666666666667,0.467,7,10,0.7
Charles Smith,smithch04,SG,26,SAS,2002,60,1141.0,441,80,34,99,133,52,44,59,114,182,428,0.4252336448598131,35,131,0.2671755725190839,147,297,0.494949494949495,0.466,42,65,0.6461538461538462
Jabari Smith,smithja01,C,24,TOT,2002,23,181.0,73,11,8,20,28,6,6,5,31,26,63,0.4126984126984127,0,3,0.0,26,60,0.4333333333333333,0.413,21,32,0.65625
Joe Smith,smithjo02,C,26,MIN,2002,72,1922.0,767,82,152,301,453,39,59,86,250,297,581,0.5111876075731497,2,3,0.6666666666666666,295,578,0.5103806228373703,0.513,171,206,0.8300970873786407
Leon Smith,smithle01,C,21,ATL,2002,14,100.0,31,3,10,21,31,5,1,3,12,10,26,0.3846153846153846,0,0,0.0,10,26,0.3846153846153846,0.385,11,17,0.6470588235294118
Steve Smith,smithst01,SG,32,SAS,2002,77,2211.0,895,151,45,148,193,54,15,108,158,310,682,0.4545454545454545,116,246,0.4715447154471545,194,436,0.4449541284403669,0.54,159,181,0.8784530386740331
Eric Snow,snower01,PG,28,PHI,2002,61,2225.0,738,400,33,182,215,95,9,138,167,276,624,0.4423076923076923,3,27,0.1111111111111111,273,597,0.457286432160804,0.445,183,227,0.8061674008810573
Will Solomon,solomwi01,SG,23,MEM,2002,62,872.0,321,92,12,56,68,35,7,62,76,113,331,0.3413897280966767,46,162,0.2839506172839506,67,169,0.3964497041420118,0.411,49,73,0.6712328767123288
Felton Spencer,spencfe01,C,34,NYK,2002,32,248.0,29,3,16,34,50,7,8,12,73,6,26,0.2307692307692307,0,0,0.0,6,26,0.2307692307692307,0.231,17,33,0.5151515151515151
Latrell Sprewell,sprewla01,SF,31,NYK,2002,81,3326.0,1575,313,59,239,298,94,14,223,161,573,1419,0.4038054968287526,145,403,0.3598014888337469,428,1016,0.421259842519685,0.455,284,346,0.8208092485549133
Jerry Stackhouse,stackje01,SF,27,DET,2002,76,2685.0,1629,403,77,238,315,77,37,266,163,524,1319,0.3972706595905989,86,300,0.2866666666666667,438,1019,0.4298331697742885,0.43,495,577,0.8578856152512998
John Starks,starkjo01,SG,36,UTA,2002,66,929.0,290,70,15,53,68,33,0,52,126,114,310,0.3677419354838709,29,95,0.3052631578947368,85,215,0.3953488372093023,0.415,33,41,0.8048780487804879
Vladimir Stepania,stepavl01,C,25,MIA,2002,67,884.0,285,16,100,170,270,24,44,52,103,117,249,0.4698795180722891,1,2,0.5,116,247,0.4696356275303643,0.472,50,104,0.4807692307692308
DeShawn Stevenson,stevede01,SG,20,UTA,2002,67,1134.0,325,116,44,87,131,29,24,68,82,143,371,0.38544474393531,2,25,0.08,141,346,0.407514450867052,0.388,37,53,0.6981132075471698
Michael Stewart,stewami01,C,26,TOR,2002,11,93.0,22,3,12,13,25,4,3,4,22,8,23,0.3478260869565217,0,0,0.0,8,23,0.3478260869565217,0.348,6,11,0.5454545454545454
Bryant Stith,stithbr01,SG,31,CLE,2002,50,665.0,208,42,20,65,85,29,6,30,42,70,188,0.3723404255319149,24,68,0.3529411764705882,46,120,0.3833333333333333,0.436,44,52,0.8461538461538461
John Stockton,stockjo01,PG,39,UTA,2002,82,2566.0,1102,674,59,204,263,152,24,208,209,401,775,0.5174193548387097,25,78,0.3205128205128205,376,697,0.539454806312769,0.534,275,321,0.8566978193146417
Peja Stojaković,stojape01,SF,24,SAC,2002,71,2649.0,1506,175,72,301,373,81,14,140,120,547,1130,0.484070796460177,129,310,0.4161290322580645,418,820,0.5097560975609756,0.541,283,323,0.8761609907120743
Damon Stoudamire,stoudda01,PG,28,POR,2002,75,2796.0,1016,490,78,214,292,67,7,149,153,369,918,0.4019607843137255,104,295,0.3525423728813559,265,623,0.4253611556982343,0.459,174,196,0.8877551020408163
Erick Strickland,stricer01,PG,28,BOS,2002,79,1643.0,606,184,22,191,213,56,1,94,145,190,488,0.3893442622950819,95,247,0.3846153846153846,95,241,0.3941908713692946,0.487,131,155,0.8451612903225807
Mark Strickland,stricma01,SF,31,ATL,2002,46,654.0,208,20,41,90,131,19,17,28,48,91,204,0.446078431372549,1,4,0.25,90,200,0.45,0.449,25,44,0.5681818181818182
Rod Strickland,stricro02,PG,35,MIA,2002,76,2294.0,794,463,49,183,232,82,11,159,114,316,714,0.4425770308123249,8,26,0.3076923076923077,308,688,0.4476744186046512,0.448,154,201,0.7661691542288557
Bruno Šundov,sundobr01,C,21,IND,2002,22,88.0,32,3,7,14,21,3,3,4,16,16,40,0.4,0,1,0.0,16,39,0.4102564102564102,0.4,0,2,0.0
Bob Sura,surabo01,PG,28,GSW,2002,78,1780.0,778,275,89,167,256,88,17,133,160,250,590,0.423728813559322,42,133,0.3157894736842105,208,457,0.4551422319474836,0.459,236,328,0.7195121951219512
Stromile Swift,swiftst01,PF,22,MEM,2002,68,1805.0,803,50,161,269,430,53,113,122,178,293,611,0.4795417348608838,0,3,0.0,293,608,0.4819078947368421,0.48,217,305,0.7114754098360656
Wally Szczerbiak,szczewa02,SF,24,MIN,2002,82,3117.0,1531,257,120,271,391,66,21,181,188,609,1200,0.5075,87,191,0.4554973821989528,522,1009,0.5173439048562933,0.544,226,272,0.8308823529411765
Jason Terry,terryja01,SG,24,ATL,2002,78,2967.0,1504,444,40,230,270,144,13,181,156,524,1219,0.4298605414273995,172,444,0.3873873873873873,352,775,0.4541935483870968,0.5,284,340,0.8352941176470589
Etan Thomas,thomaet01,C,23,WAS,2002,47,618.0,203,6,55,126,181,17,35,26,76,81,151,0.5364238410596026,0,0,0.0,81,151,0.5364238410596026,0.536,41,74,0.5540540540540541
Kenny Thomas,thomake01,PF,24,HOU,2002,72,2484.0,1015,137,158,358,516,85,66,143,195,396,829,0.4776839565741858,0,16,0.0,396,813,0.4870848708487085,0.478,223,336,0.6636904761904762
Kurt Thomas,thomaku01,C,29,NYK,2002,82,2771.0,1143,87,214,533,747,71,79,153,341,463,938,0.4936034115138593,1,6,0.1666666666666666,462,932,0.4957081545064378,0.494,216,265,0.8150943396226416
Tim Thomas,thomati01,SF,24,MIL,2002,74,1987.0,869,105,64,236,300,65,32,127,200,316,753,0.4196547144754316,95,291,0.3264604810996563,221,462,0.4783549783549783,0.483,142,179,0.7932960893854749
Jamaal Tinsley,tinslja01,PG,23,IND,2002,80,2442.0,751,647,78,220,298,138,40,270,248,289,760,0.3802631578947368,42,175,0.24,247,585,0.4222222222222222,0.408,131,186,0.7043010752688172
Óscar Torres,torreos01,SG,25,HOU,2002,65,1075.0,389,40,47,75,122,25,9,49,64,135,341,0.3958944281524926,37,126,0.2936507936507936,98,215,0.4558139534883721,0.45,82,105,0.780952380952381
Robert Traylor,traylro01,PF,24,CHH,2002,61,678.0,228,37,67,120,187,24,37,45,127,87,204,0.4264705882352941,1,1,1.0,86,203,0.4236453201970443,0.429,53,84,0.6309523809523809
Gary Trent,trentga01,PF,27,MIN,2002,64,1140.0,478,60,104,166,270,21,27,58,160,193,381,0.5065616797900262,0,2,0.0,193,379,0.5092348284960422,0.507,92,144,0.6388888888888888
Jeff Trepagnier,trepaje01,SG,22,CLE,2002,12,77.0,18,12,3,9,12,8,4,11,8,7,23,0.3043478260869565,0,1,0.0,7,22,0.3181818181818182,0.304,4,7,0.5714285714285714
Jake Tsakalidis,tsakaja01,C,22,PHO,2002,67,1582.0,491,23,130,244,374,23,69,78,193,190,400,0.475,0,1,0.0,190,399,0.4761904761904761,0.475,111,159,0.6981132075471698
Hedo Türkoğlu,turkohe01,SF,22,SAC,2002,80,1970.0,810,163,63,300,363,57,31,81,184,290,687,0.4221251819505094,63,171,0.3684210526315789,227,516,0.439922480620155,0.468,167,230,0.7260869565217392
Nick Van Exel,vanexni01,PG-SG,30,TOT,2002,72,2496.0,1322,478,28,226,254,44,11,156,104,501,1226,0.4086460032626427,119,350,0.34,382,876,0.4360730593607306,0.457,201,251,0.8007968127490039
Keith Van Horn,vanhoke01,SF,26,NJN,2002,81,2465.0,1199,164,137,472,609,63,42,146,221,471,1089,0.4325068870523416,101,293,0.3447098976109215,370,796,0.4648241206030151,0.479,156,195,0.8
Ratko Varda,vardara01,C,22,DET,2002,1,6.0,5,0,0,1,1,0,0,1,3,2,3,0.6666666666666666,0,0,0.0,2,3,0.6666666666666666,0.667,1,1,1.0
Jacque Vaughn,vaughja01,PG,26,ATL,2002,82,1856.0,540,349,18,150,168,65,2,112,183,206,438,0.4703196347031963,24,54,0.4444444444444444,182,384,0.4739583333333333,0.498,104,126,0.8253968253968254
Jake Voskuhl,voskuja01,C,24,PHO,2002,59,900.0,296,18,103,147,250,11,23,48,139,107,193,0.5544041450777202,0,0,0.0,107,193,0.5544041450777202,0.554,82,109,0.7522935779816514
Antoine Walker,walkean02,PF,25,BOS,2002,81,3406.0,1794,407,150,564,714,122,38,251,237,666,1689,0.3943161634103019,222,645,0.3441860465116279,444,1044,0.425287356321839,0.46,240,324,0.7407407407407407
Samaki Walker,walkesa01,PF,25,LAL,2002,69,1655.0,460,64,129,352,481,28,88,53,170,187,365,0.5123287671232877,0,0,0.0,187,365,0.5123287671232877,0.512,86,129,0.6666666666666666
Ben Wallace,wallabe01,C,27,DET,2002,80,2921.0,609,115,318,721,1039,138,278,70,178,255,480,0.53125,0,3,0.0,255,477,0.5345911949685535,0.531,99,234,0.4230769230769231
Gerald Wallace,wallage01,SF,19,SAC,2002,54,430.0,173,27,49,40,89,19,6,22,46,75,175,0.4285714285714285,0,7,0.0,75,168,0.4464285714285714,0.429,23,46,0.5
John Wallace,wallajo01,SF,27,PHO,2002,46,490.0,231,29,27,58,85,11,9,29,60,93,214,0.4345794392523364,5,13,0.3846153846153846,88,201,0.4378109452736318,0.446,40,46,0.8695652173913043
Rasheed Wallace,wallara01,PF,27,POR,2002,79,2963.0,1521,152,136,509,645,101,101,131,212,603,1287,0.4685314685314685,114,317,0.3596214511041009,489,970,0.5041237113402062,0.513,201,274,0.7335766423357665
Charlie Ward,wardch01,PG,31,NYK,2002,63,1058.0,326,203,15,112,127,68,14,75,100,113,303,0.3729372937293729,53,164,0.3231707317073171,60,139,0.4316546762589928,0.46,47,58,0.8103448275862069
Earl Watson,watsoea01,PG,22,SEA,2002,64,964.0,231,125,31,52,83,60,5,51,93,96,212,0.4528301886792453,16,44,0.3636363636363636,80,168,0.4761904761904761,0.491,23,36,0.6388888888888888
Clarence Weatherspoon,weathcl01,PF,31,NYK,2002,56,1728.0,494,60,149,311,460,37,48,47,132,189,452,0.4181415929203539,0,0,0.0,189,452,0.4181415929203539,0.418,116,146,0.7945205479452054
Chris Webber,webbech01,PF,28,SAC,2002,54,2071.0,1322,258,150,396,546,90,76,158,181,532,1075,0.4948837209302326,5,19,0.2631578947368421,527,1056,0.4990530303030303,0.497,253,338,0.7485207100591716
Bonzi Wells,wellsbo01,SG,25,POR,2002,74,2348.0,1255,204,121,323,444,113,25,191,208,487,1039,0.4687199230028874,66,172,0.3837209302325581,421,867,0.4855824682814302,0.5,215,290,0.7413793103448276
David Wesley,wesleda01,SG,31,CHH,2002,67,2487.0,951,236,44,99,143,74,15,119,147,364,910,0.4,85,256,0.33203125,279,654,0.4266055045871559,0.447,138,188,0.7340425531914894
Jahidi White,whiteja01,C,25,WAS,2002,71,1346.0,383,17,159,285,444,25,75,65,163,150,279,0.5376344086021505,0,0,0.0,150,279,0.5376344086021505,0.538,83,154,0.538961038961039
Rodney White,whitero02,SF,21,DET,2002,16,129.0,56,12,2,16,18,9,2,14,6,21,60,0.35,2,9,0.2222222222222222,19,51,0.3725490196078431,0.367,12,14,0.8571428571428571
Chris Whitney,whitnch01,PG,30,WAS,2002,82,2171.0,833,314,11,141,152,72,6,85,182,274,656,0.4176829268292683,131,323,0.4055727554179567,143,333,0.4294294294294294,0.518,154,175,0.88
Aaron Williams,williaa01,PF,30,NJN,2002,82,1546.0,592,77,115,224,339,29,76,79,212,231,439,0.5261958997722096,0,2,0.0,231,437,0.528604118993135,0.526,130,186,0.6989247311827957
Alvin Williams,willial02,PG,27,TOR,2002,82,2927.0,971,468,58,223,281,135,26,150,191,403,971,0.4150360453141091,62,193,0.3212435233160621,341,778,0.4383033419023136,0.447,103,140,0.7357142857142858
Eric Williams,willier01,SF,29,BOS,2002,74,1747.0,472,109,58,163,221,77,8,95,179,144,385,0.374025974025974,24,86,0.2790697674418604,120,299,0.4013377926421405,0.405,160,219,0.730593607305936
Jason Williams,willija02,PG,26,MEM,2002,65,2236.0,959,519,22,173,195,111,7,214,102,376,985,0.3817258883248731,127,430,0.2953488372093023,249,555,0.4486486486486487,0.446,80,101,0.7920792079207921
Jerome Williams,willije01,PF,28,TOR,2002,68,1641.0,518,75,165,221,386,78,25,68,153,190,388,0.4896907216494845,0,0,0.0,190,388,0.4896907216494845,0.49,138,204,0.6764705882352942
Monty Williams,willimo01,SF,30,ORL,2002,68,1284.0,484,96,80,155,235,49,17,86,134,198,362,0.5469613259668509,0,4,0.0,198,358,0.553072625698324,0.547,88,134,0.6567164179104478
Scott Williams,willisc01,PF,33,DEN,2002,41,737.0,202,13,82,127,209,17,33,35,98,86,217,0.3963133640552995,0,2,0.0,86,215,0.4,0.396,30,41,0.7317073170731707
Shammond Williams,willish01,SG,26,SEA,2002,50,603.0,221,83,16,47,63,21,2,35,35,81,193,0.4196891191709844,28,75,0.3733333333333333,53,118,0.4491525423728814,0.492,31,39,0.7948717948717948
Walt Williams,williwa02,SF,31,HOU,2002,48,1117.0,450,69,37,125,162,18,10,53,106,166,396,0.4191919191919191,78,183,0.4262295081967213,88,213,0.4131455399061033,0.518,40,51,0.7843137254901961
Corliss Williamson,willico02,SF,28,DET,2002,78,1701.0,1063,94,117,202,319,49,26,137,226,411,806,0.5099255583126551,1,5,0.2,410,801,0.5118601747815231,0.511,240,298,0.8053691275167785
Kevin Willis,willike02,PF,39,HOU,2002,52,865.0,315,14,105,194,299,25,23,41,98,125,284,0.4401408450704225,0,1,0.0,125,283,0.4416961130742049,0.44,65,87,0.7471264367816092
Loren Woods,woodslo01,C,23,MIN,2002,60,516.0,110,22,46,76,122,17,34,36,60,33,96,0.34375,0,2,0.0,33,94,0.351063829787234,0.344,44,60,0.7333333333333333
Metta World Peace,artesro01,SF,22,TOT,2002,55,1642.0,727,127,73,198,271,141,39,118,217,269,636,0.4229559748427673,53,170,0.3117647058823529,216,466,0.463519313304721,0.465,136,204,0.6666666666666666
Lorenzen Wright,wrighlo02,C,26,MEM,2002,43,1251.0,516,44,130,275,405,30,23,72,126,223,486,0.4588477366255144,0,2,0.0,223,484,0.4607438016528926,0.459,70,123,0.5691056910569106
Wang Zhizhi,zhizhwa01,C,24,DAL,2002,55,600.0,308,22,19,92,111,11,18,25,84,109,248,0.439516129032258,48,116,0.4137931034482758,61,132,0.4621212121212121,0.536,42,57,0.7368421052631579
Tariq Abdul-Wahad,abdulta01,SG,28,DAL,2003,14,204.0,57,21,14,26,40,6,3,7,26,27,58,0.4655172413793103,0,1,0.0,27,57,0.4736842105263157,0.466,3,6,0.5
Shareef Abdur-Rahim,abdursh01,PF,26,ATL,2003,81,3087.0,1608,242,175,502,677,87,38,212,240,566,1183,0.4784446322907861,21,60,0.35,545,1123,0.4853072128227961,0.487,455,541,0.8410351201478743
Courtney Alexander,alexaco02,PG,25,NOH,2003,66,1360.0,523,79,39,79,118,31,6,68,125,193,505,0.3821782178217822,19,57,0.3333333333333333,174,448,0.3883928571428571,0.401,118,146,0.8082191780821918
Malik Allen,allenma01,PF,24,MIA,2003,80,2318.0,767,54,134,291,425,37,78,128,234,335,790,0.4240506329113924,0,4,0.0,335,786,0.4262086513994911,0.424,97,121,0.8016528925619835
Ray Allen,allenra02,SG,27,TOT,2003,76,2880.0,1713,334,94,287,381,103,14,198,220,598,1363,0.4387380777696258,201,533,0.3771106941838649,397,830,0.4783132530120482,0.512,316,345,0.9159420289855073
Rafer Alston,alstora01,PG,26,TOR,2003,47,980.0,366,192,21,86,107,38,15,86,120,139,335,0.4149253731343283,51,130,0.3923076923076923,88,205,0.4292682926829268,0.491,37,54,0.6851851851851852
John Amaechi,amaecjo01,C,32,UTA,2003,50,474.0,99,21,26,51,77,14,7,34,50,37,118,0.3135593220338983,0,0,0.0,37,118,0.3135593220338983,0.314,25,52,0.4807692307692308
Chris Andersen,anderch01,C,24,DEN,2003,59,907.0,305,32,109,165,274,30,60,60,90,114,285,0.4,0,1,0.0,114,284,0.4014084507042254,0.4,77,140,0.55
Derek Anderson,anderde01,PG,28,POR,2003,76,2556.0,1057,325,53,211,264,90,16,128,141,355,832,0.4266826923076923,116,331,0.3504531722054381,239,501,0.4770459081836327,0.496,231,269,0.8587360594795539
Kenny Anderson,anderke01,PG,32,TOT,2003,61,1135.0,372,198,31,101,132,58,5,75,106,163,382,0.4267015706806282,1,7,0.1428571428571428,162,375,0.432,0.428,45,57,0.7894736842105263
Shandon Anderson,andersh01,SF,29,NYK,2003,82,1731.0,687,87,64,190,254,73,20,114,177,248,537,0.4618249534450652,52,140,0.3714285714285714,196,397,0.4937027707808564,0.51,139,190,0.7315789473684211
Robert Archibald,archiro01,PF,22,MEM,2003,12,72.0,19,3,6,11,17,0,3,7,9,6,20,0.3,0,0,0.0,6,20,0.3,0.3,7,18,0.3888888888888889
Gilbert Arenas,arenagi01,PG,21,GSW,2003,82,2866.0,1497,514,97,289,386,124,17,290,260,509,1180,0.4313559322033898,109,313,0.3482428115015974,400,867,0.461361014994233,0.478,370,468,0.7905982905982906
Brandon Armstrong,armstbr01,SG,22,NJN,2003,17,69.0,24,2,0,4,4,3,1,5,8,9,27,0.3333333333333333,1,6,0.1666666666666666,8,21,0.3809523809523809,0.352,5,6,0.8333333333333334
Darrell Armstrong,armstda01,PG,34,ORL,2003,82,2350.0,769,323,91,204,295,135,13,160,167,263,643,0.4090202177293934,78,232,0.3362068965517241,185,411,0.4501216545012165,0.47,165,188,0.8776595744680851
Carlos Arroyo,arroyca01,PG,23,UTA,2003,44,287.0,121,53,11,15,26,12,1,30,28,50,109,0.4587155963302752,3,7,0.4285714285714285,47,102,0.4607843137254901,0.472,18,22,0.8181818181818182
Chucky Atkins,atkinch01,PG,28,DET,2003,65,1398.0,462,175,21,75,96,27,4,77,108,168,465,0.3612903225806451,86,242,0.3553719008264462,82,223,0.3677130044843049,0.454,40,49,0.8163265306122449
Stacey Augmon,augmost01,SG,34,NOH,2003,70,862.0,212,69,26,93,119,27,9,40,80,79,192,0.4114583333333333,0,7,0.0,79,185,0.427027027027027,0.411,54,72,0.75
Dalibor Bagarić,bagarda01,C,22,CHI,2003,10,76.0,19,4,7,13,20,3,3,5,11,8,26,0.3076923076923077,0,0,0.0,8,26,0.3076923076923077,0.308,3,4,0.75
Vin Baker,bakervi01,C,31,BOS,2003,52,942.0,270,29,90,108,198,22,30,61,146,99,207,0.4782608695652174,0,4,0.0,99,203,0.4876847290640394,0.478,72,107,0.6728971962616822
Brent Barry,barrybr01,SG,31,SEA,2003,75,2480.0,774,384,48,253,301,113,15,142,199,264,577,0.4575389948006932,118,293,0.4027303754266211,146,284,0.5140845070422535,0.56,128,161,0.7950310559006211
Jon Barry,barryjo01,SG,33,DET,2003,80,1473.0,555,206,33,147,180,63,14,81,104,191,424,0.4504716981132075,87,214,0.4065420560747663,104,210,0.4952380952380952,0.553,86,100,0.86
Maceo Baston,bastoma01,PF,27,TOR,2003,16,106.0,40,0,4,19,23,4,11,6,16,15,25,0.6,0,0,0.0,15,25,0.6,0.6,10,12,0.8333333333333334
Mengke Bateer,bateeme01,C,27,SAS,2003,12,46.0,9,4,2,8,10,0,0,6,14,4,17,0.2352941176470588,1,3,0.3333333333333333,3,14,0.2142857142857142,0.265,0,2,0.0
Mike Batiste,batismi01,PF,25,MEM,2003,75,1248.0,481,52,82,175,257,42,16,69,120,197,467,0.4218415417558886,18,81,0.2222222222222222,179,386,0.4637305699481865,0.441,69,88,0.7840909090909091
Tony Battie,battito01,C,26,BOS,2003,67,1683.0,487,49,148,285,433,33,81,48,197,199,369,0.5392953929539296,1,5,0.2,198,364,0.5439560439560439,0.541,88,118,0.7457627118644068
Shane Battier,battish01,SF,24,MEM,2003,78,2383.0,756,105,128,217,345,102,88,68,207,275,569,0.4833040421792619,86,216,0.3981481481481481,189,353,0.5354107648725213,0.559,120,145,0.8275862068965517
Lonny Baxter,baxtelo01,C,24,CHI,2003,55,682.0,262,16,65,100,165,9,22,46,135,96,206,0.4660194174757281,0,2,0.0,96,204,0.4705882352941176,0.466,70,103,0.6796116504854369
Raja Bell,bellra01,SG,26,DAL,2003,75,1173.0,230,57,47,98,145,52,8,43,134,93,211,0.4407582938388625,21,51,0.4117647058823529,72,160,0.45,0.491,23,34,0.6764705882352942
Jonathan Bender,bendejo01,SF,22,IND,2003,46,819.0,303,42,42,91,133,8,56,42,86,112,254,0.4409448818897638,19,53,0.3584905660377358,93,201,0.4626865671641791,0.478,60,84,0.7142857142857143
Corey Benjamin,benjaco01,SG,24,ATL,2003,9,152.0,40,10,10,21,31,1,2,6,20,13,43,0.3023255813953488,2,13,0.1538461538461538,11,30,0.3666666666666666,0.326,12,16,0.75
Travis Best,besttr01,PG,30,MIA,2003,72,1807.0,603,255,26,121,147,44,7,106,174,231,583,0.3962264150943396,36,109,0.3302752293577982,195,474,0.4113924050632911,0.427,105,123,0.8536585365853658
Mike Bibby,bibbymi01,PG,24,SAC,2003,55,1835.0,875,285,34,113,147,72,8,127,93,329,700,0.47,56,137,0.4087591240875912,273,563,0.4849023090586146,0.51,161,187,0.8609625668449198
Chauncey Billups,billuch01,PG,26,DET,2003,74,2327.0,1199,287,38,235,273,63,15,134,136,366,870,0.4206896551724138,149,380,0.3921052631578947,217,490,0.4428571428571428,0.506,318,362,0.8784530386740331
Corie Blount,blounco01,C,34,CHI,2003,50,836.0,150,50,68,137,205,33,19,43,121,65,134,0.4850746268656716,0,0,0.0,65,134,0.4850746268656716,0.485,20,35,0.5714285714285714
Mark Blount,blounma01,C,27,TOT,2003,81,1403.0,401,56,111,197,308,42,68,103,187,150,347,0.4322766570605187,0,0,0.0,150,347,0.4322766570605187,0.432,101,139,0.7266187050359713
Calvin Booth,boothca01,C,26,SEA,2003,47,575.0,138,12,32,77,109,11,33,22,74,52,119,0.4369747899159664,0,2,0.0,52,117,0.4444444444444444,0.437,34,47,0.723404255319149
Carlos Boozer,boozeca01,PF,21,CLE,2003,81,2049.0,810,106,202,407,609,59,50,103,224,331,618,0.5355987055016181,0,1,0.0,331,617,0.5364667747163695,0.536,148,192,0.7708333333333334
Ruben Boumtje-Boumtje,boumtru01,C,24,POR,2003,2,5.0,0,1,1,0,1,1,0,0,0,0,1,0.0,0,0,0.0,0,1,0.0,0.0,0,0,0.0
Bruce Bowen,bowenbr01,SF,31,SAS,2003,82,2566.0,583,113,59,180,239,66,42,72,195,223,479,0.4655532359081419,101,229,0.4410480349344978,122,250,0.488,0.571,36,89,0.4044943820224719
Ryan Bowen,bowenry01,SG,27,DEN,2003,62,996.0,223,54,78,79,157,65,29,43,82,97,197,0.4923857868020304,2,7,0.2857142857142857,95,190,0.5,0.497,27,41,0.6585365853658537
Earl Boykins,boykiea01,PG,26,GSW,2003,68,1321.0,600,221,35,53,88,38,4,73,75,199,464,0.4288793103448275,29,77,0.3766233766233766,170,387,0.4392764857881137,0.46,173,200,0.865
Michael Bradley,bradlmi01,PF,23,TOR,2003,67,1314.0,338,67,162,247,409,16,32,76,125,151,314,0.4808917197452229,1,6,0.1666666666666666,150,308,0.487012987012987,0.482,35,67,0.5223880597014925
Shawn Bradley,bradlsh01,C,30,DAL,2003,81,1731.0,543,54,151,325,476,65,170,67,242,201,375,0.536,0,1,0.0,201,374,0.5374331550802139,0.536,141,175,0.8057142857142857
Elton Brand,brandel01,PF,23,LAC,2003,62,2454.0,1146,157,283,420,703,71,158,161,204,451,899,0.5016685205784205,0,1,0.0,451,898,0.5022271714922049,0.502,244,356,0.6853932584269663
J.R. Bremer,bremejr01,PG,22,BOS,2003,64,1503.0,528,164,18,127,145,38,3,59,80,171,464,0.3685344827586206,101,286,0.3531468531468531,70,178,0.3932584269662921,0.477,85,111,0.7657657657657657
Jamison Brewer,breweja01,PG,22,IND,2003,10,80.0,22,18,5,4,9,2,1,6,11,9,17,0.5294117647058824,0,2,0.0,9,15,0.6,0.529,4,9,0.4444444444444444
Primož Brezec,brezepr01,C,23,IND,2003,22,111.0,42,4,13,10,23,2,4,7,16,15,38,0.3947368421052631,0,1,0.0,15,37,0.4054054054054054,0.395,12,20,0.6
Damone Brown,brownda02,PF,23,TOR,2003,5,115.0,28,3,3,12,15,1,0,6,14,11,35,0.3142857142857143,0,2,0.0,11,33,0.3333333333333333,0.314,6,8,0.75
Devin Brown,brownde02,SG,24,TOT,2003,10,93.0,30,7,8,10,18,4,1,9,14,12,35,0.3428571428571428,0,1,0.0,12,34,0.3529411764705882,0.343,6,8,0.75
Kedrick Brown,brownke01,SF,21,BOS,2003,51,666.0,145,20,45,95,140,34,13,23,68,61,171,0.3567251461988304,3,39,0.0769230769230769,58,132,0.4393939393939394,0.365,20,32,0.625
Kwame Brown,brownkw01,C,20,WAS,2003,80,1773.0,593,58,128,298,426,50,80,110,159,224,502,0.446215139442231,0,3,0.0,224,499,0.4488977955911823,0.446,145,217,0.6682027649769585
P.J. Brown,brownpj01,PF,33,NOH,2003,78,2609.0,832,147,243,458,701,67,80,98,203,319,601,0.5307820299500832,0,3,0.0,319,598,0.5334448160535117,0.531,194,232,0.8362068965517241
Randy Brown,brownra02,PG,34,PHO,2003,32,262.0,41,35,3,23,26,17,2,17,36,16,43,0.3720930232558139,0,0,0.0,16,43,0.3720930232558139,0.372,9,12,0.75
Tierre Brown,brownti01,PG,23,CLE,2003,15,168.0,65,39,8,22,30,13,0,22,9,27,59,0.4576271186440678,0,1,0.0,27,58,0.4655172413793103,0.458,11,14,0.7857142857142857
Rick Brunson,brunsri01,PG,30,CHI,2003,17,196.0,60,36,4,15,19,10,3,17,20,23,50,0.46,4,6,0.6666666666666666,19,44,0.4318181818181818,0.5,10,12,0.8333333333333334
Kobe Bryant,bryanko01,SG,24,LAL,2003,82,3401.0,2461,481,106,458,564,181,67,288,218,868,1924,0.4511434511434511,124,324,0.382716049382716,744,1600,0.465,0.483,601,713,0.8429172510518934
Mark Bryant,bryanma01,PF,37,TOT,2003,16,100.0,13,4,8,12,20,1,1,7,18,5,19,0.2631578947368421,0,0,0.0,5,19,0.2631578947368421,0.263,3,4,0.75
Greg Buckner,buckngr01,SG,26,PHI,2003,75,1514.0,450,96,72,144,216,72,16,62,203,185,398,0.4648241206030151,15,55,0.2727272727272727,170,343,0.4956268221574344,0.484,65,81,0.8024691358024691
Pat Burke,burkepa01,C,29,ORL,2003,62,783.0,267,23,57,89,146,19,25,47,99,113,296,0.3817567567567567,1,7,0.1428571428571428,112,289,0.3875432525951557,0.383,40,58,0.6896551724137931
Caron Butler,butleca01,SF,22,MIA,2003,78,2858.0,1201,213,135,262,397,137,31,192,230,429,1032,0.4156976744186046,34,107,0.3177570093457944,395,925,0.427027027027027,0.432,309,375,0.824
Rasual Butler,butlera01,SG,23,MIA,2003,72,1514.0,540,93,29,157,186,21,43,77,105,207,572,0.3618881118881119,50,171,0.2923976608187134,157,401,0.3915211970074813,0.406,76,104,0.7307692307692307
Jason Caffey,caffeja01,PF,29,MIL,2003,51,894.0,295,38,68,108,176,19,15,56,122,113,248,0.4556451612903225,0,0,0.0,113,248,0.4556451612903225,0.456,69,106,0.6509433962264151
Marcus Camby,cambyma01,C,28,DEN,2003,29,616.0,221,47,75,133,208,20,40,27,69,93,227,0.4096916299559471,2,5,0.4,91,222,0.4099099099099099,0.414,33,50,0.66
Elden Campbell,campbel01,C,34,TOT,2003,56,869.0,343,51,47,134,181,33,39,50,129,117,295,0.3966101694915254,0,1,0.0,117,294,0.3979591836734694,0.397,109,136,0.8014705882352942
Brian Cardinal,cardibr01,PF,25,WAS,2003,5,15.0,4,1,3,2,5,0,0,1,0,1,4,0.25,0,1,0.0,1,3,0.3333333333333333,0.25,2,2,1.0
Anthony Carter,cartean01,PG,27,MIA,2003,49,912.0,199,203,12,71,83,45,5,81,70,83,233,0.3562231759656652,0,8,0.0,83,225,0.3688888888888889,0.356,33,50,0.66
Vince Carter,cartevi01,SG,26,TOR,2003,43,1471.0,884,143,59,129,188,48,41,74,121,355,760,0.4671052631578947,45,131,0.3435114503816794,310,629,0.492845786963434,0.497,129,160,0.80625
Sam Cassell,cassesa01,PG,33,MIL,2003,78,2700.0,1536,450,57,285,342,88,14,177,216,546,1162,0.4698795180722891,59,163,0.3619631901840491,487,999,0.4874874874874875,0.495,385,447,0.8612975391498882
Kelvin Cato,catoke01,C,28,HOU,2003,73,1247.0,332,20,132,296,428,38,85,56,176,133,256,0.51953125,0,4,0.0,133,252,0.5277777777777778,0.52,66,124,0.532258064516129
Tyson Chandler,chandty01,C,20,CHI,2003,75,1827.0,691,76,169,345,514,37,106,135,220,257,484,0.53099173553719,0,0,0.0,257,484,0.53099173553719,0.531,177,291,0.6082474226804123
Calbert Cheaney,cheanca01,SG,31,UTA,2003,81,2351.0,700,163,73,211,284,65,13,108,225,325,651,0.499231950844854,10,25,0.4,315,626,0.5031948881789138,0.507,40,69,0.5797101449275363
Chris Childs,childch01,PG,35,NJN,2003,12,106.0,15,16,3,2,5,8,1,6,17,6,20,0.3,1,6,0.1666666666666666,5,14,0.3571428571428571,0.325,2,3,0.6666666666666666
Doug Christie,chrisdo01,SG,32,SAC,2003,80,2710.0,748,376,61,281,342,180,37,144,186,267,557,0.4793536804308797,73,185,0.3945945945945946,194,372,0.521505376344086,0.545,141,174,0.8103448275862069
Keon Clark,clarkke01,C,27,SAC,2003,80,1780.0,536,80,138,313,451,38,150,94,227,226,451,0.5011086474501109,0,4,0.0,226,447,0.5055928411633109,0.501,84,128,0.65625
Speedy Claxton,claxtsp01,PG,24,SAS,2003,30,471.0,173,75,22,34,56,22,7,35,43,67,145,0.4620689655172413,0,11,0.0,67,134,0.5,0.462,39,57,0.6842105263157895
Mateen Cleaves,cleavma01,PG,25,SAC,2003,12,55.0,16,10,1,7,8,2,0,14,6,6,23,0.2608695652173913,1,1,1.0,5,22,0.2272727272727272,0.283,3,4,0.75
Derrick Coleman,colemde01,C,35,PHI,2003,64,1742.0,602,87,151,299,450,53,69,96,171,223,498,0.4477911646586345,22,67,0.3283582089552239,201,431,0.4663573085846867,0.47,134,171,0.783625730994152
Bimbo Coles,colesbi01,PG,34,TOT,2003,35,691.0,154,72,11,48,59,17,4,28,60,56,168,0.3333333333333333,7,32,0.21875,49,136,0.3602941176470588,0.354,35,42,0.8333333333333334
Jason Collier,collija02,C,25,HOU,2003,13,104.0,36,1,12,17,29,2,1,2,10,17,36,0.4722222222222222,0,0,0.0,17,36,0.4722222222222222,0.472,2,2,1.0
Jarron Collins,collija03,C,24,UTA,2003,22,421.0,120,14,32,28,60,5,6,19,70,38,86,0.4418604651162791,0,1,0.0,38,85,0.4470588235294118,0.442,44,62,0.7096774193548387
Jason Collins,collija04,C,24,NJN,2003,81,1900.0,460,87,136,232,368,47,44,85,252,140,338,0.4142011834319526,0,4,0.0,140,334,0.4191616766467065,0.414,180,236,0.7627118644067796
Chris Crawford,crawfch01,PF,27,ATL,2003,5,38.0,24,1,3,4,7,2,3,2,7,8,13,0.6153846153846154,1,3,0.3333333333333333,7,10,0.7,0.654,7,8,0.875
Jamal Crawford,crawfja01,PG,22,CHI,2003,80,1992.0,858,334,21,164,185,77,25,134,126,334,808,0.4133663366336633,86,242,0.3553719008264462,248,566,0.4381625441696113,0.467,104,129,0.8062015503875969
Austin Croshere,croshau01,PF,27,IND,2003,49,633.0,252,56,40,115,155,6,13,28,48,86,209,0.4114832535885167,27,69,0.391304347826087,59,140,0.4214285714285714,0.476,53,65,0.8153846153846154
John Crotty,crottjo01,PG,33,DEN,2003,12,180.0,41,29,1,14,15,3,0,9,16,14,41,0.3414634146341463,4,13,0.3076923076923077,10,28,0.3571428571428571,0.39,9,15,0.6
Eddy Curry,curryed01,C,20,CHI,2003,81,1571.0,849,37,116,237,353,18,62,137,226,335,573,0.5846422338568935,0,0,0.0,335,573,0.5846422338568935,0.585,179,287,0.6236933797909407
Michael Curry,currymi01,SF,34,DET,2003,78,1555.0,236,104,16,111,127,44,4,43,163,92,229,0.4017467248908297,16,54,0.2962962962962963,76,175,0.4342857142857143,0.437,36,45,0.8
Erick Dampier,dampier01,C,27,GSW,2003,82,1978.0,673,58,248,295,543,27,154,112,242,259,522,0.4961685823754789,0,2,0.0,259,520,0.4980769230769231,0.496,155,222,0.6981981981981982
Antonio Daniels,daniean01,SG,27,POR,2003,67,872.0,251,85,11,61,72,33,9,32,43,84,186,0.4516129032258064,18,59,0.3050847457627119,66,127,0.5196850393700787,0.5,65,76,0.8552631578947368
Antonio Davis,davisan01,C,34,TOR,2003,53,1894.0,738,131,130,307,437,23,62,118,150,261,641,0.407176287051482,0,0,0.0,261,641,0.407176287051482,0.407,216,280,0.7714285714285715
Baron Davis,davisba01,PG,23,NOH,2003,50,1889.0,856,320,56,130,186,91,22,140,148,332,798,0.4160401002506265,99,283,0.3498233215547703,233,515,0.4524271844660194,0.478,93,131,0.7099236641221374
Dale Davis,davisda01,C,33,POR,2003,78,2282.0,579,94,233,331,564,51,70,71,189,237,438,0.541095890410959,0,0,0.0,237,438,0.541095890410959,0.541,105,166,0.6325301204819277
Emanual Davis,davisem01,SG,34,ATL,2003,24,340.0,88,36,5,38,43,12,2,25,28,32,88,0.3636363636363636,7,29,0.2413793103448276,25,59,0.423728813559322,0.403,17,22,0.7727272727272727
Hubert Davis,davishu01,SG,32,DET,2003,43,328.0,79,29,6,30,36,5,0,11,23,31,79,0.3924050632911392,12,36,0.3333333333333333,19,43,0.4418604651162791,0.468,5,6,0.8333333333333334
Ricky Davis,davisri01,SG,23,CLE,2003,79,3131.0,1626,436,97,293,390,125,36,277,180,602,1470,0.4095238095238095,74,204,0.3627450980392157,528,1266,0.4170616113744075,0.435,348,465,0.7483870967741936
Andrew DeClercq,declean01,C,29,ORL,2003,77,1327.0,365,52,142,197,339,39,36,84,258,149,279,0.5340501792114696,0,0,0.0,149,279,0.5340501792114696,0.534,67,104,0.6442307692307693
Tony Delk,delkto01,PG,29,BOS,2003,67,1873.0,654,146,41,191,232,72,10,69,124,233,560,0.4160714285714286,120,304,0.3947368421052631,113,256,0.44140625,0.523,68,87,0.7816091954022989
Dan Dickau,dickada01,PG,24,ATL,2003,50,515.0,183,85,9,34,43,14,2,53,66,70,170,0.4117647058823529,22,61,0.360655737704918,48,109,0.4403669724770642,0.476,21,26,0.8076923076923077
Michael Dickerson,dickemi01,SG,27,MEM,2003,6,87.0,29,8,1,5,6,5,1,6,16,10,24,0.4166666666666667,4,11,0.3636363636363636,6,13,0.4615384615384615,0.5,5,5,1.0
DeSagana Diop,diopde01,PF,21,CLE,2003,80,943.0,119,43,63,152,215,33,81,56,148,54,154,0.3506493506493506,0,0,0.0,54,154,0.3506493506493506,0.351,11,30,0.3666666666666666
Vlade Divac,divacvl01,C,34,SAC,2003,80,2384.0,795,274,157,417,574,83,105,152,239,305,655,0.465648854961832,6,25,0.24,299,630,0.4746031746031746,0.47,179,251,0.7131474103585658
Juan Dixon,dixonju01,PG,24,WAS,2003,42,647.0,270,40,13,59,72,26,3,42,54,104,271,0.3837638376383764,25,84,0.2976190476190476,79,187,0.4224598930481283,0.43,37,46,0.8043478260869565
Michael Doleac,doleami01,C,25,NYK,2003,75,1041.0,328,42,65,154,219,16,16,49,150,146,343,0.4256559766763848,0,0,0.0,146,343,0.4256559766763848,0.426,36,46,0.782608695652174
Keyon Dooling,doolike01,SG,22,LAC,2003,55,969.0,350,89,9,63,72,24,6,60,93,128,329,0.3890577507598784,50,139,0.3597122302158273,78,190,0.4105263157894737,0.465,44,57,0.7719298245614035
Bryce Drew,drewbr01,PG,28,NOH,2003,13,79.0,19,11,4,9,13,2,0,3,2,8,27,0.2962962962962963,3,7,0.4285714285714285,5,20,0.25,0.352,0,0,0.0
Predrag Drobnjak,drobnpr01,C,27,SEA,2003,82,1984.0,771,86,111,209,320,48,38,65,180,325,789,0.41191381495564,30,85,0.3529411764705882,295,704,0.4190340909090909,0.431,91,115,0.7913043478260869
Chris Dudley,dudlech02,C,37,POR,2003,3,11.0,0,0,2,0,2,0,0,0,3,0,1,0.0,0,0,0.0,0,1,0.0,0.0,0,0,0.0
Tim Duncan,duncati01,PF,26,SAS,2003,81,3181.0,1884,316,259,784,1043,55,237,248,231,714,1392,0.5129310344827587,6,22,0.2727272727272727,708,1370,0.5167883211678832,0.515,450,634,0.7097791798107256
Mike Dunleavy,dunlemi02,SF,22,GSW,2003,82,1305.0,466,106,66,148,214,53,19,86,120,168,417,0.4028776978417266,52,150,0.3466666666666667,116,267,0.4344569288389513,0.465,78,100,0.78
Howard Eisley,eisleho01,PG,30,NYK,2003,82,2243.0,744,444,24,162,186,71,9,149,222,262,628,0.4171974522292994,131,337,0.3887240356083086,131,291,0.4501718213058419,0.521,89,105,0.8476190476190476
LaPhonso Ellis,ellisla01,PF,32,MIA,2003,55,784.0,277,15,44,113,157,15,15,31,88,100,262,0.3816793893129771,27,107,0.2523364485981308,73,155,0.4709677419354838,0.433,50,66,0.7575757575757576
Melvin Ely,elyme01,C,24,LAC,2003,52,802.0,236,15,64,110,174,10,32,50,95,92,186,0.4946236559139785,0,0,0.0,92,186,0.4946236559139785,0.495,52,74,0.7027027027027027
Evan Eschmeyer,eschmev01,C,27,DAL,2003,17,135.0,17,6,10,19,29,10,7,6,35,7,19,0.3684210526315789,0,0,0.0,7,19,0.3684210526315789,0.368,3,4,0.75
Reggie Evans,evansre01,PF,22,SEA,2003,67,1365.0,212,34,167,278,445,38,11,52,173,66,140,0.4714285714285714,0,0,0.0,66,140,0.4714285714285714,0.471,80,154,0.5194805194805194
Danny Ferry,ferryda01,SF,36,SAS,2003,64,601.0,119,21,20,55,75,7,9,27,55,44,124,0.3548387096774194,21,60,0.35,23,64,0.359375,0.44,10,13,0.7692307692307693
Michael Finley,finlemi01,SF,29,DAL,2003,69,2642.0,1331,205,107,295,402,76,21,114,105,507,1193,0.4249790444258172,119,322,0.3695652173913043,388,871,0.4454649827784156,0.475,198,230,0.8608695652173913
Derek Fisher,fishede01,PG,28,LAL,2003,82,2829.0,863,298,40,199,239,93,15,94,195,339,775,0.4374193548387097,85,212,0.4009433962264151,254,563,0.4511545293072824,0.492,100,125,0.8
Marcus Fizer,fizerma01,PF,24,CHI,2003,38,809.0,445,48,80,136,216,14,17,57,89,178,383,0.464751958224543,1,6,0.1666666666666666,177,377,0.4694960212201591,0.466,88,134,0.6567164179104478
Alton Ford,fordal02,PF,21,PHO,2003,11,31.0,7,1,0,6,6,0,0,2,7,3,9,0.3333333333333333,0,0,0.0,3,9,0.3333333333333333,0.333,1,3,0.3333333333333333
Joseph Forte,fortejo01,SG,21,SEA,2003,17,86.0,24,11,4,7,11,4,0,10,6,10,35,0.2857142857142857,0,3,0.0,10,32,0.3125,0.286,4,6,0.6666666666666666
Danny Fortson,fortsda01,PF,26,GSW,2003,17,223.0,59,12,28,45,73,9,0,15,43,20,54,0.3703703703703703,0,1,0.0,20,53,0.3773584905660377,0.37,19,29,0.6551724137931034
Greg Foster,fostegr01,C,34,TOR,2003,29,539.0,121,13,30,72,102,1,9,30,82,47,122,0.3852459016393442,1,4,0.25,46,118,0.3898305084745763,0.389,26,32,0.8125
Jeff Foster,fosteje01,C,26,IND,2003,77,802.0,162,51,118,161,279,28,21,34,103,64,178,0.3595505617977528,0,2,0.0,64,176,0.3636363636363636,0.36,34,63,0.5396825396825397
Tremaine Fowlkes,fowlktr01,SF,26,LAC,2003,37,573.0,164,23,41,62,103,25,2,20,63,56,128,0.4375,2,9,0.2222222222222222,54,119,0.453781512605042,0.445,50,59,0.847457627118644
Rick Fox,foxri01,SF,33,LAL,2003,76,2181.0,681,253,64,259,323,69,14,121,215,262,621,0.4219001610305958,105,280,0.375,157,341,0.4604105571847507,0.506,52,69,0.7536231884057971
Adonal Foyle,foylead01,C,27,GSW,2003,82,1787.0,440,37,176,314,490,40,205,73,214,185,345,0.5362318840579711,0,1,0.0,185,344,0.5377906976744186,0.536,70,104,0.6730769230769231
Steve Francis,francst01,PG,25,HOU,2003,81,3318.0,1703,502,159,340,499,141,41,299,251,571,1312,0.4352134146341463,85,240,0.3541666666666667,486,1072,0.4533582089552239,0.468,476,595,0.8
Lawrence Funderburke,fundela01,PF,32,SAC,2003,27,229.0,74,8,17,38,55,1,11,6,25,32,72,0.4444444444444444,0,0,0.0,32,72,0.4444444444444444,0.444,10,17,0.5882352941176471
Dan Gadzuric,gadzuda01,C,24,MIL,2003,49,760.0,169,9,66,131,197,22,52,27,125,70,145,0.4827586206896552,0,1,0.0,70,144,0.4861111111111111,0.483,29,56,0.5178571428571429
Kevin Garnett,garneke01,PF,26,MIN,2003,82,3321.0,1883,495,244,858,1102,113,129,229,199,743,1481,0.5016880486158002,20,71,0.2816901408450704,723,1410,0.5127659574468085,0.508,377,502,0.750996015936255
Pat Garrity,garripa01,PF,26,ORL,2003,81,2584.0,868,121,72,234,306,62,20,77,255,312,744,0.4193548387096774,161,407,0.3955773955773956,151,337,0.4480712166172106,0.528,83,100,0.83
Pau Gasol,gasolpa01,PF,22,MEM,2003,82,2948.0,1555,229,192,528,720,34,148,213,220,569,1116,0.5098566308243727,1,10,0.1,568,1106,0.5135623869801085,0.51,416,565,0.736283185840708
Devean George,georgde01,SF,25,LAL,2003,71,1613.0,492,92,91,195,286,56,38,65,180,180,461,0.3904555314533622,49,132,0.3712121212121212,131,329,0.3981762917933131,0.444,83,105,0.7904761904761904
Kendall Gill,gillke01,SG,34,MIN,2003,82,2068.0,714,156,51,197,248,78,15,108,176,286,677,0.4224519940915805,19,59,0.3220338983050847,267,618,0.4320388349514563,0.436,123,161,0.7639751552795031
Manu Ginóbili,ginobma01,SG,25,SAS,2003,69,1431.0,525,138,47,114,161,96,17,100,170,174,397,0.4382871536523929,51,148,0.3445945945945945,123,249,0.4939759036144578,0.503,126,171,0.7368421052631579
Gordan Giriček,giricgo01,SG-SF,25,TOT,2003,76,2148.0,935,137,36,202,238,52,8,145,159,350,803,0.435865504358655,85,249,0.3413654618473896,265,554,0.4783393501805054,0.489,150,183,0.819672131147541
Dion Glover,glovedi01,SG,24,ATL,2003,76,1890.0,737,141,62,220,282,71,15,108,146,277,648,0.4274691358024691,56,158,0.3544303797468354,221,490,0.4510204081632653,0.471,127,162,0.7839506172839507
Anthony Goldwire,goldwan01,PG,31,TOT,2003,15,85.0,25,4,0,6,6,3,0,6,6,9,25,0.36,3,9,0.3333333333333333,6,16,0.375,0.42,4,7,0.5714285714285714
Drew Gooden,goodedr01,SF-PF,21,TOT,2003,70,1873.0,875,83,163,292,455,53,35,150,172,355,777,0.4568854568854569,14,48,0.2916666666666667,341,729,0.4677640603566529,0.466,151,212,0.7122641509433962
Brian Grant,grantbr01,C,30,MIA,2003,82,2641.0,846,104,241,596,837,63,47,129,300,344,676,0.5088757396449705,0,0,0.0,344,676,0.5088757396449705,0.509,158,205,0.7707317073170732
Horace Grant,grantho01,PF,37,ORL,2003,5,85.0,26,7,2,6,8,3,0,1,5,13,25,0.52,0,0,0.0,13,25,0.52,0.52,0,0,0.0
Adrian Griffin,griffad01,SG,28,DAL,2003,74,1373.0,325,105,88,176,264,77,6,47,157,146,337,0.4332344213649852,6,24,0.25,140,313,0.4472843450479233,0.442,27,32,0.84375
Eddie Griffin,griffed01,PF,20,HOU,2003,77,1890.0,664,86,138,323,461,52,111,76,136,271,678,0.3997050147492625,64,192,0.3333333333333333,207,486,0.4259259259259259,0.447,58,94,0.6170212765957447
Tom Gugliotta,guglito01,PF,33,PHO,2003,27,447.0,129,31,25,75,100,14,5,31,35,60,132,0.4545454545454545,0,1,0.0,60,131,0.4580152671755725,0.455,9,9,1.0
A.J. Guyton,guytoaj01,PG,24,GSW,2003,2,9.0,0,2,0,0,0,1,0,1,0,0,4,0.0,0,1,0.0,0,3,0.0,0.0,0,0,0.0
Marcus Haislip,haislma01,PF,22,MIL,2003,39,441.0,161,9,21,32,53,7,18,21,55,66,153,0.4313725490196078,3,12,0.25,63,141,0.4468085106382978,0.441,26,38,0.6842105263157895
Darvin Ham,hamda01,SG,29,ATL,2003,75,926.0,180,38,73,80,153,16,19,65,127,71,159,0.4465408805031446,0,3,0.0,71,156,0.4551282051282051,0.447,38,79,0.4810126582278481
Richard Hamilton,hamilri01,SG,24,DET,2003,82,2640.0,1612,208,88,230,318,64,13,200,249,570,1286,0.4432348367029549,32,119,0.2689075630252101,538,1167,0.4610111396743787,0.456,440,528,0.8333333333333334
Zendon Hamilton,hamilze01,C,27,TOR,2003,3,12.0,6,0,1,3,4,1,0,1,2,2,5,0.4,0,0,0.0,2,5,0.4,0.4,2,2,1.0
Anfernee Hardaway,hardaan01,SG,31,PHO,2003,58,1777.0,615,235,66,192,258,66,26,145,150,256,573,0.4467713787085515,26,73,0.3561643835616438,230,500,0.46,0.469,77,97,0.7938144329896907
Tim Hardaway,hardati01,PG,36,IND,2003,10,127.0,49,24,1,14,15,9,0,11,8,18,49,0.3673469387755102,11,31,0.3548387096774194,7,18,0.3888888888888889,0.48,2,4,0.5
Matt Harpring,harprma01,SF,26,UTA,2003,78,2557.0,1370,133,190,324,514,73,17,160,217,521,1020,0.5107843137254902,66,160,0.4125,455,860,0.5290697674418605,0.543,262,331,0.7915407854984894
Adam Harrington,harriad01,SG,22,TOT,2003,19,111.0,30,12,1,7,8,2,1,2,8,11,37,0.2972972972972973,5,14,0.3571428571428571,6,23,0.2608695652173913,0.365,3,4,0.75
Al Harrington,harrial01,SF,22,IND,2003,82,2467.0,1002,125,159,352,511,71,33,163,280,389,896,0.4341517857142857,13,46,0.2826086956521739,376,850,0.4423529411764706,0.441,211,274,0.7700729927007299
Junior Harrington,harriju01,PG,22,DEN,2003,82,2003.0,418,277,44,206,250,80,15,157,250,169,467,0.3618843683083512,7,28,0.25,162,439,0.3690205011389522,0.369,73,112,0.6517857142857143
Othella Harrington,harriot01,PF,29,NYK,2003,74,1850.0,573,62,165,311,476,12,23,90,231,225,443,0.5079006772009029,0,0,0.0,225,443,0.5079006772009029,0.508,123,150,0.82
Lucious Harris,harrilu01,SG,32,NJN,2003,77,1973.0,795,155,63,169,232,53,8,71,95,298,721,0.4133148404993065,47,136,0.3455882352941176,251,585,0.429059829059829,0.446,152,189,0.8042328042328042
Antonio Harvey,harvean01,PF,32,ATL,2003,4,32.0,4,0,1,5,6,1,4,3,7,2,5,0.4,0,0,0.0,2,5,0.4,0.4,0,0,0.0
Donnell Harvey,harvedo01,SF,22,DEN,2003,77,1613.0,611,100,125,284,409,48,27,123,203,246,551,0.4464609800362976,1,7,0.1428571428571428,245,544,0.4503676470588235,0.447,118,176,0.6704545454545454
Trenton Hassell,hassetr01,SG,23,CHI,2003,82,1999.0,342,151,37,218,255,45,61,83,197,144,392,0.3673469387755102,13,40,0.325,131,352,0.3721590909090909,0.384,41,55,0.7454545454545455
Kirk Haston,hastoki01,SF,23,NOH,2003,12,57.0,6,3,0,7,7,0,5,7,10,2,17,0.1176470588235294,0,3,0.0,2,14,0.1428571428571428,0.118,2,4,0.5
Juaquin Hawkins,hawkiju01,SG,29,HOU,2003,58,685.0,134,47,16,62,78,29,6,29,57,57,148,0.3851351351351351,10,24,0.4166666666666667,47,124,0.3790322580645161,0.419,10,20,0.5
Brendan Haywood,haywobr01,C,23,WAS,2003,81,1930.0,501,29,192,212,404,32,119,65,225,173,339,0.5103244837758112,0,0,0.0,173,339,0.5103244837758112,0.51,155,245,0.6326530612244898
Alan Henderson,hendeal01,C,30,ATL,2003,82,1494.0,394,41,156,242,398,33,32,61,168,153,327,0.4678899082568807,0,2,0.0,153,325,0.4707692307692308,0.468,88,138,0.6376811594202898
Nenê,hilarne01,C,20,DEN,2003,80,2258.0,839,149,208,283,491,127,65,181,295,321,619,0.518578352180937,0,3,0.0,321,616,0.5211038961038961,0.519,197,341,0.5777126099706745
Grant Hill,hillgr01,SF,30,ORL,2003,29,843.0,421,122,40,166,206,28,13,84,46,151,307,0.4918566775244299,1,4,0.25,150,303,0.495049504950495,0.493,118,144,0.8194444444444444
Tyrone Hill,hillty01,PF,34,TOT,2003,56,1351.0,312,41,126,265,391,46,26,68,172,129,306,0.4215686274509804,0,0,0.0,129,306,0.4215686274509804,0.422,54,80,0.675
Fred Hoiberg,hoibefr01,SG,30,CHI,2003,63,784.0,144,70,11,126,137,40,5,25,59,49,126,0.3888888888888889,5,21,0.238095238095238,44,105,0.419047619047619,0.409,41,50,0.82
Robert Horry,horryro01,PF,32,LAL,2003,80,2343.0,522,233,181,333,514,96,61,112,247,184,476,0.3865546218487395,51,177,0.288135593220339,133,299,0.4448160535117056,0.44,103,134,0.7686567164179104
Eddie House,houseed01,SG,24,MIA,2003,55,1025.0,411,87,17,84,101,44,1,46,73,172,444,0.3873873873873873,36,120,0.3,136,324,0.419753086419753,0.428,31,36,0.8611111111111112
Allan Houston,houstal01,SG,31,NYK,2003,82,3108.0,1845,220,26,205,231,54,7,178,191,652,1465,0.4450511945392491,178,450,0.3955555555555555,474,1015,0.4669950738916256,0.506,363,395,0.918987341772152
Juwan Howard,howarju01,PF,29,DEN,2003,77,2730.0,1418,234,181,404,585,77,27,189,239,567,1261,0.4496431403647898,2,4,0.5,565,1257,0.4494828957836118,0.45,282,351,0.8034188034188035
Troy Hudson,hudsotr01,PG,26,MIN,2003,79,2600.0,1123,452,42,141,183,60,7,182,160,409,956,0.4278242677824267,97,266,0.3646616541353383,312,690,0.4521739130434782,0.479,208,231,0.9004329004329005
Nate Huffman,huffmna01,C,27,TOR,2003,7,76.0,23,5,9,14,23,1,3,3,13,9,25,0.36,0,0,0.0,9,25,0.36,0.36,5,8,0.625
Larry Hughes,hughela01,PG,24,WAS,2003,67,2137.0,857,205,67,241,308,86,24,136,149,346,741,0.4669365721997301,29,79,0.3670886075949367,317,662,0.4788519637462236,0.487,136,186,0.7311827956989247
Ryan Humphrey,humphry01,PF,23,TOT,2003,48,444.0,93,11,34,65,99,9,18,23,75,35,120,0.2916666666666667,0,0,0.0,35,120,0.2916666666666667,0.292,23,39,0.5897435897435898
Lindsey Hunter,hunteli01,PG,32,TOR,2003,29,673.0,280,71,15,44,59,35,5,57,50,106,302,0.3509933774834437,34,107,0.3177570093457944,72,195,0.3692307692307692,0.407,34,47,0.723404255319149
Steven Hunter,huntest01,C,21,ORL,2003,33,447.0,130,6,38,55,93,9,36,15,56,56,103,0.5436893203883495,0,0,0.0,56,103,0.5436893203883495,0.544,18,44,0.4090909090909091
Zydrunas Ilgauskas,ilgauzy01,C,27,CLE,2003,81,2432.0,1390,127,240,371,611,56,152,210,274,495,1122,0.4411764705882353,0,5,0.0,495,1117,0.4431512981199642,0.441,400,512,0.78125
Allen Iverson,iversal01,SG,27,PHI,2003,82,3485.0,2262,454,68,276,344,225,13,286,149,804,1940,0.4144329896907217,84,303,0.2772277227722772,720,1637,0.4398289554062309,0.436,570,736,0.7744565217391305
Bobby Jackson,jacksbo01,PG,29,SAC,2003,59,1676.0,895,182,57,162,219,71,3,106,126,340,732,0.4644808743169399,89,235,0.3787234042553191,251,497,0.5050301810865191,0.525,126,149,0.8456375838926175
Jermaine Jackson,jacksje01,SG,26,TOT,2003,53,559.0,121,74,19,38,57,19,6,34,51,40,110,0.3636363636363636,1,10,0.1,39,100,0.39,0.368,40,55,0.7272727272727273
Jim Jackson,jacksji01,SF,32,SAC,2003,63,1309.0,487,118,84,178,262,31,4,80,132,204,462,0.4415584415584415,32,71,0.4507042253521127,172,391,0.4398976982097187,0.476,47,55,0.8545454545454545
Marc Jackson,jacksma02,C,28,MIN,2003,77,1041.0,421,37,86,139,225,24,30,59,137,153,349,0.4383954154727794,1,1,1.0,152,348,0.4367816091954023,0.44,114,149,0.7651006711409396
Mark Jackson,jacksma01,PG,37,UTA,2003,82,1467.0,382,375,34,142,176,48,3,152,90,147,369,0.3983739837398374,27,95,0.2842105263157894,120,274,0.437956204379562,0.435,61,80,0.7625
Stephen Jackson,jacksst02,SG,24,SAS,2003,80,2254.0,946,183,66,220,286,125,30,176,202,356,818,0.4352078239608802,95,297,0.3198653198653198,261,521,0.5009596928982726,0.493,139,183,0.7595628415300546
Casey Jacobsen,jacobca01,SF,21,PHO,2003,72,1147.0,368,73,29,54,83,35,6,55,90,122,327,0.3730886850152905,52,165,0.3151515151515151,70,162,0.4320987654320987,0.453,72,105,0.6857142857142857
Jerome James,jamesje01,C,27,SEA,2003,51,766.0,276,27,78,138,216,12,82,75,166,111,232,0.4784482758620689,0,0,0.0,111,232,0.4784482758620689,0.478,54,92,0.5869565217391305
Mike James,jamesmi01,PG,27,MIA,2003,78,1722.0,607,246,26,123,149,64,5,108,176,218,585,0.3726495726495726,67,228,0.293859649122807,151,357,0.42296918767507,0.43,104,142,0.7323943661971831
Antawn Jamison,jamisan01,SF,26,GSW,2003,82,3226.0,1822,156,195,383,578,76,45,177,197,691,1471,0.4697484704282801,65,209,0.3110047846889952,626,1262,0.4960380348652932,0.492,375,475,0.7894736842105263
Marko Jarić,jaricma01,SF,24,LAC,2003,66,1379.0,490,193,35,125,160,97,11,103,125,179,446,0.4013452914798206,53,166,0.3192771084337349,126,280,0.45,0.461,79,105,0.7523809523809524
Chris Jefferies,jeffech01,SF,22,TOR,2003,51,666.0,197,22,16,43,59,19,16,45,56,75,194,0.3865979381443299,18,54,0.3333333333333333,57,140,0.4071428571428571,0.433,29,43,0.6744186046511628
Richard Jefferson,jefferi01,SF,22,NJN,2003,80,2879.0,1242,201,150,364,514,80,44,156,216,456,911,0.5005488474204172,6,24,0.25,450,887,0.5073280721533259,0.504,324,436,0.7431192660550459
Jared Jeffries,jeffrja01,SF,21,WAS,2003,20,292.0,79,16,26,32,58,8,5,21,28,30,63,0.4761904761904761,3,6,0.5,27,57,0.4736842105263157,0.5,16,29,0.5517241379310345
Anthony Johnson,johnsan02,PG,28,NJN,2003,66,842.0,270,86,13,65,78,37,5,41,93,103,231,0.4458874458874459,13,35,0.3714285714285714,90,196,0.4591836734693877,0.474,51,74,0.6891891891891891
Avery Johnson,johnsav01,PG,37,DAL,2003,48,430.0,156,64,10,21,31,15,1,29,26,63,150,0.42,0,2,0.0,63,148,0.4256756756756756,0.42,30,39,0.7692307692307693
Ervin Johnson,johnser02,C,35,MIL,2003,69,1170.0,152,24,117,177,294,34,63,34,178,61,135,0.4518518518518518,0,0,0.0,61,135,0.4518518518518518,0.452,30,44,0.6818181818181818
Joe Johnson,johnsjo02,SG,21,PHO,2003,82,2255.0,803,210,57,207,264,62,19,108,143,316,796,0.3969849246231156,75,205,0.3658536585365853,241,591,0.4077834179357022,0.444,96,124,0.7741935483870968
Ken Johnson,johnske03,C,24,MIA,2003,16,156.0,32,0,4,28,32,1,12,6,20,15,37,0.4054054054054054,0,0,0.0,15,37,0.4054054054054054,0.405,2,6,0.3333333333333333
Damon Jones,jonesda01,PG,26,SAC,2003,49,709.0,224,80,11,59,70,18,4,23,42,80,210,0.3809523809523809,44,121,0.3636363636363636,36,89,0.4044943820224719,0.486,20,27,0.7407407407407407
Eddie Jones,jonesed02,SG,31,MIA,2003,47,1789.0,869,173,35,191,226,64,31,85,137,291,688,0.4229651162790697,98,241,0.4066390041493776,193,447,0.4317673378076063,0.494,189,230,0.8217391304347826
Fred Jones,jonesfr01,SG,23,IND,2003,19,115.0,23,5,4,5,9,6,1,6,13,9,24,0.375,2,7,0.2857142857142857,7,17,0.4117647058823529,0.417,3,4,0.75
Jumaine Jones,jonesju01,SF,23,CLE,2003,80,2204.0,784,112,106,299,405,67,22,107,176,308,710,0.4338028169014084,111,314,0.3535031847133758,197,396,0.4974747474747474,0.512,57,83,0.6867469879518072
Popeye Jones,jonespo01,PF,32,DAL,2003,26,222.0,53,8,29,30,59,5,1,15,31,24,62,0.3870967741935484,0,0,0.0,24,62,0.3870967741935484,0.387,5,11,0.4545454545454545
Michael Jordan,jordami01,SF,39,WAS,2003,82,3031.0,1640,311,71,426,497,123,39,173,171,679,1527,0.4446627373935822,16,55,0.2909090909090909,663,1472,0.4504076086956521,0.45,266,324,0.8209876543209876
Shawn Kemp,kempsh01,C,33,ORL,2003,79,1633.0,537,55,147,304,451,66,33,102,239,211,505,0.4178217821782178,0,1,0.0,211,504,0.4186507936507936,0.418,115,155,0.7419354838709677
Steve Kerr,kerrst01,PG,37,SAS,2003,75,952.0,299,70,12,48,60,27,3,35,49,110,256,0.4296875,49,124,0.3951612903225806,61,132,0.4621212121212121,0.525,30,34,0.8823529411764706
Jason Kidd,kiddja01,PG,29,NJN,2003,80,2989.0,1495,711,110,394,504,179,25,296,127,515,1244,0.4139871382636656,126,370,0.3405405405405405,389,874,0.4450800915331808,0.465,339,403,0.8411910669975186
Andrei Kirilenko,kirilan01,SF,21,UTA,2003,80,2213.0,963,138,147,273,420,118,175,136,185,315,642,0.4906542056074766,37,114,0.3245614035087719,278,528,0.5265151515151515,0.519,296,370,0.8
Kerry Kittles,kittlke01,SG,28,NJN,2003,65,1951.0,848,170,52,200,252,101,30,55,110,332,711,0.4669479606188467,78,219,0.3561643835616438,254,492,0.516260162601626,0.522,106,135,0.7851851851851852
Brevin Knight,knighbr01,PG,27,MEM,2003,55,928.0,216,233,15,66,81,69,2,94,123,97,228,0.425438596491228,2,8,0.25,95,220,0.4318181818181818,0.43,20,37,0.5405405405405406
Travis Knight,knightr01,C,28,NYK,2003,32,287.0,60,14,18,44,62,8,9,10,44,25,65,0.3846153846153846,0,1,0.0,25,64,0.390625,0.385,10,13,0.7692307692307693
Toni Kukoč,kukocto01,PF,34,MIL,2003,63,1704.0,730,230,67,199,266,81,29,122,134,249,577,0.4315424610051993,95,263,0.3612167300380228,154,314,0.4904458598726114,0.514,137,194,0.7061855670103093
Christian Laettner,laettch01,PF,33,WAS,2003,76,2215.0,632,235,114,388,502,82,40,87,206,255,516,0.4941860465116279,2,16,0.125,253,500,0.506,0.496,120,144,0.8333333333333334
Raef LaFrentz,lafrera01,C,26,DAL,2003,69,1611.0,639,54,125,205,330,35,91,46,264,266,514,0.5175097276264592,47,116,0.4051724137931034,219,398,0.550251256281407,0.563,60,88,0.6818181818181818
Sean Lampley,lamplse01,SF,23,MIA,2003,35,487.0,169,31,26,57,83,7,3,25,43,56,129,0.4341085271317829,0,4,0.0,56,125,0.448,0.434,57,82,0.6951219512195121
Dan Langhi,langhda01,SF,25,PHO,2003,60,541.0,183,21,19,68,87,15,6,16,58,81,202,0.400990099009901,9,31,0.2903225806451613,72,171,0.4210526315789473,0.423,12,20,0.6
Voshon Lenard,lenarvo01,SG,29,TOR,2003,63,1929.0,898,144,48,164,212,59,21,103,156,325,809,0.4017305315203955,92,252,0.365079365079365,233,557,0.4183123877917414,0.459,156,194,0.8041237113402062
Rashard Lewis,lewisra02,SF,23,SEA,2003,77,3044.0,1396,133,152,351,503,99,35,143,205,519,1149,0.4516971279373368,75,217,0.3456221198156682,444,932,0.4763948497854077,0.484,283,345,0.8202898550724638
Randy Livingston,livinra01,PG,27,NOH,2003,2,12.0,6,1,0,0,0,0,0,0,0,2,4,0.5,0,0,0.0,2,4,0.5,0.5,2,2,1.0
Art Long,longar01,PF,30,TOT,2003,26,211.0,60,6,21,39,60,5,11,20,35,28,75,0.3733333333333333,2,3,0.6666666666666666,26,72,0.3611111111111111,0.387,2,10,0.2
Grant Long,longgr01,PF,36,BOS,2003,41,488.0,72,25,24,59,83,9,1,19,62,27,70,0.3857142857142857,0,3,0.0,27,67,0.4029850746268656,0.386,18,23,0.782608695652174
Tyronn Lue,luety01,PG,25,WAS,2003,75,1986.0,647,263,22,127,149,47,1,77,151,248,573,0.4328097731239092,60,176,0.3409090909090909,188,397,0.473551637279597,0.485,91,104,0.875
George Lynch,lynchge01,SG,32,NOH,2003,81,1497.0,363,104,139,214,353,66,19,52,136,147,359,0.4094707520891364,28,79,0.3544303797468354,119,280,0.425,0.448,41,74,0.5540540540540541
Todd MacCulloch,maccuto01,C,27,PHI,2003,42,812.0,299,20,66,130,196,19,32,35,107,123,238,0.5168067226890757,0,0,0.0,123,238,0.5168067226890757,0.517,53,79,0.6708860759493671
Tito Maddox,maddoti01,SG,21,HOU,2003,9,35.0,11,5,1,6,7,3,1,3,4,3,12,0.25,0,3,0.0,3,9,0.3333333333333333,0.25,5,8,0.625
Mark Madsen,madsema01,PF,27,LAL,2003,54,781.0,174,38,86,73,159,15,19,27,116,69,163,0.4233128834355828,0,0,0.0,69,163,0.4233128834355828,0.423,36,61,0.5901639344262295
Corey Maggette,maggeco01,SG,23,LAC,2003,64,2006.0,1073,123,77,245,322,55,16,147,194,343,773,0.44372574385511,62,177,0.3502824858757062,281,596,0.4714765100671141,0.484,325,405,0.8024691358024691
Jamaal Magloire,magloja01,C,24,NOH,2003,82,2443.0,841,88,260,464,724,49,111,158,276,305,635,0.4803149606299212,0,3,0.0,305,632,0.4825949367088608,0.48,231,322,0.717391304347826
Karl Malone,malonka01,PF,39,UTA,2003,81,2936.0,1667,379,113,515,628,136,31,210,204,595,1289,0.4615981380915438,3,14,0.2142857142857142,592,1275,0.464313725490196,0.463,474,621,0.7632850241545893
Matt Maloney,malonma01,PG,31,ATL,2003,14,103.0,24,17,1,6,7,4,0,5,9,8,25,0.32,5,15,0.3333333333333333,3,10,0.3,0.42,3,5,0.6
Danny Manning,mannida01,PF,36,DET,2003,13,89.0,34,7,7,11,18,9,3,7,11,13,32,0.40625,3,8,0.375,10,24,0.4166666666666667,0.453,5,6,0.8333333333333334
Stephon Marbury,marbust01,PG,25,PHO,2003,81,3240.0,1806,654,53,210,263,108,20,263,200,671,1530,0.4385620915032679,89,296,0.3006756756756756,582,1234,0.4716369529983792,0.468,375,467,0.8029978586723768
Shawn Marion,mariosh01,SF,24,PHO,2003,81,3373.0,1716,198,199,574,773,185,95,157,208,662,1466,0.451568894952251,141,364,0.3873626373626374,521,1102,0.4727767695099819,0.5,251,295,0.8508474576271187
Sean Marks,marksse01,PF,27,MIA,2003,23,223.0,54,3,8,27,35,5,6,14,37,22,59,0.3728813559322034,0,1,0.0,22,58,0.3793103448275862,0.373,10,15,0.6666666666666666
Donny Marshall,marshdo02,SF,30,NJN,2003,3,6.0,0,0,0,3,3,0,0,1,0,0,3,0.0,0,1,0.0,0,2,0.0,0.0,0,0,0.0
Donyell Marshall,marshdo01,PF,29,CHI,2003,78,2378.0,1042,137,234,465,699,95,85,135,234,421,918,0.4586056644880174,33,87,0.3793103448275862,388,831,0.4669073405535499,0.477,167,221,0.755656108597285
Kenyon Martin,martike01,PF,25,NJN,2003,77,2628.0,1283,185,164,476,640,98,70,192,294,509,1082,0.4704251386321627,9,43,0.2093023255813953,500,1039,0.4812319538017324,0.475,256,392,0.6530612244897959
Jamal Mashburn,mashbja01,SF,30,NOH,2003,82,3321.0,1772,462,66,432,498,83,17,230,196,670,1586,0.4224464060529634,119,306,0.3888888888888889,551,1280,0.43046875,0.46,313,369,0.8482384823848238
Anthony Mason,masonan01,C,36,MIL,2003,65,2119.0,466,209,90,326,416,32,12,79,147,191,393,0.4860050890585242,0,1,0.0,191,392,0.4872448979591837,0.486,84,117,0.717948717948718
Desmond Mason,masonde01,SF,25,TOT,2003,80,2763.0,1147,163,154,369,523,67,32,115,210,457,1017,0.4493608652900688,21,72,0.2916666666666667,436,945,0.4613756613756614,0.46,212,283,0.7491166077738516
Roger Mason,masonro01,SF,22,CHI,2003,17,113.0,30,12,2,10,12,4,0,5,20,11,31,0.3548387096774194,6,18,0.3333333333333333,5,13,0.3846153846153846,0.452,2,2,1.0
Tony Massenburg,masseto01,C,35,UTA,2003,58,792.0,273,17,59,97,156,17,19,50,144,104,232,0.4482758620689655,0,0,0.0,104,232,0.4482758620689655,0.448,65,84,0.7738095238095238
Walter McCarty,mccarwa01,SF,28,BOS,2003,82,1949.0,498,106,64,224,288,78,28,67,188,173,418,0.4138755980861244,91,248,0.3669354838709677,82,170,0.4823529411764706,0.523,61,98,0.6224489795918368
Amal McCaskill,mccasam01,C,29,ATL,2003,11,70.0,11,5,7,15,22,3,1,2,13,4,17,0.2352941176470588,0,0,0.0,4,17,0.2352941176470588,0.235,3,4,0.75
Jelani McCoy,mccoyje01,C,25,TOR,2003,67,1367.0,457,43,95,260,355,28,60,96,162,194,395,0.4911392405063291,0,0,0.0,194,395,0.4911392405063291,0.491,69,126,0.5476190476190477
Tracy McGrady,mcgratr01,SG,23,ORL,2003,75,2954.0,2407,411,121,367,488,124,59,195,156,829,1813,0.4572531715388858,173,448,0.3861607142857143,656,1365,0.4805860805860806,0.505,576,726,0.7933884297520661
Jeff McInnis,mcinnje01,PG,28,POR,2003,75,1311.0,432,170,22,75,97,21,2,75,117,188,423,0.4444444444444444,6,35,0.1714285714285714,182,388,0.4690721649484536,0.452,50,67,0.746268656716418
Aaron McKie,mckieaa01,SF,30,PHI,2003,80,2374.0,721,278,61,289,350,131,9,109,177,286,666,0.4294294294294294,37,112,0.3303571428571428,249,554,0.4494584837545126,0.457,112,134,0.835820895522388
Stanislav Medvedenko,medvest01,PF,23,LAL,2003,58,620.0,255,18,66,75,141,11,8,37,118,112,258,0.4341085271317829,0,2,0.0,112,256,0.4375,0.434,31,43,0.7209302325581395
Ron Mercer,mercero01,SG,26,IND,2003,72,1671.0,556,112,32,122,154,49,14,54,123,244,597,0.4087102177554438,3,16,0.1875,241,581,0.414802065404475,0.411,65,81,0.8024691358024691
Chris Mihm,mihmch01,C,23,CLE,2003,52,809.0,308,28,93,138,231,18,38,48,124,116,287,0.4041811846689895,0,3,0.0,116,284,0.4084507042253521,0.404,76,105,0.7238095238095238
Darius Miles,milesda01,SF,21,CLE,2003,67,2008.0,618,176,113,250,363,67,69,178,159,263,642,0.4096573208722741,0,14,0.0,263,628,0.4187898089171974,0.41,92,155,0.5935483870967742
Andre Miller,millean02,PG,26,LAC,2003,80,2913.0,1088,537,84,232,316,99,11,206,203,377,928,0.40625,23,108,0.2129629629629629,354,820,0.4317073170731707,0.419,311,391,0.7953964194373402
Brad Miller,millebr01,C,26,IND,2003,73,2270.0,955,193,185,418,603,65,43,118,203,329,667,0.4932533733133433,5,16,0.3125,324,651,0.4976958525345622,0.497,292,357,0.8179271708683473
Mike Miller,millemi01,SF,22,TOT,2003,65,2186.0,1011,170,46,295,341,42,21,125,173,373,859,0.4342258440046566,109,300,0.3633333333333333,264,559,0.4722719141323792,0.498,156,186,0.8387096774193549
Reggie Miller,millere01,SG,37,IND,2003,70,2117.0,882,170,21,151,172,62,4,66,89,281,637,0.4411302982731554,113,318,0.3553459119496855,168,319,0.5266457680250783,0.53,207,230,0.9
Chris Mills,millsch01,PF,33,GSW,2003,21,262.0,101,22,19,31,50,7,3,10,29,39,106,0.3679245283018867,7,25,0.28,32,81,0.3950617283950617,0.401,16,18,0.8888888888888888
Yao Ming,mingya01,C,22,HOU,2003,82,2382.0,1104,137,196,479,675,31,147,173,230,401,805,0.4981366459627329,1,2,0.5,400,803,0.49813200498132,0.499,301,371,0.8113207547169812
Cuttino Mobley,moblecu01,SG,27,HOU,2003,73,3044.0,1280,208,70,233,303,95,36,166,185,463,1067,0.4339268978444236,112,318,0.3522012578616352,351,749,0.4686248331108144,0.486,242,282,0.8581560283687943
Nazr Mohammed,mohamna01,C,25,ATL,2003,35,445.0,160,6,47,82,129,16,21,25,79,67,159,0.4213836477987421,0,0,0.0,67,159,0.4213836477987421,0.421,26,41,0.6341463414634146
Jérôme Moïso,moisoje01,C,24,NOH,2003,51,644.0,205,22,59,119,178,19,44,46,87,89,171,0.52046783625731,0,0,0.0,89,171,0.52046783625731,0.52,27,41,0.6585365853658537
Mikki Moore,mooremi01,C,27,TOT,2003,8,43.0,18,3,6,2,8,0,4,2,7,5,13,0.3846153846153846,0,0,0.0,5,13,0.3846153846153846,0.385,8,10,0.8
Terence Morris,morrite01,SF,24,HOU,2003,49,632.0,182,25,40,88,128,8,17,29,35,82,176,0.4659090909090909,7,32,0.21875,75,144,0.5208333333333334,0.486,11,14,0.7857142857142857
Troy Murphy,murphtr01,PF,22,GSW,2003,79,2510.0,923,106,228,578,806,65,30,111,246,338,749,0.4512683578104139,3,14,0.2142857142857142,335,735,0.4557823129251701,0.453,244,290,0.8413793103448276
Ronald Murray,murraro01,SG,23,TOT,2003,14,62.0,27,5,0,4,4,4,0,8,0,11,31,0.3548387096774194,0,5,0.0,11,26,0.4230769230769231,0.355,5,8,0.625
Tracy Murray,murratr01,SF,31,LAL,2003,31,193.0,61,12,5,18,23,5,3,14,22,23,71,0.323943661971831,8,38,0.2105263157894736,15,33,0.4545454545454545,0.38,7,9,0.7777777777777778
Dikembe Mutombo,mutomdi01,C,36,NJN,2003,24,514.0,138,19,54,99,153,4,37,34,54,49,131,0.3740458015267175,0,0,0.0,49,131,0.3740458015267175,0.374,40,55,0.7272727272727273
Mamadou N'Diaye,ndiayma02,C,27,TOR,2003,22,364.0,120,7,29,53,82,8,32,21,58,43,96,0.4479166666666667,0,0,0.0,43,96,0.4479166666666667,0.448,34,47,0.723404255319149
Boštjan Nachbar,nachbbo01,SF,22,HOU,2003,14,77.0,29,3,3,8,11,2,2,6,13,11,31,0.3548387096774194,2,10,0.2,9,21,0.4285714285714285,0.387,5,10,0.5
Lee Nailon,nailole01,SF,27,NYK,2003,38,405.0,210,26,32,38,70,6,3,32,46,84,190,0.4421052631578947,0,1,0.0,84,189,0.4444444444444444,0.442,42,51,0.8235294117647058
Eduardo Nájera,najered01,SF,26,DAL,2003,48,1103.0,320,47,90,133,223,40,22,23,129,129,231,0.5584415584415584,0,1,0.0,129,230,0.5608695652173913,0.558,62,91,0.6813186813186813
Steve Nash,nashst01,PG,28,DAL,2003,82,2711.0,1455,598,63,171,234,85,6,192,134,518,1114,0.4649910233393178,111,269,0.4126394052044609,407,845,0.4816568047337278,0.515,308,339,0.9085545722713864
Rasho Nesterović,nestera01,C,26,MIN,2003,77,2337.0,861,114,146,358,504,39,116,99,256,400,762,0.5249343832020997,0,2,0.0,400,760,0.5263157894736842,0.525,61,95,0.6421052631578947
Ira Newble,newblir01,SF,28,ATL,2003,73,1931.0,564,99,86,185,271,50,26,69,174,231,467,0.4946466809421841,32,84,0.3809523809523809,199,383,0.5195822454308094,0.529,70,90,0.7777777777777778
Moochie Norris,norrimo01,PG,29,HOU,2003,82,1375.0,357,196,37,122,159,55,4,86,72,134,330,0.406060606060606,11,45,0.2444444444444444,123,285,0.431578947368421,0.423,78,114,0.6842105263157895
Dirk Nowitzki,nowitdi01,PF,24,DAL,2003,80,3117.0,2011,239,81,710,791,111,82,152,206,690,1489,0.4633982538616521,148,390,0.3794871794871794,542,1099,0.4931756141947225,0.513,483,548,0.8813868613138686
Jermaine O'Neal,onealje01,PF,24,IND,2003,77,2864.0,1600,155,202,594,796,66,178,180,277,610,1260,0.4841269841269841,7,21,0.3333333333333333,603,1239,0.486682808716707,0.487,373,510,0.7313725490196078
Shaquille O'Neal,onealsh01,C,30,LAL,2003,67,2535.0,1841,206,259,483,742,38,159,196,229,695,1211,0.573905862923204,0,0,0.0,695,1211,0.573905862923204,0.574,451,725,0.6220689655172413
Charles Oakley,oaklech01,C,39,WAS,2003,42,514.0,74,40,37,70,107,13,6,21,90,23,55,0.4181818181818181,0,0,0.0,23,55,0.4181818181818181,0.418,28,34,0.8235294117647058
Lamar Odom,odomla01,SF,23,LAC,2003,49,1679.0,714,178,59,267,326,42,41,140,181,268,611,0.4386252045826514,42,129,0.3255813953488372,226,482,0.4688796680497925,0.473,136,175,0.7771428571428571
Mehmet Okur,okurme01,PF,23,DET,2003,72,1366.0,494,71,117,218,335,25,39,66,167,180,423,0.425531914893617,38,112,0.3392857142857143,142,311,0.4565916398713826,0.47,96,131,0.732824427480916
Dean Oliver,olivede01,PG,24,GSW,2003,15,93.0,22,23,8,8,16,7,0,10,9,7,29,0.2413793103448276,1,6,0.1666666666666666,6,23,0.2608695652173913,0.259,7,8,0.875
Kevin Ollie,ollieke01,PG,30,TOT,2003,82,1897.0,534,291,25,157,182,69,5,72,122,199,441,0.4512471655328798,2,6,0.3333333333333333,197,435,0.4528735632183908,0.454,134,178,0.7528089887640449
Michael Olowokandi,olowomi01,C,27,LAC,2003,36,1369.0,441,47,57,271,328,18,79,98,110,186,436,0.4266055045871559,0,0,0.0,186,436,0.4266055045871559,0.427,69,105,0.6571428571428571
Greg Ostertag,ostergr01,C,29,UTA,2003,81,1926.0,438,55,180,323,503,20,147,104,235,169,326,0.5184049079754601,0,0,0.0,169,326,0.5184049079754601,0.518,100,196,0.5102040816326531
Bo Outlaw,outlabo01,C,31,PHO,2003,80,1800.0,378,112,134,234,368,50,71,76,194,153,278,0.5503597122302158,0,2,0.0,153,276,0.5543478260869565,0.55,72,116,0.6206896551724138
Chris Owens,owensch01,SF,23,MEM,2003,1,6.0,4,0,1,0,1,0,0,1,0,2,3,0.6666666666666666,0,0,0.0,2,3,0.6666666666666666,0.667,0,0,0.0
Olumide Oyedeji,oyedeol01,C,21,ORL,2003,27,145.0,27,5,10,40,50,5,3,5,30,10,23,0.4347826086956521,0,0,0.0,10,23,0.4347826086956521,0.435,7,11,0.6363636363636364
Robert Pack,packro01,PG,33,NOH,2003,28,440.0,145,81,11,40,51,25,0,40,35,52,129,0.4031007751937984,0,5,0.0,52,124,0.4193548387096774,0.403,41,55,0.7454545454545455
Scott Padgett,padgesc01,PF,26,UTA,2003,82,1321.0,466,86,83,189,272,41,24,70,148,170,423,0.4018912529550827,45,133,0.3383458646616541,125,290,0.4310344827586206,0.455,81,107,0.7570093457943925
Milt Palacio,palacmi01,PG,24,CLE,2003,80,1976.0,397,259,48,187,235,68,16,131,168,162,388,0.4175257731958763,8,37,0.2162162162162162,154,351,0.4387464387464387,0.428,65,87,0.7471264367816092
Jannero Pargo,pargoja01,PG,23,LAL,2003,34,342.0,85,39,9,28,37,13,2,23,45,37,93,0.3978494623655914,7,24,0.2916666666666667,30,69,0.4347826086956521,0.435,4,4,1.0
Smush Parker,parkesm01,PG,21,CLE,2003,66,1103.0,408,162,29,90,119,48,12,133,106,136,338,0.4023668639053254,38,118,0.3220338983050847,98,220,0.4454545454545454,0.459,98,118,0.8305084745762712
Tony Parker,parketo01,PG,20,SAS,2003,82,2774.0,1269,432,33,183,216,71,4,198,174,484,1043,0.4640460210930009,82,243,0.3374485596707819,402,800,0.5025,0.503,219,290,0.7551724137931034
Cherokee Parks,parksch02,PF,30,LAC,2003,30,648.0,188,21,46,86,132,16,20,18,52,82,163,0.5030674846625767,1,2,0.5,81,161,0.5031055900621118,0.506,23,38,0.6052631578947368
Ruben Patterson,patteru01,SF,27,POR,2003,78,1655.0,649,101,120,144,264,73,29,117,161,254,516,0.4922480620155038,3,20,0.15,251,496,0.5060483870967742,0.495,138,220,0.6272727272727273
Gary Payton,paytoga01,PG,34,TOT,2003,80,3208.0,1634,663,79,255,334,133,20,187,181,665,1466,0.4536152796725784,54,182,0.2967032967032967,611,1284,0.4758566978193146,0.472,250,352,0.7102272727272727
Anthony Peeler,peelean01,SG,33,MIN,2003,82,2245.0,630,244,40,201,241,72,13,82,161,252,609,0.4137931034482758,87,212,0.410377358490566,165,397,0.4156171284634761,0.485,39,50,0.78
Wesley Person,persowe01,SG,31,MEM,2003,66,1941.0,727,112,24,168,192,42,19,56,64,274,601,0.4559068219633943,100,231,0.4329004329004329,174,370,0.4702702702702703,0.539,79,97,0.8144329896907216
Morris Peterson,petermo01,SF,25,TOR,2003,82,2949.0,1153,188,97,266,363,88,32,128,232,421,1073,0.3923578751164958,116,344,0.3372093023255814,305,729,0.4183813443072702,0.446,195,247,0.7894736842105263
Eric Piatkowski,piatker01,SG,32,LAC,2003,62,1360.0,601,70,44,112,156,33,9,56,92,210,446,0.4708520179372197,80,201,0.3980099502487562,130,245,0.5306122448979592,0.561,101,122,0.8278688524590164
Paul Pierce,piercpa01,SG,25,BOS,2003,79,3096.0,2048,349,106,472,578,139,62,288,227,663,1592,0.4164572864321608,118,391,0.3017902813299232,545,1201,0.4537885095753539,0.454,604,753,0.8021248339973439
Scottie Pippen,pippesc01,SF,37,POR,2003,64,1911.0,689,285,57,221,278,105,25,164,149,265,597,0.4438860971524288,38,133,0.2857142857142857,227,464,0.4892241379310345,0.476,121,148,0.8175675675675675
Scot Pollard,pollasc01,C,27,SAC,2003,23,325.0,103,6,46,60,106,13,15,15,50,40,87,0.4597701149425287,0,0,0.0,40,87,0.4597701149425287,0.46,23,38,0.6052631578947368
James Posey,poseyja01,SF,26,TOT,2003,83,2518.0,893,184,90,336,426,106,15,144,197,309,752,0.4109042553191489,70,229,0.3056768558951965,239,523,0.4569789674952199,0.457,205,246,0.8333333333333334
Lavor Postell,postela01,SG,24,NYK,2003,12,98.0,43,3,1,3,4,2,0,7,9,14,38,0.3684210526315789,2,7,0.2857142857142857,12,31,0.3870967741935484,0.395,13,15,0.8666666666666667
Vitaly Potapenko,potapvi01,C,27,SEA,2003,26,403.0,104,4,25,64,89,9,8,25,46,41,93,0.4408602150537634,0,0,0.0,41,93,0.4408602150537634,0.441,22,29,0.7586206896551724
Tayshaun Prince,princta01,SF,22,DET,2003,42,435.0,137,24,5,40,45,10,14,21,25,53,118,0.4491525423728814,20,47,0.425531914893617,33,71,0.4647887323943662,0.534,11,17,0.6470588235294118
Joel Przybilla,przybjo01,C,23,MIL,2003,32,546.0,48,12,48,97,145,10,45,19,85,18,46,0.391304347826087,0,0,0.0,18,46,0.391304347826087,0.391,12,24,0.5
Vladimir Radmanović,radmavl01,PF,22,SEA,2003,72,1910.0,724,97,76,247,323,64,22,100,136,274,668,0.4101796407185629,104,293,0.3549488054607508,170,375,0.4533333333333333,0.488,72,102,0.7058823529411765
Igor Rakočević,rakocig01,PG,24,MIN,2003,42,244.0,78,33,4,13,17,4,0,23,25,22,58,0.3793103448275862,5,12,0.4166666666666667,17,46,0.3695652173913043,0.422,29,36,0.8055555555555556
Zach Randolph,randoza01,PF,21,POR,2003,77,1301.0,650,41,139,204,343,42,14,62,141,264,515,0.512621359223301,0,5,0.0,264,510,0.5176470588235295,0.513,122,161,0.7577639751552795
Theo Ratliff,ratlith01,C,29,ATL,2003,81,2518.0,706,73,154,453,607,56,262,137,271,276,595,0.4638655462184874,0,0,0.0,276,595,0.4638655462184874,0.464,154,214,0.719626168224299
Željko Rebrača,rebraze01,C,30,DET,2003,30,488.0,198,9,27,65,92,6,17,29,79,80,145,0.5517241379310345,0,0,0.0,80,145,0.5517241379310345,0.552,38,48,0.7916666666666666
Michael Redd,reddmi01,SG,23,MIL,2003,82,2316.0,1241,117,98,273,371,100,13,74,143,455,971,0.4685890834191555,182,416,0.4375,273,555,0.4918918918918919,0.562,149,185,0.8054054054054054
Don Reid,reiddo01,PF,29,DET,2003,1,10.0,1,0,0,0,0,0,0,0,4,0,3,0.0,0,0,0.0,0,3,0.0,0.0,1,2,0.5
Efthimios Rentzias,rentzef01,C,27,PHI,2003,35,144.0,52,7,10,16,26,6,2,4,21,20,59,0.3389830508474576,4,8,0.5,16,51,0.3137254901960784,0.373,8,9,0.8888888888888888
Glen Rice,ricegl01,SF,35,HOU,2003,62,1532.0,556,65,28,126,154,23,5,55,99,196,457,0.4288840262582057,101,254,0.3976377952755905,95,203,0.4679802955665024,0.539,63,83,0.7590361445783133
Jason Richardson,richaja01,SG,22,GSW,2003,82,2698.0,1282,247,111,267,378,90,23,179,201,476,1161,0.4099913867355728,123,334,0.3682634730538922,353,827,0.4268440145102781,0.463,207,271,0.7638376383763837
Quentin Richardson,richaqu01,SG,22,LAC,2003,59,1368.0,552,52,98,183,281,35,10,64,92,203,546,0.3717948717948718,61,198,0.308080808080808,142,348,0.4080459770114942,0.428,85,124,0.6854838709677419
Antoine Rigaudeau,rigauan01,SG,31,DAL,2003,11,91.0,17,6,4,4,8,3,0,6,11,8,35,0.2285714285714285,1,5,0.2,7,30,0.2333333333333333,0.243,0,0,0.0
Clifford Robinson,robincl02,PF,36,DET,2003,81,2825.0,992,268,81,237,318,87,88,158,259,372,935,0.3978609625668449,87,259,0.3359073359073359,285,676,0.4215976331360946,0.444,161,238,0.6764705882352942
David Robinson,robinda01,C,37,SAS,2003,64,1676.0,546,61,163,345,508,52,111,83,126,197,420,0.469047619047619,0,0,0.0,197,420,0.469047619047619,0.469,152,214,0.7102803738317757
Eddie Robinson,robined01,SF,26,CHI,2003,64,1355.0,364,66,76,124,200,62,13,52,120,155,315,0.492063492063492,3,14,0.2142857142857142,152,301,0.5049833887043189,0.497,51,63,0.8095238095238095
Glenn Robinson,robingl01,SF,30,ATL,2003,69,2591.0,1436,205,86,371,457,91,26,248,183,539,1248,0.4318910256410256,90,263,0.3422053231939163,449,985,0.4558375634517767,0.468,268,306,0.8758169934640523
Rodney Rogers,rogerro01,PF,31,NJN,2003,68,1303.0,478,107,61,202,263,50,31,91,192,183,455,0.4021978021978022,44,132,0.3333333333333333,139,323,0.4303405572755417,0.451,68,90,0.7555555555555555
Sean Rooks,rooksse01,C,33,LAC,2003,70,1344.0,297,69,53,163,216,34,44,66,174,125,297,0.4208754208754209,0,1,0.0,125,296,0.4222972972972973,0.421,47,58,0.8103448275862069
Jalen Rose,roseja01,SF,30,CHI,2003,82,3351.0,1816,395,68,283,351,72,23,285,271,642,1583,0.4055590650663297,133,359,0.3704735376044568,509,1224,0.4158496732026144,0.448,399,467,0.854389721627409
Malik Rose,rosema01,PF,28,SAS,2003,79,1933.0,822,124,148,358,506,57,40,170,206,289,630,0.4587301587301587,2,5,0.4,287,625,0.4592,0.46,242,306,0.7908496732026143
Guy Rucker,ruckegu01,PF,25,GSW,2003,3,4.0,0,1,0,1,1,0,0,0,1,0,0,0.0,0,0,0.0,0,0,0.0,0.0,0,0,0.0
Kareem Rush,rushka01,PG,22,LAL,2003,76,872.0,227,68,26,68,94,10,11,63,71,96,244,0.3934426229508196,19,68,0.2794117647058823,77,176,0.4375,0.432,16,23,0.6956521739130435
Bryon Russell,russebr01,SF,32,WAS,2003,70,1388.0,315,72,43,165,208,70,7,55,130,108,306,0.3529411764705882,46,140,0.3285714285714285,62,166,0.3734939759036144,0.428,53,69,0.7681159420289855
Arvydas Sabonis,sabonar01,C,38,POR,2003,78,1209.0,476,142,88,247,335,61,49,75,141,172,361,0.4764542936288088,3,6,0.5,169,355,0.476056338028169,0.481,129,164,0.7865853658536586
John Salmons,salmojo01,PG,23,PHI,2003,64,504.0,132,47,16,43,59,17,6,29,53,48,116,0.4137931034482758,10,31,0.3225806451612903,38,85,0.4470588235294118,0.457,26,35,0.7428571428571429
Soumaila Samake,samakso01,C,24,LAL,2003,13,77.0,22,4,10,13,23,0,5,2,13,10,24,0.4166666666666667,0,0,0.0,10,24,0.4166666666666667,0.417,2,2,1.0
Jamal Sampson,sampsja01,PF,19,MIL,2003,5,8.0,0,1,1,1,2,1,0,0,0,0,2,0.0,0,0,0.0,0,2,0.0,0.0,0,0,0.0
Pepe Sánchez,sanchpe01,PG,25,DET,2003,9,37.0,0,8,4,2,6,5,0,2,3,0,5,0.0,0,0,0.0,0,5,0.0,0.0,0,0,0.0
Jeryl Sasser,sasseje01,SG,23,ORL,2003,75,1025.0,194,65,64,120,184,45,12,39,91,64,207,0.3091787439613526,13,44,0.2954545454545454,51,163,0.3128834355828221,0.341,53,78,0.6794871794871795
Kenny Satterfield,satteke01,PG,21,TOT,2003,39,502.0,132,68,16,27,43,20,2,43,36,55,183,0.3005464480874317,5,28,0.1785714285714285,50,155,0.3225806451612903,0.314,17,25,0.68
Predrag Savović,savovpr01,SG,26,DEN,2003,27,256.0,83,22,9,16,25,14,1,21,33,29,93,0.3118279569892473,4,26,0.1538461538461538,25,67,0.373134328358209,0.333,21,29,0.7241379310344828
Brian Scalabrine,scalabr01,PF,24,NJN,2003,59,724.0,180,46,40,101,141,16,18,46,77,68,169,0.4023668639053254,14,39,0.358974358974359,54,130,0.4153846153846154,0.444,30,36,0.8333333333333334
Ansu Sesay,sesayan01,SF,26,SEA,2003,45,448.0,94,23,34,39,73,14,5,25,62,41,107,0.3831775700934579,0,0,0.0,41,107,0.3831775700934579,0.383,12,21,0.5714285714285714
Brian Shaw,shawbr01,PG,36,LAL,2003,72,900.0,250,103,20,99,119,32,13,54,62,101,261,0.3869731800766283,38,109,0.3486238532110092,63,152,0.4144736842105263,0.46,10,15,0.6666666666666666
Paul Shirley,shirlpa01,PF,25,ATL,2003,2,5.0,0,0,0,1,1,0,0,0,0,0,4,0.0,0,0,0.0,0,4,0.0,0.0,0,0,0.0
Bobby Simmons,simmobo01,SG,22,WAS,2003,36,378.0,120,20,33,44,77,10,3,8,51,44,112,0.3928571428571428,0,5,0.0,44,107,0.411214953271028,0.393,32,35,0.9142857142857144
Brian Skinner,skinnbr01,PF,26,PHI,2003,77,1381.0,461,19,136,230,366,47,53,62,176,182,331,0.5498489425981873,0,0,0.0,182,331,0.5498489425981873,0.55,97,161,0.6024844720496895
Reggie Slater,slatere01,PF,32,MIN,2003,26,141.0,81,4,18,13,31,6,1,9,31,27,50,0.54,0,0,0.0,27,50,0.54,0.54,27,45,0.6
Tamar Slay,slayta01,SG,22,NJN,2003,36,274.0,92,14,8,23,31,14,3,20,31,39,103,0.3786407766990291,7,25,0.28,32,78,0.4102564102564102,0.413,7,10,0.7
Charles Smith,smithch04,SG,27,POR,2003,3,13.0,5,1,0,0,0,1,0,1,3,1,4,0.25,0,1,0.0,1,3,0.3333333333333333,0.25,3,4,0.75
Joe Smith,smithjo02,SF,27,MIN,2003,54,1117.0,404,38,111,159,270,14,55,43,171,151,328,0.4603658536585366,0,2,0.0,151,326,0.4631901840490797,0.46,102,131,0.7786259541984732
Steve Smith,smithst01,SG,33,SAS,2003,53,1032.0,360,70,21,78,99,28,9,43,79,113,291,0.3883161512027491,39,118,0.3305084745762712,74,173,0.4277456647398844,0.455,95,114,0.8333333333333334
Eric Snow,snower01,PG,29,PHI,2003,82,3108.0,1054,544,71,230,301,133,11,194,235,361,799,0.4518147684605757,7,32,0.21875,354,767,0.4615384615384615,0.456,325,379,0.8575197889182058
Latrell Sprewell,sprewla01,SF,32,NYK,2003,74,2859.0,1215,332,45,240,285,102,22,172,134,454,1127,0.4028393966282165,134,360,0.3722222222222222,320,767,0.4172099087353325,0.462,173,218,0.7935779816513762
Jerry Stackhouse,stackje01,SG,28,WAS,2003,70,2747.0,1508,316,61,197,258,65,28,193,130,491,1201,0.4088259783513738,71,245,0.2897959183673469,420,956,0.4393305439330544,0.438,455,518,0.8783783783783784
Vladimir Stepania,stepavl01,C,26,MIA,2003,79,1594.0,441,24,211,343,554,45,40,69,169,185,427,0.4332552693208431,0,0,0.0,185,427,0.4332552693208431,0.433,71,134,0.5298507462686567
DeShawn Stevenson,stevede01,SG,21,UTA,2003,61,760.0,279,40,22,63,85,22,8,49,57,114,284,0.4014084507042254,4,12,0.3333333333333333,110,272,0.4044117647058823,0.408,47,68,0.6911764705882353
Michael Stewart,stewami01,PF,27,CLE,2003,47,251.0,36,6,19,36,55,2,15,10,42,14,37,0.3783783783783784,0,0,0.0,14,37,0.3783783783783784,0.378,8,12,0.6666666666666666
John Stockton,stockjo01,PG,40,UTA,2003,82,2275.0,884,629,51,150,201,137,16,182,184,309,640,0.4828125,29,80,0.3625,280,560,0.5,0.505,237,287,0.8257839721254355
Peja Stojaković,stojape01,SF,25,SAC,2003,72,2450.0,1380,141,61,336,397,72,5,101,143,497,1034,0.4806576402321083,155,406,0.3817733990147783,342,628,0.5445859872611465,0.556,231,264,0.875
Damon Stoudamire,stoudda01,PG,29,POR,2003,59,1315.0,409,204,40,115,155,39,6,82,67,156,415,0.3759036144578313,44,114,0.3859649122807017,112,301,0.3720930232558139,0.429,53,67,0.7910447761194029
Amar'e Stoudemire,stoudam01,PF,20,PHO,2003,82,2570.0,1106,78,250,471,721,62,87,189,269,392,830,0.472289156626506,2,10,0.2,390,820,0.4756097560975609,0.473,320,484,0.6611570247933884
Erick Strickland,stricer01,SG,29,IND,2003,71,1275.0,458,209,23,122,145,38,7,98,111,163,380,0.4289473684210526,62,160,0.3875,101,220,0.4590909090909091,0.511,70,87,0.8045977011494253
Mark Strickland,stricma01,SF,32,DAL,2003,4,13.0,4,0,5,2,7,0,0,1,1,2,5,0.4,0,0,0.0,2,5,0.4,0.4,0,0,0.0
Rod Strickland,stricro02,PG,36,MIN,2003,47,956.0,320,215,20,75,95,46,6,76,55,120,278,0.4316546762589928,1,11,0.0909090909090909,119,267,0.445692883895131,0.433,79,107,0.7383177570093458
Bruno Šundov,sundobr01,C,22,BOS,2003,26,138.0,32,7,8,20,28,6,3,9,24,14,56,0.25,4,16,0.25,10,40,0.25,0.286,0,2,0.0
Bob Sura,surabo01,SG,29,GSW,2003,55,1130.0,401,177,58,109,167,45,2,82,108,135,328,0.4115853658536585,28,85,0.3294117647058823,107,243,0.4403292181069959,0.454,103,148,0.6959459459459459
Stromile Swift,swiftst01,PF,23,MEM,2003,67,1478.0,647,45,114,270,384,55,104,99,152,235,489,0.4805725971370143,0,2,0.0,235,487,0.4825462012320328,0.481,177,245,0.7224489795918367
Wally Szczerbiak,szczewa02,SF,25,MIN,2003,52,1836.0,913,136,53,188,241,44,22,87,123,351,729,0.4814814814814814,61,145,0.4206896551724138,290,584,0.4965753424657534,0.523,150,173,0.8670520231213873
Maurice Taylor,tayloma01,PF,26,HOU,2003,67,1377.0,562,66,95,143,238,22,22,100,151,231,535,0.4317757009345794,0,2,0.0,231,533,0.4333958724202627,0.432,100,138,0.7246376811594203
Jason Terry,terryja01,PG,25,ATL,2003,81,3081.0,1395,600,37,242,279,126,14,249,175,488,1141,0.4276950043821209,160,431,0.37122969837587,328,710,0.4619718309859155,0.498,259,292,0.886986301369863
Etan Thomas,thomaet01,PF,24,WAS,2003,38,513.0,182,3,70,95,165,8,23,33,66,61,124,0.4919354838709677,0,0,0.0,61,124,0.4919354838709677,0.492,60,94,0.6382978723404256
Kenny Thomas,thomake01,PF,25,TOT,2003,66,1978.0,667,112,185,344,529,62,28,116,169,260,559,0.4651162790697674,0,0,0.0,260,559,0.4651162790697674,0.465,147,197,0.7461928934010152
Kurt Thomas,thomaku01,C,30,NYK,2003,81,2577.0,1134,162,160,477,637,81,97,138,344,497,1028,0.4834630350194552,2,3,0.6666666666666666,495,1025,0.4829268292682926,0.484,138,184,0.75
Tim Thomas,thomati01,SF,25,MIL,2003,80,2358.0,1066,102,97,292,389,70,49,133,257,412,930,0.443010752688172,97,265,0.3660377358490566,315,665,0.4736842105263157,0.495,145,186,0.7795698924731183
Jamaal Tinsley,tinslja01,PG,24,IND,2003,73,2237.0,566,548,58,202,260,125,18,192,201,220,556,0.39568345323741,46,166,0.2771084337349397,174,390,0.4461538461538462,0.437,80,112,0.7142857142857143
Óscar Torres,torreos01,SG,26,GSW,2003,17,109.0,53,3,3,9,12,4,2,8,9,16,36,0.4444444444444444,7,13,0.5384615384615384,9,23,0.391304347826087,0.542,14,20,0.7
Robert Traylor,traylro01,C,25,NOH,2003,69,851.0,268,50,108,154,262,45,37,53,153,105,237,0.4430379746835443,1,3,0.3333333333333333,104,234,0.4444444444444444,0.445,57,88,0.6477272727272727
Gary Trent,trentga01,SF,28,MIN,2003,80,1222.0,476,77,106,185,291,32,23,59,142,208,389,0.5347043701799485,0,2,0.0,208,387,0.537467700258398,0.535,60,101,0.594059405940594
Jeff Trepagnier,trepaje01,SG,23,DEN,2003,8,97.0,45,6,8,8,16,8,0,8,5,17,40,0.425,4,8,0.5,13,32,0.40625,0.475,7,7,1.0
Cezary Trybański,trybace01,C,23,MEM,2003,15,86.0,14,1,6,8,14,0,6,8,13,5,20,0.25,0,0,0.0,5,20,0.25,0.25,4,10,0.4
Jake Tsakalidis,tsakaja01,C,23,PHO,2003,33,543.0,161,13,45,77,122,6,17,26,80,61,135,0.4518518518518518,0,0,0.0,61,135,0.4518518518518518,0.452,39,58,0.6724137931034483
Nikoloz Tskitishvili,tskitni01,SF,19,DEN,2003,81,1320.0,315,91,64,117,181,31,29,84,136,115,393,0.2926208651399491,37,152,0.2434210526315789,78,241,0.3236514522821577,0.34,48,65,0.7384615384615385
Hedo Türkoğlu,turkohe01,SF,23,SAC,2003,67,1175.0,447,87,35,153,188,25,12,50,125,165,391,0.4219948849104859,29,78,0.3717948717948718,136,313,0.4345047923322683,0.459,88,110,0.8
Nick Van Exel,vanexni01,SG,31,DAL,2003,73,2026.0,912,312,35,173,208,42,4,123,86,342,831,0.4115523465703971,118,312,0.3782051282051282,224,519,0.4315992292870905,0.483,110,144,0.7638888888888888
Keith Van Horn,vanhoke01,PF,27,PHI,2003,74,2337.0,1176,93,159,365,524,63,30,150,251,459,952,0.4821428571428571,65,176,0.3693181818181818,394,776,0.5077319587628866,0.516,193,240,0.8041666666666667
Jacque Vaughn,vaughja01,PG,27,ORL,2003,80,1686.0,473,232,26,92,118,64,2,97,169,184,411,0.4476885644768856,8,34,0.2352941176470588,176,377,0.4668435013262599,0.457,97,125,0.776
Jake Voskuhl,voskuja01,C,25,PHO,2003,65,947.0,248,36,97,128,225,18,29,48,172,92,163,0.5644171779141104,0,0,0.0,92,163,0.5644171779141104,0.564,64,96,0.6666666666666666
Dajuan Wagner,wagneda02,SG,19,CLE,2003,47,1385.0,629,130,20,62,82,38,7,85,107,223,605,0.3685950413223141,55,174,0.3160919540229885,168,431,0.3897911832946635,0.414,128,160,0.8
Antoine Walker,walkean02,PF,26,BOS,2003,78,3235.0,1570,373,99,464,563,116,31,260,221,603,1554,0.388030888030888,188,582,0.3230240549828179,415,972,0.4269547325102881,0.449,176,286,0.6153846153846154
Samaki Walker,walkesa01,C,26,LAL,2003,67,1243.0,296,64,115,253,368,20,55,56,143,115,274,0.4197080291970803,0,1,0.0,115,273,0.4212454212454212,0.42,66,101,0.6534653465346535
Ben Wallace,wallabe01,C,28,DET,2003,73,2873.0,506,120,293,833,1126,104,230,88,179,210,437,0.4805491990846682,1,6,0.1666666666666666,209,431,0.4849187935034802,0.482,85,189,0.4497354497354497
Gerald Wallace,wallage01,SF,20,SAC,2003,47,571.0,220,23,38,90,128,24,15,44,68,90,183,0.4918032786885246,1,4,0.25,89,179,0.4972067039106145,0.495,39,74,0.527027027027027
Rasheed Wallace,wallara01,PF,28,POR,2003,74,2684.0,1340,153,113,435,548,70,77,140,223,515,1094,0.4707495429616087,110,307,0.3583061889250814,405,787,0.5146124523506989,0.521,200,272,0.7352941176470589
Charlie Ward,wardch01,PG,32,NYK,2003,66,1465.0,472,306,25,152,177,78,11,95,146,165,414,0.3985507246376811,101,267,0.3782771535580524,64,147,0.4353741496598639,0.521,41,53,0.7735849056603774
Earl Watson,watsoea01,PG,23,MEM,2003,79,1366.0,433,225,46,118,164,89,14,88,138,170,391,0.4347826086956521,31,91,0.3406593406593406,139,300,0.4633333333333333,0.474,62,86,0.7209302325581395
Clarence Weatherspoon,weathcl01,PF,32,NYK,2003,79,2024.0,521,68,214,385,599,69,36,63,174,186,414,0.4492753623188406,0,0,0.0,186,414,0.4492753623188406,0.449,149,194,0.7680412371134021
Chris Webber,webbech01,PF,29,SAC,2003,67,2622.0,1542,364,160,544,704,106,88,215,204,661,1433,0.4612700628053036,5,21,0.238095238095238,656,1412,0.4645892351274787,0.463,215,354,0.6073446327683616
Bonzi Wells,wellsbo01,SG,26,POR,2003,75,2396.0,1138,246,98,296,394,123,18,215,220,437,990,0.4414141414141414,38,130,0.2923076923076923,399,860,0.463953488372093,0.461,226,313,0.7220447284345048
Jiří Welsch,welscji01,SF,23,GSW,2003,37,234.0,61,27,12,16,28,8,2,19,32,19,75,0.2533333333333333,1,4,0.25,18,71,0.2535211267605634,0.26,22,29,0.7586206896551724
David Wesley,wesleda01,SG,32,NOH,2003,73,2710.0,1217,251,38,137,175,109,9,132,173,449,1037,0.4329797492767598,134,316,0.4240506329113924,315,721,0.4368932038834951,0.498,185,237,0.7805907172995781
Jahidi White,whiteja01,C,26,WAS,2003,16,230.0,67,2,37,36,73,1,12,9,33,25,53,0.4716981132075472,0,0,0.0,25,53,0.4716981132075472,0.472,17,25,0.68
Rodney White,whitero02,SG,22,DEN,2003,72,1563.0,650,121,43,170,213,45,32,156,134,260,638,0.4075235109717868,32,134,0.2388059701492537,228,504,0.4523809523809524,0.433,98,125,0.784
Chris Whitney,whitnch01,PG,31,TOT,2003,51,1052.0,355,145,3,64,67,29,2,71,92,124,349,0.3553008595988539,50,164,0.3048780487804878,74,185,0.4,0.427,57,69,0.8260869565217391
Chris Wilcox,wilcoch01,PF,20,LAC,2003,46,479.0,171,21,32,72,104,7,12,26,65,73,140,0.5214285714285715,0,0,0.0,73,140,0.5214285714285715,0.521,25,50,0.5
Mike Wilks,wilksmi01,PG-SG,23,TOT,2003,46,688.0,147,92,20,51,71,27,4,28,69,50,148,0.3378378378378378,10,35,0.2857142857142857,40,113,0.3539823008849557,0.372,37,47,0.7872340425531915
Aaron Williams,williaa01,C,31,NJN,2003,81,1597.0,500,88,137,194,331,27,57,85,206,199,439,0.4533029612756264,0,1,0.0,199,438,0.454337899543379,0.453,102,130,0.7846153846153846
Alvin Williams,willial02,PG,28,TOR,2003,78,2638.0,1027,416,55,190,245,111,21,128,170,396,905,0.4375690607734807,48,146,0.3287671232876712,348,759,0.458498023715415,0.464,187,239,0.7824267782426778
Brandon Williams,willibr01,SF,27,ATL,2003,6,19.0,2,0,2,0,2,2,0,3,4,1,7,0.1428571428571428,0,1,0.0,1,6,0.1666666666666666,0.143,0,0,0.0
Eric Williams,willier01,SF,30,BOS,2003,82,2350.0,746,140,143,239,382,86,19,97,234,254,575,0.4417391304347826,37,110,0.3363636363636363,217,465,0.4666666666666667,0.474,201,268,0.75
Frank Williams,willifr02,PG,22,NYK,2003,21,167.0,28,34,3,15,18,7,2,17,20,9,33,0.2727272727272727,6,16,0.375,3,17,0.1764705882352941,0.364,4,6,0.6666666666666666
Jason Williams,willija02,PG,27,MEM,2003,76,2407.0,919,631,25,187,212,91,10,168,130,333,859,0.3876600698486612,143,404,0.3539603960396039,190,455,0.4175824175824176,0.471,110,131,0.8396946564885496
Jay Williams,willija03,PG,21,CHI,2003,75,1961.0,714,350,27,168,195,86,17,171,179,273,685,0.3985401459854014,65,202,0.3217821782178218,208,483,0.4306418219461698,0.446,103,161,0.639751552795031
Jerome Williams,willije01,PF,29,TOR,2003,71,2346.0,691,95,231,419,650,116,26,98,197,267,535,0.4990654205607476,1,6,0.1666666666666666,266,529,0.502835538752363,0.5,156,281,0.5551601423487544
Monty Williams,willimo01,SF,31,PHI,2003,21,276.0,92,26,12,33,45,12,5,17,33,34,80,0.425,0,2,0.0,34,78,0.4358974358974359,0.425,24,32,0.75
Scott Williams,willisc01,C,34,PHO,2003,69,872.0,273,22,72,121,193,27,21,32,159,120,292,0.410958904109589,0,2,0.0,120,290,0.4137931034482758,0.411,33,42,0.7857142857142857
Shammond Williams,willish01,PG,27,TOT,2003,78,1881.0,627,266,24,147,171,77,6,114,140,228,579,0.3937823834196891,93,261,0.3563218390804598,135,318,0.4245283018867924,0.474,78,102,0.7647058823529411
Walt Williams,williwa02,SF,32,DAL,2003,66,1161.0,363,59,53,154,207,42,26,35,141,134,341,0.3929618768328445,64,171,0.3742690058479532,70,170,0.4117647058823529,0.487,31,50,0.62
Corliss Williamson,willico02,SF,29,DET,2003,82,2061.0,987,104,147,211,358,44,27,126,238,374,826,0.4527845036319612,2,11,0.1818181818181818,372,815,0.456441717791411,0.454,237,300,0.79
Kevin Willis,willike02,C,40,SAS,2003,71,840.0,297,24,83,143,226,20,20,60,120,123,257,0.4785992217898833,0,2,0.0,123,255,0.4823529411764706,0.479,51,83,0.6144578313253012
Rubén Wolkowyski,wolkoru01,PF,29,BOS,2003,7,24.0,5,1,0,1,1,0,0,1,3,2,4,0.5,0,1,0.0,2,3,0.6666666666666666,0.5,1,4,0.25
Loren Woods,woodslo01,C,24,MIN,2003,38,353.0,80,19,27,68,95,10,13,23,37,29,76,0.3815789473684211,1,3,0.3333333333333333,28,73,0.3835616438356164,0.388,21,27,0.7777777777777778
Qyntel Woods,woodsqy01,PF,21,POR,2003,53,334.0,128,12,15,38,53,15,1,23,36,59,118,0.5,3,9,0.3333333333333333,56,109,0.5137614678899083,0.513,7,20,0.35
Metta World Peace,artesro01,SF,23,IND,2003,69,2317.0,1068,198,101,261,362,159,50,145,242,362,846,0.4278959810874704,71,211,0.3364928909952606,291,635,0.4582677165354331,0.47,273,371,0.7358490566037735
Lorenzen Wright,wrighlo02,C,27,MEM,2003,70,1982.0,797,80,170,358,528,51,54,110,209,325,716,0.4539106145251396,0,5,0.0,325,711,0.4571026722925457,0.454,147,223,0.6591928251121076
Vincent Yarbrough,yarbrvi01,SG,21,DEN,2003,59,1381.0,406,130,36,126,162,57,33,81,145,168,428,0.3925233644859813,21,78,0.2692307692307692,147,350,0.42,0.417,49,62,0.7903225806451613
Wang Zhizhi,zhizhwa01,C,25,LAC,2003,41,412.0,182,10,26,51,77,8,10,31,41,62,162,0.382716049382716,16,47,0.3404255319148936,46,115,0.4,0.432,42,58,0.7241379310344828
Shareef Abdur-Rahim,abdursh01,PF,27,TOT,2004,85,2684.0,1384,174,189,450,639,68,37,184,222,501,1054,0.4753320683111954,9,34,0.2647058823529412,492,1020,0.4823529411764706,0.48,373,429,0.8694638694638694
Malik Allen,allenma01,PF,25,MIA,2004,45,616.0,191,16,42,77,119,12,28,27,81,83,198,0.4191919191919191,0,0,0.0,83,198,0.4191919191919191,0.419,25,33,0.7575757575757576
Ray Allen,allenra02,SG,28,SEA,2004,56,2152.0,1287,268,69,217,286,71,11,156,132,447,1017,0.43952802359882,148,378,0.3915343915343915,299,639,0.4679186228482003,0.512,245,271,0.904059040590406
Rafer Alston,alstora01,PG,27,MIA,2004,82,2581.0,838,372,26,200,226,114,18,128,212,287,764,0.3756544502617801,161,434,0.3709677419354839,126,330,0.3818181818181818,0.481,103,134,0.7686567164179104
Chris Andersen,anderch01,PF,25,DEN,2004,71,1029.0,243,35,89,209,298,34,114,48,119,90,203,0.4433497536945813,0,1,0.0,90,202,0.4455445544554455,0.443,63,107,0.5887850467289719
Derek Anderson,anderde01,SG,29,POR,2004,51,1810.0,694,228,26,156,182,66,3,90,79,230,612,0.3758169934640523,79,259,0.305019305019305,151,353,0.4277620396600566,0.44,155,188,0.824468085106383
Kenny Anderson,anderke01,PG,33,IND,2004,44,905.0,262,125,19,62,81,26,5,50,73,113,256,0.44140625,1,4,0.25,112,252,0.4444444444444444,0.443,35,48,0.7291666666666666
Shandon Anderson,andersh01,SG,30,NYK,2004,80,1974.0,635,122,53,169,222,68,17,118,182,238,564,0.4219858156028369,36,128,0.28125,202,436,0.463302752293578,0.454,123,161,0.7639751552795031
Carmelo Anthony,anthoca01,SF,19,DEN,2004,82,2995.0,1725,227,183,315,498,97,41,247,225,624,1465,0.425938566552901,69,214,0.322429906542056,555,1251,0.4436450839328537,0.449,408,525,0.7771428571428571
Robert Archibald,archiro01,C-PF,23,TOT,2004,32,256.0,32,13,21,31,52,14,3,10,50,9,33,0.2727272727272727,0,0,0.0,9,33,0.2727272727272727,0.273,14,31,0.4516129032258064
Gilbert Arenas,arenagi01,PG,22,WAS,2004,55,2066.0,1078,275,55,199,254,103,12,226,176,358,914,0.3916849015317287,125,333,0.3753753753753753,233,581,0.4010327022375215,0.46,237,317,0.7476340694006309
Brandon Armstrong,armstbr01,SG,23,NJN,2004,56,434.0,151,14,12,31,43,12,2,24,49,65,175,0.3714285714285714,19,52,0.3653846153846153,46,123,0.3739837398373983,0.426,2,4,0.5
Darrell Armstrong,armstda01,PG,35,NOH,2004,79,2247.0,840,311,63,163,226,133,16,155,148,291,736,0.3953804347826087,135,429,0.3146853146853147,156,307,0.50814332247557,0.487,123,144,0.8541666666666666
Carlos Arroyo,arroyca01,PG,24,UTA,2004,71,2008.0,897,355,41,144,185,63,5,156,165,339,768,0.44140625,38,117,0.3247863247863248,301,651,0.4623655913978494,0.466,181,225,0.8044444444444444
Chucky Atkins,atkinch01,PG,29,TOT,2004,64,1544.0,538,223,9,84,93,45,2,92,102,192,484,0.396694214876033,81,241,0.3360995850622407,111,243,0.4567901234567901,0.48,73,97,0.7525773195876289
Stacey Augmon,augmost01,SF,35,NOH,2004,69,1416.0,397,85,52,122,174,55,15,76,114,143,347,0.4121037463976945,1,7,0.1428571428571428,142,340,0.4176470588235294,0.414,110,139,0.7913669064748201
Vin Baker,bakervi01,PF,32,TOT,2004,54,1313.0,531,66,112,168,280,29,32,77,160,208,432,0.4814814814814814,1,3,0.3333333333333333,207,429,0.4825174825174825,0.483,114,157,0.7261146496815286
Marcus Banks,banksma01,PG,22,BOS,2004,81,1385.0,480,175,30,103,133,88,13,125,171,177,442,0.4004524886877828,27,86,0.313953488372093,150,356,0.4213483146067415,0.431,99,131,0.7557251908396947
Leandro Barbosa,barbole01,PG,21,PHO,2004,70,1500.0,550,165,23,100,123,93,7,120,184,210,470,0.4468085106382978,83,210,0.3952380952380952,127,260,0.4884615384615384,0.535,47,61,0.7704918032786885
Matt Barnes,barnema02,SF,23,LAC,2004,38,724.0,171,48,53,98,151,27,3,44,76,63,138,0.4565217391304347,2,13,0.1538461538461538,61,125,0.488,0.464,43,61,0.7049180327868853
Dana Barros,barroda01,SG,36,BOS,2004,1,11.0,6,0,0,0,0,0,0,0,2,2,3,0.6666666666666666,0,0,0.0,2,3,0.6666666666666666,0.667,2,2,1.0
Brent Barry,barrybr01,SG,32,SEA,2004,59,1803.0,635,342,21,183,204,85,16,139,121,215,427,0.5035128805620609,114,252,0.4523809523809524,101,175,0.5771428571428572,0.637,91,110,0.8272727272727273
Jon Barry,barryjo01,SG,34,DEN,2004,57,1101.0,351,147,25,98,123,57,8,53,66,120,297,0.404040404040404,51,138,0.3695652173913043,69,159,0.4339622641509434,0.49,60,71,0.8450704225352113
Mengke Bateer,bateeme01,C,28,TOR,2004,7,40.0,8,1,5,3,8,1,0,2,10,4,7,0.5714285714285714,0,0,0.0,4,7,0.5714285714285714,0.571,0,0,0.0
Tony Battie,battito01,C,27,TOT,2004,73,1478.0,408,58,118,241,359,26,67,63,159,170,384,0.4427083333333333,2,9,0.2222222222222222,168,375,0.448,0.445,66,89,0.7415730337078652
Shane Battier,battish01,SF,25,MEM,2004,79,1947.0,669,101,102,201,303,101,58,56,187,242,543,0.4456721915285451,65,186,0.3494623655913978,177,357,0.4957983193277311,0.506,120,164,0.7317073170731707
Lonny Baxter,baxtelo01,C-PF,25,TOT,2004,62,766.0,251,20,64,123,187,17,29,38,123,103,209,0.492822966507177,1,3,0.3333333333333333,102,206,0.4951456310679611,0.495,44,76,0.5789473684210527
Jerome Beasley,beaslje01,PF,23,MIA,2004,2,5.0,2,0,0,1,1,0,0,0,0,1,3,0.3333333333333333,0,0,0.0,1,3,0.3333333333333333,0.333,0,0,0.0
Raja Bell,bellra01,SG,27,UTA,2004,82,2020.0,915,107,60,181,241,63,13,111,262,329,805,0.408695652173913,62,166,0.3734939759036144,267,639,0.4178403755868544,0.447,195,248,0.7862903225806451
Troy Bell,belltr01,PG,23,MEM,2004,6,34.0,11,4,3,1,4,1,0,6,6,4,18,0.2222222222222222,0,4,0.0,4,14,0.2857142857142857,0.222,3,3,1.0
Jonathan Bender,bendejo01,SF,23,IND,2004,21,271.0,148,9,9,31,40,5,11,33,23,50,106,0.4716981132075472,9,22,0.4090909090909091,41,84,0.4880952380952381,0.514,39,47,0.8297872340425532
Travis Best,besttr01,PG,31,DAL,2004,61,762.0,171,112,17,51,68,31,4,33,66,64,172,0.3720930232558139,3,20,0.15,61,152,0.4013157894736842,0.381,40,46,0.8695652173913043
Mike Bibby,bibbymi01,PG,25,SAC,2004,82,2980.0,1506,444,67,210,277,112,18,175,146,527,1170,0.4504273504273504,148,378,0.3915343915343915,379,792,0.4785353535353535,0.514,304,373,0.8150134048257373
Chauncey Billups,billuch01,PG,27,DET,2004,78,2758.0,1318,446,35,241,276,84,8,189,177,392,996,0.393574297188755,130,335,0.3880597014925373,262,661,0.3963691376701966,0.459,404,460,0.8782608695652174
Steve Blake,blakest01,PG,23,WAS,2004,75,1392.0,444,209,18,99,117,57,7,128,100,157,407,0.3857493857493858,75,202,0.3712871287128713,82,205,0.4,0.478,55,67,0.8208955223880597
Corie Blount,blounco01,PF-C,35,TOT,2004,62,1050.0,245,55,98,177,275,49,24,43,135,115,253,0.4545454545454545,0,3,0.0,115,250,0.46,0.455,15,27,0.5555555555555556
Mark Blount,blounma01,C,28,BOS,2004,82,2402.0,843,75,207,382,589,80,106,150,253,342,604,0.5662251655629139,0,0,0.0,342,604,0.5662251655629139,0.566,159,221,0.7194570135746606
Keith Bogans,boganke01,SF,23,ORL,2004,73,1787.0,498,98,106,211,317,46,10,75,128,183,454,0.4030837004405286,67,187,0.3582887700534759,116,267,0.4344569288389513,0.477,65,103,0.6310679611650486
Calvin Booth,boothca01,C,27,SEA,2004,71,1206.0,345,28,86,194,280,17,101,45,150,135,290,0.4655172413793103,0,2,0.0,135,288,0.46875,0.466,75,94,0.7978723404255319
Carlos Boozer,boozeca01,PF,22,CLE,2004,75,2592.0,1162,148,230,627,857,74,55,134,199,471,900,0.5233333333333333,1,6,0.1666666666666666,470,894,0.5257270693512305,0.524,219,285,0.7684210526315789
Curtis Borchardt,borchcu01,C,23,UTA,2004,16,258.0,58,15,13,41,54,4,14,18,40,22,56,0.3928571428571428,0,1,0.0,22,55,0.4,0.393,14,18,0.7777777777777778
Chris Bosh,boshch01,C,19,TOR,2004,75,2510.0,861,78,191,366,557,59,106,107,215,327,712,0.4592696629213483,5,14,0.3571428571428571,322,698,0.4613180515759312,0.463,202,288,0.7013888888888888
Ruben Boumtje-Boumtje,boumtru01,C,25,POR,2004,9,26.0,4,1,0,1,1,0,1,0,2,1,5,0.2,0,0,0.0,1,5,0.2,0.2,2,2,1.0
Bruce Bowen,bowenbr01,SF,32,SAS,2004,82,2624.0,565,113,45,208,253,84,33,90,166,211,502,0.4203187250996016,77,212,0.3632075471698113,134,290,0.4620689655172413,0.497,66,114,0.5789473684210527
Ryan Bowen,bowenry01,PF,28,DEN,2004,52,392.0,46,18,39,48,87,18,16,6,47,18,53,0.3396226415094339,0,0,0.0,18,53,0.3396226415094339,0.34,10,12,0.8333333333333334
Earl Boykins,boykiea01,SG,27,DEN,2004,82,1849.0,839,295,42,101,143,51,3,100,84,321,766,0.4190600522193211,55,171,0.3216374269005848,266,595,0.4470588235294118,0.455,142,162,0.8765432098765432
Michael Bradley,bradlmi01,C-PF,24,TOT,2004,16,98.0,15,1,6,17,23,3,0,7,14,7,15,0.4666666666666667,0,0,0.0,7,15,0.4666666666666667,0.467,1,2,0.5
Shawn Bradley,bradlsh01,C,31,DAL,2004,66,773.0,219,20,72,101,173,33,74,17,130,89,188,0.4734042553191489,0,1,0.0,89,187,0.4759358288770053,0.473,41,49,0.8367346938775511
Torraye Braggs,braggto01,PF,27,TOT,2004,15,154.0,40,7,18,21,39,4,2,13,29,16,33,0.4848484848484848,0,0,0.0,16,33,0.4848484848484848,0.485,8,12,0.6666666666666666
Elton Brand,brandel01,PF,24,LAC,2004,69,2670.0,1379,227,269,445,714,64,154,193,229,484,982,0.4928716904276985,0,1,0.0,484,981,0.4933741080530071,0.493,411,532,0.7725563909774437
J.R. Bremer,bremejr01,PG,23,TOT,2004,36,443.0,118,51,9,27,36,18,4,24,32,43,158,0.2721518987341772,19,74,0.2567567567567567,24,84,0.2857142857142857,0.332,13,20,0.65
Jamison Brewer,breweja01,PG,23,IND,2004,13,160.0,32,17,2,9,11,7,0,10,9,13,35,0.3714285714285714,5,14,0.3571428571428571,8,21,0.3809523809523809,0.443,1,6,0.1666666666666666
Primož Brezec,brezepr01,C,24,IND,2004,18,72.0,28,3,5,10,15,0,3,6,13,12,26,0.4615384615384615,0,0,0.0,12,26,0.4615384615384615,0.462,4,6,0.6666666666666666
Damone Brown,brownda02,PF,24,NJN,2004,3,17.0,3,0,3,2,5,2,0,1,2,1,10,0.1,0,0,0.0,1,10,0.1,0.1,1,2,0.5
Devin Brown,brownde02,SG,25,SAS,2004,58,627.0,234,33,38,92,130,15,4,38,61,85,196,0.4336734693877551,4,14,0.2857142857142857,81,182,0.445054945054945,0.444,60,74,0.8108108108108109
Kedrick Brown,brownke01,SF,22,TOT,2004,55,969.0,289,64,41,105,146,30,7,29,80,117,254,0.4606299212598425,38,99,0.3838383838383838,79,155,0.5096774193548387,0.535,17,27,0.6296296296296297
Kwame Brown,brownkw01,PF,21,WAS,2004,74,2239.0,805,112,178,372,550,66,52,140,144,288,589,0.4889643463497453,1,2,0.5,287,587,0.4889267461669506,0.49,228,334,0.6826347305389222
P.J. Brown,brownpj01,PF,34,NOH,2004,80,2753.0,836,155,237,453,690,78,73,101,203,339,712,0.476123595505618,0,1,0.0,339,711,0.4767932489451477,0.476,158,185,0.8540540540540541
Tierre Brown,brownti01,PG,24,NOH,2004,3,17.0,6,2,0,1,1,0,0,7,1,2,4,0.5,0,0,0.0,2,4,0.5,0.5,2,4,0.5
Rick Brunson,brunsri01,PG,31,TOT,2004,40,412.0,118,82,9,28,37,25,3,33,44,40,105,0.3809523809523809,11,23,0.4782608695652174,29,82,0.3536585365853658,0.433,27,31,0.8709677419354839
Kobe Bryant,bryanko01,SG,25,LAL,2004,65,2447.0,1557,330,103,256,359,112,28,171,176,516,1178,0.4380305602716469,71,217,0.3271889400921659,445,961,0.4630593132154006,0.468,454,533,0.851782363977486
Greg Buckner,buckngr01,SG,27,PHI,2004,53,703.0,164,45,28,75,103,21,4,34,77,66,175,0.3771428571428571,12,44,0.2727272727272727,54,131,0.4122137404580153,0.411,20,27,0.7407407407407407
Rodney Buford,buforro01,SF,26,SAC,2004,22,141.0,41,7,6,9,15,6,1,4,9,19,56,0.3392857142857143,0,2,0.0,19,54,0.3518518518518518,0.339,3,6,0.5
Caron Butler,butleca01,SF,23,MIA,2004,68,2030.0,623,126,92,234,326,75,13,91,162,240,631,0.3803486529318542,10,42,0.238095238095238,230,589,0.3904923599320883,0.388,133,176,0.7556818181818182
Mitchell Butler,butlemi02,SG,33,WAS,2004,41,552.0,134,32,24,47,71,22,4,24,54,54,124,0.4354838709677419,11,30,0.3666666666666666,43,94,0.4574468085106383,0.48,15,24,0.625
Rasual Butler,butlera01,SF,24,MIA,2004,45,675.0,304,23,4,57,61,10,13,28,72,119,250,0.476,50,108,0.4629629629629629,69,142,0.4859154929577465,0.576,16,21,0.7619047619047619
Žarko Čabarkapa,cabarza01,PF,22,PHO,2004,49,570.0,203,40,26,73,99,10,13,54,75,81,197,0.4111675126903553,6,32,0.1875,75,165,0.4545454545454545,0.426,35,53,0.660377358490566
Marcus Camby,cambyma01,C,29,DEN,2004,72,2162.0,622,132,211,516,727,86,187,98,239,262,549,0.4772313296903461,0,2,0.0,262,547,0.4789762340036563,0.477,98,136,0.7205882352941176
Elden Campbell,campbel01,C,35,DET,2004,65,892.0,361,45,52,157,209,21,50,63,137,138,314,0.4394904458598726,0,0,0.0,138,314,0.4394904458598726,0.439,85,124,0.6854838709677419
Brian Cardinal,cardibr01,PF,26,GSW,2004,76,1634.0,733,103,100,217,317,66,20,84,206,220,466,0.4721030042918455,55,124,0.4435483870967742,165,342,0.4824561403508772,0.531,238,271,0.8782287822878229
Matt Carroll,carroma01,SG,23,TOT,2004,16,70.0,19,2,1,5,6,1,0,6,8,7,16,0.4375,1,3,0.3333333333333333,6,13,0.4615384615384615,0.469,4,6,0.6666666666666666
Anthony Carter,cartean01,PG,28,SAS,2004,5,87.0,22,12,2,9,11,4,0,12,9,11,37,0.2972972972972973,0,3,0.0,11,34,0.3235294117647059,0.297,0,0,0.0
Maurice Carter,cartema01,SG,27,TOT,2004,10,110.0,42,4,2,9,11,0,0,9,10,11,35,0.3142857142857143,4,11,0.3636363636363636,7,24,0.2916666666666667,0.371,16,20,0.8
Vince Carter,cartevi01,SG,27,TOR,2004,73,2785.0,1645,348,95,254,349,88,65,223,212,608,1457,0.4172958133150309,93,243,0.382716049382716,515,1214,0.4242174629324547,0.449,336,417,0.8057553956834532
Sam Cassell,cassesa01,PG,34,MIN,2004,81,2838.0,1603,592,44,227,271,102,18,220,247,620,1270,0.4881889763779528,74,186,0.3978494623655914,546,1084,0.503690036900369,0.517,289,331,0.8731117824773413
Kelvin Cato,catoke01,PF,29,HOU,2004,69,1743.0,418,72,153,319,472,52,96,84,203,161,360,0.4472222222222222,0,0,0.0,161,360,0.4472222222222222,0.447,96,142,0.676056338028169
Tyson Chandler,chandty01,PF,21,CHI,2004,35,782.0,213,23,82,188,270,17,43,38,87,67,158,0.4240506329113924,0,1,0.0,67,157,0.4267515923566879,0.424,79,118,0.6694915254237288
Calbert Cheaney,cheanca01,SF,32,GSW,2004,79,2067.0,603,136,77,183,260,60,12,85,184,278,578,0.4809688581314879,0,10,0.0,278,568,0.4894366197183099,0.481,47,77,0.6103896103896104
Doug Christie,chrisdo01,SG,33,SAC,2004,82,2780.0,831,347,69,260,329,151,41,155,186,317,688,0.4607558139534883,49,142,0.3450704225352112,268,546,0.4908424908424908,0.496,148,172,0.8604651162790697
Keon Clark,clarkke01,PF,28,UTA,2004,2,27.0,4,1,1,6,7,1,0,0,1,2,6,0.3333333333333333,0,0,0.0,2,6,0.3333333333333333,0.333,0,0,0.0
Speedy Claxton,claxtsp01,PG,25,GSW,2004,60,1595.0,634,267,38,118,156,97,9,102,146,224,524,0.4274809160305343,4,22,0.1818181818181818,220,502,0.4382470119521912,0.431,182,224,0.8125
Mateen Cleaves,cleavma01,PG,26,CLE,2004,4,92.0,15,19,1,6,7,4,2,5,13,7,23,0.3043478260869565,0,1,0.0,7,22,0.3181818181818182,0.304,1,2,0.5
Derrick Coleman,colemde01,C,36,PHI,2004,34,843.0,271,46,45,147,192,23,26,57,79,107,259,0.4131274131274131,8,36,0.2222222222222222,99,223,0.4439461883408072,0.429,49,65,0.7538461538461538
Bimbo Coles,colesbi01,PG,35,MIA,2004,22,170.0,28,15,2,8,10,3,0,9,27,12,34,0.3529411764705882,0,0,0.0,12,34,0.3529411764705882,0.353,4,6,0.6666666666666666
Jason Collier,collija02,C,26,ATL,2004,20,545.0,226,17,36,75,111,11,11,31,71,79,165,0.4787878787878787,1,4,0.25,78,161,0.484472049689441,0.482,67,85,0.788235294117647
Jarron Collins,collija03,C,25,UTA,2004,81,1732.0,482,77,117,199,316,26,18,79,255,147,295,0.4983050847457627,0,1,0.0,147,294,0.5,0.498,188,262,0.7175572519083969
Jason Collins,collija04,C,25,NJN,2004,78,2220.0,462,153,143,257,400,67,56,97,251,163,384,0.4244791666666667,0,2,0.0,163,382,0.4267015706806282,0.424,136,184,0.7391304347826086
Brian Cook,cookbr01,C,23,LAL,2004,35,442.0,155,20,31,70,101,16,16,17,64,67,141,0.475177304964539,0,5,0.0,67,136,0.4926470588235294,0.475,21,28,0.75
Omar Cook,cookom01,PG,22,POR,2004,17,139.0,14,24,3,3,6,10,0,10,14,7,27,0.2592592592592592,0,1,0.0,7,26,0.2692307692307692,0.259,0,0,0.0
Chris Crawford,crawfch01,PF,28,ATL,2004,56,1207.0,569,45,58,117,175,37,20,55,131,211,471,0.4479830148619957,44,113,0.3893805309734513,167,358,0.4664804469273743,0.495,103,119,0.865546218487395
Jamal Crawford,crawfja01,SG,23,CHI,2004,80,2811.0,1383,405,46,237,283,111,29,193,161,509,1318,0.3861911987860394,165,521,0.3166986564299424,344,797,0.4316185696361355,0.449,200,240,0.8333333333333334
Austin Croshere,croshau01,PF,28,IND,2004,77,1051.0,387,52,60,183,243,24,14,55,101,119,307,0.3876221498371335,56,144,0.3888888888888889,63,163,0.3865030674846625,0.479,93,104,0.8942307692307693
Eddy Curry,curryed01,PF,21,CHI,2004,73,2154.0,1070,68,143,308,451,24,83,177,258,417,840,0.4964285714285714,1,1,1.0,416,839,0.4958283671036949,0.497,235,350,0.6714285714285714
Michael Curry,currymi01,SF,35,TOR,2004,70,1229.0,204,53,22,65,87,23,5,48,153,76,196,0.3877551020408163,3,15,0.2,73,181,0.4033149171270718,0.395,49,58,0.8448275862068966
Samuel Dalembert,dalemsa01,C,22,PHI,2004,82,2197.0,652,21,194,432,626,44,189,86,273,270,499,0.5410821643286573,0,1,0.0,270,498,0.5421686746987951,0.541,112,174,0.6436781609195402
Erick Dampier,dampier01,C,28,GSW,2004,74,2403.0,913,60,344,543,887,33,137,131,227,348,650,0.5353846153846153,0,2,0.0,348,648,0.5370370370370371,0.535,217,332,0.6536144578313253
Antonio Daniels,daniean01,PG,28,SEA,2004,71,1512.0,571,298,23,119,142,45,6,61,64,187,398,0.4698492462311557,42,116,0.3620689655172414,145,282,0.5141843971631206,0.523,155,184,0.842391304347826
Marquis Daniels,daniema01,SG,23,DAL,2004,56,1039.0,477,116,66,80,146,53,12,44,51,203,411,0.4939172749391727,11,36,0.3055555555555556,192,375,0.512,0.507,60,78,0.7692307692307693
Antonio Davis,davisan01,C,35,TOT,2004,80,2570.0,708,137,207,464,671,37,65,114,206,266,660,0.403030303030303,0,0,0.0,266,660,0.403030303030303,0.403,176,230,0.7652173913043478
Baron Davis,davisba01,PG,24,NOH,2004,67,2686.0,1532,501,66,221,287,158,27,215,178,554,1402,0.3951497860199714,187,582,0.3213058419243986,367,820,0.4475609756097561,0.462,237,352,0.6732954545454546
Dale Davis,davisda01,C,34,POR,2004,76,1682.0,331,72,158,240,398,43,62,40,154,133,281,0.4733096085409252,0,0,0.0,133,281,0.4733096085409252,0.473,65,106,0.6132075471698113
Hubert Davis,davishu01,SG,33,TOT,2004,17,78.0,4,4,2,6,8,2,0,3,12,1,11,0.0909090909090909,0,1,0.0,1,10,0.1,0.091,2,2,1.0
Josh Davis,davisjo02,PF,23,ATL,2004,4,23.0,5,0,1,4,5,0,0,2,3,2,5,0.4,0,2,0.0,2,3,0.6666666666666666,0.4,1,1,1.0
Ricky Davis,davisri01,SF-SG,24,TOT,2004,79,2474.0,1140,259,77,281,358,96,22,189,171,446,950,0.4694736842105263,52,140,0.3714285714285714,394,810,0.4864197530864197,0.497,196,273,0.717948717948718
Andrew DeClercq,declean01,C,30,ORL,2004,71,1211.0,230,44,131,186,317,47,32,54,217,93,195,0.4769230769230769,0,0,0.0,93,195,0.4769230769230769,0.477,44,54,0.8148148148148148
Tony Delk,delkto01,SG,30,DAL,2004,33,509.0,197,28,16,43,59,27,7,17,46,70,184,0.3804347826086957,20,66,0.303030303030303,50,118,0.423728813559322,0.435,37,44,0.8409090909090909
Derrick Dial,dialde01,SG,28,ORL,2004,9,86.0,26,2,5,8,13,6,0,1,6,9,28,0.3214285714285714,2,9,0.2222222222222222,7,19,0.3684210526315789,0.357,6,8,0.75
Boris Diaw,diawbo01,SG,21,ATL,2004,76,1919.0,342,182,111,231,342,59,37,126,191,140,313,0.4472843450479233,6,26,0.2307692307692307,134,287,0.4668989547038327,0.457,56,93,0.6021505376344086
Dan Dickau,dickada01,PG,25,TOT,2004,43,294.0,95,38,7,19,26,17,0,26,44,37,98,0.3775510204081632,10,30,0.3333333333333333,27,68,0.3970588235294117,0.429,11,14,0.7857142857142857
Kaniel Dickens,dickeka01,PF,25,POR,2004,3,12.0,7,0,2,0,2,0,0,1,3,3,3,1.0,0,0,0.0,3,3,1.0,1.0,1,2,0.5
DeSagana Diop,diopde01,C,22,CLE,2004,56,730.0,126,34,72,127,199,26,51,29,116,57,147,0.3877551020408163,0,0,0.0,57,147,0.3877551020408163,0.388,12,20,0.6
Vlade Divac,divacvl01,C,35,SAC,2004,81,2317.0,800,432,136,327,463,57,77,173,222,314,668,0.4700598802395209,2,13,0.1538461538461538,312,655,0.4763358778625954,0.472,170,260,0.6538461538461539
Juan Dixon,dixonju01,SG,25,WAS,2004,71,1478.0,664,137,30,118,148,82,4,104,111,247,637,0.3877551020408163,59,198,0.2979797979797979,188,439,0.428246013667426,0.434,111,139,0.7985611510791367
Michael Doleac,doleami01,C,26,TOT,2004,72,1029.0,325,44,88,177,265,23,36,48,142,140,322,0.4347826086956521,0,0,0.0,140,322,0.4347826086956521,0.435,45,52,0.8653846153846154
Keyon Dooling,doolike01,PG,23,LAC,2004,58,1137.0,360,130,17,62,79,45,6,65,108,137,352,0.3892045454545454,8,46,0.1739130434782608,129,306,0.4215686274509804,0.401,78,94,0.8297872340425532
Bryce Drew,drewbr01,PG,29,NOH,2004,15,78.0,12,13,0,6,6,4,0,8,1,4,18,0.2222222222222222,1,7,0.1428571428571428,3,11,0.2727272727272727,0.25,3,3,1.0
Predrag Drobnjak,drobnpr01,C,28,LAC,2004,61,949.0,382,39,54,142,196,22,24,48,85,149,379,0.3931398416886543,11,36,0.3055555555555556,138,343,0.4023323615160349,0.408,73,86,0.8488372093023255
Tim Duncan,duncati01,PF,27,SAS,2004,69,2527.0,1538,213,227,632,859,62,185,183,164,592,1181,0.5012701100762066,2,12,0.1666666666666666,590,1169,0.504704875962361,0.502,352,588,0.5986394557823129
Mike Dunleavy,dunlemi02,SF,23,GSW,2004,75,2336.0,877,220,87,355,442,68,13,143,169,323,720,0.4486111111111111,94,254,0.3700787401574803,229,466,0.4914163090128755,0.514,137,185,0.7405405405405405
Ronald Dupree,duprero01,SF,23,CHI,2004,47,893.0,292,55,55,112,167,32,18,51,134,111,282,0.3936170212765957,4,9,0.4444444444444444,107,273,0.3919413919413919,0.401,66,105,0.6285714285714286
Ndudi Ebi,ebind01,SF,19,MIN,2004,17,32.0,13,3,2,1,3,0,4,3,6,6,14,0.4285714285714285,0,0,0.0,6,14,0.4285714285714285,0.429,1,4,0.25
Howard Eisley,eisleho01,PG,31,TOT,2004,67,1457.0,460,273,20,109,129,56,5,98,137,166,451,0.368070953436807,52,163,0.3190184049079754,114,288,0.3958333333333333,0.426,76,89,0.8539325842696629
Francisco Elson,elsonfr01,C,27,DEN,2004,62,875.0,218,32,65,138,203,35,39,35,145,94,199,0.4723618090452261,0,1,0.0,94,198,0.4747474747474747,0.472,30,45,0.6666666666666666
Melvin Ely,elyme01,PF,25,LAC,2004,42,510.0,157,22,48,53,101,9,17,20,68,66,153,0.4313725490196078,0,1,0.0,66,152,0.4342105263157895,0.431,25,42,0.5952380952380952
Reggie Evans,evansre01,PF,23,SEA,2004,75,1280.0,217,33,156,252,408,54,10,65,176,67,165,0.406060606060606,0,3,0.0,67,162,0.4135802469135802,0.406,83,148,0.5608108108108109
Desmond Ferguson,fergude01,SF,26,POR,2004,7,32.0,13,1,0,4,4,0,0,1,0,5,12,0.4166666666666667,3,8,0.375,2,4,0.5,0.542,0,2,0.0
Michael Finley,finlemi01,SG,30,DAL,2004,72,2778.0,1342,212,78,247,325,84,39,83,118,514,1159,0.4434857635893011,150,370,0.4054054054054054,364,789,0.4613434727503168,0.508,164,193,0.8497409326424871
Derek Fisher,fishede01,SG,29,LAL,2004,82,1769.0,580,187,30,122,152,103,4,79,115,203,576,0.3524305555555556,52,179,0.2905027932960894,151,397,0.380352644836272,0.398,122,153,0.7973856209150327
Marcus Fizer,fizerma01,SF,25,CHI,2004,46,738.0,360,43,61,141,202,16,8,51,97,134,350,0.3828571428571428,2,17,0.1176470588235294,132,333,0.3963963963963964,0.386,90,120,0.75
Alton Ford,fordal02,PF,22,HOU,2004,9,41.0,15,3,3,8,11,0,1,3,9,6,11,0.5454545454545454,0,0,0.0,6,11,0.5454545454545454,0.545,3,6,0.5
T.J. Ford,fordtj01,PG,20,MIL,2004,55,1472.0,391,356,37,140,177,60,3,139,123,153,398,0.3844221105527638,5,21,0.238095238095238,148,377,0.3925729442970822,0.391,80,98,0.8163265306122449
Danny Fortson,fortsda01,C,27,DAL,2004,56,625.0,217,9,114,136,250,12,11,37,148,71,139,0.5107913669064749,0,0,0.0,71,139,0.5107913669064749,0.511,75,92,0.8152173913043478
Jeff Foster,fosteje01,C,27,IND,2004,82,1961.0,497,64,248,362,610,71,27,60,189,197,362,0.5441988950276243,0,4,0.0,197,358,0.5502793296089385,0.544,103,154,0.6688311688311688
Tremaine Fowlkes,fowlktr01,SF,27,DET,2004,36,261.0,44,14,18,35,53,9,3,12,37,15,48,0.3125,1,8,0.125,14,40,0.35,0.323,13,18,0.7222222222222222
Rick Fox,foxri01,SF,34,LAL,2004,38,846.0,183,98,29,73,102,29,4,48,99,73,186,0.3924731182795699,15,61,0.2459016393442623,58,125,0.464,0.433,22,30,0.7333333333333333
Adonal Foyle,foylead01,C,28,GSW,2004,44,572.0,137,17,54,113,167,6,46,21,68,59,130,0.4538461538461538,0,0,0.0,59,130,0.4538461538461538,0.454,19,35,0.5428571428571428
Richie Frahm,frahmri01,SF,26,SEA,2004,54,469.0,183,24,12,44,56,16,4,7,50,63,139,0.4532374100719424,34,92,0.3695652173913043,29,47,0.6170212765957447,0.576,23,26,0.8846153846153846
Steve Francis,francst01,PG,26,HOU,2004,79,3194.0,1310,493,116,317,433,139,35,294,257,450,1117,0.4028648164726947,73,250,0.292,377,867,0.4348327566320646,0.436,337,435,0.774712643678161
Hiram Fuller,fullehi01,PF,22,ATL,2004,4,43.0,8,2,4,7,11,0,1,4,5,3,8,0.375,0,0,0.0,3,8,0.375,0.375,2,6,0.3333333333333333
Dan Gadzuric,gadzuda01,C,25,MIL,2004,75,1260.0,424,28,126,220,346,51,105,45,186,183,349,0.5243553008595988,0,1,0.0,183,348,0.5258620689655172,0.524,58,118,0.4915254237288136
Reece Gaines,gainere01,PG,23,ORL,2004,38,364.0,69,40,8,31,39,11,2,18,22,25,86,0.2906976744186046,3,10,0.3,22,76,0.2894736842105263,0.308,16,25,0.64
Alex Garcia,garcial01,SG,23,SAS,2004,2,13.0,3,0,0,0,0,2,0,1,0,1,7,0.1428571428571428,0,0,0.0,1,7,0.1428571428571428,0.143,1,2,0.5
Kevin Garnett,garneke01,PF,27,MIN,2004,82,3231.0,1987,409,245,894,1139,120,178,212,202,804,1611,0.4990689013035381,11,43,0.2558139534883721,793,1568,0.5057397959183674,0.502,368,465,0.7913978494623656
Pat Garrity,garripa01,PF,27,ORL,2004,2,22.0,2,1,0,0,0,0,0,0,2,1,3,0.3333333333333333,0,0,0.0,1,3,0.3333333333333333,0.333,0,0,0.0
Pau Gasol,gasolpa01,PF,23,MEM,2004,78,2458.0,1381,198,206,394,600,44,132,187,185,506,1049,0.4823641563393708,4,15,0.2666666666666666,502,1034,0.4854932301740812,0.484,365,511,0.7142857142857143
Devean George,georgde01,SF,26,LAL,2004,82,1951.0,604,112,87,245,332,81,38,88,189,233,571,0.4080560420315236,65,186,0.3494623655913978,168,385,0.4363636363636363,0.465,73,96,0.7604166666666666
Eddie Gill,gilled01,PG,25,POR,2004,22,157.0,50,16,4,13,17,9,1,12,16,15,36,0.4166666666666667,3,8,0.375,12,28,0.4285714285714285,0.458,17,20,0.85
Kendall Gill,gillke01,SG,35,CHI,2004,56,1411.0,539,89,61,129,190,65,16,83,107,215,548,0.3923357664233576,9,38,0.2368421052631578,206,510,0.403921568627451,0.401,100,136,0.7352941176470589
Manu Ginóbili,ginobma01,SG,26,SAS,2004,77,2260.0,987,291,86,258,344,136,16,161,181,330,789,0.4182509505703422,88,245,0.3591836734693877,242,544,0.4448529411764705,0.474,239,298,0.802013422818792
Gordan Giriček,giricgo01,SF-SG,26,TOT,2004,73,2041.0,827,122,51,175,226,56,15,103,144,316,724,0.43646408839779,60,152,0.3947368421052631,256,572,0.4475524475524475,0.478,135,158,0.8544303797468354
Dion Glover,glovedi01,SG,25,TOT,2004,69,1643.0,620,130,58,208,266,50,19,102,123,230,589,0.3904923599320883,40,119,0.3361344537815126,190,470,0.4042553191489361,0.424,120,156,0.7692307692307693
Anthony Goldwire,goldwan01,PG,32,TOT,2004,11,85.0,17,11,1,6,7,5,0,3,5,7,22,0.3181818181818182,2,8,0.25,5,14,0.3571428571428571,0.364,1,1,1.0
Drew Gooden,goodedr01,PF,22,ORL,2004,79,2134.0,914,89,160,356,516,62,72,126,196,369,829,0.4451145958986731,9,42,0.2142857142857142,360,787,0.4574332909783989,0.451,167,262,0.6374045801526718
Brian Grant,grantbr01,C,31,MIA,2004,76,2303.0,664,69,174,350,524,51,35,82,254,289,613,0.4714518760195758,0,1,0.0,289,612,0.4722222222222222,0.471,86,110,0.7818181818181819
Horace Grant,grantho01,PF,38,LAL,2004,55,1106.0,223,71,79,154,233,24,21,29,70,92,224,0.4107142857142857,0,1,0.0,92,223,0.4125560538116592,0.411,39,54,0.7222222222222222
Paul Grant,grantpa01,C,30,UTA,2004,10,98.0,25,3,7,10,17,1,1,7,17,11,23,0.4782608695652174,0,0,0.0,11,23,0.4782608695652174,0.478,3,8,0.375
Willie Green,greenwi01,SG,22,PHI,2004,53,767.0,364,53,16,49,65,26,5,59,83,143,357,0.4005602240896359,19,61,0.3114754098360656,124,296,0.4189189189189189,0.427,59,81,0.7283950617283951
Adrian Griffin,griffad01,SG,29,HOU,2004,19,133.0,11,10,1,18,19,7,2,3,17,5,18,0.2777777777777778,1,2,0.5,4,16,0.25,0.306,0,4,0.0
Tom Gugliotta,guglito01,PF,34,TOT,2004,55,819.0,161,63,65,122,187,31,12,39,81,70,203,0.3448275862068966,1,4,0.25,69,199,0.3467336683417085,0.347,20,28,0.7142857142857143
Marcus Haislip,haislma01,PF,23,MIL,2004,31,263.0,93,4,21,32,53,6,12,9,25,36,74,0.4864864864864865,1,2,0.5,35,72,0.4861111111111111,0.493,20,28,0.7142857142857143
Darvin Ham,hamda01,SF,30,DET,2004,54,484.0,96,16,47,46,93,13,8,31,63,37,75,0.4933333333333333,1,2,0.5,36,73,0.4931506849315068,0.5,21,35,0.6
Richard Hamilton,hamilri01,SG,25,DET,2004,78,2772.0,1375,310,78,201,279,103,17,210,222,530,1166,0.4545454545454545,18,68,0.2647058823529412,512,1098,0.4663023679417122,0.462,297,342,0.868421052631579
Zendon Hamilton,hamilze01,C,28,PHI,2004,46,473.0,169,13,49,97,146,8,8,27,74,51,95,0.5368421052631579,0,0,0.0,51,95,0.5368421052631579,0.537,67,96,0.6979166666666666
Ben Handlogten,handlbe01,C,30,UTA,2004,17,172.0,68,6,22,33,55,3,4,10,32,25,47,0.5319148936170213,0,0,0.0,25,47,0.5319148936170213,0.532,18,27,0.6666666666666666
Travis Hansen,hansetr01,SF,25,ATL,2004,41,507.0,123,19,30,40,70,10,9,15,67,46,130,0.3538461538461538,9,30,0.3,37,100,0.37,0.388,22,27,0.8148148148148148
Anfernee Hardaway,hardaan01,SG,32,TOT,2004,76,2095.0,699,176,69,218,287,70,20,107,146,279,679,0.4108983799705449,30,79,0.379746835443038,249,600,0.415,0.433,111,138,0.8043478260869565
Matt Harpring,harprma01,SF,27,UTA,2004,31,1134.0,502,63,91,156,247,22,2,65,102,193,410,0.4707317073170731,8,33,0.2424242424242424,185,377,0.4907161803713528,0.48,108,157,0.6878980891719745
Al Harrington,harrial01,PF,23,IND,2004,79,2441.0,1048,131,163,345,508,80,22,163,250,421,909,0.4631463146314631,21,77,0.2727272727272727,400,832,0.4807692307692308,0.475,185,252,0.7341269841269841
Othella Harrington,harriot01,PF,30,NYK,2004,56,872.0,258,29,58,119,177,12,14,65,134,100,202,0.495049504950495,0,0,0.0,100,202,0.495049504950495,0.495,58,78,0.7435897435897436
Lucious Harris,harrilu01,PG,33,NJN,2004,69,1504.0,478,135,39,101,140,41,2,53,74,187,463,0.4038876889848812,38,101,0.3762376237623762,149,362,0.4116022099447514,0.445,66,78,0.8461538461538461
Jason Hart,hartja01,PG,25,SAS,2004,53,660.0,177,81,10,69,79,28,5,29,59,71,159,0.4465408805031446,2,9,0.2222222222222222,69,150,0.46,0.453,33,43,0.7674418604651163
Donnell Harvey,harvedo01,PF,23,TOT,2004,60,783.0,239,21,48,116,164,24,27,45,129,89,201,0.4427860696517413,0,3,0.0,89,198,0.4494949494949495,0.443,61,83,0.7349397590361446
Udonis Haslem,hasleud01,PF,23,MIA,2004,75,1795.0,550,51,189,284,473,33,24,74,197,205,447,0.4586129753914988,0,3,0.0,205,444,0.4617117117117117,0.459,140,183,0.7650273224043715
Trenton Hassell,hassetr01,SG,24,MIN,2004,81,2264.0,406,133,68,189,257,36,54,46,200,177,381,0.4645669291338583,4,13,0.3076923076923077,173,368,0.4701086956521739,0.47,48,61,0.7868852459016393
Jarvis Hayes,hayesja01,SF,22,WAS,2004,70,2044.0,673,106,71,193,264,71,11,110,157,278,695,0.4,40,131,0.3053435114503817,238,564,0.4219858156028369,0.429,77,98,0.7857142857142857
Brendan Haywood,haywobr01,C,24,WAS,2004,77,1484.0,537,43,186,201,387,32,100,80,154,200,388,0.5154639175257731,0,1,0.0,200,387,0.5167958656330749,0.515,137,234,0.5854700854700855
Shane Heal,healsh01,PG,33,SAS,2004,6,72.0,22,5,1,3,4,1,0,5,2,7,24,0.2916666666666667,4,18,0.2222222222222222,3,6,0.5,0.375,4,5,0.8
Alan Henderson,hendeal01,PF,31,ATL,2004,6,68.0,24,2,11,10,21,1,2,3,1,10,21,0.4761904761904761,0,0,0.0,10,21,0.4761904761904761,0.476,4,6,0.6666666666666666
Nenê,hilarne01,PF,21,DEN,2004,77,2504.0,908,168,154,349,503,116,41,183,280,334,630,0.5301587301587302,0,2,0.0,334,628,0.5318471337579618,0.53,240,352,0.6818181818181818
Tyrone Hill,hillty01,PF,35,MIA,2004,5,38.0,9,0,5,3,8,0,1,2,10,3,5,0.6,0,0,0.0,3,5,0.6,0.6,3,4,0.75
Kirk Hinrich,hinriki01,PG,23,CHI,2004,76,2706.0,915,517,42,217,259,101,21,204,276,318,823,0.3863912515188335,144,369,0.3902439024390244,174,454,0.3832599118942731,0.474,135,168,0.8035714285714286
Fred Hoiberg,hoibefr01,SG,31,MIN,2004,79,1804.0,530,109,21,247,268,66,10,44,136,178,383,0.464751958224543,76,172,0.4418604651162791,102,211,0.4834123222748815,0.564,98,116,0.8448275862068966
Robert Horry,horryro01,PF,33,SAS,2004,81,1290.0,392,101,108,164,272,48,49,55,165,141,348,0.4051724137931034,41,108,0.3796296296296296,100,240,0.4166666666666667,0.464,69,107,0.6448598130841121
Eddie House,houseed01,SG,25,LAC,2004,60,1188.0,409,148,28,110,138,65,4,63,92,161,449,0.3585746102449889,51,136,0.375,110,313,0.3514376996805112,0.415,36,45,0.8
Allan Houston,houstal01,SG,32,NYK,2004,50,1799.0,924,99,20,101,121,38,2,102,105,340,781,0.4353393085787452,87,202,0.4306930693069307,253,579,0.4369602763385147,0.491,157,172,0.9127906976744186
Josh Howard,howarjo01,SF,23,DAL,2004,67,1589.0,575,97,149,219,368,69,54,67,168,229,532,0.4304511278195488,20,66,0.303030303030303,209,466,0.4484978540772532,0.449,97,138,0.7028985507246377
Juwan Howard,howarju01,PF,30,ORL,2004,81,2877.0,1376,158,171,399,570,54,22,178,284,529,1169,0.4525235243798118,0,1,0.0,529,1168,0.4529109589041096,0.453,318,393,0.8091603053435115
Troy Hudson,hudsotr01,PG,27,MIN,2004,29,503.0,218,70,4,31,35,7,0,34,32,80,207,0.3864734299516908,31,77,0.4025974025974026,49,130,0.3769230769230769,0.461,27,33,0.8181818181818182
Larry Hughes,hughela01,SG,25,WAS,2004,61,2061.0,1148,148,96,230,326,95,26,152,147,401,1009,0.3974231912784935,79,232,0.3405172413793103,322,777,0.4144144144144144,0.437,267,335,0.7970149253731343
Ryan Humphrey,humphry01,PF,24,MEM,2004,2,11.0,2,1,2,1,3,1,0,2,3,1,4,0.25,0,1,0.0,1,3,0.3333333333333333,0.25,0,0,0.0
Brandon Hunter,huntebr01,PF,23,BOS,2004,36,406.0,125,19,50,68,118,13,1,22,40,53,116,0.4568965517241379,0,3,0.0,53,113,0.4690265486725664,0.457,19,43,0.4418604651162791
Lindsey Hunter,hunteli01,SG,33,DET,2004,33,661.0,117,85,13,54,67,39,6,34,45,49,143,0.3426573426573426,14,50,0.28,35,93,0.3763440860215054,0.392,5,8,0.625
Steven Hunter,huntest01,C,22,ORL,2004,59,789.0,187,12,54,116,170,5,73,29,101,82,155,0.5290322580645161,0,0,0.0,82,155,0.5290322580645161,0.529,23,69,0.3333333333333333
Zydrunas Ilgauskas,ilgauzy01,C,28,CLE,2004,81,2539.0,1237,109,279,374,653,39,201,163,277,466,965,0.482901554404145,2,7,0.2857142857142857,464,958,0.4843423799582463,0.484,303,406,0.7463054187192119
Allen Iverson,iversal01,SG,28,PHI,2004,48,2040.0,1266,324,34,144,178,115,5,209,87,435,1125,0.3866666666666666,57,199,0.2864321608040201,378,926,0.408207343412527,0.412,339,455,0.7450549450549451
Bobby Jackson,jacksbo01,SG,30,SAC,2004,50,1185.0,689,105,55,119,174,49,8,63,106,263,592,0.4442567567567567,81,219,0.3698630136986301,182,373,0.4879356568364611,0.513,82,109,0.7522935779816514
Jim Jackson,jacksji01,SF,33,HOU,2004,80,3119.0,1033,226,52,435,487,86,23,175,227,382,900,0.4244444444444444,162,405,0.4,220,495,0.4444444444444444,0.514,107,127,0.84251968503937
Marc Jackson,jacksma02,PF,29,PHI,2004,22,598.0,206,18,45,81,126,12,6,24,45,71,171,0.4152046783625731,0,1,0.0,71,170,0.4176470588235294,0.415,64,81,0.7901234567901234
Mark Jackson,jacksma01,PG,38,HOU,2004,42,577.0,103,119,10,60,70,17,1,53,41,34,100,0.34,7,41,0.1707317073170731,27,59,0.4576271186440678,0.375,28,39,0.717948717948718
Stephen Jackson,jacksst02,SF,25,ATL,2004,80,2940.0,1450,244,97,273,370,142,20,223,216,536,1261,0.4250594766058683,145,427,0.3395784543325527,391,834,0.4688249400479616,0.483,233,297,0.7845117845117845
Casey Jacobsen,jacobca01,SF,22,PHO,2004,78,1828.0,466,98,42,159,201,48,9,68,144,150,360,0.4166666666666667,75,180,0.4166666666666667,75,180,0.4166666666666667,0.521,91,111,0.8198198198198198
Jerome James,jamesje01,C,28,SEA,2004,65,990.0,324,32,78,152,230,20,60,82,180,129,259,0.4980694980694981,0,0,0.0,129,259,0.4980694980694981,0.498,66,100,0.66
LeBron James,jamesle01,SG,19,CLE,2004,79,3122.0,1654,465,99,333,432,130,58,273,149,622,1492,0.4168900804289544,63,217,0.2903225806451613,559,1275,0.4384313725490196,0.438,347,460,0.7543478260869565
Mike James,jamesmi01,PG,28,TOT,2004,81,2196.0,753,339,28,206,234,96,3,124,156,272,657,0.4140030441400304,106,281,0.3772241992882562,166,376,0.4414893617021276,0.495,103,127,0.8110236220472441
Antawn Jamison,jamisan01,SF,27,DAL,2004,82,2376.0,1212,70,233,287,520,83,30,81,174,488,913,0.5345016429353778,16,40,0.4,472,873,0.5406643757159221,0.543,220,294,0.7482993197278912
Marko Jarić,jaricma01,PG,25,LAC,2004,58,1760.0,495,281,44,131,175,93,20,115,132,185,477,0.3878406708595387,51,150,0.34,134,327,0.4097859327217125,0.441,74,101,0.7326732673267327
Chris Jefferies,jeffech01,SF-SG,23,TOT,2004,21,195.0,84,7,5,24,29,4,7,19,36,27,72,0.375,17,42,0.4047619047619047,10,30,0.3333333333333333,0.493,13,20,0.65
Richard Jefferson,jefferi01,SF,23,NJN,2004,82,3133.0,1515,315,109,355,464,92,28,198,224,555,1115,0.4977578475336323,48,132,0.3636363636363636,507,983,0.5157680569684638,0.519,357,468,0.7628205128205128
Jared Jeffries,jeffrja01,PF,22,WAS,2004,82,1913.0,464,93,180,244,424,48,28,107,212,177,469,0.3773987206823028,5,30,0.1666666666666666,172,439,0.3917995444191344,0.383,105,171,0.6140350877192983
Britton Johnsen,johnsbr01,C,24,ORL,2004,20,290.0,42,12,15,30,45,7,1,14,28,17,59,0.288135593220339,1,12,0.0833333333333333,16,47,0.3404255319148936,0.297,7,16,0.4375
Anthony Johnson,johnsan02,PG,29,IND,2004,73,1598.0,450,202,28,102,130,64,8,75,138,167,411,0.4063260340632603,41,122,0.3360655737704918,126,289,0.4359861591695502,0.456,75,94,0.7978723404255319
Avery Johnson,johnsav01,PG,38,GSW,2004,46,637.0,212,111,3,30,33,26,3,51,34,80,199,0.4020100502512563,0,3,0.0,80,196,0.4081632653061224,0.402,52,78,0.6666666666666666
DerMarr Johnson,johnsde03,SF,23,NYK,2004,21,287.0,113,11,5,34,39,8,7,16,32,36,97,0.3711340206185567,13,36,0.3611111111111111,23,61,0.3770491803278688,0.438,28,31,0.9032258064516128
Ervin Johnson,johnser02,C,36,MIN,2004,66,965.0,127,24,61,171,232,27,43,30,156,55,103,0.5339805825242718,0,1,0.0,55,102,0.5392156862745098,0.534,17,28,0.6071428571428571
Joe Johnson,johnsjo02,SG,22,PHO,2004,82,3331.0,1367,362,80,305,385,93,26,199,177,555,1291,0.4298993028659953,83,272,0.3051470588235294,472,1019,0.4631992149165849,0.462,174,232,0.75
Linton Johnson,johnsli01,SF,23,CHI,2004,41,734.0,173,27,59,124,183,37,32,37,90,72,203,0.354679802955665,7,33,0.2121212121212121,65,170,0.3823529411764705,0.372,22,37,0.5945945945945946
Dahntay Jones,jonesda02,SG,23,MEM,2004,20,154.0,36,12,7,16,23,5,6,12,23,15,53,0.2830188679245283,1,4,0.25,14,49,0.2857142857142857,0.292,5,11,0.4545454545454545
Damon Jones,jonesda01,PG,27,MIL,2004,82,2016.0,573,478,15,155,170,30,4,103,92,210,524,0.4007633587786259,98,273,0.358974358974359,112,251,0.446215139442231,0.494,55,72,0.7638888888888888
Eddie Jones,jonesed02,SG,32,MIA,2004,81,2998.0,1401,258,38,270,308,92,34,129,226,473,1156,0.4091695501730104,177,479,0.3695198329853862,296,677,0.4372230428360413,0.486,278,333,0.8348348348348348
Fred Jones,jonesfr01,SG,24,IND,2004,81,1508.0,397,173,25,101,126,65,18,73,132,123,311,0.3954983922829582,27,89,0.3033707865168539,96,222,0.4324324324324324,0.439,124,149,0.8322147651006712
James Jones,jonesja02,SF,23,IND,2004,6,26.0,7,0,0,2,2,1,0,0,1,2,9,0.2222222222222222,1,4,0.25,1,5,0.2,0.278,2,2,1.0
Jumaine Jones,jonesju01,SG,24,BOS,2004,42,373.0,93,14,24,44,68,12,9,19,48,33,96,0.34375,13,44,0.2954545454545454,20,52,0.3846153846153846,0.411,14,23,0.6086956521739131
Popeye Jones,jonespo01,PF,33,GSW,2004,5,10.0,0,0,1,0,1,0,0,0,2,0,2,0.0,0,0,0.0,0,2,0.0,0.0,0,0,0.0
Chris Kaman,kamanch01,C,21,LAC,2004,82,1843.0,499,85,126,335,461,23,73,155,211,200,435,0.4597701149425287,0,2,0.0,200,433,0.4618937644341801,0.46,99,142,0.6971830985915493
Jason Kapono,kaponja01,SF,22,CLE,2004,41,427.0,145,14,19,36,55,13,2,21,41,52,129,0.4031007751937984,21,44,0.4772727272727273,31,85,0.3647058823529411,0.484,20,24,0.8333333333333334
Jason Kidd,kiddja01,PG,30,NJN,2004,67,2450.0,1036,618,85,343,428,122,14,214,110,368,959,0.3837330552659019,94,293,0.3208191126279863,274,666,0.4114114114114114,0.433,206,249,0.8273092369477911
Andrei Kirilenko,kirilan01,PF,22,UTA,2004,78,2895.0,1284,244,226,403,629,150,215,215,174,412,931,0.4425349087003222,68,201,0.3383084577114428,344,730,0.4712328767123288,0.479,392,496,0.7903225806451613
Kerry Kittles,kittlke01,SG,29,NJN,2004,82,2842.0,1072,206,56,271,327,125,40,95,144,434,959,0.4525547445255474,97,276,0.3514492753623188,337,683,0.493411420204978,0.503,107,136,0.7867647058823529
Brevin Knight,knighbr01,PG,28,TOT,2004,56,1037.0,261,204,14,98,112,84,1,72,107,105,246,0.4268292682926829,2,8,0.25,103,238,0.4327731092436975,0.431,49,65,0.7538461538461538
Kyle Korver,korveky01,SF,22,PHI,2004,74,882.0,330,40,30,81,111,25,8,41,102,115,327,0.3516819571865443,81,207,0.391304347826087,34,120,0.2833333333333333,0.476,19,24,0.7916666666666666
Toni Kukoč,kukocto01,PF,35,MIL,2004,73,1522.0,616,200,60,211,271,59,21,110,110,211,506,0.41699604743083,49,168,0.2916666666666667,162,338,0.4792899408284023,0.465,145,199,0.7286432160804021
Christian Laettner,laettch01,PF,34,WAS,2004,48,984.0,284,89,50,182,232,37,28,42,102,119,256,0.46484375,6,21,0.2857142857142857,113,235,0.4808510638297872,0.477,40,50,0.8
Raef LaFrentz,lafrera01,C,27,BOS,2004,17,328.0,132,24,30,49,79,8,13,11,47,57,124,0.4596774193548387,8,40,0.2,49,84,0.5833333333333334,0.492,10,13,0.7692307692307693
Maciej Lampe,lampema01,C,18,PHO,2004,21,224.0,96,9,9,35,44,3,3,15,28,43,88,0.4886363636363636,0,4,0.0,43,84,0.5119047619047619,0.489,10,13,0.7692307692307693
Sean Lampley,lamplse01,SF,24,GSW,2004,10,63.0,34,2,2,9,11,0,1,3,2,13,20,0.65,0,0,0.0,13,20,0.65,0.65,8,12,0.6666666666666666
Dan Langhi,langhda01,SF,26,TOT,2004,6,37.0,13,0,0,4,4,0,0,2,7,5,14,0.3571428571428571,1,2,0.5,4,12,0.3333333333333333,0.393,2,2,1.0
Rusty LaRue,larueru01,PG,30,GSW,2004,4,22.0,4,2,0,3,3,2,0,4,2,1,3,0.3333333333333333,1,1,1.0,0,2,0.0,0.5,1,2,0.5
Voshon Lenard,lenarvo01,SG,30,DEN,2004,73,2233.0,1038,151,46,154,200,61,12,101,177,394,933,0.4222936763129689,106,289,0.3667820069204152,288,644,0.4472049689440994,0.479,144,182,0.7912087912087912
Quincy Lewis,lewisqu01,SF,26,MIN,2004,14,65.0,16,2,1,6,7,2,2,3,10,7,20,0.35,2,5,0.4,5,15,0.3333333333333333,0.4,0,0,0.0
Rashard Lewis,lewisra02,SF,24,SEA,2004,80,2931.0,1421,175,133,385,518,99,54,135,233,535,1229,0.435313262815297,145,386,0.3756476683937824,390,843,0.4626334519572954,0.494,206,270,0.762962962962963
Randy Livingston,livinra01,PG,28,LAC,2004,4,48.0,8,4,2,5,7,2,0,4,7,2,10,0.2,0,3,0.0,2,7,0.2857142857142857,0.2,4,6,0.6666666666666666
Raül López,lopezra01,PG,23,UTA,2004,82,1617.0,572,305,24,131,155,62,2,174,200,223,517,0.4313346228239845,25,85,0.2941176470588235,198,432,0.4583333333333333,0.456,101,117,0.8632478632478633
Tyronn Lue,luety01,PG,26,ORL,2004,76,2332.0,799,317,26,161,187,61,5,124,185,309,714,0.4327731092436975,80,209,0.3827751196172249,229,505,0.4534653465346535,0.489,101,131,0.7709923664122137
George Lynch,lynchge01,SF,33,NOH,2004,78,1701.0,375,117,96,216,312,48,18,64,159,149,375,0.3973333333333333,43,139,0.3093525179856115,106,236,0.4491525423728814,0.455,34,51,0.6666666666666666
Mark Madsen,madsema01,C,28,MIN,2004,72,1246.0,259,28,134,138,272,33,18,47,175,101,204,0.4950980392156863,0,6,0.0,101,198,0.51010101010101,0.495,57,118,0.4830508474576271
Corey Maggette,maggeco01,SF,24,LAC,2004,73,2628.0,1508,224,96,334,430,65,16,207,217,453,1013,0.4471865745310958,76,231,0.329004329004329,377,782,0.4820971867007673,0.485,526,620,0.8483870967741935
Jamaal Magloire,magloja01,C,25,NOH,2004,82,2777.0,1119,86,268,579,847,43,101,201,278,383,809,0.4734239802224969,0,1,0.0,383,808,0.474009900990099,0.473,353,470,0.7510638297872341
Karl Malone,malonka01,PF,40,LAL,2004,42,1373.0,554,163,61,306,367,50,20,103,116,193,400,0.4825,0,1,0.0,193,399,0.4837092731829573,0.483,168,225,0.7466666666666667
Stephon Marbury,marbust01,PG,26,TOT,2004,81,3254.0,1639,719,58,205,263,129,9,249,172,598,1386,0.4314574314574315,87,274,0.3175182481751825,511,1112,0.4595323741007194,0.463,356,436,0.8165137614678899
Shawn Marion,mariosh01,SF,25,PHO,2004,79,3217.0,1498,214,212,525,737,167,104,156,203,590,1341,0.4399701715137957,90,265,0.3396226415094339,500,1076,0.4646840148698885,0.474,228,268,0.8507462686567164
Donyell Marshall,marshdo01,PF,30,TOT,2004,82,2988.0,1205,122,210,598,808,93,124,117,247,470,1020,0.4607843137254901,131,325,0.403076923076923,339,695,0.4877697841726618,0.525,134,182,0.7362637362637363
Darrick Martin,martida01,PG,32,MIN,2004,16,172.0,55,23,2,5,7,2,1,7,23,20,67,0.2985074626865671,6,26,0.2307692307692307,14,41,0.3414634146341463,0.343,9,9,1.0
Kenyon Martin,martike01,PF,26,NJN,2004,65,2252.0,1086,160,133,484,617,95,82,168,230,439,900,0.4877777777777777,7,25,0.28,432,875,0.4937142857142857,0.492,201,294,0.6836734693877551
Jamal Mashburn,mashbja01,SF,31,NOH,2004,19,730.0,396,47,19,98,117,14,5,37,42,156,398,0.3919597989949748,19,67,0.2835820895522388,137,331,0.4138972809667673,0.416,65,80,0.8125
Desmond Mason,masonde01,SF,26,MIL,2004,82,2534.0,1183,152,93,266,359,60,24,148,191,409,867,0.4717416378316032,9,39,0.2307692307692307,400,828,0.4830917874396135,0.477,356,463,0.7688984881209503
Roger Mason,masonro01,SG,23,TOT,2004,26,328.0,96,26,1,30,31,11,6,20,36,32,98,0.3265306122448979,13,39,0.3333333333333333,19,59,0.3220338983050847,0.393,19,22,0.8636363636363636
Tony Massenburg,masseto01,PF,36,SAC,2004,59,789.0,251,29,57,131,188,14,18,45,144,104,219,0.4748858447488584,0,1,0.0,104,218,0.4770642201834862,0.475,43,63,0.6825396825396826
Walter McCarty,mccarwa01,PF,29,BOS,2004,77,1900.0,605,124,28,211,239,72,22,91,179,203,523,0.3881453154875717,137,366,0.3743169398907104,66,157,0.4203821656050955,0.519,62,82,0.7560975609756098
Amal McCaskill,mccasam01,C,30,PHI,2004,59,636.0,113,20,48,85,133,12,20,25,89,47,117,0.4017094017094017,0,1,0.0,47,116,0.4051724137931034,0.402,19,27,0.7037037037037037
Jelani McCoy,mccoyje01,C,26,CLE,2004,2,12.0,0,0,1,3,4,0,0,1,4,0,0,0.0,0,0,0.0,0,0,0.0,0.0,0,0,0.0
Antonio McDyess,mcdyean01,PF,29,TOT,2004,42,927.0,290,36,70,187,257,37,24,57,117,126,268,0.4701492537313433,0,0,0.0,126,268,0.4701492537313433,0.47,38,69,0.5507246376811594
Tracy McGrady,mcgratr01,SG,24,ORL,2004,67,2675.0,1878,370,95,307,402,93,42,179,129,653,1566,0.4169859514687101,174,513,0.3391812865497076,479,1053,0.4548907882241215,0.473,398,500,0.796
Jeff McInnis,mcinnje01,SG-PG,29,TOT,2004,70,2365.0,828,430,33,143,176,72,6,120,163,334,747,0.4471218206157965,46,127,0.3622047244094488,288,620,0.4645161290322581,0.478,114,143,0.7972027972027972
Aaron McKie,mckieaa01,SF,31,PHI,2004,75,2112.0,689,195,45,208,253,85,23,103,142,265,577,0.4592720970537262,75,172,0.436046511627907,190,405,0.4691358024691358,0.524,84,111,0.7567567567567568
Keith McLeod,mcleoke01,PG,24,MIN,2004,33,391.0,88,59,5,29,34,16,1,29,39,27,82,0.3292682926829268,1,10,0.1,26,72,0.3611111111111111,0.335,33,43,0.7674418604651163
Stanislav Medvedenko,medvest01,PF,24,LAL,2004,68,1442.0,563,57,148,195,343,38,18,59,191,237,537,0.441340782122905,0,3,0.0,237,534,0.4438202247191011,0.441,89,116,0.7672413793103449
Ron Mercer,mercero01,SG,27,SAS,2004,39,516.0,195,22,10,39,49,14,5,26,37,90,211,0.4265402843601896,2,7,0.2857142857142857,88,204,0.4313725490196078,0.431,13,17,0.7647058823529411
Chris Mihm,mihmch01,C-PF,24,TOT,2004,76,1330.0,482,21,156,257,413,37,63,90,208,186,381,0.4881889763779528,0,0,0.0,186,381,0.4881889763779528,0.488,110,166,0.6626506024096386
Darius Miles,milesda01,SF,22,TOT,2004,79,2079.0,861,162,112,247,359,67,61,130,168,365,753,0.4847277556440903,7,40,0.175,358,713,0.5021037868162693,0.489,124,193,0.6424870466321243
Darko Miličić,milicda01,C,18,DET,2004,34,159.0,48,7,11,32,43,7,15,13,33,17,65,0.2615384615384615,0,1,0.0,17,64,0.265625,0.262,14,24,0.5833333333333334
Andre Miller,millean02,PG,27,DEN,2004,82,2838.0,1214,501,127,239,366,142,25,215,194,430,941,0.4569606801275239,12,65,0.1846153846153846,418,876,0.4771689497716895,0.463,342,411,0.8321167883211679
Brad Miller,millebr01,PF,27,SAC,2004,72,2621.0,1014,312,191,552,743,68,86,144,247,373,731,0.5102599179206566,12,38,0.3157894736842105,361,693,0.5209235209235209,0.518,256,329,0.7781155015197568
Mike Miller,millemi01,SF,23,MEM,2004,65,1770.0,722,232,42,174,216,59,14,107,162,270,616,0.4383116883116883,80,215,0.3720930232558139,190,401,0.4738154613466334,0.503,102,141,0.723404255319149
Oliver Miller,milleol01,C,33,MIN,2004,48,506.0,121,36,46,84,130,19,26,33,91,53,100,0.53,0,1,0.0,53,99,0.5353535353535354,0.53,15,23,0.6521739130434783
Reggie Miller,millere01,SG,38,IND,2004,80,2254.0,800,249,18,170,188,65,11,68,96,260,594,0.4377104377104377,134,334,0.4011976047904191,126,260,0.4846153846153846,0.551,146,165,0.8848484848484849
Yao Ming,mingya01,C,23,HOU,2004,82,2692.0,1431,122,197,538,735,22,156,204,273,535,1025,0.5219512195121951,0,2,0.0,535,1023,0.52297165200391,0.522,361,446,0.8094170403587444
Cuttino Mobley,moblecu01,SG,28,HOU,2004,80,3229.0,1260,258,40,322,362,107,33,180,179,460,1081,0.425531914893617,164,420,0.3904761904761905,296,661,0.4478063540090771,0.501,176,217,0.8110599078341014
Nazr Mohammed,mohamna01,C,26,TOT,2004,80,1611.0,592,36,178,296,474,55,52,96,195,246,472,0.5211864406779662,0,0,0.0,246,472,0.5211864406779662,0.521,100,169,0.591715976331361
Jérôme Moïso,moisoje01,PF,25,TOR,2004,35,417.0,102,8,41,72,113,17,12,25,42,40,84,0.4761904761904761,0,1,0.0,40,83,0.4819277108433735,0.476,22,38,0.5789473684210527
Mikki Moore,mooremi01,PF-C,28,TOT,2004,32,395.0,130,19,29,55,84,7,13,22,65,50,99,0.5050505050505051,0,0,0.0,50,99,0.5050505050505051,0.505,30,35,0.8571428571428571
Alonzo Mourning,mournal01,C,33,NJN,2004,12,215.0,96,8,8,19,27,2,6,10,32,33,71,0.4647887323943662,0,0,0.0,33,71,0.4647887323943662,0.465,30,34,0.8823529411764706
Troy Murphy,murphtr01,PF,23,GSW,2004,28,610.0,279,20,48,125,173,12,17,34,58,107,243,0.4403292181069959,5,17,0.2941176470588235,102,226,0.4513274336283185,0.451,60,80,0.75
Lamond Murray,murrala01,SF,30,TOR,2004,33,518.0,197,28,14,76,90,15,7,38,47,76,215,0.3534883720930232,21,60,0.35,55,155,0.3548387096774194,0.402,24,35,0.6857142857142857
Ronald Murray,murraro01,PG,24,SEA,2004,82,2021.0,1013,205,45,159,204,81,28,149,158,389,915,0.4251366120218579,67,229,0.2925764192139738,322,686,0.4693877551020408,0.462,168,235,0.7148936170212766
Tracy Murray,murratr01,SF,32,POR,2004,7,35.0,8,1,3,2,5,1,0,2,3,3,12,0.25,2,5,0.4,1,7,0.1428571428571428,0.333,0,1,0.0
Dikembe Mutombo,mutomdi01,C,37,NYK,2004,65,1494.0,363,25,145,292,437,17,123,54,141,141,295,0.4779661016949152,0,0,0.0,141,295,0.4779661016949152,0.478,81,119,0.680672268907563
Mamadou N'Diaye,ndiayma02,C,28,TOT,2004,28,366.0,98,0,43,69,112,8,25,18,59,27,69,0.391304347826087,0,0,0.0,27,69,0.391304347826087,0.391,44,59,0.7457627118644068
Boštjan Nachbar,nachbbo01,SF,23,HOU,2004,45,516.0,138,30,8,62,70,14,14,23,72,47,132,0.3560606060606061,23,63,0.365079365079365,24,69,0.3478260869565217,0.443,21,29,0.7241379310344828
Lee Nailon,nailole01,PF-SF,28,TOT,2004,57,780.0,341,38,64,79,143,15,8,45,93,147,327,0.4495412844036697,0,3,0.0,147,324,0.4537037037037037,0.45,47,58,0.8103448275862069
Eduardo Nájera,najered01,SF,27,DAL,2004,58,720.0,176,25,67,89,156,35,19,29,90,72,162,0.4444444444444444,2,4,0.5,70,158,0.4430379746835443,0.451,30,46,0.6521739130434783
Steve Nash,nashst01,PG,29,DAL,2004,78,2612.0,1128,687,59,173,232,67,8,209,139,397,845,0.4698224852071005,104,257,0.4046692607003891,293,588,0.4982993197278911,0.531,230,251,0.9163346613545816
Rasho Nesterović,nestera01,C,27,SAS,2004,82,2353.0,710,114,257,376,633,51,165,107,247,328,700,0.4685714285714286,0,0,0.0,328,700,0.4685714285714286,0.469,54,114,0.4736842105263157
Ira Newble,newblir01,SF,29,CLE,2004,64,1245.0,254,72,65,90,155,25,19,54,109,108,276,0.391304347826087,2,19,0.1052631578947368,106,257,0.4124513618677042,0.395,36,46,0.782608695652174
Moochie Norris,norrimo01,PG,30,TOT,2004,66,847.0,234,121,10,55,65,44,5,64,51,80,217,0.3686635944700461,20,58,0.3448275862068966,60,159,0.3773584905660377,0.415,54,71,0.7605633802816901
Dirk Nowitzki,nowitdi01,C,25,DAL,2004,77,2915.0,1680,207,90,580,670,92,104,135,216,605,1310,0.4618320610687023,99,290,0.3413793103448276,506,1020,0.496078431372549,0.5,371,423,0.8770685579196218
Jermaine O'Neal,onealje01,PF,25,IND,2004,78,2788.0,1566,164,193,585,778,59,199,181,248,608,1400,0.4342857142857143,2,18,0.1111111111111111,606,1382,0.4384949348769899,0.435,348,460,0.7565217391304347
Shaquille O'Neal,onealsh01,C,31,LAL,2004,67,2464.0,1439,196,246,523,769,34,166,195,225,554,948,0.5843881856540084,0,0,0.0,554,948,0.5843881856540084,0.584,331,676,0.4896449704142012
Charles Oakley,oaklech01,PF,40,HOU,2004,7,25.0,9,2,0,5,5,0,0,1,8,2,6,0.3333333333333333,0,0,0.0,2,6,0.3333333333333333,0.333,5,6,0.8333333333333334
Lamar Odom,odomla01,PF,24,MIA,2004,80,3003.0,1371,327,160,616,776,85,71,236,273,485,1127,0.4303460514640639,61,205,0.2975609756097561,424,922,0.4598698481561822,0.457,340,458,0.74235807860262
Mehmet Okur,okurme01,PF,24,DET,2004,71,1580.0,682,69,160,261,421,36,63,101,138,251,542,0.4630996309963099,18,48,0.375,233,494,0.4716599190283401,0.48,162,209,0.7751196172248804
Kevin Ollie,ollieke01,PG,31,CLE,2004,82,1401.0,341,234,23,147,170,51,8,81,119,95,257,0.3696498054474708,4,9,0.4444444444444444,91,248,0.3669354838709677,0.377,147,176,0.8352272727272727
Michael Olowokandi,olowomi01,C,28,MIN,2004,43,925.0,278,24,78,167,245,16,68,54,137,121,285,0.4245614035087719,0,0,0.0,121,285,0.4245614035087719,0.425,36,61,0.5901639344262295
Greg Ostertag,ostergr01,C,30,UTA,2004,78,2153.0,529,123,221,357,578,30,139,99,228,208,437,0.4759725400457666,0,1,0.0,208,436,0.4770642201834862,0.476,113,195,0.5794871794871795
Bo Outlaw,outlabo01,PF,32,MEM,2004,82,1606.0,379,90,125,217,342,73,70,69,170,159,312,0.5096153846153846,0,4,0.0,159,308,0.5162337662337663,0.51,61,116,0.5258620689655172
Travis Outlaw,outlatr01,PF,19,POR,2004,8,19.0,8,1,2,2,4,1,0,1,1,3,7,0.4285714285714285,0,0,0.0,3,7,0.4285714285714285,0.429,2,4,0.5
Doug Overton,overtdo01,PG,34,TOT,2004,61,1033.0,224,138,16,70,86,26,2,58,89,99,245,0.4040816326530612,3,23,0.1304347826086956,96,222,0.4324324324324324,0.41,23,31,0.7419354838709677
Zaza Pachulia,pachuza01,C,19,ORL,2004,59,664.0,194,13,69,105,174,21,12,34,87,68,175,0.3885714285714285,0,0,0.0,68,175,0.3885714285714285,0.389,58,90,0.6444444444444445
Robert Pack,packro01,PG,34,NJN,2004,26,220.0,49,27,4,14,18,12,1,16,20,22,52,0.4230769230769231,0,0,0.0,22,52,0.4230769230769231,0.423,5,6,0.8333333333333334
Scott Padgett,padgesc01,PF,27,HOU,2004,58,547.0,200,23,46,93,139,12,13,22,73,74,167,0.4431137724550898,28,65,0.4307692307692308,46,102,0.4509803921568627,0.527,24,32,0.75
Milt Palacio,palacmi01,PG,25,TOR,2004,59,1211.0,257,184,15,87,102,41,11,87,90,104,298,0.348993288590604,4,26,0.1538461538461538,100,272,0.3676470588235294,0.356,45,68,0.6617647058823529
Jannero Pargo,pargoja01,PG,24,TOT,2004,31,479.0,207,70,8,29,37,13,6,47,50,81,199,0.4070351758793969,22,62,0.3548387096774194,59,137,0.4306569343065693,0.462,23,27,0.8518518518518519
Tony Parker,parketo01,PG,21,SAS,2004,75,2577.0,1099,411,43,194,237,61,7,179,148,423,946,0.4471458773784355,62,199,0.3115577889447236,361,747,0.4832663989290495,0.48,191,272,0.7022058823529411
Cherokee Parks,parksch02,C,31,GSW,2004,12,64.0,12,1,4,6,10,0,3,2,7,4,10,0.4,0,0,0.0,4,10,0.4,0.4,4,6,0.6666666666666666
Ruben Patterson,patteru01,SF,28,POR,2004,73,1651.0,507,139,129,139,268,84,21,105,152,200,395,0.5063291139240507,2,12,0.1666666666666666,198,383,0.5169712793733682,0.509,105,190,0.5526315789473685
Sasha Pavlović,pavloal01,SF,20,UTA,2004,79,1144.0,382,60,44,115,159,41,16,67,187,149,376,0.3962765957446808,19,70,0.2714285714285714,130,306,0.4248366013071895,0.422,65,84,0.7738095238095238
Gary Payton,paytoga01,PG,35,LAL,2004,82,2825.0,1199,449,72,270,342,96,19,151,169,482,1024,0.470703125,55,165,0.3333333333333333,427,859,0.4970896391152503,0.498,180,252,0.7142857142857143
Anthony Peeler,peelean01,SG,34,SAC,2004,75,1391.0,431,120,31,122,153,56,10,77,103,156,348,0.4482758620689655,68,141,0.4822695035460992,88,207,0.4251207729468599,0.546,51,61,0.8360655737704918
Desmond Penigar,penigde01,PF,22,ORL,2004,10,89.0,32,3,6,18,24,2,2,6,14,14,28,0.5,0,0,0.0,14,28,0.5,0.5,4,4,1.0
Kirk Penney,penneki01,SG,23,MIA,2004,2,18.0,3,1,0,1,1,1,0,3,1,1,6,0.1666666666666666,1,3,0.3333333333333333,0,3,0.0,0.25,0,0,0.0
Kendrick Perkins,perkike01,C,19,BOS,2004,10,35.0,22,3,5,9,14,0,2,5,6,8,15,0.5333333333333333,0,0,0.0,8,15,0.5333333333333333,0.533,6,9,0.6666666666666666
Wesley Person,persowe01,SG,32,TOT,2004,58,1037.0,338,66,16,101,117,19,9,38,38,126,314,0.4012738853503185,55,138,0.3985507246376811,71,176,0.4034090909090909,0.489,31,39,0.7948717948717948
Morris Peterson,petermo01,SF,26,TOR,2004,82,2148.0,678,113,35,226,261,88,14,69,206,238,587,0.4054514480408858,126,340,0.3705882352941176,112,247,0.4534412955465587,0.513,76,94,0.8085106382978723
Eric Piatkowski,piatker01,SF,33,HOU,2004,49,703.0,201,26,10,63,73,16,5,29,42,72,191,0.3769633507853403,43,122,0.3524590163934426,29,69,0.4202898550724637,0.49,14,16,0.875
Paul Pierce,piercpa01,SG,26,BOS,2004,80,3099.0,1836,410,69,453,522,131,52,303,234,602,1497,0.4021376085504342,115,384,0.2994791666666667,487,1113,0.4375561545372866,0.441,517,631,0.8193343898573693
Mickaël Piétrus,pietrmi01,PG,21,GSW,2004,53,748.0,279,27,48,71,119,32,12,40,100,96,231,0.4155844155844156,35,105,0.3333333333333333,61,126,0.4841269841269841,0.491,52,75,0.6933333333333334
Scottie Pippen,pippesc01,SF,38,CHI,2004,23,412.0,136,50,20,48,68,21,9,29,38,53,140,0.3785714285714285,13,48,0.2708333333333333,40,92,0.4347826086956521,0.425,17,27,0.6296296296296297
Zoran Planinić,planizo01,SG,21,NJN,2004,49,473.0,153,68,14,41,55,13,3,36,70,53,129,0.4108527131782946,9,32,0.28125,44,97,0.4536082474226804,0.446,38,60,0.6333333333333333
Scot Pollard,pollasc01,C,28,IND,2004,61,678.0,106,10,67,97,164,23,26,22,110,47,114,0.4122807017543859,0,0,0.0,47,114,0.4122807017543859,0.412,12,21,0.5714285714285714
Olden Polynice,polynol01,C,39,LAC,2004,2,12.0,0,1,1,1,2,1,0,4,2,0,0,0.0,0,0,0.0,0,0,0.0,0.0,0,0,0.0
Mark Pope,popema01,PF,31,DEN,2004,4,20.0,2,0,0,3,3,1,0,3,8,1,2,0.5,0,0,0.0,1,2,0.5,0.5,0,1,0.0
James Posey,poseyja01,SG,27,MEM,2004,82,2451.0,1126,122,92,311,403,137,40,112,248,368,770,0.4779220779220779,112,290,0.3862068965517241,256,480,0.5333333333333333,0.551,278,335,0.8298507462686567
Vitaly Potapenko,potapvi01,C,28,SEA,2004,65,1419.0,459,53,101,188,289,22,28,77,161,200,409,0.4889975550122249,0,0,0.0,200,409,0.4889975550122249,0.489,59,92,0.6413043478260869
Tayshaun Prince,princta01,SF,23,DET,2004,82,2701.0,841,191,93,297,390,63,69,119,149,338,723,0.4674965421853388,57,157,0.3630573248407643,281,566,0.4964664310954063,0.507,108,141,0.7659574468085106
Joel Przybilla,przybjo01,C,24,TOT,2004,17,347.0,49,7,32,79,111,5,17,18,53,18,50,0.36,0,0,0.0,18,50,0.36,0.36,13,31,0.4193548387096774
Vladimir Radmanović,radmavl01,PF,23,SEA,2004,77,2321.0,925,142,104,302,406,80,42,109,187,345,812,0.4248768472906404,140,377,0.3713527851458886,205,435,0.4712643678160919,0.511,95,127,0.7480314960629921
Zach Randolph,randoza01,PF,22,POR,2004,81,3067.0,1626,163,242,609,851,68,41,247,227,663,1368,0.4846491228070175,1,5,0.2,662,1363,0.4856933235509905,0.485,299,393,0.7608142493638677
Theo Ratliff,ratlith01,C,30,TOT,2004,85,2664.0,672,71,195,419,614,54,307,120,300,266,549,0.4845173041894353,0,0,0.0,266,549,0.4845173041894353,0.485,140,217,0.6451612903225806
Željko Rebrača,rebraze01,C,31,TOT,2004,24,273.0,91,6,23,35,58,5,11,17,52,34,77,0.4415584415584415,0,0,0.0,34,77,0.4415584415584415,0.442,23,30,0.7666666666666667
Michael Redd,reddmi01,SG,24,MIL,2004,82,3021.0,1776,185,118,289,407,81,6,116,152,633,1439,0.4398888116747741,127,363,0.349862258953168,506,1076,0.4702602230483271,0.484,383,441,0.8684807256235828
Glen Rice,ricegl01,SF,36,LAC,2004,18,262.0,66,24,9,32,41,6,0,13,22,22,76,0.2894736842105263,5,28,0.1785714285714285,17,48,0.3541666666666667,0.322,17,17,1.0
Jason Richardson,richaja01,SG,23,GSW,2004,78,2936.0,1461,226,124,400,524,86,41,196,182,563,1284,0.4384735202492212,77,273,0.282051282051282,486,1011,0.4807121661721068,0.468,258,377,0.6843501326259946
Quentin Richardson,richaqu01,SG,23,LAC,2004,65,2338.0,1121,139,146,268,414,67,19,141,130,425,1068,0.397940074906367,120,341,0.3519061583577713,305,727,0.4195323246217332,0.454,151,204,0.7401960784313726
Luke Ridnour,ridnolu01,PG,22,SEA,2004,69,1114.0,382,163,35,73,108,52,7,80,105,145,350,0.4142857142857143,27,80,0.3375,118,270,0.437037037037037,0.453,65,79,0.8227848101265823
Clifford Robinson,robincl02,PF,37,GSW,2004,82,2846.0,967,271,54,268,322,68,73,173,237,366,945,0.3873015873015873,112,314,0.3566878980891719,254,631,0.4025356576862123,0.447,123,173,0.7109826589595376
Eddie Robinson,robined01,SF,27,CHI,2004,51,1024.0,343,58,27,77,104,33,10,45,57,157,326,0.4815950920245399,1,5,0.2,156,321,0.4859813084112149,0.483,28,43,0.6511627906976745
Glenn Robinson,robingl01,SF,31,PHI,2004,42,1336.0,698,57,46,143,189,42,9,106,96,275,614,0.4478827361563517,34,100,0.34,241,514,0.4688715953307393,0.476,114,137,0.8321167883211679
Rodney Rogers,rogerro01,PF,32,NJN,2004,69,1409.0,539,137,100,207,307,59,27,98,183,207,505,0.4099009900990099,50,152,0.3289473684210526,157,353,0.4447592067988669,0.459,75,98,0.7653061224489796
Sean Rooks,rooksse01,C,34,TOT,2004,55,595.0,141,29,24,73,97,14,10,22,89,54,151,0.3576158940397351,0,1,0.0,54,150,0.36,0.358,33,37,0.8918918918918919
Jalen Rose,roseja01,PG-SF,31,TOT,2004,66,2497.0,1022,329,34,232,266,51,22,208,184,383,952,0.4023109243697479,69,202,0.3415841584158416,314,750,0.4186666666666667,0.439,187,231,0.8095238095238095
Malik Rose,rosema01,PF,29,SAS,2004,67,1256.0,529,69,110,210,320,36,24,112,164,173,404,0.4282178217821782,0,3,0.0,173,401,0.4314214463840399,0.428,183,225,0.8133333333333334
Michael Ruffin,ruffimi01,PF,27,UTA,2004,41,733.0,92,41,78,129,207,22,21,42,103,38,117,0.3247863247863248,0,0,0.0,38,117,0.3247863247863248,0.325,16,38,0.4210526315789473
Kareem Rush,rushka01,SG,23,LAL,2004,72,1244.0,459,59,20,77,97,33,20,48,109,190,432,0.4398148148148148,48,138,0.3478260869565217,142,294,0.4829931972789115,0.495,31,52,0.5961538461538461
Bryon Russell,russebr01,SF,33,LAL,2004,72,945.0,289,71,32,114,146,32,12,37,110,98,244,0.4016393442622951,43,112,0.3839285714285714,55,132,0.4166666666666667,0.49,50,65,0.7692307692307693
John Salmons,salmojo01,SG,24,PHI,2004,77,1603.0,443,134,38,158,196,62,16,77,122,161,416,0.3870192307692308,50,147,0.3401360544217687,111,269,0.4126394052044609,0.447,71,92,0.7717391304347826
Jamal Sampson,sampsja01,C,20,LAL,2004,10,130.0,29,7,23,29,52,2,4,6,16,11,23,0.4782608695652174,0,0,0.0,11,23,0.4782608695652174,0.478,7,12,0.5833333333333334
Daniel Santiago,santida01,C,27,MIL,2004,54,708.0,217,24,35,97,132,19,21,32,98,78,163,0.4785276073619632,0,0,0.0,78,163,0.4785276073619632,0.479,61,90,0.6777777777777778
Brian Scalabrine,scalabr01,PF,25,NJN,2004,69,928.0,240,65,42,131,173,21,14,42,113,86,218,0.3944954128440367,10,41,0.2439024390243902,76,177,0.4293785310734463,0.417,58,70,0.8285714285714286
Ansu Sesay,sesayan01,SF,27,SEA,2004,57,583.0,200,19,43,49,92,19,20,23,66,81,178,0.4550561797752809,6,21,0.2857142857142857,75,157,0.4777070063694267,0.472,32,46,0.6956521739130435
Paul Shirley,shirlpa01,PF,26,CHI,2004,7,86.0,21,4,8,8,16,1,1,9,9,10,23,0.4347826086956521,0,1,0.0,10,22,0.4545454545454545,0.435,1,3,0.3333333333333333
Bobby Simmons,simmobo01,SF,23,LAC,2004,56,1376.0,437,96,115,147,262,51,17,73,169,147,373,0.3941018766756032,2,12,0.1666666666666666,145,361,0.4016620498614958,0.397,141,169,0.834319526627219
Brian Skinner,skinnbr01,C,27,MIL,2004,56,1577.0,589,49,119,292,411,30,61,78,165,255,513,0.4970760233918128,0,0,0.0,255,513,0.4970760233918128,0.497,79,138,0.572463768115942
Tamar Slay,slayta01,SG,23,NJN,2004,22,165.0,53,14,10,15,25,7,1,11,20,21,60,0.35,4,12,0.3333333333333333,17,48,0.3541666666666667,0.383,7,14,0.5
Jabari Smith,smithja01,C,26,SAC,2004,31,168.0,64,11,11,20,31,2,6,7,25,26,70,0.3714285714285714,0,3,0.0,26,67,0.3880597014925373,0.371,12,20,0.6
Joe Smith,smithjo02,PF,28,MIL,2004,76,2254.0,830,78,230,413,643,47,94,82,209,311,708,0.4392655367231638,1,5,0.2,310,703,0.4409672830725462,0.44,207,241,0.8589211618257261
Leon Smith,smithle01,C,23,SEA,2004,1,4.0,2,0,1,1,2,0,0,0,1,1,2,0.5,0,0,0.0,1,2,0.5,0.5,0,0,0.0
Steve Smith,smithst01,SG,34,NOH,2004,71,929.0,358,56,27,54,81,15,6,42,91,119,293,0.4061433447098976,43,107,0.4018691588785046,76,186,0.4086021505376344,0.48,77,83,0.927710843373494
Theron Smith,smithth01,SF,23,MEM,2004,20,178.0,44,7,13,28,41,5,5,14,18,16,43,0.3720930232558139,6,12,0.5,10,31,0.3225806451612903,0.442,6,8,0.75
Eric Snow,snower01,PG,30,PHI,2004,82,2966.0,844,563,62,219,281,97,6,187,213,295,715,0.4125874125874126,2,18,0.1111111111111111,293,697,0.4203730272596843,0.414,252,316,0.7974683544303798
Darius Songaila,songada01,PF,25,SAC,2004,73,976.0,337,48,91,134,225,42,12,43,126,133,273,0.4871794871794871,0,0,0.0,133,273,0.4871794871794871,0.487,71,88,0.8068181818181818
Latrell Sprewell,sprewla01,SF,33,MIN,2004,82,3100.0,1375,286,56,254,310,88,21,158,101,518,1266,0.4091627172195892,99,299,0.3311036789297659,419,967,0.4332988624612203,0.448,240,295,0.8135593220338984
Jerry Stackhouse,stackje01,SF,29,WAS,2004,26,774.0,362,103,16,78,94,24,3,88,49,128,321,0.3987538940809969,23,65,0.3538461538461538,105,256,0.41015625,0.435,83,103,0.8058252427184466
Vladimir Stepania,stepavl01,C,27,POR,2004,42,453.0,108,23,50,75,125,11,15,19,61,43,103,0.4174757281553398,0,0,0.0,43,103,0.4174757281553398,0.417,22,36,0.6111111111111112
DeShawn Stevenson,stevede01,SG-SF,22,TOT,2004,80,2444.0,909,158,79,219,298,52,17,120,140,376,871,0.4316877152698048,19,71,0.2676056338028169,357,800,0.44625,0.443,138,204,0.6764705882352942
Michael Stewart,stewami01,C-PF,28,TOT,2004,25,147.0,13,0,8,21,29,2,10,3,34,5,12,0.4166666666666667,0,0,0.0,5,12,0.4166666666666667,0.417,3,4,0.75
Peja Stojaković,stojape01,SF,26,SAC,2004,81,3264.0,1964,173,91,417,508,108,14,153,159,665,1386,0.4797979797979798,240,554,0.4332129963898917,425,832,0.5108173076923077,0.566,394,425,0.9270588235294116
Damon Stoudamire,stoudda01,PG,30,POR,2004,82,3118.0,1099,500,52,256,308,99,9,180,173,408,1018,0.4007858546168958,156,427,0.3653395784543325,252,591,0.4263959390862944,0.477,127,145,0.8758620689655172
Amar'e Stoudemire,stoudam01,PF,21,PHO,2004,55,2025.0,1133,78,157,339,496,64,89,177,188,411,865,0.4751445086705202,1,5,0.2,410,860,0.4767441860465116,0.476,310,435,0.7126436781609196
Erick Strickland,stricer01,PG,30,MIL,2004,43,571.0,231,90,13,58,71,26,2,54,63,79,196,0.4030612244897959,29,66,0.4393939393939394,50,130,0.3846153846153846,0.477,44,51,0.8627450980392157
Rod Strickland,stricro02,PG,37,TOT,2004,61,1197.0,382,244,34,121,155,35,11,85,76,150,353,0.4249291784702549,10,36,0.2777777777777778,140,317,0.4416403785488959,0.439,72,98,0.7346938775510204
Bruno Šundov,sundobr01,C,23,TOT,2004,5,33.0,11,1,2,8,10,0,0,3,9,4,10,0.4,0,0,0.0,4,10,0.4,0.4,3,6,0.5
Bob Sura,surabo01,SG,30,TOT,2004,80,1663.0,596,233,100,226,326,62,14,105,158,202,485,0.4164948453608247,21,79,0.2658227848101265,181,406,0.4458128078817734,0.438,171,226,0.7566371681415929
Mike Sweetney,sweetmi01,PF,21,NYK,2004,42,494.0,180,14,68,89,157,18,12,32,57,69,140,0.4928571428571429,0,1,0.0,69,139,0.4964028776978417,0.493,42,58,0.7241379310344828
Stromile Swift,swiftst01,PF,24,MEM,2004,77,1528.0,727,38,141,237,378,56,118,88,188,268,571,0.4693520140105078,1,4,0.25,267,567,0.4708994708994709,0.47,190,262,0.7251908396946565
Wally Szczerbiak,szczewa02,SF,26,MIN,2004,28,622.0,285,33,24,64,88,12,1,28,42,106,236,0.4491525423728814,20,46,0.4347826086956521,86,190,0.4526315789473684,0.492,53,64,0.828125
Maurice Taylor,tayloma01,PF,27,HOU,2004,75,2081.0,862,107,131,253,384,43,47,149,253,367,765,0.4797385620915033,0,2,0.0,367,763,0.4809960681520314,0.48,128,174,0.735632183908046
Jason Terry,terryja01,PG,26,ATL,2004,81,3018.0,1359,437,49,287,336,124,16,229,192,499,1196,0.4172240802675585,146,421,0.346793349168646,353,775,0.4554838709677419,0.478,215,260,0.8269230769230769
Etan Thomas,thomaet01,C,25,WAS,2004,79,1901.0,705,68,183,345,528,36,123,113,219,257,526,0.4885931558935361,0,0,0.0,257,526,0.4885931558935361,0.489,191,295,0.6474576271186441
Kenny Thomas,thomake01,PF,26,PHI,2004,74,2699.0,1006,111,261,489,750,82,33,172,219,381,813,0.4686346863468634,1,5,0.2,380,808,0.4702970297029702,0.469,243,323,0.7523219814241486
Kurt Thomas,thomaku01,PF,31,NYK,2004,80,2548.0,890,149,145,517,662,56,80,132,298,392,829,0.4728588661037394,0,3,0.0,392,826,0.4745762711864407,0.473,106,127,0.8346456692913385
Tim Thomas,thomati01,SF,26,TOT,2004,66,2089.0,970,124,64,256,320,64,20,116,196,363,813,0.4464944649446494,73,194,0.3762886597938144,290,619,0.468497576736672,0.491,171,218,0.7844036697247706
Jamaal Tinsley,tinslja01,PG,25,IND,2004,52,1378.0,432,303,28,108,136,84,17,110,132,153,370,0.4135135135135135,77,207,0.3719806763285024,76,163,0.4662576687116564,0.518,49,67,0.7313432835820896
Robert Traylor,traylro01,C,26,NOH,2004,71,942.0,362,43,106,156,262,39,37,62,161,145,287,0.5052264808362369,2,5,0.4,143,282,0.5070921985815603,0.509,70,128,0.546875
Gary Trent,trentga01,C,29,MIN,2004,68,1025.0,379,49,83,133,216,12,17,54,129,155,328,0.4725609756097561,0,6,0.0,155,322,0.4813664596273292,0.473,69,91,0.7582417582417582
Jeff Trepagnier,trepaje01,SG,24,DEN,2004,11,96.0,25,4,6,9,15,3,0,6,7,10,38,0.2631578947368421,2,4,0.5,8,34,0.2352941176470588,0.289,3,6,0.5
Cezary Trybański,trybace01,C,24,TOT,2004,7,15.0,1,0,0,1,1,1,1,2,3,0,4,0.0,0,0,0.0,0,4,0.0,0.0,1,2,0.5
Jake Tsakalidis,tsakaja01,C,24,MEM,2004,40,533.0,170,18,37,91,128,9,22,23,79,67,133,0.5037593984962406,0,0,0.0,67,133,0.5037593984962406,0.504,36,61,0.5901639344262295
Nikoloz Tskitishvili,tskitni01,PF,20,DEN,2004,39,307.0,106,10,24,39,63,6,8,17,50,40,122,0.3278688524590163,3,11,0.2727272727272727,37,111,0.3333333333333333,0.34,23,29,0.7931034482758621
Hedo Türkoğlu,turkohe01,SF,24,SAS,2004,80,2073.0,739,154,52,306,358,80,32,94,165,262,645,0.4062015503875969,101,241,0.4190871369294606,161,404,0.3985148514851485,0.484,114,161,0.7080745341614907
Ime Udoka,udokaim01,SF,26,LAL,2004,4,28.0,8,2,1,4,5,2,1,3,3,3,9,0.3333333333333333,0,1,0.0,3,8,0.375,0.333,2,4,0.5
Nick Van Exel,vanexni01,PG,32,GSW,2004,39,1255.0,490,206,16,88,104,20,2,78,57,187,479,0.3903966597077244,46,150,0.3066666666666666,141,329,0.4285714285714285,0.438,70,99,0.7070707070707071
Keith Van Horn,vanhoke01,SF,28,TOT,2004,72,2340.0,1162,120,149,352,501,68,33,169,215,410,903,0.4540420819490587,93,233,0.3991416309012875,317,670,0.4731343283582089,0.506,249,290,0.8586206896551725
Jacque Vaughn,vaughja01,PG,28,ATL,2004,71,1271.0,270,195,12,104,116,44,2,84,126,107,277,0.3862815884476534,3,20,0.15,104,257,0.4046692607003891,0.392,53,68,0.7794117647058824
Jake Voskuhl,voskuja01,C,26,PHO,2004,66,1606.0,438,57,123,220,343,42,25,77,258,152,300,0.5066666666666667,0,0,0.0,152,300,0.5066666666666667,0.507,134,181,0.7403314917127072
Slavko Vraneš,vranesl01,C,21,POR,2004,1,3.0,0,0,0,0,0,0,0,0,1,0,1,0.0,0,0,0.0,0,1,0.0,0.0,0,0,0.0
Dwyane Wade,wadedw01,PG,22,MIA,2004,61,2126.0,991,275,85,162,247,86,34,196,140,371,798,0.4649122807017544,16,53,0.3018867924528302,355,745,0.4765100671140939,0.475,233,312,0.7467948717948718
Dajuan Wagner,wagneda02,SG,20,CLE,2004,44,708.0,287,51,9,49,58,26,7,41,89,112,306,0.3660130718954248,31,86,0.3604651162790697,81,220,0.3681818181818181,0.417,32,47,0.6808510638297872
Antoine Walker,walkean02,PF,27,DAL,2004,82,2840.0,1151,369,198,486,684,65,65,202,212,483,1129,0.4278122232063773,82,305,0.2688524590163934,401,824,0.4866504854368932,0.464,103,186,0.553763440860215
Samaki Walker,walkesa01,PF,27,MIA,2004,33,418.0,105,6,42,70,112,9,11,15,54,38,99,0.3838383838383838,0,2,0.0,38,97,0.3917525773195876,0.384,29,44,0.6590909090909091
Ben Wallace,wallabe01,C,29,DET,2004,81,3050.0,773,138,324,682,1006,143,246,123,162,315,748,0.4211229946524064,1,8,0.125,314,740,0.4243243243243243,0.422,142,290,0.4896551724137931
Gerald Wallace,wallage01,SF,21,SAC,2004,37,337.0,75,19,35,39,74,14,14,8,37,32,89,0.3595505617977528,0,2,0.0,32,87,0.367816091954023,0.36,11,24,0.4583333333333333
John Wallace,wallajo01,SF,29,MIA,2004,37,368.0,158,14,12,47,59,5,8,24,38,61,145,0.4206896551724138,5,13,0.3846153846153846,56,132,0.4242424242424242,0.438,31,40,0.775
Rasheed Wallace,wallara01,PF,29,TOT,2004,68,2390.0,1088,156,102,357,459,61,122,119,190,425,974,0.4363449691991786,82,248,0.3306451612903225,343,726,0.4724517906336088,0.478,156,212,0.7358490566037735
Luke Walton,waltolu01,PF,23,LAL,2004,72,730.0,174,113,39,88,127,28,8,44,70,65,153,0.4248366013071895,13,39,0.3333333333333333,52,114,0.4561403508771929,0.467,31,44,0.7045454545454546
Charlie Ward,wardch01,PG,33,TOT,2004,71,1252.0,424,215,12,132,144,64,11,96,107,160,390,0.4102564102564102,84,206,0.4077669902912621,76,184,0.4130434782608695,0.518,20,27,0.7407407407407407
Earl Watson,watsoea01,PG,24,MEM,2004,81,1669.0,460,402,49,129,178,91,19,146,175,172,464,0.3706896551724138,26,106,0.2452830188679245,146,358,0.4078212290502793,0.399,90,138,0.6521739130434783
Clarence Weatherspoon,weathcl01,PF,33,TOT,2004,52,868.0,261,30,74,130,204,30,15,35,75,104,211,0.4928909952606635,0,1,0.0,104,210,0.4952380952380952,0.493,53,72,0.7361111111111112
Chris Webber,webbech01,PF,30,SAC,2004,23,831.0,430,105,48,152,200,31,20,60,76,174,421,0.4133016627078384,1,5,0.2,173,416,0.4158653846153846,0.414,81,114,0.7105263157894737
Bonzi Wells,wellsbo01,SG,27,TOT,2004,72,1872.0,886,139,78,182,260,91,19,161,197,363,850,0.4270588235294117,22,69,0.3188405797101449,341,781,0.4366197183098591,0.44,138,183,0.7540983606557377
Jiří Welsch,welscji01,SG,24,BOS,2004,81,2179.0,746,183,60,236,296,101,7,129,176,262,612,0.4281045751633986,69,181,0.3812154696132597,193,431,0.4477958236658932,0.484,153,206,0.7427184466019418
David Wesley,wesleda01,SG,33,NOH,2004,61,2001.0,851,175,28,106,134,71,14,100,147,311,800,0.38875,92,285,0.3228070175438596,219,515,0.4252427184466019,0.446,137,182,0.7527472527472527
David West,westda01,PF,23,NOH,2004,71,930.0,273,60,117,180,297,27,28,48,117,108,228,0.4736842105263157,0,2,0.0,108,226,0.4778761061946903,0.474,57,80,0.7125
Jahidi White,whiteja01,C,27,TOT,2004,62,865.0,261,7,97,164,261,25,51,66,176,99,190,0.5210526315789473,0,0,0.0,99,190,0.5210526315789473,0.521,63,126,0.5
Rodney White,whitero02,SF,23,DEN,2004,72,985.0,541,60,44,121,165,32,20,78,105,215,468,0.4594017094017094,33,87,0.3793103448275862,182,381,0.4776902887139108,0.495,78,104,0.75
Chris Whitney,whitnch01,PG,32,WAS,2004,16,186.0,47,14,3,12,15,6,2,6,6,17,45,0.3777777777777777,8,18,0.4444444444444444,9,27,0.3333333333333333,0.467,5,5,1.0
Chris Wilcox,wilcoch01,C,21,LAC,2004,65,1340.0,559,51,125,180,305,29,20,80,183,227,436,0.5206422018348624,0,1,0.0,227,435,0.5218390804597701,0.521,105,150,0.7
Mike Wilks,wilksmi01,PG,24,HOU,2004,26,145.0,50,17,3,13,16,3,0,7,15,17,36,0.4722222222222222,6,10,0.6,11,26,0.4230769230769231,0.556,10,12,0.8333333333333334
Aaron Williams,williaa01,C,32,NJN,2004,72,1337.0,450,81,101,193,294,34,46,89,187,172,342,0.5029239766081871,1,3,0.3333333333333333,171,339,0.504424778761062,0.504,105,155,0.6774193548387096
Alvin Williams,willial02,SG,29,TOR,2004,56,1730.0,494,224,18,132,150,55,10,78,114,201,496,0.4052419354838709,26,89,0.2921348314606741,175,407,0.42997542997543,0.431,66,85,0.7764705882352941
Eric Williams,willier01,SF,31,TOT,2004,71,1886.0,712,120,65,221,286,70,9,88,180,231,598,0.3862876254180602,35,127,0.2755905511811024,196,471,0.416135881104034,0.416,215,283,0.7597173144876325
Frank Williams,willifr02,PG,23,NYK,2004,56,714.0,219,121,8,45,53,25,6,63,58,80,208,0.3846153846153846,18,60,0.3,62,148,0.4189189189189189,0.428,41,48,0.8541666666666666
Jason Williams,willija02,PG,28,MEM,2004,72,2115.0,782,492,25,122,147,92,5,136,97,290,713,0.4067321178120617,120,364,0.3296703296703296,170,349,0.4871060171919771,0.491,82,98,0.8367346938775511
Jerome Williams,willije01,PF,30,TOT,2004,68,1637.0,422,72,177,298,475,90,8,74,134,158,336,0.4702380952380952,0,8,0.0,158,328,0.4817073170731707,0.47,106,155,0.6838709677419355
Mo Williams,willima01,SG,21,UTA,2004,57,772.0,284,76,23,49,72,28,2,51,87,115,303,0.3795379537953795,10,39,0.2564102564102564,105,264,0.3977272727272727,0.396,44,56,0.7857142857142857
Scott Williams,willisc01,C,35,TOT,2004,43,527.0,198,17,38,94,132,20,16,16,95,90,186,0.4838709677419355,2,3,0.6666666666666666,88,183,0.4808743169398907,0.489,16,27,0.5925925925925926
Shammond Williams,willish01,SG-PG,28,TOT,2004,53,763.0,255,116,9,51,60,37,2,47,62,87,232,0.375,30,100,0.3,57,132,0.4318181818181818,0.44,51,58,0.8793103448275862
Corliss Williamson,willico02,PF,30,DET,2004,79,1574.0,752,57,88,168,256,30,20,113,204,304,602,0.5049833887043189,0,0,0.0,304,602,0.5049833887043189,0.505,144,197,0.7309644670050761
Kevin Willis,willike02,C,41,SAS,2004,48,373.0,164,11,37,61,98,21,9,32,61,70,150,0.4666666666666667,0,1,0.0,70,149,0.4697986577181208,0.467,24,39,0.6153846153846154
Loren Woods,woodslo01,C,25,MIA,2004,38,506.0,121,10,65,69,134,11,19,26,52,44,96,0.4583333333333333,0,0,0.0,44,96,0.4583333333333333,0.458,33,55,0.6
Qyntel Woods,woodsqy01,SF,22,POR,2004,62,673.0,224,46,46,90,136,20,14,52,88,88,237,0.3713080168776371,10,29,0.3448275862068966,78,208,0.375,0.392,38,60,0.6333333333333333
Metta World Peace,artesro01,SF,24,IND,2004,73,2714.0,1333,272,100,285,385,152,50,202,194,468,1112,0.420863309352518,75,242,0.3099173553719008,393,870,0.4517241379310345,0.455,322,439,0.7334851936218679
Lorenzen Wright,wrighlo02,C,28,MEM,2004,65,1674.0,610,71,144,301,445,45,58,77,192,257,586,0.4385665529010238,0,5,0.0,257,581,0.4423407917383821,0.439,96,131,0.732824427480916
Wang Zhizhi,zhizhwa01,C,26,TOT,2004,16,114.0,47,2,4,14,18,3,5,6,13,17,46,0.3695652173913043,4,14,0.2857142857142857,13,32,0.40625,0.413,9,10,0.9
Shareef Abdur-Rahim,abdursh01,PF,28,POR,2005,54,1867.0,909,111,123,269,392,49,26,117,150,337,670,0.5029850746268657,15,39,0.3846153846153846,322,631,0.5103011093502378,0.514,220,254,0.8661417322834646
Cory Alexander,alexaco01,SG,31,CHA,2005,16,201.0,49,37,8,21,29,9,1,19,29,16,49,0.3265306122448979,8,19,0.4210526315789473,8,30,0.2666666666666666,0.408,9,12,0.75
Malik Allen,allenma01,PF,26,TOT,2005,36,519.0,194,18,40,59,99,9,22,18,53,84,177,0.4745762711864407,0,0,0.0,84,177,0.4745762711864407,0.475,26,28,0.9285714285714286
Ray Allen,allenra02,SG,29,SEA,2005,78,3064.0,1867,289,79,268,347,84,5,171,167,640,1494,0.428380187416332,209,556,0.3758992805755395,431,938,0.4594882729211087,0.498,378,428,0.883177570093458
Tony Allen,allento01,SG,23,BOS,2005,77,1262.0,492,64,85,136,221,76,24,77,156,184,387,0.4754521963824289,12,31,0.3870967741935484,172,356,0.4831460674157303,0.491,112,152,0.7368421052631579
Rafer Alston,alstora01,PG,28,TOR,2005,80,2717.0,1136,514,42,237,279,118,7,170,212,403,974,0.4137577002053388,139,389,0.3573264781491002,264,585,0.4512820512820513,0.485,191,258,0.7403100775193798
Chris Andersen,anderch01,C,26,NOH,2005,67,1430.0,513,71,137,273,410,14,100,64,144,191,358,0.5335195530726257,0,3,0.0,191,355,0.5380281690140845,0.534,131,190,0.6894736842105263
Derek Anderson,anderde01,SG,30,POR,2005,47,1239.0,432,143,25,103,128,36,4,70,89,152,391,0.3887468030690537,58,151,0.3841059602649007,94,240,0.3916666666666666,0.463,70,87,0.8045977011494253
Kenny Anderson,anderke01,PG,34,TOT,2005,43,743.0,203,103,24,64,88,33,0,49,87,85,201,0.4228855721393035,6,13,0.4615384615384615,79,188,0.4202127659574468,0.438,27,37,0.7297297297297297
Shandon Anderson,andersh01,SF-SG,31,TOT,2005,66,1171.0,255,70,41,150,191,40,14,50,138,98,217,0.4516129032258064,5,29,0.1724137931034483,93,188,0.4946808510638298,0.463,54,66,0.8181818181818182
Carmelo Anthony,anthoca01,SF,20,DEN,2005,75,2608.0,1558,194,141,285,426,68,30,224,229,530,1230,0.4308943089430894,42,158,0.2658227848101265,488,1072,0.4552238805970149,0.448,456,573,0.7958115183246073
Rafael Araújo,araujra01,C,24,TOR,2005,59,736.0,196,16,59,126,185,21,8,52,157,76,175,0.4342857142857143,1,3,0.3333333333333333,75,172,0.436046511627907,0.437,43,55,0.7818181818181819
Gilbert Arenas,arenagi01,PG,23,WAS,2005,80,3274.0,2038,411,83,295,378,139,23,242,245,656,1523,0.4307288246881156,205,562,0.3647686832740213,451,961,0.469302809573361,0.498,521,640,0.8140625
Trevor Ariza,arizatr01,SF,19,NYK,2005,80,1382.0,468,85,89,153,242,70,18,73,150,172,389,0.442159383033419,3,13,0.2307692307692307,169,376,0.449468085106383,0.446,121,174,0.6954022988505747
Darrell Armstrong,armstda01,PG,36,TOT,2005,66,988.0,264,178,35,80,115,45,8,67,92,89,277,0.3212996389891697,28,111,0.2522522522522522,61,166,0.3674698795180723,0.372,58,68,0.8529411764705882
Carlos Arroyo,arroyca01,PG,25,TOT,2005,70,1448.0,461,280,26,78,104,44,4,107,143,167,429,0.3892773892773892,8,30,0.2666666666666666,159,399,0.3984962406015037,0.399,119,149,0.7986577181208053
Chucky Atkins,atkinch01,PG,30,LAL,2005,82,2903.0,1115,358,31,166,197,73,2,151,181,388,910,0.4263736263736263,176,455,0.3868131868131868,212,455,0.4659340659340659,0.523,163,203,0.8029556650246306
Stacey Augmon,augmost01,SF,36,ORL,2005,55,663.0,193,36,45,54,99,23,8,31,83,68,167,0.4071856287425149,0,0,0.0,68,167,0.4071856287425149,0.407,57,77,0.7402597402597403
Maurice Baker,bakerma01,PG,25,TOT,2005,5,19.0,0,1,1,1,2,1,0,1,3,0,1,0.0,0,0,0.0,0,1,0.0,0.0,0,0,0.0
Vin Baker,bakervi01,PF-C,33,TOT,2005,27,204.0,35,10,17,22,39,2,4,17,38,13,42,0.3095238095238095,0,1,0.0,13,41,0.3170731707317073,0.31,9,17,0.5294117647058824
Marcus Banks,banksma01,PG,23,BOS,2005,81,1145.0,372,155,29,97,126,63,13,79,146,115,286,0.4020979020979021,21,59,0.3559322033898305,94,227,0.4140969162995594,0.439,121,163,0.7423312883435583
Leandro Barbosa,barbole01,PG,22,PHO,2005,63,1087.0,442,126,32,98,130,30,7,87,127,168,354,0.4745762711864407,51,139,0.3669064748201439,117,215,0.5441860465116279,0.547,55,69,0.7971014492753623
Matt Barnes,barnema02,SF,24,SAC,2005,43,715.0,164,57,49,84,133,30,7,45,80,62,151,0.4105960264900662,5,22,0.2272727272727272,57,129,0.4418604651162791,0.427,35,58,0.603448275862069
Andre Barrett,barrean01,PG,22,TOT,2005,38,483.0,118,69,11,29,40,19,1,27,51,45,124,0.3629032258064516,14,52,0.2692307692307692,31,72,0.4305555555555556,0.419,14,19,0.7368421052631579
Brent Barry,barrybr01,SG,33,SAS,2005,81,1742.0,601,178,29,161,190,39,20,64,123,194,459,0.4226579520697168,100,280,0.3571428571428571,94,179,0.5251396648044693,0.532,113,135,0.837037037037037
Jon Barry,barryjo01,SG,35,TOT,2005,69,1505.0,455,167,26,133,159,60,9,67,95,161,368,0.4375,71,165,0.4303030303030303,90,203,0.4433497536945813,0.534,62,71,0.8732394366197183
Tony Battie,battito01,C,28,ORL,2005,81,1894.0,394,42,109,343,452,30,81,81,244,163,354,0.4604519774011299,0,6,0.0,163,348,0.4683908045977011,0.46,68,94,0.723404255319149
Shane Battier,battish01,SG,26,MEM,2005,80,2516.0,792,126,158,255,413,91,77,75,201,271,613,0.4420880913539967,70,177,0.3954802259887006,201,436,0.4610091743119266,0.499,180,228,0.7894736842105263
Lonny Baxter,baxtelo01,PF,26,NOH,2005,4,36.0,6,0,4,4,8,0,0,4,10,3,11,0.2727272727272727,0,0,0.0,3,11,0.2727272727272727,0.273,0,2,0.0
Raja Bell,bellra01,SG,28,UTA,2005,63,1790.0,772,91,48,153,201,44,8,79,205,303,667,0.4542728635682159,54,134,0.4029850746268656,249,533,0.4671669793621013,0.495,112,150,0.7466666666666667
Jonathan Bender,bendejo01,SF,24,IND,2005,7,93.0,36,4,5,9,14,1,2,10,9,16,40,0.4,1,5,0.2,15,35,0.4285714285714285,0.413,3,6,0.5
Travis Best,besttr01,PG,32,NJN,2005,76,1461.0,514,143,19,88,107,66,9,67,148,190,452,0.4203539823008849,26,85,0.3058823529411765,164,367,0.4468664850136239,0.449,108,122,0.8852459016393442
Mike Bibby,bibbymi01,PG,26,SAC,2005,80,3084.0,1571,541,77,255,332,124,30,203,191,560,1264,0.4430379746835443,131,364,0.3598901098901099,429,900,0.4766666666666667,0.495,320,413,0.774818401937046
Andris Biedriņš,biedran01,C,18,GSW,2005,30,384.0,109,12,47,71,118,12,24,12,87,45,78,0.5769230769230769,0,1,0.0,45,77,0.5844155844155844,0.577,19,40,0.475
Chauncey Billups,billuch01,PG,28,DET,2005,80,2866.0,1316,464,48,223,271,81,9,180,194,404,913,0.4424972617743702,165,387,0.4263565891472868,239,526,0.4543726235741445,0.533,343,382,0.8979057591623036
Steve Blake,blakest01,PG,24,WAS,2005,44,648.0,191,69,18,53,71,13,0,39,47,61,186,0.3279569892473118,36,93,0.3870967741935484,25,93,0.2688172043010752,0.425,33,41,0.8048780487804879
Mark Blount,blounma01,C,29,BOS,2005,82,2130.0,771,129,143,254,397,33,64,158,229,327,618,0.529126213592233,0,1,0.0,327,617,0.5299837925445705,0.529,117,164,0.7134146341463414
Tony Bobbitt,bobbito01,SG,25,LAL,2005,2,12.0,5,0,0,3,3,0,0,0,1,2,5,0.4,1,2,0.5,1,3,0.3333333333333333,0.5,0,0,0.0
Keith Bogans,boganke01,SG,24,CHA,2005,74,1791.0,714,135,76,150,226,68,8,122,167,262,688,0.3808139534883721,57,173,0.3294797687861271,205,515,0.3980582524271844,0.422,133,183,0.726775956284153
Matt Bonner,bonnema01,C,24,TOR,2005,82,1553.0,589,48,108,177,285,39,19,40,220,247,463,0.5334773218142549,39,92,0.4239130434782608,208,371,0.5606469002695418,0.576,56,71,0.7887323943661971
Calvin Booth,boothca01,C,28,TOT,2005,51,451.0,124,8,29,78,107,15,28,16,78,49,108,0.4537037037037037,0,1,0.0,49,107,0.4579439252336448,0.454,26,32,0.8125
Carlos Boozer,boozeca01,PF,23,UTA,2005,51,1772.0,909,144,141,316,457,41,24,137,179,361,693,0.5209235209235209,0,1,0.0,361,692,0.5216763005780347,0.521,187,268,0.6977611940298507
Curtis Borchardt,borchcu01,C,24,UTA,2005,67,859.0,200,49,86,138,224,10,32,52,160,74,172,0.4302325581395348,0,0,0.0,74,172,0.4302325581395348,0.43,52,71,0.7323943661971831
Chris Bosh,boshch01,PF,20,TOR,2005,81,3017.0,1361,153,194,524,718,76,113,187,226,473,1005,0.4706467661691542,3,10,0.3,470,995,0.4723618090452261,0.472,412,542,0.7601476014760148
Bruce Bowen,bowenbr01,SF,33,SAS,2005,82,2627.0,675,126,50,235,285,55,39,57,175,251,598,0.4197324414715719,102,253,0.4031620553359684,149,345,0.4318840579710145,0.505,71,112,0.6339285714285714
Ryan Bowen,bowenry01,SF,29,HOU,2005,66,604.0,111,18,21,55,76,23,5,7,61,47,111,0.4234234234234234,3,6,0.5,44,105,0.419047619047619,0.437,14,21,0.6666666666666666
Earl Boykins,boykiea01,PG,28,DEN,2005,82,2162.0,1015,372,37,106,143,78,12,121,122,340,824,0.4126213592233009,56,166,0.3373493975903614,284,658,0.4316109422492401,0.447,279,303,0.9207920792079208
Michael Bradley,bradlmi01,PF,25,TOT,2005,18,119.0,33,5,8,20,28,1,2,5,12,15,24,0.625,0,1,0.0,15,23,0.6521739130434783,0.625,3,8,0.375
Shawn Bradley,bradlsh01,C,32,DAL,2005,77,885.0,211,15,70,144,214,25,63,33,153,84,186,0.4516129032258064,0,0,0.0,84,186,0.4516129032258064,0.452,43,63,0.6825396825396826
Torraye Braggs,braggto01,PF,28,HOU,2005,7,24.0,6,0,7,5,12,0,0,2,4,3,7,0.4285714285714285,0,0,0.0,3,7,0.4285714285714285,0.429,0,0,0.0
Elton Brand,brandel01,PF,25,LAC,2005,81,3001.0,1622,208,296,474,770,62,169,183,240,629,1251,0.5027977617905676,0,3,0.0,629,1248,0.5040064102564102,0.503,364,484,0.7520661157024794
Jamison Brewer,breweja01,PG,24,NYK,2005,18,185.0,31,12,6,16,22,8,1,13,11,11,37,0.2972972972972973,3,15,0.2,8,22,0.3636363636363636,0.338,6,13,0.4615384615384615
Primož Brezec,brezepr01,C,25,CHA,2005,72,2276.0,938,86,226,305,531,33,55,106,183,387,756,0.5119047619047619,0,0,0.0,387,756,0.5119047619047619,0.512,164,220,0.7454545454545455
Damone Brown,brownda02,SF,25,WAS,2005,14,152.0,54,14,10,18,28,1,6,15,17,23,62,0.3709677419354839,4,11,0.3636363636363636,19,51,0.3725490196078431,0.403,4,9,0.4444444444444444
Devin Brown,brownde02,SG,26,SAS,2005,67,1238.0,494,92,37,139,176,39,12,53,83,173,409,0.4229828850855746,45,121,0.371900826446281,128,288,0.4444444444444444,0.478,103,130,0.7923076923076923
Kedrick Brown,brownke01,SF,23,PHI,2005,8,55.0,12,4,1,10,11,3,1,5,4,2,6,0.3333333333333333,0,3,0.0,2,3,0.6666666666666666,0.333,8,10,0.8
Kwame Brown,brownkw01,PF,22,WAS,2005,42,908.0,292,39,72,134,206,25,15,67,112,109,237,0.459915611814346,0,0,0.0,109,237,0.459915611814346,0.46,74,129,0.5736434108527132
P.J. Brown,brownpj01,PF,35,NOH,2005,82,2817.0,886,178,266,471,737,74,50,101,233,338,758,0.445910290237467,0,0,0.0,338,758,0.445910290237467,0.446,210,243,0.8641975308641975
Tierre Brown,brownti01,PG,25,LAL,2005,76,1066.0,333,155,21,72,93,32,1,74,59,124,348,0.3563218390804598,26,72,0.3611111111111111,98,276,0.3550724637681159,0.394,59,75,0.7866666666666666
Rick Brunson,brunsri01,PG,32,LAC,2005,80,1945.0,437,410,23,164,187,82,7,125,106,166,442,0.3755656108597285,48,130,0.3692307692307692,118,312,0.3782051282051282,0.43,57,74,0.7702702702702703
Kobe Bryant,bryanko01,SG,26,LAL,2005,66,2689.0,1819,398,95,297,392,86,53,270,174,573,1324,0.4327794561933534,131,387,0.3385012919896641,442,937,0.471718249733191,0.482,542,664,0.8162650602409639
Greg Buckner,buckngr01,SG,28,DEN,2005,70,1522.0,432,133,66,142,208,75,6,49,169,160,303,0.528052805280528,49,121,0.4049586776859504,111,182,0.6098901098901099,0.609,63,81,0.7777777777777778
Rodney Buford,buforro01,SF,27,NJN,2005,64,1313.0,445,63,33,156,189,40,4,35,101,187,489,0.3824130879345603,34,108,0.3148148148148148,153,381,0.4015748031496063,0.417,37,45,0.8222222222222222
Antonio Burks,burksan01,PG,24,MEM,2005,24,219.0,73,28,1,11,12,13,1,12,25,28,60,0.4666666666666667,3,11,0.2727272727272727,25,49,0.5102040816326531,0.492,14,19,0.7368421052631579
Caron Butler,butleca01,SF,24,LAL,2005,77,2746.0,1195,146,146,304,450,110,23,125,213,441,991,0.4450050454086781,38,125,0.304,403,866,0.4653579676674365,0.464,275,319,0.8620689655172413
Jackie Butler,butleja01,C,19,NYK,2005,3,5.0,10,0,0,0,0,1,0,1,0,4,4,1.0,0,0,0.0,4,4,1.0,1.0,2,2,1.0
Rasual Butler,butlera01,SF,25,MIA,2005,65,1203.0,420,62,15,136,151,18,29,37,104,163,409,0.3985330073349633,57,153,0.3725490196078431,106,256,0.4140625,0.468,37,48,0.7708333333333334
Žarko Čabarkapa,cabarza01,PF,23,TOT,2005,40,475.0,238,25,35,67,102,10,5,30,59,86,177,0.4858757062146893,13,36,0.3611111111111111,73,141,0.5177304964539007,0.523,53,65,0.8153846153846154
Marcus Camby,cambyma01,C,30,DEN,2005,66,2015.0,683,152,131,530,661,61,199,103,177,279,600,0.465,0,4,0.0,279,596,0.4681208053691275,0.465,125,173,0.7225433526011561
Elden Campbell,campbel01,C,36,TOT,2005,40,390.0,120,19,28,65,93,8,7,29,57,39,123,0.3170731707317073,0,2,0.0,39,121,0.3223140495867768,0.317,42,55,0.7636363636363637
Brian Cardinal,cardibr01,PF,27,MEM,2005,58,1433.0,522,114,63,162,225,88,19,83,172,160,432,0.3703703703703703,44,125,0.352,116,307,0.3778501628664495,0.421,158,181,0.8729281767955801
Geno Carlisle,carlige01,SG,28,POR,2005,6,16.0,8,1,1,0,1,0,0,1,1,2,3,0.6666666666666666,0,0,0.0,2,3,0.6666666666666666,0.667,4,6,0.6666666666666666
Matt Carroll,carroma01,SG,24,CHA,2005,25,430.0,224,17,13,47,60,17,2,25,37,70,180,0.3888888888888889,13,39,0.3333333333333333,57,141,0.4042553191489361,0.425,71,83,0.8554216867469879
Anthony Carter,cartean01,PG,29,MIN,2005,66,742.0,181,161,12,57,69,35,18,62,88,72,177,0.4067796610169492,2,17,0.1176470588235294,70,160,0.4375,0.412,35,51,0.6862745098039216
Vince Carter,cartevi01,SF-SG,28,TOT,2005,77,2828.0,1886,327,106,295,401,109,48,168,243,696,1541,0.4516547696301103,127,313,0.4057507987220447,569,1228,0.4633550488599348,0.493,367,460,0.7978260869565217
Sam Cassell,cassesa01,PG,35,MIN,2005,59,1522.0,799,301,25,132,157,36,14,109,160,319,687,0.4643377001455604,27,103,0.2621359223300971,292,584,0.5,0.484,134,155,0.864516129032258
Kelvin Cato,catoke01,C,30,ORL,2005,62,1525.0,432,40,102,314,416,55,82,64,170,160,297,0.5387205387205387,0,0,0.0,160,297,0.5387205387205387,0.539,112,143,0.7832167832167832
Lionel Chalmers,chalmli01,PG,24,LAC,2005,36,433.0,111,51,4,27,31,13,0,24,30,42,125,0.336,12,49,0.2448979591836734,30,76,0.3947368421052631,0.384,15,24,0.625
Tyson Chandler,chandty01,C,22,CHI,2005,80,2189.0,640,65,261,514,775,69,141,118,268,207,419,0.4940334128878281,0,2,0.0,207,417,0.4964028776978417,0.494,226,336,0.6726190476190477
Calbert Cheaney,cheanca01,SG,33,GSW,2005,55,951.0,250,64,32,92,124,17,15,35,95,113,265,0.4264150943396226,0,3,0.0,113,262,0.4312977099236641,0.426,24,37,0.6486486486486487
Josh Childress,childjo01,SG,21,ATL,2005,80,2376.0,807,151,195,287,482,74,35,106,184,302,642,0.470404984423676,13,56,0.2321428571428571,289,586,0.4931740614334471,0.481,190,231,0.8225108225108225
Doug Christie,chrisdo01,SG,34,TOT,2005,52,1525.0,345,199,38,139,177,80,18,104,106,130,332,0.3915662650602409,15,62,0.2419354838709677,115,270,0.4259259259259259,0.414,70,78,0.8974358974358975
Speedy Claxton,claxtsp01,PG,26,TOT,2005,62,1866.0,712,374,37,147,184,109,8,119,184,257,611,0.4206219312602291,11,61,0.180327868852459,246,550,0.4472727272727272,0.43,187,254,0.7362204724409449
Mateen Cleaves,cleavma01,PG,27,SEA,2005,14,65.0,13,7,2,4,6,2,0,2,2,5,14,0.3571428571428571,0,2,0.0,5,12,0.4166666666666667,0.357,3,4,0.75
Derrick Coleman,colemde01,C,37,DET,2005,5,50.0,9,0,3,12,15,0,0,2,6,3,14,0.2142857142857142,0,2,0.0,3,12,0.25,0.214,3,3,1.0
Jason Collier,collija02,C,27,ATL,2005,70,942.0,402,18,84,100,184,15,13,63,147,174,376,0.4627659574468085,6,14,0.4285714285714285,168,362,0.4640883977900552,0.471,48,71,0.676056338028169
Jarron Collins,collija03,C,26,UTA,2005,50,961.0,213,61,57,107,164,11,6,34,146,65,157,0.4140127388535032,0,1,0.0,65,156,0.4166666666666667,0.414,83,119,0.6974789915966386
Jason Collins,collija04,C,26,NJN,2005,80,2542.0,511,105,153,335,488,71,71,91,322,186,451,0.4124168514412417,2,6,0.3333333333333333,184,445,0.4134831460674157,0.415,137,209,0.6555023923444976
Nick Collison,collini01,C,24,SEA,2005,82,1396.0,463,32,156,220,376,34,50,62,252,190,354,0.536723163841808,0,3,0.0,190,351,0.5413105413105413,0.537,83,118,0.7033898305084746
Brian Cook,cookbr01,C,24,LAL,2005,72,1087.0,458,35,63,153,216,23,26,29,139,176,422,0.4170616113744075,78,199,0.3919597989949748,98,223,0.4394618834080717,0.509,28,37,0.7567567567567568
Omar Cook,cookom01,PG,23,TOR,2005,5,74.0,23,22,2,5,7,6,1,6,6,10,24,0.4166666666666667,0,4,0.0,10,20,0.5,0.417,3,6,0.5
Jamal Crawford,crawfja01,SG,24,NYK,2005,70,2688.0,1241,302,33,170,203,92,19,148,135,437,1097,0.398359161349134,185,512,0.361328125,252,585,0.4307692307692308,0.483,182,216,0.8425925925925926
Austin Croshere,croshau01,PF,29,IND,2005,73,1827.0,647,98,103,272,375,48,17,104,154,188,497,0.3782696177062374,45,174,0.2586206896551724,143,323,0.4427244582043343,0.424,226,256,0.8828125
Eddy Curry,curryed01,C,22,CHI,2005,63,1808.0,1012,37,116,222,338,21,58,163,202,393,730,0.5383561643835616,0,0,0.0,393,730,0.5383561643835616,0.538,226,314,0.7197452229299363
Michael Curry,currymi01,SF,36,IND,2005,18,249.0,30,15,8,19,27,5,4,5,39,13,29,0.4482758620689655,0,0,0.0,13,29,0.4482758620689655,0.448,4,8,0.5
Samuel Dalembert,dalemsa01,C,23,PHI,2005,72,1785.0,589,35,187,355,542,46,121,114,241,250,477,0.5241090146750524,0,0,0.0,250,477,0.5241090146750524,0.524,89,148,0.6013513513513513
Erick Dampier,dampier01,C,29,DAL,2005,59,1609.0,542,51,183,318,501,15,80,102,205,202,367,0.5504087193460491,0,3,0.0,202,364,0.554945054945055,0.55,138,228,0.6052631578947368
Antonio Daniels,daniean01,PG,29,SEA,2005,75,2026.0,843,309,20,149,169,51,3,78,78,273,623,0.4382022471910112,49,165,0.296969696969697,224,458,0.4890829694323144,0.478,248,304,0.8157894736842105
Erik Daniels,danieer01,SF,22,SAC,2005,21,72.0,13,4,7,11,18,2,0,6,7,6,18,0.3333333333333333,1,2,0.5,5,16,0.3125,0.361,0,0,0.0
Marquis Daniels,daniema01,SG,24,DAL,2005,60,1412.0,545,128,87,129,216,83,14,86,124,220,504,0.4365079365079365,7,35,0.2,213,469,0.4541577825159915,0.443,98,133,0.7368421052631579
Antonio Davis,davisan01,PF,36,CHI,2005,72,1843.0,501,80,152,276,428,27,41,96,147,193,419,0.4606205250596659,0,0,0.0,193,419,0.4606205250596659,0.461,115,152,0.756578947368421
Baron Davis,davisba01,PG,25,TOT,2005,46,1581.0,885,362,32,143,175,81,14,131,126,291,752,0.386968085106383,118,354,0.3333333333333333,173,398,0.4346733668341708,0.465,185,243,0.7613168724279835
Dale Davis,davisda01,C,35,TOT,2005,61,1307.0,284,47,152,223,375,32,65,43,162,112,234,0.4786324786324786,0,0,0.0,112,234,0.4786324786324786,0.479,60,99,0.6060606060606061
Josh Davis,davisjo02,PF,24,PHI,2005,42,328.0,117,12,29,50,79,8,4,15,45,42,111,0.3783783783783784,19,53,0.3584905660377358,23,58,0.396551724137931,0.464,14,17,0.8235294117647058
Ricky Davis,davisri01,SG,25,BOS,2005,82,2696.0,1309,246,66,183,249,89,27,205,174,481,1041,0.4620557156580211,61,180,0.3388888888888889,420,861,0.4878048780487805,0.491,286,351,0.8148148148148148
Andrew DeClercq,declean01,C,31,ORL,2005,8,49.0,9,0,7,3,10,2,0,1,14,4,9,0.4444444444444444,0,0,0.0,4,9,0.4444444444444444,0.444,1,3,0.3333333333333333
Carlos Delfino,delfica01,SG,22,DET,2005,30,459.0,116,38,13,42,55,22,6,23,44,42,117,0.358974358974359,9,35,0.2571428571428571,33,82,0.4024390243902439,0.397,23,40,0.575
Tony Delk,delkto01,SG,31,ATL,2005,56,1340.0,667,104,28,102,130,47,3,54,123,246,591,0.416243654822335,72,202,0.3564356435643564,174,389,0.4473007712082262,0.477,103,136,0.7573529411764706
Luol Deng,denglu01,SF,19,CHI,2005,61,1663.0,711,135,92,230,322,48,27,118,98,280,645,0.4341085271317829,31,117,0.2649572649572649,249,528,0.4715909090909091,0.458,120,162,0.7407407407407407
Boris Diaw,diawbo01,SG,22,ATL,2005,66,1201.0,314,149,54,116,170,37,18,87,123,124,294,0.4217687074829932,9,50,0.18,115,244,0.4713114754098361,0.437,57,77,0.7402597402597403
Dan Dickau,dickada01,PG,26,TOT,2005,71,2090.0,887,347,34,146,180,76,4,145,201,306,756,0.4047619047619047,85,245,0.3469387755102041,221,511,0.4324853228962818,0.461,190,228,0.8333333333333334
Kaniel Dickens,dickeka01,SF,26,NJN,2005,11,61.0,13,1,3,6,9,2,1,2,5,4,14,0.2857142857142857,3,9,0.3333333333333333,1,5,0.2,0.393,2,2,1.0
DeSagana Diop,diopde01,C,23,CLE,2005,39,306.0,40,15,30,40,70,8,27,12,53,20,69,0.2898550724637681,0,2,0.0,20,67,0.2985074626865671,0.29,0,5,0.0
Vlade Divac,divacvl01,C,36,LAL,2005,15,130.0,34,19,18,14,32,4,1,14,25,13,31,0.4193548387096774,0,0,0.0,13,31,0.4193548387096774,0.419,8,12,0.6666666666666666
Juan Dixon,dixonju01,SG,26,WAS,2005,63,1054.0,507,111,32,87,119,43,4,68,98,186,447,0.4161073825503356,48,147,0.3265306122448979,138,300,0.46,0.47,87,97,0.8969072164948454
Michael Doleac,doleami01,C,27,MIA,2005,80,1175.0,321,47,74,185,259,23,22,36,160,148,331,0.4471299093655589,0,2,0.0,148,329,0.4498480243161094,0.447,25,41,0.6097560975609756
Keyon Dooling,doolike01,PG,24,MIA,2005,74,1184.0,382,132,11,79,90,39,11,65,120,139,345,0.4028985507246377,19,75,0.2533333333333333,120,270,0.4444444444444444,0.43,85,109,0.7798165137614679
Predrag Drobnjak,drobnpr01,C,29,ATL,2005,71,1435.0,597,49,73,165,238,42,24,78,138,238,543,0.438305709023941,25,71,0.352112676056338,213,472,0.451271186440678,0.461,96,120,0.8
Chris Duhon,duhonch01,PG,22,CHI,2005,82,2177.0,487,398,23,190,213,82,3,119,205,172,488,0.3524590163934426,94,265,0.3547169811320754,78,223,0.3497757847533632,0.449,49,67,0.7313432835820896
Tim Duncan,duncati01,PF,28,SAS,2005,66,2203.0,1342,179,202,530,732,45,174,127,144,517,1042,0.4961612284069098,3,9,0.3333333333333333,514,1033,0.4975798644724105,0.498,305,455,0.6703296703296703
Mike Dunleavy,dunlemi02,SF,24,GSW,2005,79,2570.0,1057,203,97,338,435,79,26,132,198,408,905,0.450828729281768,107,276,0.3876811594202898,301,629,0.4785373608903021,0.51,134,172,0.7790697674418605
Ronald Dupree,duprero01,SF,24,DET,2005,47,472.0,152,24,34,61,95,7,10,22,60,61,127,0.4803149606299212,1,2,0.5,60,125,0.48,0.484,29,47,0.6170212765957447
Ndudi Ebi,ebind01,SG,20,MIN,2005,2,54.0,27,1,6,10,16,1,1,3,7,11,21,0.5238095238095238,0,1,0.0,11,20,0.55,0.524,5,9,0.5555555555555556
Corsley Edwards,edwarco01,C,25,NOH,2005,10,110.0,27,3,12,13,25,3,4,2,19,10,31,0.3225806451612903,0,0,0.0,10,31,0.3225806451612903,0.323,7,12,0.5833333333333334
John Edwards,edwarjo01,C,23,IND,2005,25,139.0,29,3,8,11,19,3,4,8,12,11,30,0.3666666666666666,0,0,0.0,11,30,0.3666666666666666,0.367,7,14,0.5
Howard Eisley,eisleho01,PG,32,UTA,2005,74,1428.0,415,250,15,75,90,45,9,111,156,161,405,0.3975308641975308,27,103,0.2621359223300971,134,302,0.4437086092715231,0.431,66,83,0.7951807228915663
Obinna Ekezie,ekeziob01,C,29,ATL,2005,42,732.0,230,11,69,110,179,22,12,45,129,79,182,0.4340659340659341,0,1,0.0,79,181,0.43646408839779,0.434,72,93,0.7741935483870968
Francisco Elson,elsonfr01,C,28,DEN,2005,67,939.0,248,34,61,140,201,34,41,40,129,101,216,0.4675925925925926,1,3,0.3333333333333333,100,213,0.4694835680751174,0.47,45,79,0.569620253164557
Melvin Ely,elyme01,PF,26,CHA,2005,79,1649.0,576,76,142,184,326,32,69,115,199,227,526,0.4315589353612167,0,0,0.0,227,526,0.4315589353612167,0.432,122,212,0.5754716981132075
Andre Emmett,emmetan01,SG,22,MEM,2005,8,28.0,7,0,0,2,2,0,0,1,4,2,6,0.3333333333333333,0,0,0.0,2,6,0.3333333333333333,0.333,3,5,0.6
Maurice Evans,evansma01,SG,26,SAC,2005,65,1233.0,416,45,88,113,201,37,8,34,104,165,373,0.4423592493297587,27,82,0.3292682926829268,138,291,0.4742268041237113,0.479,59,78,0.7564102564102564
Reggie Evans,evansre01,PF,24,SEA,2005,79,1881.0,387,58,254,482,736,58,15,104,202,131,275,0.4763636363636364,0,2,0.0,131,273,0.4798534798534798,0.476,125,234,0.5341880341880342
Michael Finley,finlemi01,SG,31,DAL,2005,64,2358.0,1003,169,45,217,262,48,18,60,123,387,907,0.4266813671444321,116,285,0.4070175438596491,271,622,0.4356913183279742,0.491,113,136,0.8308823529411765
Derek Fisher,fishede01,PG,30,GSW,2005,74,2222.0,877,301,38,180,218,76,4,129,176,297,755,0.3933774834437086,108,291,0.3711340206185567,189,464,0.4073275862068966,0.465,175,203,0.8620689655172413
Marcus Fizer,fizerma01,PF,26,MIL,2005,54,903.0,336,64,29,146,175,25,13,63,96,133,292,0.4554794520547945,0,6,0.0,133,286,0.465034965034965,0.455,70,103,0.6796116504854369
Luis Flores,florelu01,PG,23,TOT,2005,16,77.0,35,11,1,2,3,2,0,11,9,14,29,0.4827586206896552,5,10,0.5,9,19,0.4736842105263157,0.569,2,2,1.0
Danny Fortson,fortsda01,C,28,SEA,2005,62,1047.0,463,8,157,191,348,15,7,91,265,118,226,0.5221238938053098,0,0,0.0,118,226,0.5221238938053098,0.522,227,258,0.8798449612403101
Jeff Foster,fosteje01,C,28,IND,2005,61,1594.0,426,43,205,345,550,46,12,55,186,168,324,0.5185185185185185,0,5,0.0,168,319,0.5266457680250783,0.519,90,142,0.6338028169014085
Tremaine Fowlkes,fowlktr01,SF,28,IND,2005,8,56.0,19,0,3,5,8,2,0,5,7,9,17,0.5294117647058824,1,3,0.3333333333333333,8,14,0.5714285714285714,0.559,0,2,0.0
Adonal Foyle,foylead01,C,29,GSW,2005,78,1700.0,352,56,165,264,429,26,159,58,201,156,311,0.5016077170418006,0,0,0.0,156,311,0.5016077170418006,0.502,40,72,0.5555555555555556
Richie Frahm,frahmri01,SG,27,POR,2005,43,499.0,164,30,17,44,61,15,4,14,35,56,140,0.4,31,80,0.3875,25,60,0.4166666666666667,0.511,21,25,0.84
Steve Francis,francst01,PG,27,ORL,2005,78,2978.0,1663,547,126,324,450,112,28,317,273,563,1330,0.4233082706766917,38,127,0.2992125984251969,525,1203,0.4364089775561097,0.438,499,606,0.8234323432343235
Matt Freije,freijma01,PF,23,NOH,2005,23,441.0,93,20,16,45,61,13,2,17,40,37,127,0.2913385826771653,14,54,0.2592592592592592,23,73,0.3150684931506849,0.346,5,8,0.625
Lawrence Funderburke,fundela01,PF,34,CHI,2005,2,21.0,9,0,1,2,3,0,0,0,2,3,6,0.5,0,0,0.0,3,6,0.5,0.5,3,5,0.6
Dan Gadzuric,gadzuda01,C,26,MIL,2005,81,1783.0,593,30,261,413,674,47,106,81,224,243,451,0.5388026607538803,0,0,0.0,243,451,0.5388026607538803,0.539,107,199,0.5376884422110553
Reece Gaines,gainere01,PG,24,TOT,2005,21,187.0,41,7,1,13,14,5,1,7,17,17,50,0.34,4,14,0.2857142857142857,13,36,0.3611111111111111,0.38,3,4,0.75
Alex Garcia,garcial01,SG,24,NOH,2005,8,146.0,44,18,7,8,15,4,1,8,15,18,52,0.3461538461538461,5,18,0.2777777777777778,13,34,0.3823529411764705,0.394,3,4,0.75
Kevin Garnett,garneke01,PF,28,MIN,2005,82,3121.0,1817,466,247,861,1108,121,112,222,207,683,1360,0.5022058823529412,6,25,0.24,677,1335,0.5071161048689139,0.504,445,549,0.8105646630236795
Pat Garrity,garripa01,PF,28,ORL,2005,71,955.0,324,30,21,103,124,19,9,30,107,123,306,0.4019607843137255,49,147,0.3333333333333333,74,159,0.4654088050314465,0.482,29,33,0.8787878787878788
Pau Gasol,gasolpa01,PF,24,MEM,2005,56,1790.0,997,135,130,280,410,37,93,137,146,357,695,0.5136690647482014,1,6,0.1666666666666666,356,689,0.5166908563134979,0.514,282,367,0.7683923705722071
Devean George,georgde01,SF,27,LAL,2005,15,306.0,110,14,13,40,53,8,2,12,32,37,104,0.3557692307692308,21,58,0.3620689655172414,16,46,0.3478260869565217,0.457,15,20,0.75
Eddie Gill,gilled01,PG,26,IND,2005,73,1021.0,269,83,16,96,112,59,5,60,105,81,242,0.3347107438016529,36,117,0.3076923076923077,45,125,0.36,0.409,71,81,0.8765432098765432
Kendall Gill,gillke01,SG,36,MIL,2005,14,284.0,85,27,11,26,37,14,4,9,37,32,80,0.4,3,9,0.3333333333333333,29,71,0.4084507042253521,0.419,18,20,0.9
Manu Ginóbili,ginobma01,SG,27,SAS,2005,74,2193.0,1186,288,75,254,329,119,27,172,190,367,780,0.4705128205128205,97,258,0.375968992248062,270,522,0.5172413793103449,0.533,355,442,0.8031674208144797
Gordan Giriček,giricgo01,SG,27,UTA,2005,81,1660.0,715,137,25,157,182,46,11,90,155,283,632,0.4477848101265823,38,105,0.3619047619047619,245,527,0.4648956356736243,0.478,111,137,0.8102189781021898
Dion Glover,glovedi01,SG,26,SAS,2005,7,68.0,25,4,3,8,11,3,3,2,9,8,22,0.3636363636363636,1,8,0.125,7,14,0.5,0.386,8,10,0.8
Anthony Goldwire,goldwan01,PG,33,TOT,2005,33,537.0,172,78,10,49,59,15,0,15,32,57,136,0.4191176470588235,32,80,0.4,25,56,0.4464285714285714,0.537,26,31,0.8387096774193549
Drew Gooden,goodedr01,PF,23,CLE,2005,82,2523.0,1184,130,207,546,753,77,76,133,233,464,943,0.4920466595970307,5,28,0.1785714285714285,459,915,0.5016393442622951,0.495,251,310,0.8096774193548387
Ben Gordon,gordobe01,SG,21,CHI,2005,82,2002.0,1235,164,55,160,215,53,10,186,224,434,1056,0.4109848484848485,134,331,0.404833836858006,300,725,0.4137931034482758,0.474,233,270,0.8629629629629629
Brian Grant,grantbr01,C,32,LAL,2005,69,1136.0,263,34,101,156,257,23,23,43,175,103,209,0.492822966507177,0,0,0.0,103,209,0.492822966507177,0.493,57,79,0.7215189873417721
Willie Green,greenwi01,SG,23,PHI,2005,57,1066.0,437,100,22,111,133,34,6,75,121,155,423,0.3664302600472813,30,105,0.2857142857142857,125,318,0.3930817610062893,0.402,97,125,0.776
Adrian Griffin,griffad01,SF,30,CHI,2005,69,667.0,151,53,52,94,146,43,4,30,78,58,161,0.3602484472049689,2,9,0.2222222222222222,56,152,0.3684210526315789,0.366,33,44,0.75
Eddie Griffin,griffed01,PF,22,MIN,2005,70,1492.0,527,53,128,325,453,23,118,55,120,202,522,0.3869731800766283,67,204,0.3284313725490196,135,318,0.4245283018867924,0.451,56,78,0.717948717948718
Tom Gugliotta,guglito01,PF,35,TOT,2005,47,966.0,239,68,56,135,191,41,17,57,104,99,241,0.4107883817427386,8,26,0.3076923076923077,91,215,0.4232558139534884,0.427,33,43,0.7674418604651163
Marcus Haislip,haislma01,PF,24,IND,2005,9,106.0,32,3,5,10,15,2,2,6,15,13,38,0.3421052631578947,0,1,0.0,13,37,0.3513513513513513,0.342,6,11,0.5454545454545454
Darvin Ham,hamda01,SF,31,DET,2005,47,275.0,46,5,19,16,35,6,7,8,39,17,37,0.4594594594594595,0,0,0.0,17,37,0.4594594594594595,0.459,12,31,0.3870967741935484
Richard Hamilton,hamilri01,SG,26,DET,2005,76,2926.0,1424,372,74,221,295,77,13,217,232,510,1160,0.4396551724137931,36,118,0.3050847457627119,474,1042,0.45489443378119,0.455,368,429,0.8578088578088578
Zendon Hamilton,hamilze01,C,29,MIL,2005,16,159.0,51,6,18,24,42,5,2,12,26,11,32,0.34375,0,0,0.0,11,32,0.34375,0.344,29,48,0.6041666666666666
Ben Handlogten,handlbe01,C,31,UTA,2005,21,297.0,95,13,23,42,65,7,5,18,55,43,83,0.5180722891566265,0,1,0.0,43,82,0.524390243902439,0.518,9,17,0.5294117647058824
Anfernee Hardaway,hardaan01,SF,33,NYK,2005,37,894.0,269,74,19,70,89,28,3,50,79,110,260,0.4230769230769231,15,50,0.3,95,210,0.4523809523809524,0.452,34,46,0.7391304347826086
Matt Harpring,harprma01,SF,28,UTA,2005,78,2584.0,1090,142,196,284,480,70,16,133,250,418,855,0.4888888888888889,9,43,0.2093023255813953,409,812,0.5036945812807881,0.494,245,315,0.7777777777777778
Al Harrington,harrial01,SF,24,ATL,2005,66,2550.0,1158,208,145,316,461,85,16,204,249,453,986,0.4594320486815416,16,74,0.2162162162162162,437,912,0.4791666666666667,0.468,236,351,0.6723646723646723
Junior Harrington,harriju01,SG,24,NOH,2005,29,550.0,163,62,13,50,63,25,5,41,72,64,178,0.3595505617977528,6,19,0.3157894736842105,58,159,0.3647798742138364,0.376,29,35,0.8285714285714286
Othella Harrington,harriot01,PF,31,CHI,2005,70,1271.0,561,56,106,186,292,24,18,84,188,217,424,0.5117924528301887,0,0,0.0,217,424,0.5117924528301887,0.512,127,177,0.7175141242937854
Devin Harris,harride01,PG,21,DAL,2005,76,1173.0,436,169,28,74,102,77,19,82,139,157,366,0.4289617486338797,44,131,0.3358778625954198,113,235,0.4808510638297872,0.489,78,103,0.7572815533980582
Lucious Harris,harrilu01,SG,34,CLE,2005,73,1128.0,313,49,39,82,121,27,6,29,68,118,299,0.3946488294314381,21,65,0.3230769230769231,97,234,0.4145299145299145,0.43,56,69,0.8115942028985508
David Harrison,harrida01,C,22,IND,2005,43,760.0,264,13,48,87,135,16,55,53,134,106,184,0.5760869565217391,0,0,0.0,106,184,0.5760869565217391,0.576,52,91,0.5714285714285714
Jason Hart,hartja01,PG,26,CHA,2005,74,1887.0,706,367,18,185,203,99,14,102,167,257,573,0.4485165794066317,35,95,0.3684210526315789,222,478,0.4644351464435146,0.479,157,200,0.785
Donnell Harvey,harvedo01,PF,24,NJN,2005,3,16.0,8,1,2,5,7,1,1,1,2,2,2,1.0,0,0,0.0,2,2,1.0,1.0,4,4,1.0
Udonis Haslem,hasleud01,PF,24,MIA,2005,80,2675.0,870,108,239,487,726,63,41,113,260,346,641,0.5397815912636506,0,4,0.0,346,637,0.543171114599686,0.54,178,225,0.7911111111111111
Trenton Hassell,hassetr01,SG,25,MIN,2005,82,2068.0,541,128,80,139,219,30,30,64,200,225,475,0.4736842105263157,1,11,0.0909090909090909,224,464,0.4827586206896552,0.475,90,114,0.7894736842105263
Jarvis Hayes,hayesja01,SF,23,WAS,2005,54,1560.0,553,90,41,186,227,49,9,62,107,206,530,0.3886792452830189,42,123,0.3414634146341463,164,407,0.4029484029484029,0.428,99,118,0.8389830508474576
Brendan Haywood,haywobr01,C,25,WAS,2005,68,1865.0,637,57,202,262,464,52,114,96,218,239,427,0.5597189695550351,0,0,0.0,239,427,0.5597189695550351,0.56,159,261,0.6091954022988506
Alan Henderson,hendeal01,PF,32,DAL,2005,78,1203.0,273,21,164,184,348,29,37,49,149,116,220,0.5272727272727272,0,2,0.0,116,218,0.5321100917431193,0.527,41,76,0.5394736842105263
Nenê,hilarne01,C,22,DEN,2005,55,1317.0,528,84,104,221,325,50,48,94,167,194,386,0.5025906735751295,0,2,0.0,194,384,0.5052083333333334,0.503,140,212,0.660377358490566
Grant Hill,hillgr01,SF,32,ORL,2005,67,2338.0,1317,220,77,241,318,97,28,161,144,517,1015,0.50935960591133,3,13,0.2307692307692307,514,1002,0.5129740518962076,0.511,280,341,0.8211143695014663
Kirk Hinrich,hinriki01,PG,24,CHI,2005,77,2800.0,1206,494,32,272,304,122,21,176,244,445,1122,0.3966131907308378,145,408,0.3553921568627451,300,714,0.4201680672268907,0.461,171,216,0.7916666666666666
Fred Hoiberg,hoibefr01,SG,32,MIN,2005,76,1272.0,437,85,32,149,181,50,15,20,105,139,284,0.4894366197183099,70,145,0.4827586206896552,69,139,0.4964028776978417,0.613,89,102,0.8725490196078431
Robert Horry,horryro01,PF,34,SAS,2005,75,1396.0,451,80,91,177,268,67,60,69,138,157,375,0.4186666666666667,51,138,0.3695652173913043,106,237,0.4472573839662447,0.487,86,109,0.7889908256880734
Eddie House,houseed01,PG-SG,26,TOT,2005,68,891.0,397,96,16,67,83,44,6,35,65,165,366,0.4508196721311475,44,97,0.4536082474226804,121,269,0.449814126394052,0.511,23,27,0.8518518518518519
Allan Houston,houstal01,SG,33,NYK,2005,20,532.0,237,42,4,19,23,8,2,21,40,85,205,0.4146341463414634,31,80,0.3875,54,125,0.432,0.49,36,43,0.8372093023255814
Dwight Howard,howardw01,PF,19,ORL,2005,82,2670.0,981,75,287,536,823,77,136,165,232,352,677,0.5199409158050221,0,2,0.0,352,675,0.5214814814814814,0.52,277,413,0.6707021791767555
Josh Howard,howarjo01,SF,24,DAL,2005,76,2446.0,958,109,169,315,484,116,49,122,211,377,793,0.4754098360655737,34,115,0.2956521739130435,343,678,0.5058997050147492,0.497,170,232,0.7327586206896551
Juwan Howard,howarju01,PF,31,HOU,2005,61,1624.0,585,94,126,220,346,32,5,79,143,244,541,0.4510166358595194,0,1,0.0,244,540,0.4518518518518518,0.451,97,115,0.8434782608695652
Troy Hudson,hudsotr01,PG,28,MIN,2005,79,1729.0,691,283,19,86,105,27,6,113,121,266,664,0.4006024096385542,89,258,0.3449612403100775,177,406,0.4359605911330049,0.468,70,90,0.7777777777777778
Larry Hughes,hughela01,SG,26,WAS,2005,61,2358.0,1345,285,74,308,382,176,18,153,168,467,1086,0.4300184162062615,59,209,0.2822966507177033,408,877,0.4652223489167617,0.457,352,453,0.7770419426048565
Ryan Humphrey,humphry01,SF,25,MEM,2005,35,317.0,102,6,50,37,87,10,1,23,35,42,103,0.4077669902912621,0,2,0.0,42,101,0.4158415841584158,0.408,18,37,0.4864864864864865
Kris Humphries,humphkr01,PF,19,UTA,2005,67,873.0,278,43,73,124,197,25,18,52,96,116,287,0.4041811846689895,2,6,0.3333333333333333,114,281,0.4056939501779359,0.408,44,101,0.4356435643564356
Brandon Hunter,huntebr01,PF,24,ORL,2005,31,224.0,95,3,25,44,69,4,7,22,42,37,73,0.5068493150684932,0,0,0.0,37,73,0.5068493150684932,0.507,21,39,0.5384615384615384
Lindsey Hunter,hunteli01,SG,34,DET,2005,76,1144.0,285,130,38,85,123,68,13,68,125,108,302,0.3576158940397351,23,84,0.2738095238095238,85,218,0.3899082568807339,0.396,46,58,0.7931034482758621
Steven Hunter,huntest01,C,23,PHO,2005,76,1046.0,348,13,98,129,227,4,102,44,131,135,220,0.6136363636363636,0,1,0.0,135,219,0.6164383561643836,0.614,78,163,0.4785276073619632
Andre Iguodala,iguodan01,SG,21,PHI,2005,82,2686.0,741,246,89,375,464,138,48,139,204,269,546,0.4926739926739927,47,142,0.3309859154929577,222,404,0.5495049504950495,0.536,156,210,0.7428571428571429
Zydrunas Ilgauskas,ilgauzy01,C,29,CLE,2005,78,2615.0,1320,100,299,373,672,53,165,191,313,458,979,0.4678243105209397,2,7,0.2857142857142857,456,972,0.4691358024691358,0.469,402,503,0.7992047713717694
D.J. Mbenga,mbengdj01,C,24,DAL,2005,15,58.0,15,0,3,5,8,0,5,5,13,6,14,0.4285714285714285,0,0,0.0,6,14,0.4285714285714285,0.429,3,4,0.75
Allen Iverson,iversal01,PG,29,PHI,2005,75,3174.0,2302,596,51,248,299,180,9,344,140,771,1818,0.4240924092409241,104,338,0.3076923076923077,667,1480,0.4506756756756757,0.453,656,786,0.8346055979643766
Royal Ivey,iveyro01,PG,23,ATL,2005,62,809.0,220,103,19,65,84,39,7,58,140,85,198,0.4292929292929293,3,9,0.3333333333333333,82,189,0.4338624338624338,0.437,47,67,0.7014925373134329
Bobby Jackson,jacksbo01,SG,31,SAC,2005,25,536.0,301,59,23,62,85,14,2,28,58,109,255,0.4274509803921568,33,96,0.34375,76,159,0.4779874213836478,0.492,50,58,0.8620689655172413
Jermaine Jackson,jacksje01,SG,28,NYK,2005,21,230.0,42,24,3,20,23,7,1,10,26,17,33,0.5151515151515151,0,2,0.0,17,31,0.5483870967741935,0.515,8,13,0.6153846153846154
Jim Jackson,jacksji01,SF,34,TOT,2005,64,1987.0,672,183,33,236,269,35,5,115,153,248,582,0.4261168384879725,122,295,0.4135593220338983,126,287,0.4390243902439024,0.531,54,58,0.9310344827586208
Luke Jackson,jackslu02,SF,23,CLE,2005,10,43.0,29,3,2,4,6,0,0,2,4,10,27,0.3703703703703703,4,6,0.6666666666666666,6,21,0.2857142857142857,0.444,5,6,0.8333333333333334
Marc Jackson,jacksma02,C,30,PHI,2005,81,1976.0,969,81,184,222,406,32,18,131,171,340,731,0.4651162790697674,0,2,0.0,340,729,0.4663923182441701,0.465,289,349,0.828080229226361
Stephen Jackson,jacksst02,SF,26,IND,2005,51,1806.0,953,119,44,206,250,64,14,123,154,330,819,0.4029304029304029,103,286,0.3601398601398601,227,533,0.425891181988743,0.466,190,229,0.8296943231441049
Casey Jacobsen,jacobca01,SG-SF,23,TOT,2005,84,1798.0,547,113,35,132,167,33,8,71,104,165,408,0.4044117647058823,66,177,0.3728813559322034,99,231,0.4285714285714285,0.485,151,192,0.7864583333333334
Jerome James,jamesje01,C,29,SEA,2005,80,1330.0,395,19,81,160,241,23,111,88,279,174,342,0.5087719298245614,0,2,0.0,174,340,0.5117647058823529,0.509,47,65,0.7230769230769231
LeBron James,jamesle01,SF,20,CLE,2005,80,3388.0,2175,577,111,477,588,177,52,262,146,795,1684,0.4720902612826603,108,308,0.3506493506493506,687,1376,0.4992732558139535,0.504,477,636,0.75
Mike James,jamesmi01,PG,29,TOT,2005,74,1859.0,871,263,35,173,208,65,6,106,174,331,751,0.440745672436751,100,259,0.3861003861003861,231,492,0.4695121951219512,0.507,109,145,0.7517241379310344
Antawn Jamison,jamisan01,PF,28,WAS,2005,68,2605.0,1334,154,160,359,519,55,16,118,151,519,1189,0.4365012615643397,71,208,0.3413461538461538,448,981,0.4566768603465851,0.466,225,296,0.7601351351351351
Marko Jarić,jaricma01,PG,26,LAC,2005,50,1656.0,493,303,20,141,161,84,17,98,107,189,457,0.4135667396061269,56,151,0.3708609271523179,133,306,0.434640522875817,0.475,59,82,0.7195121951219512
Al Jefferson,jeffeal01,PF,20,BOS,2005,71,1051.0,475,24,119,193,312,22,55,66,195,195,369,0.5284552845528455,0,3,0.0,195,366,0.5327868852459017,0.528,85,135,0.6296296296296297
Richard Jefferson,jefferi01,SF,24,NJN,2005,33,1355.0,733,133,49,191,240,33,17,132,109,238,564,0.4219858156028369,30,89,0.3370786516853932,208,475,0.4378947368421053,0.449,227,269,0.8438661710037175
Jared Jeffries,jeffrja01,SF,23,WAS,2005,77,2007.0,523,151,152,222,374,66,35,114,206,203,434,0.4677419354838709,16,51,0.3137254901960784,187,383,0.4882506527415143,0.486,101,173,0.5838150289017341
Horace Jenkins,jenkiho01,PG,30,DET,2005,15,104.0,42,9,3,6,9,5,1,7,6,15,45,0.3333333333333333,0,9,0.0,15,36,0.4166666666666667,0.333,12,13,0.9230769230769232
Britton Johnsen,johnsbr01,SF,25,IND,2005,6,87.0,12,4,5,5,10,1,0,3,10,6,22,0.2727272727272727,0,4,0.0,6,18,0.3333333333333333,0.273,0,0,0.0
Anthony Johnson,johnsan02,PG,30,IND,2005,63,1747.0,532,302,32,147,179,59,15,96,144,203,456,0.4451754385964912,41,108,0.3796296296296296,162,348,0.4655172413793103,0.49,85,113,0.7522123893805309
DerMarr Johnson,johnsde03,SG,24,DEN,2005,71,1232.0,503,75,43,108,151,43,18,65,140,185,371,0.4986522911051212,53,148,0.3581081081081081,132,223,0.5919282511210763,0.57,80,101,0.7920792079207921
Ervin Johnson,johnser02,C,37,MIN,2005,46,410.0,73,6,43,70,113,7,13,18,86,28,54,0.5185185185185185,1,1,1.0,27,53,0.5094339622641509,0.528,16,25,0.64
Joe Johnson,johnsjo02,SF,23,PHO,2005,82,3240.0,1400,291,120,302,422,79,24,148,167,544,1179,0.4614079728583545,177,370,0.4783783783783784,367,809,0.453646477132262,0.536,135,180,0.75
Linton Johnson,johnsli01,SF,24,SAS,2005,2,15.0,0,0,0,3,3,1,0,1,1,0,2,0.0,0,1,0.0,0,1,0.0,0.0,0,0,0.0
Dahntay Jones,jonesda02,SG,24,MEM,2005,52,649.0,233,21,11,58,69,13,11,29,81,83,190,0.4368421052631579,23,60,0.3833333333333333,60,130,0.4615384615384615,0.497,44,64,0.6875
Damon Jones,jonesda01,PG,28,MIA,2005,82,2576.0,955,350,14,217,231,44,5,98,121,331,726,0.4559228650137741,225,521,0.4318618042226487,106,205,0.5170731707317073,0.611,68,86,0.7906976744186046
Eddie Jones,jonesed02,SF,33,MIA,2005,80,2839.0,1018,212,38,367,405,86,38,99,251,351,820,0.4280487804878048,142,382,0.3717277486910995,209,438,0.4771689497716895,0.515,174,216,0.8055555555555556
Fred Jones,jonesfr01,SG,25,IND,2005,77,2268.0,813,196,34,208,242,61,31,114,171,275,647,0.4250386398763524,87,229,0.3799126637554585,188,418,0.4497607655502392,0.492,176,207,0.8502415458937198
James Jones,jonesja02,SF,24,IND,2005,75,1330.0,371,57,39,135,174,31,28,43,123,126,318,0.3962264150943396,66,166,0.3975903614457831,60,152,0.3947368421052631,0.5,53,62,0.8548387096774194
Jumaine Jones,jonesju01,SF,25,LAL,2005,76,1830.0,577,65,107,291,398,44,24,49,165,210,486,0.4320987654320987,102,261,0.3908045977011494,108,225,0.48,0.537,55,75,0.7333333333333333
Mark Jones,jonesma03,SF,29,ORL,2005,10,116.0,23,6,6,7,13,5,2,3,16,9,31,0.2903225806451613,0,4,0.0,9,27,0.3333333333333333,0.29,5,10,0.5
Chris Kaman,kamanch01,C,22,LAC,2005,63,1632.0,572,73,135,288,423,26,68,115,182,246,495,0.4969696969696969,0,1,0.0,246,494,0.4979757085020243,0.497,80,121,0.6611570247933884
Jason Kapono,kaponja01,SF,23,CHA,2005,81,1491.0,688,61,32,132,164,40,6,46,132,269,671,0.4008941877794337,80,194,0.4123711340206185,189,477,0.3962264150943396,0.461,70,85,0.8235294117647058
Mario Kasun,kasunma01,C,24,ORL,2005,45,356.0,118,8,52,76,128,8,13,26,86,47,98,0.4795918367346938,0,1,0.0,47,97,0.4845360824742268,0.48,24,43,0.5581395348837209
Viktor Khryapa,khryavi01,SF,22,POR,2005,32,523.0,135,25,28,80,108,20,18,33,80,54,124,0.4354838709677419,4,11,0.3636363636363636,50,113,0.4424778761061947,0.452,23,42,0.5476190476190477
Jason Kidd,kiddja01,PG,31,NJN,2005,66,2435.0,951,545,94,394,488,123,9,167,110,340,855,0.3976608187134502,129,358,0.3603351955307262,211,497,0.4245472837022133,0.473,142,192,0.7395833333333334
Andrei Kirilenko,kirilan01,PF,23,UTA,2005,41,1349.0,640,132,89,166,255,67,136,90,101,207,420,0.4928571428571429,23,77,0.2987012987012987,184,343,0.5364431486880467,0.52,203,259,0.7837837837837838
Kerry Kittles,kittlke01,SG,30,LAC,2005,11,243.0,69,20,1,31,32,8,3,7,12,28,73,0.3835616438356164,7,21,0.3333333333333333,21,52,0.4038461538461538,0.432,6,10,0.6
Brandin Knight,knighbr02,PG,23,HOU,2005,1,3.0,0,1,0,0,0,0,0,0,0,0,1,0.0,0,0,0.0,0,1,0.0,0.0,0,0,0.0
Brevin Knight,knighbr01,PG,29,CHA,2005,66,1944.0,666,591,21,149,170,131,5,147,192,248,587,0.4224872231686541,3,20,0.15,245,567,0.4320987654320987,0.425,167,196,0.8520408163265306
Kyle Korver,korveky01,SF,23,PHI,2005,82,2667.0,942,182,40,339,379,103,33,106,265,317,759,0.4176548089591568,226,558,0.4050179211469534,91,201,0.4527363184079602,0.567,82,96,0.8541666666666666
Nenad Krstić,krstine01,PF,21,NJN,2005,75,1965.0,747,77,161,240,401,32,63,112,280,281,570,0.4929824561403508,0,2,0.0,281,568,0.4947183098591549,0.493,185,255,0.7254901960784313
Toni Kukoč,kukocto01,SF,36,MIL,2005,53,1099.0,296,160,31,129,160,39,13,64,70,105,256,0.41015625,42,116,0.3620689655172414,63,140,0.45,0.492,44,61,0.7213114754098361
Ibo Kutluay,kutluib01,SG,30,SEA,2005,5,12.0,0,0,0,1,1,0,0,2,1,0,1,0.0,0,0,0.0,0,1,0.0,0.0,0,0,0.0
Christian Laettner,laettch01,PF,35,MIA,2005,49,739.0,260,41,36,95,131,32,15,29,78,107,184,0.5815217391304348,1,7,0.1428571428571428,106,177,0.5988700564971752,0.584,45,59,0.7627118644067796
Raef LaFrentz,lafrera01,PF,28,BOS,2005,80,2196.0,884,98,154,399,553,42,99,70,262,341,688,0.4956395348837209,82,225,0.3644444444444444,259,463,0.5593952483801296,0.555,120,148,0.8108108108108109
Maciej Lampe,lampema01,C,19,TOT,2005,37,380.0,115,11,24,65,89,5,7,17,51,49,132,0.3712121212121212,2,4,0.5,47,128,0.3671875,0.379,15,22,0.6818181818181818
Voshon Lenard,lenarvo01,SG,31,DEN,2005,3,54.0,29,6,0,6,6,1,0,2,2,10,26,0.3846153846153846,4,12,0.3333333333333333,6,14,0.4285714285714285,0.462,5,8,0.625
Rashard Lewis,lewisra02,SF,25,SEA,2005,71,2697.0,1457,94,110,278,388,75,62,123,158,532,1151,0.4622067767158992,173,432,0.4004629629629629,359,719,0.4993045897079277,0.537,220,283,0.7773851590106007
Randy Livingston,livinra01,PG,29,UTA,2005,17,227.0,64,45,3,9,12,12,2,14,28,22,52,0.4230769230769231,5,8,0.625,17,44,0.3863636363636363,0.471,15,17,0.8823529411764706
Shaun Livingston,livinsh01,PG,19,LAC,2005,30,814.0,222,151,22,67,89,32,11,75,82,89,215,0.413953488372093,0,2,0.0,89,213,0.4178403755868544,0.414,44,59,0.7457627118644068
Raül López,lopezra01,PG,24,UTA,2005,31,518.0,161,123,7,32,39,22,3,47,78,57,135,0.4222222222222222,20,45,0.4444444444444444,37,90,0.4111111111111111,0.496,27,33,0.8181818181818182
Tyronn Lue,luety01,PG,27,TOT,2005,70,2007.0,787,322,14,135,149,33,0,105,168,295,654,0.4510703363914373,55,155,0.3548387096774194,240,499,0.4809619238476953,0.493,142,165,0.8606060606060606
George Lynch,lynchge01,SF,34,NOH,2005,44,933.0,164,88,55,119,174,32,12,57,83,68,189,0.3597883597883597,11,37,0.2972972972972973,57,152,0.375,0.389,17,23,0.7391304347826086
Mark Madsen,madsema01,C,29,MIN,2005,41,601.0,88,18,63,65,128,7,14,24,103,34,66,0.5151515151515151,0,0,0.0,34,66,0.5151515151515151,0.515,20,40,0.5
Corey Maggette,maggeco01,SG,25,LAC,2005,66,2436.0,1464,225,70,324,394,70,8,195,191,425,986,0.4310344827586206,51,168,0.3035714285714285,374,818,0.4572127139364303,0.457,563,657,0.8569254185692542
Jamaal Magloire,magloja01,C,26,NOH,2005,23,703.0,270,29,79,126,205,8,23,59,74,98,227,0.4317180616740088,0,0,0.0,98,227,0.4317180616740088,0.432,74,123,0.6016260162601627
Stephon Marbury,marbust01,PG,27,NYK,2005,82,3281.0,1781,668,50,198,248,122,6,233,186,604,1308,0.4617737003058104,115,325,0.3538461538461538,489,983,0.4974567650050864,0.506,458,549,0.8342440801457195
Shawn Marion,mariosh01,PF,26,PHO,2005,81,3146.0,1569,154,235,680,915,163,119,125,199,613,1289,0.4755624515128006,114,341,0.3343108504398827,499,948,0.5263713080168776,0.52,229,275,0.8327272727272728
Sean Marks,marksse01,PF,29,SAS,2005,23,244.0,76,8,18,38,56,3,11,14,29,27,80,0.3375,0,3,0.0,27,77,0.3506493506493506,0.338,22,28,0.7857142857142857
Donyell Marshall,marshdo01,PF,31,TOR,2005,65,1645.0,747,81,95,333,428,57,46,42,136,262,592,0.4425675675675675,151,363,0.4159779614325068,111,229,0.4847161572052402,0.57,72,91,0.7912087912087912
Darrick Martin,martida01,PG,33,LAC,2005,11,190.0,42,28,3,7,10,6,0,6,19,16,50,0.32,5,18,0.2777777777777778,11,32,0.34375,0.37,5,8,0.625
Kenyon Martin,martike01,PF,27,DEN,2005,70,2272.0,1087,170,146,365,511,100,78,149,228,444,907,0.4895259095920617,0,12,0.0,444,895,0.4960893854748603,0.49,199,308,0.6461038961038961
Kevin Martin,martike02,PG,21,SAC,2005,45,455.0,131,22,29,29,58,16,3,24,35,45,117,0.3846153846153846,5,25,0.2,40,92,0.4347826086956521,0.406,36,55,0.6545454545454545
Desmond Mason,masonde01,SF,27,MIL,2005,80,2893.0,1377,217,85,227,312,58,27,164,198,478,1079,0.4430027803521779,1,8,0.125,477,1071,0.4453781512605042,0.443,420,524,0.8015267175572519
Tony Massenburg,masseto01,PF,37,SAS,2005,61,699.0,196,14,54,109,163,18,20,40,122,74,182,0.4065934065934066,0,0,0.0,74,182,0.4065934065934066,0.407,48,63,0.7619047619047619
Walter McCarty,mccarwa01,PF,30,TOT,2005,72,906.0,260,37,29,109,138,25,15,36,144,95,235,0.4042553191489361,55,155,0.3548387096774194,40,80,0.5,0.521,15,29,0.5172413793103449
Jelani McCoy,mccoyje01,C,27,ATL,2005,10,88.0,15,0,7,14,21,3,8,6,24,7,13,0.5384615384615384,0,0,0.0,7,13,0.5384615384615384,0.538,1,5,0.2
Antonio McDyess,mcdyean01,PF,30,DET,2005,77,1797.0,740,71,177,305,482,46,52,93,204,307,598,0.5133779264214047,0,1,0.0,307,597,0.5142378559463987,0.513,126,192,0.65625
Tracy McGrady,mcgratr01,SF,25,HOU,2005,78,3182.0,2003,448,71,413,484,135,52,201,167,715,1660,0.4307228915662651,142,435,0.3264367816091954,573,1225,0.4677551020408163,0.473,431,557,0.7737881508078994
Jeff McInnis,mcinnje01,PG,30,CLE,2005,76,2651.0,975,391,32,125,157,56,1,117,177,377,915,0.4120218579234972,91,264,0.3446969696969697,286,651,0.4393241167434716,0.462,130,160,0.8125
Aaron McKie,mckieaa01,SG,32,PHI,2005,68,1118.0,152,103,20,152,172,48,17,31,116,61,142,0.4295774647887324,20,62,0.3225806451612903,41,80,0.5125,0.5,10,16,0.625
Keith McLeod,mcleoke01,PG,25,UTA,2005,53,1382.0,416,236,20,93,113,63,12,99,138,143,408,0.3504901960784313,18,72,0.25,125,336,0.3720238095238095,0.373,112,146,0.7671232876712328
Stanislav Medvedenko,medvest01,PF,25,LAL,2005,43,423.0,165,13,31,48,79,9,2,13,64,71,156,0.4551282051282051,0,1,0.0,71,155,0.4580645161290322,0.455,23,28,0.8214285714285714
Ron Mercer,mercero01,SF,28,NJN,2005,18,390.0,137,20,9,31,40,16,2,14,20,65,158,0.4113924050632911,0,3,0.0,65,155,0.4193548387096774,0.411,7,10,0.7
Chris Mihm,mihmch01,C,25,LAL,2005,75,1870.0,735,50,197,305,502,14,108,110,237,280,552,0.5072463768115942,0,2,0.0,280,550,0.509090909090909,0.507,175,258,0.6782945736434108
Darius Miles,milesda01,SF,23,POR,2005,63,1699.0,809,129,71,228,299,75,78,157,189,336,697,0.4820659971305595,8,23,0.3478260869565217,328,674,0.486646884272997,0.488,129,215,0.6
Darko Miličić,milicda01,C,19,DET,2005,37,254.0,67,7,3,40,43,2,17,16,31,25,76,0.3289473684210526,0,0,0.0,25,76,0.3289473684210526,0.329,17,24,0.7083333333333334
Andre Miller,millean02,PG,28,DEN,2005,82,2852.0,1113,569,100,238,338,121,8,220,204,427,895,0.4770949720670391,6,39,0.1538461538461538,421,856,0.491822429906542,0.48,253,302,0.8377483443708609
Anthony Miller,millean01,PF,33,ATL,2005,2,9.0,4,1,0,1,1,1,0,1,2,2,3,0.6666666666666666,0,0,0.0,2,3,0.6666666666666666,0.667,0,0,0.0
Brad Miller,millebr01,C,28,SAC,2005,56,2089.0,876,220,139,382,521,69,68,82,181,319,609,0.5238095238095238,5,19,0.2631578947368421,314,590,0.5322033898305085,0.528,233,287,0.8118466898954704
Mike Miller,millemi01,SF,24,MEM,2005,76,2278.0,1022,220,36,264,300,54,23,127,197,387,766,0.5052219321148825,140,323,0.4334365325077399,247,443,0.5575620767494357,0.597,108,150,0.72
Reggie Miller,millere01,SG,39,IND,2005,66,2105.0,974,146,18,138,156,50,5,77,109,314,719,0.4367176634214186,96,298,0.3221476510067114,218,421,0.517814726840855,0.503,250,268,0.9328358208955224
Yao Ming,mingya01,C,24,HOU,2005,80,2447.0,1465,61,208,461,669,34,160,196,298,538,975,0.5517948717948717,0,0,0.0,538,975,0.5517948717948717,0.552,389,497,0.7826961770623743
Cuttino Mobley,moblecu01,SG,29,TOT,2005,66,2388.0,1134,188,45,184,229,74,30,133,152,408,932,0.4377682403433476,150,342,0.4385964912280701,258,590,0.4372881355932203,0.518,168,205,0.8195121951219512
Nazr Mohammed,mohamna01,C,27,TOT,2005,77,1933.0,731,34,247,339,586,58,86,108,236,289,602,0.4800664451827242,0,1,0.0,289,601,0.480865224625624,0.48,153,227,0.6740088105726872
Jérôme Moïso,moisoje01,C-PF,26,TOT,2005,20,120.0,28,1,10,27,37,3,6,7,13,9,18,0.5,0,1,0.0,9,17,0.5294117647058824,0.5,10,13,0.7692307692307693
Mikki Moore,mooremi01,PF,29,LAC,2005,74,1178.0,396,47,97,149,246,19,32,63,173,144,287,0.5017421602787456,1,5,0.2,143,282,0.5070921985815603,0.503,107,136,0.7867647058823529
Alonzo Mourning,mournal01,C-PF,34,TOT,2005,37,702.0,282,18,53,145,198,8,74,57,82,100,212,0.4716981132075472,0,0,0.0,100,212,0.4716981132075472,0.472,82,141,0.5815602836879432
Troy Murphy,murphtr01,PF,24,GSW,2005,70,2375.0,1076,97,251,505,756,53,33,108,190,392,947,0.4139387539598733,59,148,0.3986486486486486,333,799,0.4167709637046308,0.445,233,319,0.7304075235109718
Lamond Murray,murrala01,SF,31,TOR,2005,62,918.0,371,47,44,120,164,32,16,54,85,132,310,0.4258064516129032,46,105,0.4380952380952381,86,205,0.4195121951219512,0.5,61,80,0.7625
Ronald Murray,murraro01,SG,25,SEA,2005,49,883.0,345,65,15,83,98,30,11,57,59,131,363,0.3608815426997245,24,95,0.2526315789473684,107,268,0.3992537313432835,0.394,59,80,0.7375
Dikembe Mutombo,mutomdi01,C,38,HOU,2005,80,1212.0,322,10,150,276,426,16,101,51,135,108,217,0.4976958525345622,0,0,0.0,108,217,0.4976958525345622,0.498,106,143,0.7412587412587412
Mamadou N'Diaye,ndiayma02,C,29,LAC,2005,11,72.0,20,1,9,9,18,1,5,0,20,8,20,0.4,0,1,0.0,8,19,0.4210526315789473,0.4,4,7,0.5714285714285714
Boštjan Nachbar,nachbbo01,PF-SF,24,TOT,2005,71,1341.0,494,74,24,158,182,29,16,73,183,161,411,0.3917274939172749,75,196,0.3826530612244898,86,215,0.4,0.483,97,117,0.8290598290598291
Lee Nailon,nailole01,SF,29,NOH,2005,68,2017.0,963,109,128,170,298,36,16,110,190,415,869,0.477560414269275,0,2,0.0,415,867,0.4786620530565167,0.478,133,165,0.806060606060606
Eduardo Nájera,najered01,PF,28,TOT,2005,68,1185.0,354,65,102,141,243,41,24,61,148,145,322,0.4503105590062112,6,21,0.2857142857142857,139,301,0.4617940199335548,0.46,58,91,0.6373626373626373
Steve Nash,nashst01,PG,30,PHO,2005,75,2573.0,1165,861,57,192,249,74,6,245,136,430,857,0.5017502917152858,94,218,0.4311926605504587,336,639,0.5258215962441315,0.557,211,238,0.8865546218487395
Jameer Nelson,nelsoja01,PG,22,ORL,2005,79,1612.0,689,237,52,141,193,78,3,117,199,286,628,0.4554140127388535,44,141,0.3120567375886525,242,487,0.4969199178644763,0.49,73,107,0.6822429906542056
Rasho Nesterović,nestera01,C,28,SAS,2005,70,1785.0,410,71,184,275,459,31,117,73,207,198,430,0.4604651162790698,0,0,0.0,198,430,0.4604651162790698,0.46,14,30,0.4666666666666667
Ira Newble,newblir01,SG,30,CLE,2005,74,1832.0,438,91,78,142,220,50,18,61,144,182,424,0.4292452830188679,19,53,0.3584905660377358,163,371,0.4393530997304582,0.452,55,69,0.7971014492753623
Andrés Nocioni,nocioan01,SF,25,CHI,2005,81,1892.0,677,122,69,317,386,37,34,135,208,241,601,0.4009983361064891,25,97,0.2577319587628865,216,504,0.4285714285714285,0.422,170,222,0.7657657657657657
Moochie Norris,norrimo01,PG,31,TOT,2005,38,360.0,90,39,10,36,46,18,2,27,44,35,109,0.3211009174311927,0,12,0.0,35,97,0.3608247422680412,0.321,20,24,0.8333333333333334
Dirk Nowitzki,nowitdi01,PF,26,DAL,2005,78,3020.0,2032,240,96,661,757,97,119,176,219,663,1445,0.4588235294117647,91,228,0.3991228070175439,572,1217,0.4700082169268693,0.49,615,708,0.8686440677966102
Jermaine O'Neal,onealje01,PF,26,IND,2005,44,1530.0,1068,82,85,303,388,25,88,131,173,386,854,0.4519906323185012,1,6,0.1666666666666666,385,848,0.4540094339622642,0.453,295,391,0.7544757033248082
Shaquille O'Neal,onealsh01,C,32,MIA,2005,73,2492.0,1669,200,253,507,760,36,171,203,262,658,1095,0.6009132420091324,0,0,0.0,658,1095,0.6009132420091324,0.601,353,765,0.461437908496732
Lamar Odom,odomla01,PF,25,LAL,2005,64,2320.0,975,238,134,519,653,42,65,161,211,366,774,0.4728682170542636,36,117,0.3076923076923077,330,657,0.502283105022831,0.496,207,298,0.6946308724832215
Emeka Okafor,okafoem01,PF,22,CHA,2005,73,2600.0,1105,64,275,520,795,62,125,125,214,448,1003,0.4466600199401794,0,1,0.0,448,1002,0.4471057884231537,0.447,209,343,0.60932944606414
Mehmet Okur,okurme01,C,25,UTA,2005,82,2304.0,1054,166,194,422,616,32,68,141,227,354,756,0.4682539682539682,17,63,0.2698412698412698,337,693,0.4862914862914863,0.479,329,387,0.8501291989664083
Kevin Ollie,ollieke01,PG,32,PHI,2005,26,158.0,28,19,3,16,19,5,0,6,16,11,31,0.3548387096774194,0,0,0.0,11,31,0.3548387096774194,0.355,6,9,0.6666666666666666
Michael Olowokandi,olowomi01,C,29,MIN,2005,62,1215.0,368,29,106,218,324,15,56,68,193,161,353,0.4560906515580736,0,0,0.0,161,353,0.4560906515580736,0.456,46,69,0.6666666666666666
Greg Ostertag,ostergr01,C,31,SAC,2005,56,556.0,87,37,55,112,167,7,40,24,88,37,84,0.4404761904761904,0,2,0.0,37,82,0.4512195121951219,0.44,13,38,0.3421052631578947
Bo Outlaw,outlabo01,PF,33,PHO,2005,39,214.0,29,13,16,37,53,6,12,8,29,12,34,0.3529411764705882,0,0,0.0,12,34,0.3529411764705882,0.353,5,9,0.5555555555555556
Travis Outlaw,outlatr01,SF,20,POR,2005,59,793.0,319,35,40,81,121,30,40,39,77,133,267,0.49812734082397,4,10,0.4,129,257,0.5019455252918288,0.506,49,75,0.6533333333333333
Zaza Pachulia,pachuza01,C,20,MIL,2005,74,1397.0,458,60,131,247,378,44,34,70,166,160,354,0.4519774011299435,0,1,0.0,160,353,0.4532577903682719,0.452,138,185,0.745945945945946
Scott Padgett,padgesc01,PF,28,HOU,2005,66,942.0,275,55,47,138,185,33,10,30,119,98,233,0.4206008583690987,50,126,0.3968253968253968,48,107,0.4485981308411215,0.528,29,40,0.725
Milt Palacio,palacmi01,PG,26,TOR,2005,80,1533.0,467,279,26,108,134,48,13,104,126,175,392,0.4464285714285714,2,12,0.1666666666666666,173,380,0.4552631578947368,0.449,115,155,0.7419354838709677
Jannero Pargo,pargoja01,PG,25,CHI,2005,32,453.0,204,76,12,35,47,16,1,45,53,82,213,0.3849765258215962,23,66,0.3484848484848485,59,147,0.4013605442176871,0.439,17,23,0.7391304347826086
Smush Parker,parkesm01,PG,23,TOT,2005,16,144.0,48,15,4,8,12,5,0,19,16,18,43,0.4186046511627907,3,13,0.2307692307692307,15,30,0.5,0.453,9,13,0.6923076923076923
Tony Parker,parketo01,PG,22,SAS,2005,80,2735.0,1331,491,47,251,298,98,4,215,167,539,1118,0.4821109123434705,43,156,0.2756410256410256,496,962,0.5155925155925156,0.501,210,323,0.6501547987616099
Ruben Patterson,patteru01,SF,29,POR,2005,70,1957.0,809,138,126,147,273,106,21,143,164,319,601,0.5307820299500832,2,25,0.08,317,576,0.5503472222222222,0.532,169,282,0.599290780141844
Sasha Pavlović,pavloal01,SG,21,CLE,2005,65,862.0,314,49,15,56,71,29,4,47,121,120,276,0.4347826086956521,30,78,0.3846153846153846,90,198,0.4545454545454545,0.489,44,64,0.6875
Gary Payton,paytoga01,PG,36,BOS,2005,77,2541.0,873,469,48,188,236,88,12,148,121,339,725,0.4675862068965517,42,129,0.3255813953488372,297,596,0.4983221476510067,0.497,153,201,0.7611940298507462
Anthony Peeler,peelean01,SG,35,WAS,2005,40,529.0,153,57,14,51,65,18,2,28,39,56,150,0.3733333333333333,25,65,0.3846153846153846,31,85,0.3647058823529411,0.457,16,18,0.8888888888888888
Kirk Penney,penneki01,SG,24,LAC,2005,4,12.0,2,1,0,1,1,0,0,2,0,1,3,0.3333333333333333,0,1,0.0,1,2,0.5,0.333,0,0,0.0
Kendrick Perkins,perkike01,C,20,BOS,2005,60,548.0,149,21,53,123,176,9,37,43,98,56,119,0.4705882352941176,0,0,0.0,56,119,0.4705882352941176,0.471,37,58,0.6379310344827587
Wesley Person,persowe01,SF,33,TOT,2005,41,667.0,264,39,3,80,83,19,4,17,30,107,226,0.4734513274336283,41,89,0.4606741573033708,66,137,0.4817518248175182,0.564,9,13,0.6923076923076923
Morris Peterson,petermo01,SG,27,TOR,2005,82,2510.0,1029,169,71,269,340,91,18,93,219,356,848,0.419811320754717,129,335,0.3850746268656716,227,513,0.442495126705653,0.496,188,226,0.831858407079646
Eric Piatkowski,piatker01,SG,34,CHI,2005,68,841.0,324,51,15,64,79,29,1,37,67,111,258,0.4302325581395348,57,134,0.4253731343283582,54,124,0.4354838709677419,0.541,45,56,0.8035714285714286
Paul Pierce,piercpa01,SF,27,BOS,2005,82,2960.0,1769,348,78,461,539,133,39,230,255,556,1223,0.454619787408013,108,292,0.3698630136986301,448,931,0.4812030075187969,0.499,549,668,0.8218562874251497
Mickaël Piétrus,pietrmi01,SF,22,GSW,2005,67,1340.0,636,82,65,124,189,46,18,92,139,214,501,0.4271457085828343,67,195,0.3435897435897436,147,306,0.4803921568627451,0.494,141,202,0.698019801980198
Zoran Planinić,planizo01,PG,22,NJN,2005,43,515.0,217,44,19,50,69,25,0,41,76,78,174,0.4482758620689655,15,40,0.375,63,134,0.4701492537313433,0.491,46,66,0.696969696969697
Pavel Podkolzin,podkopa01,C,20,DAL,2005,5,10.0,1,0,0,2,2,0,0,2,4,0,0,0.0,0,0,0.0,0,0,0.0,0.0,1,2,0.5
Scot Pollard,pollasc01,C,29,IND,2005,49,865.0,191,18,85,120,205,30,24,31,123,79,167,0.4730538922155688,0,0,0.0,79,167,0.4730538922155688,0.473,33,49,0.673469387755102
Mark Pope,popema01,PF,32,DEN,2005,9,27.0,4,1,5,3,8,1,2,1,5,2,6,0.3333333333333333,0,0,0.0,2,6,0.3333333333333333,0.333,0,0,0.0
James Posey,poseyja01,SF,28,MEM,2005,50,1382.0,405,88,45,174,219,48,23,69,134,127,356,0.3567415730337078,55,178,0.3089887640449438,72,178,0.4044943820224719,0.434,96,111,0.8648648648648649
Vitaly Potapenko,potapvi01,C,29,SEA,2005,33,335.0,117,9,30,48,78,7,3,12,53,45,87,0.5172413793103449,0,1,0.0,45,86,0.5232558139534884,0.517,27,31,0.8709677419354839
Tayshaun Prince,princta01,SF,24,DET,2005,82,3039.0,1206,247,133,302,435,56,71,135,161,469,963,0.4870197300103842,47,138,0.3405797101449275,422,825,0.5115151515151515,0.511,221,274,0.8065693430656934
Laron Profit,profila01,SF,27,WAS,2005,42,428.0,136,37,24,52,76,16,5,27,44,56,128,0.4375,8,28,0.2857142857142857,48,100,0.48,0.469,16,25,0.64
Joel Przybilla,przybjo01,C,25,POR,2005,76,1858.0,488,74,178,410,588,24,163,98,239,199,333,0.5975975975975976,0,0,0.0,199,333,0.5975975975975976,0.598,90,174,0.5172413793103449
Vladimir Radmanović,radmavl01,PF,24,SEA,2005,63,1856.0,741,86,52,237,289,57,31,80,172,266,650,0.4092307692307692,128,329,0.3890577507598784,138,321,0.4299065420560747,0.508,81,103,0.7864077669902912
Aleksandar Radojević,radojal01,C,28,UTA,2005,12,128.0,19,6,9,19,28,0,2,15,32,6,19,0.3157894736842105,0,0,0.0,6,19,0.3157894736842105,0.316,7,10,0.7
Peter John Ramos,ramospe01,C,19,WAS,2005,6,20.0,11,0,1,3,4,0,1,3,4,5,10,0.5,0,0,0.0,5,10,0.5,0.5,1,2,0.5
Zach Randolph,randoza01,PF,23,POR,2005,46,1603.0,871,86,142,300,442,34,17,112,112,332,741,0.4480431848852901,0,6,0.0,332,735,0.4517006802721088,0.448,207,254,0.8149606299212598
Theo Ratliff,ratlith01,C,31,POR,2005,63,1731.0,304,34,111,220,331,23,158,56,183,115,257,0.4474708171206226,0,0,0.0,115,257,0.4474708171206226,0.447,74,107,0.6915887850467289
Željko Rebrača,rebraze01,C,32,LAC,2005,58,928.0,339,26,49,135,184,13,40,49,130,133,234,0.5683760683760684,0,0,0.0,133,234,0.5683760683760684,0.568,73,85,0.8588235294117647
Michael Redd,reddmi01,SG,25,MIL,2005,75,2848.0,1723,172,72,240,312,63,8,133,152,625,1418,0.4407616361071932,104,293,0.3549488054607508,521,1125,0.4631111111111111,0.477,369,432,0.8541666666666666
Justin Reed,reedju01,SF,23,BOS,2005,23,121.0,41,10,8,8,16,3,1,5,12,15,29,0.5172413793103449,0,3,0.0,15,26,0.5769230769230769,0.517,11,15,0.7333333333333333
Jared Reiner,reineja01,C,22,CHI,2005,19,132.0,21,1,13,25,38,3,7,9,35,10,30,0.3333333333333333,0,0,0.0,10,30,0.3333333333333333,0.333,1,4,0.25
Jason Richardson,richaja01,SG,24,GSW,2005,72,2724.0,1559,281,125,299,424,105,32,169,156,610,1368,0.445906432748538,125,370,0.3378378378378378,485,998,0.4859719438877755,0.492,214,309,0.6925566343042071
Quentin Richardson,richaqu01,SG,24,PHO,2005,79,2839.0,1176,158,91,388,479,96,27,102,197,407,1045,0.3894736842105263,226,631,0.358161648177496,181,414,0.4371980676328502,0.498,136,184,0.7391304347826086
Luke Ridnour,ridnolu01,PG,23,SEA,2005,82,2571.0,824,483,55,149,204,94,23,149,185,299,739,0.4046008119079837,67,178,0.3764044943820224,232,561,0.4135472370766488,0.45,159,180,0.8833333333333333
Bernard Robinson,robinbe01,SG,24,CHA,2005,31,328.0,93,30,14,34,48,11,4,20,42,36,81,0.4444444444444444,3,8,0.375,33,73,0.4520547945205479,0.463,18,26,0.6923076923076923
Clifford Robinson,robincl02,C-PF,38,TOT,2005,71,1689.0,533,104,54,155,209,62,53,66,181,202,523,0.3862332695984704,67,193,0.3471502590673575,135,330,0.4090909090909091,0.45,62,97,0.6391752577319587
Glenn Robinson,robingl01,SF,32,SAS,2005,9,157.0,90,8,4,20,24,4,3,7,19,34,77,0.4415584415584415,2,6,0.3333333333333333,32,71,0.4507042253521127,0.455,20,23,0.8695652173913043
Rodney Rogers,rogerro01,SF-PF,33,TOT,2005,58,1367.0,444,86,61,185,246,41,20,86,172,172,450,0.3822222222222222,48,168,0.2857142857142857,124,282,0.4397163120567376,0.436,52,70,0.7428571428571429
Jalen Rose,roseja01,SF,32,TOR,2005,81,2710.0,1495,209,44,232,276,63,10,180,190,527,1159,0.454702329594478,108,274,0.3941605839416058,419,885,0.4734463276836158,0.501,333,390,0.8538461538461538
Malik Rose,rosema01,PF,30,TOT,2005,76,1475.0,534,59,129,212,341,46,16,102,208,198,441,0.4489795918367347,1,10,0.1,197,431,0.45707656612529,0.45,137,186,0.7365591397849462
Quinton Ross,rossqu01,SG,23,LAC,2005,78,1659.0,397,109,59,151,210,51,22,54,165,161,373,0.4316353887399464,1,4,0.25,160,369,0.4336043360433604,0.433,74,110,0.6727272727272727
Michael Ruffin,ruffimi01,C,28,WAS,2005,79,1262.0,111,64,157,175,332,43,41,44,193,41,99,0.4141414141414141,0,1,0.0,41,98,0.4183673469387755,0.414,29,67,0.4328358208955223
Kareem Rush,rushka01,SG,24,TOT,2005,48,968.0,402,68,20,69,89,20,7,47,74,157,406,0.3866995073891626,51,137,0.3722627737226277,106,269,0.3940520446096654,0.45,37,48,0.7708333333333334
Bryon Russell,russebr01,SF,34,DEN,2005,70,1026.0,307,72,50,122,172,44,11,35,130,95,252,0.376984126984127,56,149,0.3758389261744966,39,103,0.3786407766990291,0.488,61,77,0.7922077922077922
John Salmons,salmojo01,SG,25,PHI,2005,58,993.0,236,114,12,109,121,40,13,51,92,85,210,0.4047619047619047,31,91,0.3406593406593406,54,119,0.453781512605042,0.479,35,48,0.7291666666666666
Jamal Sampson,sampsja01,PF,21,CHA,2005,23,329.0,79,8,36,86,122,4,17,17,53,28,62,0.4516129032258064,0,0,0.0,28,62,0.4516129032258064,0.452,23,39,0.5897435897435898
Daniel Santiago,santida01,C,28,MIL,2005,11,105.0,22,1,6,13,19,3,4,4,28,7,21,0.3333333333333333,0,0,0.0,7,21,0.3333333333333333,0.333,8,11,0.7272727272727273
Brian Scalabrine,scalabr01,PF,26,NJN,2005,54,1167.0,339,88,83,161,244,34,18,66,111,132,332,0.3975903614457831,22,68,0.3235294117647059,110,264,0.4166666666666667,0.431,53,69,0.7681159420289855
Ansu Sesay,sesayan01,SF,28,GSW,2005,16,128.0,49,12,18,20,38,2,3,8,16,17,42,0.4047619047619047,2,8,0.25,15,34,0.4411764705882353,0.429,13,24,0.5416666666666666
Ha Seung-Jin,seungha01,C,19,POR,2005,19,104.0,26,2,6,12,18,1,5,12,21,10,23,0.4347826086956521,0,0,0.0,10,23,0.4347826086956521,0.435,6,11,0.5454545454545454
Paul Shirley,shirlpa01,PF,27,PHO,2005,9,30.0,12,3,1,1,2,0,0,1,3,5,11,0.4545454545454545,0,0,0.0,5,11,0.4545454545454545,0.455,2,4,0.5
Bobby Simmons,simmobo01,SF,24,LAC,2005,75,2799.0,1229,205,128,318,446,106,16,135,227,474,1017,0.4660766961651917,50,115,0.4347826086956521,424,902,0.4700665188470067,0.491,231,273,0.8461538461538461
Brian Skinner,skinnbr01,C-PF,28,TOT,2005,49,941.0,233,43,107,173,280,31,49,40,102,104,205,0.5073170731707317,0,1,0.0,104,204,0.5098039215686274,0.507,25,70,0.3571428571428571
Tamar Slay,slayta01,SG,24,CHA,2005,8,78.0,28,3,6,8,14,5,0,8,20,13,39,0.3333333333333333,2,12,0.1666666666666666,11,27,0.4074074074074074,0.359,0,2,0.0
Donta Smith,smithdo04,SG,21,ATL,2005,38,433.0,127,39,19,33,52,23,5,25,50,44,113,0.3893805309734513,6,22,0.2727272727272727,38,91,0.4175824175824176,0.416,33,48,0.6875
J.R. Smith,smithjr01,SG,19,NOH,2005,76,1859.0,782,142,39,113,152,55,11,109,135,295,748,0.3943850267379679,81,281,0.2882562277580071,214,467,0.4582441113490364,0.449,111,161,0.6894409937888198
Jabari Smith,smithja01,PF,27,NJN,2005,45,648.0,166,38,29,82,111,25,14,39,103,62,148,0.4189189189189189,1,2,0.5,61,146,0.4178082191780822,0.422,41,55,0.7454545454545455
Joe Smith,smithjo02,PF,29,MIL,2005,74,2265.0,813,67,179,362,541,43,38,79,222,319,621,0.5136876006441223,0,1,0.0,319,620,0.5145161290322581,0.514,175,228,0.7675438596491229
Josh Smith,smithjo03,SF,19,ATL,2005,74,2050.0,715,127,147,310,457,59,144,135,157,274,602,0.4551495016611295,4,23,0.1739130434782608,270,579,0.466321243523316,0.458,163,237,0.6877637130801688
Steve Smith,smithst01,SG,35,TOT,2005,50,750.0,314,71,15,50,65,14,7,27,82,102,248,0.4112903225806452,41,105,0.3904761904761905,61,143,0.4265734265734265,0.494,69,80,0.8625
Theron Smith,smithth01,SF,24,CHA,2005,33,510.0,105,28,39,77,116,6,4,27,58,44,136,0.3235294117647059,3,12,0.25,41,124,0.3306451612903225,0.335,14,16,0.875
Eric Snow,snower01,SG,31,CLE,2005,81,1844.0,322,317,37,118,155,67,16,89,189,125,327,0.382262996941896,13,45,0.2888888888888888,112,282,0.3971631205673759,0.402,59,80,0.7375
Kirk Snyder,snydeki01,SG,21,UTA,2005,68,906.0,338,36,50,71,121,26,19,58,116,122,328,0.3719512195121951,30,85,0.3529411764705882,92,243,0.3786008230452675,0.418,64,96,0.6666666666666666
Darius Songaila,songada01,PF,26,SAC,2005,81,1668.0,608,114,125,219,344,51,18,70,206,257,488,0.5266393442622951,0,3,0.0,257,485,0.5298969072164949,0.527,94,111,0.8468468468468469
Pape Sow,sowpa01,C,23,TOR,2005,27,255.0,62,2,18,39,57,12,4,10,46,23,58,0.396551724137931,0,0,0.0,23,58,0.396551724137931,0.397,16,27,0.5925925925925926
Latrell Sprewell,sprewla01,SF,34,MIN,2005,80,2450.0,1021,179,65,189,254,53,21,127,124,398,961,0.4141519250780437,69,211,0.3270142180094786,329,750,0.4386666666666666,0.45,156,188,0.8297872340425532
Jerry Stackhouse,stackje01,SG,30,DAL,2005,56,1617.0,833,127,38,145,183,53,10,106,104,274,662,0.4138972809667673,32,120,0.2666666666666666,242,542,0.4464944649446494,0.438,253,298,0.8489932885906041
DeShawn Stevenson,stevede01,SG,23,ORL,2005,55,1089.0,429,69,38,64,102,16,9,57,73,174,426,0.4084507042253521,25,67,0.373134328358209,149,359,0.415041782729805,0.438,56,101,0.5544554455445545
Michael Stewart,stewami01,PF,29,ATL,2005,12,145.0,25,5,21,19,40,6,5,6,32,11,21,0.5238095238095238,0,0,0.0,11,21,0.5238095238095238,0.524,3,7,0.4285714285714285
Peja Stojaković,stojape01,SF,27,SAC,2005,66,2534.0,1329,138,62,223,285,79,12,102,157,451,1016,0.4438976377952756,174,433,0.4018475750577367,277,583,0.4751286449399657,0.53,253,275,0.92
Awvee Storey,storeaw01,SG,27,NJN,2005,9,32.0,8,1,4,1,5,0,0,0,3,3,10,0.3,1,2,0.5,2,8,0.25,0.35,1,2,0.5
Damon Stoudamire,stoudda01,PG,31,POR,2005,81,2762.0,1277,458,56,254,310,86,2,164,158,457,1165,0.392274678111588,181,490,0.3693877551020408,276,675,0.4088888888888889,0.47,182,199,0.914572864321608
Amar'e Stoudemire,stoudam01,C,22,PHO,2005,80,2889.0,2080,131,219,494,713,77,130,189,278,747,1336,0.5591317365269461,3,16,0.1875,744,1320,0.5636363636363636,0.56,583,795,0.7333333333333333
Erick Strickland,stricer01,SG,31,MIL,2005,62,1014.0,301,115,11,92,103,30,1,64,103,114,304,0.375,21,83,0.253012048192771,93,221,0.420814479638009,0.41,52,64,0.8125
Rod Strickland,stricro02,PG,38,HOU,2005,16,196.0,28,39,3,24,27,3,2,16,15,9,43,0.2093023255813953,1,2,0.5,8,41,0.1951219512195122,0.221,9,10,0.9
Bruno Šundov,sundobr01,C,24,NYK,2005,21,73.0,25,2,6,7,13,2,2,6,16,11,37,0.2972972972972973,1,3,0.3333333333333333,10,34,0.2941176470588235,0.311,2,2,1.0
Bob Sura,surabo01,PG,31,HOU,2005,61,1922.0,626,317,79,258,337,65,7,147,168,215,504,0.4265873015873015,55,155,0.3548387096774194,160,349,0.4584527220630373,0.481,141,188,0.75
Mike Sweetney,sweetmi01,C,22,NYK,2005,77,1509.0,650,44,169,249,418,27,28,108,224,237,446,0.531390134529148,0,1,0.0,237,445,0.5325842696629214,0.531,176,235,0.7489361702127659
Robert Swift,swiftro01,C,19,SEA,2005,16,72.0,15,2,1,4,5,1,7,4,16,5,11,0.4545454545454545,0,0,0.0,5,11,0.4545454545454545,0.455,5,9,0.5555555555555556
Stromile Swift,swiftst01,PF,25,MEM,2005,60,1279.0,604,43,92,181,273,41,92,90,182,219,488,0.4487704918032787,0,4,0.0,219,484,0.4524793388429752,0.449,166,219,0.7579908675799086
Wally Szczerbiak,szczewa02,SF,27,MIN,2005,81,2558.0,1253,191,82,221,303,40,16,132,178,465,919,0.5059847660500544,63,169,0.3727810650887574,402,750,0.536,0.54,260,304,0.8552631578947368
Yuta Tabuse,tabusyu01,PG,24,PHO,2005,4,17.0,7,3,2,2,4,0,0,1,1,1,6,0.1666666666666666,1,1,1.0,0,5,0.0,0.25,4,4,1.0
Maurice Taylor,tayloma01,PF-C,28,TOT,2005,65,1336.0,472,67,67,190,257,27,20,94,180,203,446,0.4551569506726457,3,9,0.3333333333333333,200,437,0.4576659038901602,0.459,63,103,0.6116504854368932
Sebastian Telfair,telfase01,PG,19,POR,2005,68,1330.0,460,224,10,94,104,35,4,125,120,169,430,0.3930232558139535,17,69,0.2463768115942029,152,361,0.4210526315789473,0.413,105,133,0.7894736842105263
Jason Terry,terryja01,PG,27,DAL,2005,80,2401.0,993,429,38,150,188,109,15,147,177,372,743,0.5006729475100942,103,245,0.4204081632653061,269,498,0.5401606425702812,0.57,146,173,0.8439306358381503
Billy Thomas,thomabi01,SF,29,NJN,2005,25,356.0,92,17,7,29,36,14,1,9,29,34,94,0.3617021276595745,17,56,0.3035714285714285,17,38,0.4473684210526316,0.452,7,9,0.7777777777777778
Etan Thomas,thomaet01,C,26,WAS,2005,47,976.0,332,20,85,159,244,17,51,50,133,128,255,0.5019607843137255,0,0,0.0,128,255,0.5019607843137255,0.502,76,144,0.5277777777777778
James Thomas,thomaja02,PF,24,TOT,2005,11,117.0,26,4,17,20,37,4,4,7,13,12,20,0.6,0,0,0.0,12,20,0.6,0.6,2,6,0.3333333333333333
John Thomas,thomajo02,C,29,MIN,2005,44,521.0,111,17,39,58,97,15,13,18,82,42,86,0.4883720930232558,0,0,0.0,42,86,0.4883720930232558,0.488,27,46,0.5869565217391305
Kenny Thomas,thomake01,PF,27,TOT,2005,73,2167.0,908,152,184,351,535,67,17,131,227,367,781,0.469910371318822,1,5,0.2,366,776,0.4716494845360824,0.471,173,227,0.762114537444934
Kurt Thomas,thomaku01,PF,32,NYK,2005,80,2855.0,916,160,170,661,831,70,79,99,310,424,901,0.4705882352941176,2,4,0.5,422,897,0.4704570791527313,0.472,66,84,0.7857142857142857
Tim Thomas,thomati01,SF,27,NYK,2005,71,1940.0,851,110,45,192,237,41,17,113,222,315,718,0.4387186629526462,85,208,0.4086538461538461,230,510,0.4509803921568627,0.498,136,173,0.7861271676300579
Jamaal Tinsley,tinslja01,PG,26,IND,2005,40,1301.0,616,257,26,134,160,81,12,134,112,218,522,0.4176245210727969,58,156,0.3717948717948718,160,366,0.4371584699453552,0.473,122,164,0.7439024390243902
Robert Traylor,traylro01,C,27,CLE,2005,74,1327.0,409,61,136,196,332,54,50,73,215,177,399,0.4436090225563909,0,8,0.0,177,391,0.4526854219948849,0.444,55,102,0.5392156862745098
Jake Tsakalidis,tsakaja01,C,25,MEM,2005,31,278.0,78,10,21,35,56,3,16,12,42,32,64,0.5,0,0,0.0,32,64,0.5,0.5,14,18,0.7777777777777778
Nikoloz Tskitishvili,tskitni01,PF,21,TOT,2005,35,220.0,50,10,12,29,41,8,11,19,33,22,74,0.2972972972972973,2,17,0.1176470588235294,20,57,0.3508771929824561,0.311,4,7,0.5714285714285714
Hedo Türkoğlu,turkohe01,SF,25,ORL,2005,67,1757.0,937,153,62,171,233,41,18,119,140,328,782,0.4194373401534527,93,245,0.3795918367346939,235,537,0.4376163873370577,0.479,188,225,0.8355555555555556
Beno Udrih,udrihbe01,PG,22,SAS,2005,80,1149.0,471,150,16,67,83,41,10,77,96,173,390,0.4435897435897435,58,142,0.4084507042253521,115,248,0.4637096774193548,0.518,67,89,0.7528089887640449
Nick Van Exel,vanexni01,SG,33,POR,2005,53,1619.0,586,227,20,141,161,44,0,92,70,214,561,0.3814616755793226,100,257,0.3891050583657587,114,304,0.375,0.471,58,74,0.7837837837837838
Keith Van Horn,vanhoke01,SF-PF,29,TOT,2005,62,1502.0,696,75,89,205,294,36,21,81,170,257,564,0.4556737588652482,54,142,0.380281690140845,203,422,0.481042654028436,0.504,128,157,0.8152866242038217
Anderson Varejão,varejan01,PF,22,CLE,2005,54,863.0,266,27,109,148,257,41,38,26,122,99,193,0.5129533678756477,0,2,0.0,99,191,0.518324607329843,0.513,68,127,0.5354330708661418
Jacque Vaughn,vaughja01,SG,29,NJN,2005,71,1410.0,373,135,17,90,107,41,1,62,138,146,325,0.4492307692307692,5,15,0.3333333333333333,141,310,0.4548387096774193,0.457,76,91,0.8351648351648352
Jake Voskuhl,voskuja01,C,27,PHO,2005,38,360.0,80,17,30,62,92,4,11,20,60,27,59,0.4576271186440678,0,0,0.0,27,59,0.4576271186440678,0.458,26,38,0.6842105263157895
Jackson Vroman,vromaja01,C-PF,23,TOT,2005,46,705.0,212,40,64,111,175,25,19,64,105,82,199,0.4120603015075377,0,3,0.0,82,196,0.4183673469387755,0.412,48,75,0.64
Sasha Vujačić,vujacsa01,SG,20,LAL,2005,35,403.0,101,51,13,49,62,12,2,15,41,33,117,0.282051282051282,17,63,0.2698412698412698,16,54,0.2962962962962963,0.355,18,19,0.9473684210526316
Dwyane Wade,wadedw01,SG,23,MIA,2005,77,2974.0,1854,520,110,287,397,121,82,321,230,630,1318,0.4779969650986343,13,45,0.2888888888888888,617,1273,0.4846818538884525,0.483,581,762,0.7624671916010499
Dajuan Wagner,wagneda02,SG,21,CLE,2005,11,102.0,44,13,0,2,2,5,0,9,15,18,55,0.3272727272727272,5,26,0.1923076923076923,13,29,0.4482758620689655,0.373,3,4,0.75
Antoine Walker,walkean02,PF,28,TOT,2005,77,2955.0,1473,265,182,513,695,89,58,253,217,581,1377,0.4219317356572258,110,341,0.3225806451612903,471,1036,0.4546332046332046,0.462,201,373,0.5388739946380697
Samaki Walker,walkesa01,PF,28,WAS,2005,14,134.0,24,4,8,10,18,3,7,8,25,11,31,0.3548387096774194,0,0,0.0,11,31,0.3548387096774194,0.355,2,3,0.6666666666666666
Ben Wallace,wallabe01,C,30,DET,2005,74,2671.0,721,123,292,610,902,106,176,82,159,295,651,0.4531490015360983,1,9,0.1111111111111111,294,642,0.4579439252336448,0.454,130,304,0.4276315789473684
Gerald Wallace,wallage01,SF,22,CHA,2005,70,2147.0,780,137,118,268,386,117,91,159,182,286,637,0.4489795918367347,17,62,0.2741935483870967,269,575,0.4678260869565217,0.462,191,289,0.6608996539792388
Rasheed Wallace,wallara01,PF,30,DET,2005,79,2687.0,1145,142,174,470,644,65,115,127,236,467,1062,0.4397363465160075,75,236,0.3177966101694915,392,826,0.4745762711864407,0.475,136,195,0.6974358974358974
Luke Walton,waltolu01,SF,24,LAL,2005,61,768.0,198,93,55,87,142,26,11,58,70,74,180,0.4111111111111111,16,61,0.2622950819672131,58,119,0.4873949579831932,0.456,34,48,0.7083333333333334
Charlie Ward,wardch01,PG,34,HOU,2005,14,360.0,75,43,6,33,39,15,0,18,22,24,77,0.3116883116883117,16,51,0.3137254901960784,8,26,0.3076923076923077,0.416,11,13,0.8461538461538461
Earl Watson,watsoea01,PG,25,MEM,2005,80,1808.0,615,359,35,129,164,83,19,167,184,236,554,0.4259927797833935,52,163,0.3190184049079754,184,391,0.4705882352941176,0.473,91,138,0.6594202898550725
Clarence Weatherspoon,weathcl01,PF,34,HOU,2005,40,525.0,123,17,35,87,122,9,6,15,74,47,114,0.4122807017543859,0,0,0.0,47,114,0.4122807017543859,0.412,29,35,0.8285714285714286
Chris Webber,webbech01,PF,31,TOT,2005,67,2370.0,1306,318,130,482,612,94,53,182,214,555,1283,0.4325798908807482,15,44,0.3409090909090909,540,1239,0.4358353510895884,0.438,181,228,0.793859649122807
Bonzi Wells,wellsbo01,SG,28,MEM,2005,69,1489.0,721,80,49,180,229,85,27,90,165,272,617,0.4408427876823338,36,104,0.3461538461538461,236,513,0.4600389863547758,0.47,141,188,0.75
Jiří Welsch,welscji01,SG-SF,25,TOT,2005,71,1317.0,461,103,26,141,167,44,5,73,121,149,371,0.4016172506738544,34,110,0.3090909090909091,115,261,0.4406130268199233,0.447,129,169,0.7633136094674556
David Wesley,wesleda01,SG,34,TOT,2005,80,2774.0,948,265,38,190,228,96,9,113,215,334,840,0.3976190476190476,118,315,0.3746031746031746,216,525,0.4114285714285714,0.468,162,189,0.8571428571428571
David West,westda01,SF,24,NOH,2005,30,552.0,186,23,40,89,129,12,16,37,62,75,172,0.436046511627907,2,5,0.4,73,167,0.437125748502994,0.442,34,50,0.68
Delonte West,westde01,SG,21,BOS,2005,39,507.0,175,53,14,51,65,21,8,24,69,66,155,0.4258064516129032,24,67,0.3582089552238806,42,88,0.4772727272727273,0.503,19,27,0.7037037037037037
Jahidi White,whiteja01,C,28,CHA,2005,17,135.0,42,1,11,23,34,2,12,11,31,14,31,0.4516129032258064,0,0,0.0,14,31,0.4516129032258064,0.452,14,40,0.35
Rodney White,whitero02,SF,24,TOT,2005,58,677.0,293,44,24,65,89,32,11,37,64,121,289,0.4186851211072664,24,60,0.4,97,229,0.4235807860262008,0.46,27,44,0.6136363636363636
Chris Wilcox,wilcoch01,C,22,LAC,2005,54,1005.0,426,38,63,165,228,26,24,77,129,169,329,0.513677811550152,0,0,0.0,169,329,0.513677811550152,0.514,88,144,0.6111111111111112
Damien Wilkins,wilkida02,SF,25,SEA,2005,29,520.0,183,26,29,37,66,22,10,16,55,73,168,0.4345238095238095,16,59,0.2711864406779661,57,109,0.5229357798165137,0.482,21,34,0.6176470588235294
Mike Wilks,wilksmi01,PG,25,SAS,2005,48,278.0,81,33,4,21,25,14,1,14,26,32,77,0.4155844155844156,5,16,0.3125,27,61,0.4426229508196721,0.448,12,16,0.75
Aaron Williams,williaa01,C,33,TOT,2005,42,315.0,73,8,17,43,60,5,8,17,70,29,63,0.4603174603174603,0,0,0.0,29,63,0.4603174603174603,0.46,15,17,0.8823529411764706
Eric Williams,willier01,SG,32,TOT,2005,55,1322.0,424,92,44,128,172,38,4,60,147,142,330,0.4303030303030303,28,73,0.3835616438356164,114,257,0.4435797665369649,0.473,112,161,0.6956521739130435
Frank Williams,willifr02,SG,24,CHI,2005,9,71.0,6,11,2,4,6,2,3,3,9,3,20,0.15,0,4,0.0,3,16,0.1875,0.15,0,0,0.0
Jason Williams,willija02,PG,29,MEM,2005,71,1952.0,719,399,19,103,122,75,5,130,91,266,644,0.4130434782608695,107,330,0.3242424242424242,159,314,0.5063694267515924,0.496,80,101,0.7920792079207921
Jerome Williams,willije01,SF,31,NYK,2005,79,1211.0,359,41,115,168,283,55,10,65,155,122,243,0.5020576131687243,0,5,0.0,122,238,0.5126050420168067,0.502,115,172,0.6686046511627907
Mo Williams,willima01,PG,22,MIL,2005,80,2254.0,814,484,50,194,244,74,11,196,221,323,737,0.4382632293080054,32,99,0.3232323232323232,291,638,0.4561128526645768,0.46,136,160,0.85
Scott Williams,willisc01,C,36,CLE,2005,19,152.0,33,8,15,15,30,4,6,5,30,12,41,0.2926829268292683,0,1,0.0,12,40,0.3,0.293,9,11,0.8181818181818182
Corliss Williamson,willico02,PF,31,TOT,2005,72,1527.0,741,78,104,155,259,38,15,86,218,273,584,0.4674657534246575,0,2,0.0,273,582,0.4690721649484536,0.467,195,244,0.7991803278688525
Kevin Willis,willike02,C,42,ATL,2005,29,344.0,87,9,29,47,76,8,7,15,53,35,90,0.3888888888888889,0,2,0.0,35,88,0.3977272727272727,0.389,17,23,0.7391304347826086
Loren Woods,woodslo01,C,26,TOR,2005,45,712.0,176,17,81,139,220,8,39,37,78,71,164,0.4329268292682927,0,1,0.0,71,163,0.4355828220858895,0.433,34,59,0.576271186440678
Qyntel Woods,woodsqy01,SF,23,MIA,2005,3,40.0,10,0,2,4,6,4,0,2,6,5,12,0.4166666666666667,0,0,0.0,5,12,0.4166666666666667,0.417,0,0,0.0
Metta World Peace,artesro01,SF,25,IND,2005,7,291.0,172,22,8,37,45,12,6,17,27,59,119,0.4957983193277311,7,17,0.4117647058823529,52,102,0.5098039215686274,0.525,47,51,0.9215686274509804
Dorell Wright,wrighdo01,SF,19,MIA,2005,3,27.0,7,3,0,1,1,4,0,3,2,3,11,0.2727272727272727,0,4,0.0,3,7,0.4285714285714285,0.273,1,1,1.0
Lorenzen Wright,wrighlo02,C,29,MEM,2005,80,2287.0,771,87,177,436,613,58,69,100,251,320,683,0.4685212298682284,0,3,0.0,320,680,0.4705882352941176,0.469,131,198,0.6616161616161617
Wang Zhizhi,zhizhwa01,C,27,MIA,2005,20,92.0,43,5,6,12,18,3,2,5,9,17,36,0.4722222222222222,2,3,0.6666666666666666,15,33,0.4545454545454545,0.5,7,12,0.5833333333333334
Shareef Abdur-Rahim,abdursh01,PF,29,SAC,2006,72,1961.0,887,149,106,251,357,48,42,108,227,332,632,0.5253164556962026,5,22,0.2272727272727272,327,610,0.5360655737704918,0.529,218,278,0.7841726618705036
Alex Acker,ackeral01,SG,23,DET,2006,5,35.0,9,4,1,4,5,1,0,4,4,4,16,0.25,1,5,0.2,3,11,0.2727272727272727,0.281,0,0,0.0
Malik Allen,allenma01,PF,27,CHI,2006,54,701.0,266,20,44,96,140,14,16,34,92,121,247,0.4898785425101215,1,1,1.0,120,246,0.4878048780487805,0.492,23,38,0.6052631578947368
Ray Allen,allenra02,SG,30,SEA,2006,78,3022.0,1955,286,71,261,332,105,16,188,151,681,1500,0.454,269,653,0.4119448698315467,412,847,0.48642266824085,0.544,324,359,0.9025069637883008
Tony Allen,allento01,PG,24,BOS,2006,51,978.0,369,67,32,79,111,51,18,67,126,129,274,0.4708029197080292,11,34,0.3235294117647059,118,240,0.4916666666666666,0.491,100,134,0.746268656716418
Rafer Alston,alstora01,PG,29,HOU,2006,63,2431.0,761,425,36,219,255,101,15,157,194,280,738,0.3794037940379404,102,312,0.3269230769230769,178,426,0.4178403755868544,0.449,99,143,0.6923076923076923
Chris Andersen,anderch01,C,27,NOK,2006,32,570.0,161,6,61,94,155,8,41,26,84,56,98,0.5714285714285714,0,0,0.0,56,98,0.5714285714285714,0.571,49,103,0.4757281553398058
Alan Anderson,anderal01,SF,23,CHA,2006,36,564.0,207,32,23,47,70,11,4,32,48,75,181,0.4143646408839779,24,58,0.4137931034482758,51,123,0.4146341463414634,0.481,33,41,0.8048780487804879
Derek Anderson,anderde01,SG,31,TOT,2006,43,1047.0,349,101,21,122,143,23,6,54,98,108,303,0.3564356435643564,40,134,0.2985074626865671,68,169,0.4023668639053254,0.422,93,111,0.8378378378378378
Shandon Anderson,andersh01,SF,32,MIA,2006,48,638.0,126,30,18,63,81,17,6,24,75,54,126,0.4285714285714285,5,19,0.2631578947368421,49,107,0.4579439252336448,0.448,13,18,0.7222222222222222
Martynas Andriuškevičius,andrima01,C,19,CLE,2006,6,9.0,0,0,1,3,4,2,0,0,1,0,1,0.0,0,0,0.0,0,1,0.0,0.0,0,0,0.0
Carmelo Anthony,anthoca01,SF,21,DEN,2006,80,2941.0,2122,216,122,272,394,88,42,218,229,756,1572,0.4809160305343511,37,152,0.2434210526315789,719,1420,0.5063380281690141,0.493,573,709,0.8081805359661495
Rafael Araújo,araujra01,C,25,TOR,2006,52,601.0,121,15,43,101,144,24,6,42,104,53,145,0.3655172413793103,0,1,0.0,53,144,0.3680555555555556,0.366,15,28,0.5357142857142857
Gilbert Arenas,arenagi01,PG,24,WAS,2006,80,3384.0,2346,484,59,221,280,161,25,297,286,746,1668,0.447242206235012,199,540,0.3685185185185185,547,1128,0.4849290780141844,0.507,655,799,0.8197747183979975
Trevor Ariza,arizatr01,SF,20,TOT,2006,57,999.0,264,61,78,140,218,57,11,62,100,93,226,0.411504424778761,1,5,0.2,92,221,0.416289592760181,0.414,77,127,0.6062992125984252
Darrell Armstrong,armstda01,PG,37,DAL,2006,62,622.0,130,86,18,63,81,27,3,58,71,43,128,0.3359375,11,48,0.2291666666666666,32,80,0.4,0.379,33,42,0.7857142857142857
Carlos Arroyo,arroyca01,PG-SG,26,TOT,2006,77,1194.0,449,232,33,97,130,38,4,83,119,168,378,0.4444444444444444,7,20,0.35,161,358,0.4497206703910614,0.454,106,137,0.7737226277372263
Chucky Atkins,atkinch01,PG-SG,31,TOT,2006,71,1713.0,678,198,23,97,120,43,2,87,152,226,573,0.3944153577661431,97,274,0.354014598540146,129,299,0.431438127090301,0.479,129,163,0.7914110429447853
Stacey Augmon,augmost01,SF,37,ORL,2006,36,385.0,71,23,18,35,53,12,6,11,40,25,73,0.3424657534246575,0,0,0.0,25,73,0.3424657534246575,0.342,21,30,0.7
Vin Baker,bakervi01,C,34,LAC,2006,8,85.0,27,4,2,17,19,4,4,9,13,7,15,0.4666666666666667,0,0,0.0,7,15,0.4666666666666667,0.467,13,18,0.7222222222222222
Marcus Banks,banksma01,PG,24,TOT,2006,58,1497.0,578,220,23,112,135,54,11,119,162,219,468,0.4679487179487179,22,63,0.3492063492063492,197,405,0.4864197530864197,0.491,118,147,0.8027210884353742
Leandro Barbosa,barbole01,SG,23,PHO,2006,57,1592.0,744,158,31,119,150,48,6,89,145,273,567,0.4814814814814814,87,196,0.4438775510204081,186,371,0.5013477088948787,0.558,111,147,0.7551020408163265
Matt Barnes,barnema02,PF-SF,25,TOT,2006,56,631.0,175,28,48,73,121,20,7,30,100,70,140,0.5,3,15,0.2,67,125,0.536,0.511,32,47,0.6808510638297872
Andre Barrett,barrean01,PG,23,TOT,2006,19,282.0,87,52,9,16,25,10,0,15,13,38,104,0.3653846153846153,2,14,0.1428571428571428,36,90,0.4,0.375,9,12,0.75
Earl Barron,barroea01,C,24,MIA,2006,8,45.0,13,0,2,8,10,0,0,5,10,5,16,0.3125,0,0,0.0,5,16,0.3125,0.313,3,4,0.75
Brent Barry,barrybr01,SG,34,SAS,2006,74,1259.0,431,123,29,130,159,39,27,52,99,156,345,0.4521739130434782,80,202,0.396039603960396,76,143,0.5314685314685315,0.568,39,59,0.6610169491525424
Jon Barry,barryjo01,SG,36,HOU,2006,20,342.0,86,26,1,30,31,13,1,22,25,25,65,0.3846153846153846,12,32,0.375,13,33,0.3939393939393939,0.477,24,29,0.8275862068965517
Eddie Basden,basdeed01,SF,22,CHI,2006,19,141.0,39,8,7,21,28,9,2,9,17,15,37,0.4054054054054054,1,7,0.1428571428571428,14,30,0.4666666666666667,0.419,8,10,0.8
Brandon Bass,bassbr01,PF,20,NOK,2006,29,268.0,68,3,18,50,68,3,7,11,18,28,70,0.4,0,0,0.0,28,70,0.4,0.4,12,19,0.631578947368421
Esteban Batista,batises01,PF,22,ATL,2006,57,495.0,101,7,61,83,144,15,11,38,111,34,80,0.425,0,1,0.0,34,79,0.430379746835443,0.425,33,53,0.6226415094339622
Tony Battie,battito01,C,29,ORL,2006,82,2215.0,649,49,145,312,457,46,69,88,250,280,552,0.5072463768115942,0,6,0.0,280,546,0.5128205128205128,0.507,89,134,0.664179104477612
Shane Battier,battish01,SF,27,MEM,2006,81,2839.0,818,136,164,265,429,92,114,90,223,303,621,0.4879227053140096,65,165,0.3939393939393939,238,456,0.5219298245614035,0.54,147,208,0.7067307692307693
Lonny Baxter,baxtelo01,C-PF,27,TOT,2006,41,400.0,118,4,45,72,117,11,8,20,56,45,104,0.4326923076923077,0,0,0.0,45,104,0.4326923076923077,0.433,28,35,0.8
Charlie Bell,bellch01,SG,26,MIL,2006,59,1283.0,494,130,21,99,120,59,5,41,126,180,410,0.4390243902439024,71,168,0.4226190476190476,109,242,0.4504132231404958,0.526,63,89,0.7078651685393258
Raja Bell,bellra01,SG,29,PHO,2006,79,2959.0,1162,207,44,209,253,76,22,89,248,425,930,0.4569892473118279,197,446,0.4417040358744394,228,484,0.4710743801652892,0.563,115,146,0.7876712328767124
Jonathan Bender,bendejo01,SF,25,IND,2006,2,21.0,10,2,0,4,4,0,1,0,2,4,5,0.8,0,0,0.0,4,5,0.8,0.8,2,2,1.0
Mike Bibby,bibbymi01,PG,27,SAC,2006,82,3167.0,1728,444,29,211,240,82,10,199,169,597,1382,0.4319826338639653,192,497,0.386317907444668,405,885,0.4576271186440678,0.501,342,403,0.8486352357320099
Andris Biedriņš,biedran01,C,19,GSW,2006,68,1000.0,258,24,124,159,283,23,47,34,190,118,185,0.6378378378378379,0,0,0.0,118,185,0.6378378378378379,0.638,22,72,0.3055555555555556
Chauncey Billups,billuch01,PG,29,DET,2006,81,2925.0,1495,699,41,211,252,71,8,170,160,423,1012,0.4179841897233201,184,425,0.4329411764705882,239,587,0.4071550255536627,0.509,465,520,0.8942307692307693
Steve Blake,blakest01,PG,25,POR,2006,68,1781.0,560,306,26,120,146,42,5,83,107,206,470,0.4382978723404255,76,184,0.4130434782608695,130,286,0.4545454545454545,0.519,72,91,0.7912087912087912
Andray Blatche,blatcan01,PF,19,WAS,2006,29,175.0,65,10,12,26,38,5,7,12,36,26,67,0.3880597014925373,3,13,0.2307692307692307,23,54,0.4259259259259259,0.41,10,12,0.8333333333333334
Mark Blount,blounma01,C,30,TOT,2006,81,2240.0,914,99,96,269,365,40,76,194,254,373,734,0.5081743869209809,0,0,0.0,373,734,0.5081743869209809,0.508,168,222,0.7567567567567568
Keith Bogans,boganke01,SG-SF,25,TOT,2006,72,1912.0,622,128,55,200,255,71,9,90,167,215,544,0.3952205882352941,65,200,0.325,150,344,0.436046511627907,0.455,127,186,0.6827956989247311
Andrew Bogut,bogutan01,PF,21,MIL,2006,82,2348.0,768,192,189,384,573,49,68,125,259,323,606,0.533003300330033,0,3,0.0,323,603,0.5356550580431177,0.533,122,194,0.6288659793814433
Matt Bonner,bonnema01,PF,25,TOR,2006,78,1710.0,583,56,86,198,284,49,31,32,216,209,467,0.4475374732334047,102,243,0.419753086419753,107,224,0.4776785714285714,0.557,63,76,0.8289473684210527
Calvin Booth,boothca01,C,29,WAS,2006,33,250.0,46,12,19,33,52,9,9,8,44,20,47,0.425531914893617,1,2,0.5,19,45,0.4222222222222222,0.436,5,9,0.5555555555555556
Carlos Boozer,boozeca01,PF,24,UTA,2006,33,1025.0,537,88,73,212,285,30,8,69,105,219,399,0.5488721804511278,0,0,0.0,219,399,0.5488721804511278,0.549,99,137,0.7226277372262774
Chris Bosh,boshch01,C,21,TOR,2006,70,2751.0,1572,181,204,443,647,50,79,157,209,549,1087,0.5050597976080957,0,13,0.0,549,1074,0.5111731843575419,0.505,474,581,0.8158347676419966
Bruce Bowen,bowenbr01,SF,34,SAS,2006,82,2755.0,619,126,35,285,320,79,30,67,191,232,536,0.4328358208955223,104,245,0.4244897959183673,128,291,0.4398625429553264,0.53,51,84,0.6071428571428571
Ryan Bowen,bowenry01,SF,30,HOU,2006,68,652.0,88,24,31,57,88,21,6,13,85,37,124,0.2983870967741935,3,22,0.1363636363636363,34,102,0.3333333333333333,0.31,11,14,0.7857142857142857
Earl Boykins,boykiea01,PG,29,DEN,2006,60,1542.0,756,230,21,60,81,48,4,83,73,271,661,0.4099848714069591,62,179,0.3463687150837989,209,482,0.4336099585062241,0.457,152,174,0.8735632183908046
Michael Bradley,bradlmi01,PF,26,PHI,2006,46,367.0,67,17,40,67,107,5,7,19,39,32,79,0.4050632911392405,1,5,0.2,31,74,0.4189189189189189,0.411,2,3,0.6666666666666666
Elton Brand,brandel01,PF,26,LAC,2006,79,3099.0,1953,208,236,554,790,81,201,173,227,756,1435,0.526829268292683,1,3,0.3333333333333333,755,1432,0.5272346368715084,0.527,440,568,0.7746478873239436
Primož Brezec,brezepr01,C,26,CHA,2006,79,2165.0,982,45,181,259,440,19,32,85,227,409,791,0.5170670037926675,0,2,0.0,409,789,0.5183776932826363,0.517,164,224,0.7321428571428571
Devin Brown,brownde02,SG,27,UTA,2006,81,1711.0,611,104,73,134,207,44,14,99,153,207,527,0.3927893738140417,39,118,0.3305084745762712,168,409,0.4107579462102689,0.43,158,212,0.7452830188679245
Kwame Brown,brownkw01,C,23,LAL,2006,72,1978.0,536,72,182,291,473,27,46,100,196,204,388,0.5257731958762887,0,1,0.0,204,387,0.5271317829457365,0.526,128,235,0.5446808510638298
P.J. Brown,brownpj01,C,36,NOK,2006,75,2380.0,677,90,182,365,547,46,50,90,216,269,583,0.4614065180102916,0,0,0.0,269,583,0.4614065180102916,0.461,139,168,0.8273809523809523
Rick Brunson,brunsri01,PG,33,TOT,2006,27,246.0,54,35,1,21,22,8,1,22,22,21,54,0.3888888888888889,5,13,0.3846153846153846,16,41,0.3902439024390244,0.435,7,12,0.5833333333333334
Kobe Bryant,bryanko01,SG,27,LAL,2006,80,3277.0,2832,360,71,354,425,147,30,250,233,978,2173,0.4500690289921767,180,518,0.3474903474903475,798,1655,0.4821752265861027,0.491,696,819,0.8498168498168498
Greg Buckner,buckngr01,SG,29,DEN,2006,73,1758.0,491,127,31,178,209,87,20,52,180,181,417,0.434052757793765,86,243,0.3539094650205761,95,174,0.5459770114942529,0.537,43,55,0.7818181818181819
Pat Burke,burkepa01,C,32,PHO,2006,42,346.0,141,16,21,52,73,6,13,33,62,63,127,0.4960629921259842,2,7,0.2857142857142857,61,120,0.5083333333333333,0.504,13,21,0.6190476190476191
Antonio Burks,burksan01,PG,25,MEM,2006,57,570.0,113,76,4,33,37,20,0,36,45,51,144,0.3541666666666667,1,6,0.1666666666666666,50,138,0.3623188405797101,0.358,10,23,0.4347826086956521
Kevin Burleson,burleke01,PG,26,CHA,2006,39,340.0,70,48,4,22,26,26,2,25,63,22,88,0.25,10,54,0.1851851851851851,12,34,0.3529411764705882,0.307,16,17,0.9411764705882352
Caron Butler,butleca01,SF,25,WAS,2006,75,2708.0,1318,186,114,352,466,127,18,175,238,494,1086,0.4548802946593002,41,120,0.3416666666666667,453,966,0.468944099378882,0.474,289,332,0.8704819277108434
Jackie Butler,butleja01,C,20,NYK,2006,55,740.0,292,25,67,116,183,17,31,62,127,117,215,0.5441860465116279,0,0,0.0,117,215,0.5441860465116279,0.544,58,77,0.7532467532467533
Rasual Butler,butlera01,SF,26,NOK,2006,79,1875.0,685,40,51,181,232,33,45,65,142,257,633,0.4060031595576619,92,242,0.3801652892561983,165,391,0.4219948849104859,0.479,79,114,0.6929824561403509
Andrew Bynum,bynuman01,C,18,LAL,2006,46,338.0,74,9,34,46,80,4,22,17,56,33,82,0.4024390243902439,0,0,0.0,33,82,0.4024390243902439,0.402,8,27,0.2962962962962963
Will Bynum,bynumwi01,PG,23,GSW,2006,15,162.0,54,19,3,9,12,7,0,14,10,21,52,0.4038461538461538,2,9,0.2222222222222222,19,43,0.4418604651162791,0.423,10,16,0.625
Žarko Čabarkapa,cabarza01,PF,24,GSW,2006,61,505.0,199,20,37,74,111,13,7,35,87,67,174,0.3850574712643678,5,20,0.25,62,154,0.4025974025974026,0.399,60,84,0.7142857142857143
José Calderón,caldejo01,SG,24,TOR,2006,64,1487.0,349,288,30,111,141,42,4,101,93,132,312,0.4230769230769231,7,43,0.1627906976744186,125,269,0.4646840148698885,0.434,78,92,0.8478260869565217
Marcus Camby,cambyma01,C,31,DEN,2006,56,1857.0,716,115,132,536,668,79,184,92,158,302,649,0.4653312788906009,1,11,0.0909090909090909,301,638,0.4717868338557994,0.466,111,156,0.7115384615384616
Brian Cardinal,cardibr01,PF,28,MEM,2006,36,402.0,124,33,11,44,55,23,0,27,65,46,111,0.4144144144144144,13,29,0.4482758620689655,33,82,0.4024390243902439,0.473,19,27,0.7037037037037037
Matt Carroll,carroma01,SG,25,CHA,2006,78,1275.0,594,35,34,123,157,47,11,48,120,192,476,0.4033613445378151,72,185,0.3891891891891892,120,291,0.4123711340206185,0.479,138,168,0.8214285714285714
Anthony Carter,cartean01,PG,30,MIN,2006,45,589.0,150,101,9,53,62,24,9,40,71,53,137,0.3868613138686131,4,15,0.2666666666666666,49,122,0.4016393442622951,0.401,40,55,0.7272727272727273
Vince Carter,cartevi01,SG,29,NJN,2006,79,2906.0,1911,338,135,327,462,94,53,213,235,653,1518,0.4301712779973649,125,367,0.3405994550408719,528,1151,0.4587315377932233,0.471,480,601,0.7986688851913477
Sam Cassell,cassesa01,PG,36,LAC,2006,78,2653.0,1345,491,40,247,287,74,11,175,225,493,1112,0.4433453237410072,70,190,0.3684210526315789,423,922,0.4587852494577006,0.475,289,335,0.8626865671641791
Kelvin Cato,catoke01,C,31,TOT,2006,27,333.0,98,4,20,50,70,6,12,18,52,36,84,0.4285714285714285,0,0,0.0,36,84,0.4285714285714285,0.429,26,35,0.7428571428571429
Tyson Chandler,chandty01,C,23,CHI,2006,79,2121.0,417,81,265,449,714,41,104,123,298,160,283,0.5653710247349824,0,1,0.0,160,282,0.5673758865248227,0.565,97,193,0.5025906735751295
Calbert Cheaney,cheanca01,SF,34,GSW,2006,42,448.0,92,19,20,41,61,13,2,17,38,42,108,0.3888888888888889,0,8,0.0,42,100,0.42,0.389,8,8,1.0
Josh Childress,childjo01,SF,22,ATL,2006,74,2249.0,742,131,134,253,387,86,39,101,184,278,504,0.5515873015873016,32,65,0.4923076923076923,246,439,0.5603644646924829,0.583,154,201,0.7661691542288557
Doug Christie,chrisdo01,SG,35,DAL,2006,7,185.0,26,14,2,11,13,9,1,6,10,9,26,0.3461538461538461,0,1,0.0,9,25,0.36,0.346,8,12,0.6666666666666666
Speedy Claxton,claxtsp01,PG,27,NOK,2006,71,2019.0,871,339,39,154,193,108,6,154,177,304,736,0.4130434782608695,17,63,0.2698412698412698,287,673,0.4264487369985141,0.425,246,320,0.76875
Mateen Cleaves,cleavma01,PG,28,SEA,2006,27,230.0,73,42,2,12,14,3,2,14,30,25,71,0.352112676056338,4,16,0.25,21,55,0.3818181818181818,0.38,19,24,0.7916666666666666
Jarron Collins,collija03,C,27,UTA,2006,79,1730.0,415,97,134,199,333,36,27,61,252,129,280,0.4607142857142857,0,0,0.0,129,280,0.4607142857142857,0.461,157,219,0.7168949771689498
Jason Collins,collija04,C,27,NJN,2006,71,1895.0,255,70,93,249,342,46,40,61,251,104,262,0.3969465648854962,3,12,0.25,101,250,0.404,0.403,44,86,0.5116279069767442
Nick Collison,collini01,PF,25,SEA,2006,66,1448.0,493,74,143,225,368,21,35,77,213,207,394,0.5253807106598984,0,3,0.0,207,391,0.5294117647058824,0.525,79,113,0.6991150442477876
Brian Cook,cookbr01,PF,25,LAL,2006,81,1535.0,642,74,88,186,274,37,32,61,205,261,511,0.5107632093933464,36,84,0.4285714285714285,225,427,0.5269320843091335,0.546,84,101,0.8316831683168316
Jamal Crawford,crawfja01,SG,25,NYK,2006,79,2555.0,1128,301,36,212,248,87,15,175,150,366,879,0.4163822525597269,101,293,0.3447098976109215,265,586,0.4522184300341297,0.474,295,357,0.8263305322128851
Austin Croshere,croshau01,PF,30,IND,2006,50,1148.0,408,62,62,203,265,22,7,48,105,132,285,0.4631578947368421,54,140,0.3857142857142857,78,145,0.5379310344827586,0.558,90,102,0.8823529411764706
Eddy Curry,curryed01,C,23,NYK,2006,72,1865.0,979,19,145,287,432,28,56,179,239,336,597,0.5628140703517588,0,0,0.0,336,597,0.5628140703517588,0.563,307,486,0.6316872427983539
Samuel Dalembert,dalemsa01,C,24,PHI,2006,66,1761.0,485,25,159,382,541,34,160,107,244,196,369,0.5311653116531165,0,1,0.0,196,368,0.532608695652174,0.531,93,132,0.7045454545454546
Erick Dampier,dampier01,C,30,DAL,2006,82,1934.0,469,51,273,367,640,27,106,115,263,171,347,0.4927953890489913,0,0,0.0,171,347,0.4927953890489913,0.493,127,215,0.5906976744186047
Antonio Daniels,daniean01,SG,30,WAS,2006,80,2283.0,767,284,19,153,172,52,8,89,96,230,550,0.4181818181818181,23,101,0.2277227722772277,207,449,0.4610244988864143,0.439,284,336,0.8452380952380952
Marquis Daniels,daniema01,SG,25,DAL,2006,62,1766.0,634,172,81,143,224,67,13,100,143,246,512,0.48046875,4,19,0.2105263157894736,242,493,0.4908722109533469,0.484,138,183,0.7540983606557377
Antonio Davis,davisan01,PF-C,37,TOT,2006,44,940.0,216,21,90,118,208,23,10,51,125,82,190,0.431578947368421,0,1,0.0,82,189,0.4338624338624338,0.432,52,81,0.6419753086419753
Baron Davis,davisba01,PG,26,GSW,2006,54,1971.0,967,480,45,191,236,89,14,159,165,335,861,0.389082462253194,102,324,0.3148148148148148,233,537,0.4338919925512104,0.448,195,289,0.6747404844290658
Dale Davis,davisda01,C,36,DET,2006,28,178.0,26,6,21,32,53,0,9,4,23,9,24,0.375,0,1,0.0,9,23,0.391304347826087,0.375,8,15,0.5333333333333333
Josh Davis,davisjo02,PF,25,TOT,2006,6,17.0,6,1,3,1,4,2,0,1,3,2,7,0.2857142857142857,0,2,0.0,2,5,0.4,0.286,2,3,0.6666666666666666
Ricky Davis,davisri01,SG-SF,26,TOT,2006,78,3207.0,1516,394,65,286,351,91,17,213,190,584,1304,0.4478527607361963,73,242,0.3016528925619834,511,1062,0.4811676082862524,0.476,275,345,0.7971014492753623
Carlos Delfino,delfica01,SG,23,DET,2006,68,726.0,247,44,28,85,113,21,15,36,86,91,226,0.4026548672566372,20,60,0.3333333333333333,71,166,0.4277108433734939,0.447,45,67,0.6716417910447762
Tony Delk,delkto01,PG-SG,32,TOT,2006,24,385.0,182,33,14,39,53,13,1,19,28,71,161,0.4409937888198758,20,47,0.425531914893617,51,114,0.4473684210526316,0.503,20,27,0.7407407407407407
Luol Deng,denglu01,SF,20,CHI,2006,78,2604.0,1112,147,127,389,516,72,50,105,128,442,954,0.4633123689727463,21,78,0.2692307692307692,421,876,0.4805936073059361,0.474,207,276,0.75
Boris Diaw,diawbo01,PF,23,PHO,2006,81,2874.0,1080,503,159,399,558,58,85,189,260,449,853,0.5263774912075029,8,30,0.2666666666666666,441,823,0.5358444714459295,0.531,174,238,0.7310924369747899
Dan Dickau,dickada01,PG,27,BOS,2006,19,234.0,62,40,5,11,16,11,1,18,40,17,46,0.3695652173913043,10,20,0.5,7,26,0.2692307692307692,0.478,18,18,1.0
Travis Diener,dienetr01,PG,23,ORL,2006,23,246.0,88,16,4,17,21,7,0,10,22,29,69,0.4202898550724637,25,57,0.4385964912280701,4,12,0.3333333333333333,0.601,5,6,0.8333333333333334
Ike Diogu,dioguik01,PF,22,GSW,2006,69,1031.0,486,29,95,134,229,15,30,78,164,175,334,0.5239520958083832,0,0,0.0,175,334,0.5239520958083832,0.524,136,168,0.8095238095238095
DeSagana Diop,diopde01,C,24,DAL,2006,81,1510.0,190,23,145,229,374,44,146,36,253,75,154,0.487012987012987,1,2,0.5,74,152,0.4868421052631579,0.49,39,72,0.5416666666666666
Juan Dixon,dixonju01,SG,27,POR,2006,76,1920.0,935,149,30,147,177,58,6,113,157,357,821,0.4348355663824604,65,170,0.3823529411764705,292,651,0.4485407066052227,0.474,156,194,0.8041237113402062
Michael Doleac,doleami01,C,28,MIA,2006,31,371.0,98,8,23,62,85,10,7,14,45,37,88,0.4204545454545454,0,0,0.0,37,88,0.4204545454545454,0.42,24,30,0.8
Keyon Dooling,doolike01,PG,25,ORL,2006,50,1137.0,470,109,11,67,78,49,4,82,116,178,405,0.4395061728395061,13,43,0.3023255813953488,165,362,0.4558011049723757,0.456,101,121,0.8347107438016529
Chris Duhon,duhonch01,PG,23,CHI,2006,74,2155.0,647,373,28,192,220,70,3,117,152,215,538,0.3996282527881041,100,278,0.3597122302158273,115,260,0.4423076923076923,0.493,117,143,0.8181818181818182
Tim Duncan,duncati01,PF,29,SAS,2006,80,2784.0,1485,253,231,650,881,70,162,198,219,574,1185,0.4843881856540084,2,5,0.4,572,1180,0.4847457627118644,0.485,335,533,0.6285178236397748
Mike Dunleavy,dunlemi02,SF,25,GSW,2006,81,2578.0,932,237,78,321,399,60,32,120,199,331,816,0.4056372549019608,74,260,0.2846153846153846,257,556,0.4622302158273381,0.451,196,252,0.7777777777777778
Ronald Dupree,duprero01,SF,25,MIN,2006,36,265.0,80,14,21,28,49,12,0,14,44,33,63,0.5238095238095238,0,1,0.0,33,62,0.532258064516129,0.524,14,41,0.3414634146341463
John Edwards,edwarjo01,C,24,ATL,2006,40,296.0,70,5,18,30,48,3,15,12,76,31,64,0.484375,0,0,0.0,31,64,0.484375,0.484,8,11,0.7272727272727273
Howard Eisley,eisleho01,PG,33,TOT,2006,32,394.0,101,69,3,30,33,11,2,21,34,34,103,0.3300970873786408,13,42,0.3095238095238095,21,61,0.3442622950819672,0.393,20,24,0.8333333333333334
Monta Ellis,ellismo01,SG,20,GSW,2006,49,886.0,334,78,22,83,105,32,11,58,69,132,318,0.4150943396226415,28,82,0.3414634146341463,104,236,0.4406779661016949,0.459,42,59,0.711864406779661
Francisco Elson,elsonfr01,C,29,DEN,2006,72,1579.0,352,47,99,240,339,54,45,65,211,151,284,0.5316901408450704,1,5,0.2,150,279,0.5376344086021505,0.533,49,74,0.6621621621621622
Melvin Ely,elyme01,PF,27,CHA,2006,57,1348.0,560,76,94,183,277,29,44,100,160,216,425,0.508235294117647,0,2,0.0,216,423,0.5106382978723404,0.508,128,192,0.6666666666666666
Maurice Evans,evansma01,SG,27,DET,2006,80,1139.0,403,60,76,87,163,41,15,39,122,154,341,0.4516129032258064,43,116,0.3706896551724138,111,225,0.4933333333333333,0.515,52,65,0.8
Reggie Evans,evansre01,PF,25,TOT,2006,67,1393.0,377,38,171,331,502,40,10,85,166,131,268,0.4888059701492537,0,1,0.0,131,267,0.4906367041198501,0.489,115,217,0.5299539170506913
Daniel Ewing,ewingda01,SG,22,LAC,2006,66,971.0,252,84,23,62,85,37,6,57,86,97,255,0.3803921568627451,22,78,0.282051282051282,75,177,0.423728813559322,0.424,36,46,0.782608695652174
Noel Felix,felixno01,SF,24,SEA,2006,12,82.0,18,2,3,10,13,2,3,8,13,6,25,0.24,1,3,0.3333333333333333,5,22,0.2272727272727272,0.26,5,8,0.625
Raymond Felton,feltora01,PG,21,CHA,2006,80,2406.0,948,446,77,188,265,102,8,182,181,345,883,0.3907134767836919,97,271,0.3579335793357933,248,612,0.4052287581699346,0.446,161,222,0.7252252252252253
Michael Finley,finlemi01,SG,32,SAS,2006,77,2038.0,780,116,31,216,247,37,7,62,97,286,695,0.4115107913669065,110,279,0.3942652329749104,176,416,0.4230769230769231,0.491,98,115,0.8521739130434782
Derek Fisher,fishede01,PG,31,GSW,2006,82,2589.0,1089,352,36,175,211,125,8,156,237,364,887,0.4103720405862457,117,295,0.3966101694915254,247,592,0.4172297297297297,0.476,244,293,0.8327645051194539
Gerald Fitch,fitchge01,PG,23,MIA,2006,18,239.0,84,33,7,23,30,7,5,15,28,30,89,0.3370786516853932,7,26,0.2692307692307692,23,63,0.365079365079365,0.376,17,23,0.7391304347826086
Marcus Fizer,fizerma01,PF,27,NOK,2006,3,39.0,20,1,1,6,7,0,0,2,5,9,17,0.5294117647058824,1,1,1.0,8,16,0.5,0.559,1,2,0.5
Sharrod Ford,fordsh02,PF,24,PHO,2006,3,13.0,4,0,1,2,3,0,1,2,7,2,3,0.6666666666666666,0,0,0.0,2,3,0.6666666666666666,0.667,0,0,0.0
T.J. Ford,fordtj01,PG,22,MIL,2006,72,2557.0,878,473,63,248,311,104,7,219,196,328,789,0.4157160963244613,35,104,0.3365384615384615,293,685,0.4277372262773722,0.438,187,248,0.7540322580645161
Danny Fortson,fortsda01,C,29,SEA,2006,23,276.0,87,2,31,47,78,4,2,26,76,27,51,0.5294117647058824,0,0,0.0,27,51,0.5294117647058824,0.529,33,43,0.7674418604651163
Jeff Foster,fosteje01,C,29,IND,2006,63,1581.0,372,50,224,350,574,41,27,64,191,138,250,0.552,0,4,0.0,138,246,0.5609756097560976,0.552,96,159,0.6037735849056604
Adonal Foyle,foylead01,C,30,GSW,2006,77,1824.0,345,33,143,281,424,44,125,80,215,152,300,0.5066666666666667,0,0,0.0,152,300,0.5066666666666667,0.507,41,67,0.6119402985074627
Richie Frahm,frahmri01,SG,28,TOT,2006,33,342.0,108,21,3,30,33,4,2,8,30,39,100,0.39,23,70,0.3285714285714285,16,30,0.5333333333333333,0.505,7,10,0.7
Steve Francis,francst01,PG-SG,28,TOT,2006,70,2393.0,1005,345,74,216,290,74,17,214,204,333,765,0.4352941176470588,25,83,0.3012048192771084,308,682,0.4516129032258064,0.452,314,399,0.7869674185463659
Channing Frye,fryech01,C,22,NYK,2006,65,1572.0,802,53,138,236,374,30,47,97,200,305,640,0.4765625,3,9,0.3333333333333333,302,631,0.4786053882725832,0.479,189,229,0.8253275109170306
Dan Gadzuric,gadzuda01,C,27,MIL,2006,74,885.0,383,24,91,141,232,25,43,35,171,171,309,0.5533980582524272,0,1,0.0,171,308,0.5551948051948052,0.553,41,89,0.4606741573033708
Deng Gai,gaide01,C,23,PHI,2006,2,5.0,0,0,0,0,0,0,0,0,0,0,0,0.0,0,0,0.0,0,0,0.0,0.0,0,0,0.0
Reece Gaines,gainere01,PG,25,MIL,2006,12,54.0,13,3,0,0,0,1,0,1,1,6,12,0.5,0,2,0.0,6,10,0.6,0.5,1,4,0.25
Francisco García,garcifr01,SF,24,SAC,2006,67,1301.0,377,94,39,146,185,41,47,75,135,130,325,0.4,39,137,0.2846715328467153,91,188,0.4840425531914893,0.46,78,101,0.7722772277227723
Kevin Garnett,garneke01,PF,29,MIN,2006,76,2957.0,1656,308,214,752,966,104,107,180,206,626,1191,0.5256087321578505,8,30,0.2666666666666666,618,1161,0.5322997416020672,0.529,396,489,0.8098159509202454
Pat Garrity,garripa01,PF,29,ORL,2006,57,938.0,282,38,31,77,108,12,9,38,108,101,242,0.4173553719008264,50,129,0.3875968992248062,51,113,0.4513274336283185,0.521,30,37,0.8108108108108109
Pau Gasol,gasolpa01,PF,25,MEM,2006,80,3135.0,1628,371,191,522,713,46,153,235,184,600,1194,0.5025125628140703,3,12,0.25,597,1182,0.5050761421319797,0.504,425,617,0.6888168557536467
Devean George,georgde01,SF,28,LAL,2006,71,1542.0,448,68,82,192,274,66,34,54,159,170,425,0.4,50,160,0.3125,120,265,0.4528301886792453,0.459,58,86,0.6744186046511628
Eddie Gill,gilled01,PG,27,IND,2006,41,122.0,45,12,0,15,15,11,1,9,13,10,45,0.2222222222222222,7,23,0.3043478260869565,3,22,0.1363636363636363,0.3,18,23,0.782608695652174
Manu Ginóbili,ginobma01,SG,28,SAS,2006,65,1813.0,981,235,42,188,230,101,26,121,156,309,669,0.4618834080717489,83,217,0.3824884792626728,226,452,0.5,0.524,280,360,0.7777777777777778
Gordan Giriček,giricgo01,SG,28,UTA,2006,37,956.0,393,63,15,55,70,16,4,63,87,166,383,0.433420365535248,18,59,0.3050847457627119,148,324,0.4567901234567901,0.457,43,57,0.7543859649122807
Anthony Goldwire,goldwan01,PG,34,LAC,2006,3,22.0,2,2,0,1,1,0,0,1,0,1,7,0.1428571428571428,0,2,0.0,1,5,0.2,0.143,0,0,0.0
Ryan Gomes,gomesry01,PF,23,BOS,2006,61,1376.0,461,58,102,196,298,35,5,55,83,173,355,0.4873239436619718,3,9,0.3333333333333333,170,346,0.4913294797687861,0.492,112,149,0.7516778523489933
Drew Gooden,goodedr01,PF,24,CLE,2006,79,2174.0,845,56,237,428,665,52,49,106,190,334,652,0.5122699386503068,1,3,0.3333333333333333,333,649,0.5130970724191063,0.513,176,258,0.6821705426356589
Ben Gordon,gordobe01,SG,22,CHI,2006,80,2482.0,1349,240,43,176,219,75,5,180,238,486,1152,0.421875,166,382,0.4345549738219895,320,770,0.4155844155844156,0.494,211,268,0.7873134328358209
Joey Graham,grahajo01,SF,23,TOR,2006,80,1581.0,533,60,57,187,244,37,13,92,228,198,414,0.4782608695652174,29,87,0.3333333333333333,169,327,0.5168195718654435,0.513,108,133,0.8120300751879699
Stephen Graham,grahast01,SG,23,TOT,2006,22,175.0,58,7,5,22,27,5,2,13,31,21,54,0.3888888888888889,2,10,0.2,19,44,0.4318181818181818,0.407,14,15,0.9333333333333332
Danny Granger,grangda01,SF,22,IND,2006,78,1765.0,587,90,131,253,384,58,62,80,211,221,478,0.4623430962343096,30,93,0.3225806451612903,191,385,0.4961038961038961,0.494,115,148,0.777027027027027
Brian Grant,grantbr01,C,33,PHO,2006,21,248.0,61,7,11,46,57,5,3,7,45,27,65,0.4153846153846154,0,0,0.0,27,65,0.4153846153846154,0.415,7,8,0.875
Devin Green,greende01,SG,23,LAL,2006,27,135.0,25,7,10,14,24,3,0,5,13,6,28,0.2142857142857142,0,2,0.0,6,26,0.2307692307692307,0.214,13,21,0.6190476190476191
Gerald Green,greenge01,SG,20,BOS,2006,32,374.0,167,18,10,31,41,13,4,22,41,66,138,0.4782608695652174,6,20,0.3,60,118,0.5084745762711864,0.5,29,37,0.7837837837837838
Willie Green,greenwi01,SG,24,PHI,2006,10,153.0,70,5,1,14,15,2,0,12,13,28,66,0.4242424242424242,10,19,0.5263157894736842,18,47,0.3829787234042553,0.5,4,5,0.8
Orien Greene,greenor01,PG,23,BOS,2006,80,1235.0,254,129,37,108,145,77,10,109,181,100,253,0.3952569169960474,9,40,0.225,91,213,0.4272300469483568,0.413,45,68,0.6617647058823529
Adrian Griffin,griffad01,SG,31,DAL,2006,52,1245.0,237,89,75,152,227,51,9,39,113,98,204,0.4803921568627451,0,2,0.0,98,202,0.4851485148514851,0.48,41,53,0.7735849056603774
Eddie Griffin,griffed01,C,23,MIN,2006,70,1359.0,320,40,107,282,389,13,148,43,125,130,370,0.3513513513513513,16,82,0.1951219512195122,114,288,0.3958333333333333,0.373,44,74,0.5945945945945946
Anthony Grundy,grundan01,SG,26,ATL,2006,12,108.0,52,9,1,16,17,7,0,9,14,19,38,0.5,5,15,0.3333333333333333,14,23,0.6086956521739131,0.566,9,14,0.6428571428571429
Richard Hamilton,hamilri01,SG,27,DET,2006,80,2825.0,1609,275,84,172,256,52,16,173,207,649,1322,0.4909228441754917,55,120,0.4583333333333333,594,1202,0.4941763727121464,0.512,256,303,0.8448844884488449
Zendon Hamilton,hamilze01,C,30,TOT,2006,12,49.0,26,0,3,8,11,4,0,6,5,7,14,0.5,0,0,0.0,7,14,0.5,0.5,12,18,0.6666666666666666
Anfernee Hardaway,hardaan01,SF,34,NYK,2006,4,72.0,10,8,0,10,10,2,0,6,7,4,14,0.2857142857142857,0,1,0.0,4,13,0.3076923076923077,0.286,2,2,1.0
Matt Harpring,harprma01,SF,29,UTA,2006,71,1944.0,885,98,158,210,368,59,14,109,202,322,678,0.4749262536873156,14,39,0.358974358974359,308,639,0.4820031298904538,0.485,227,313,0.7252396166134185
Al Harrington,harrial01,PF,25,ATL,2006,76,2782.0,1411,238,132,391,523,85,14,195,301,551,1220,0.4516393442622951,66,191,0.3455497382198952,485,1029,0.4713313896987366,0.479,243,350,0.6942857142857143
Othella Harrington,harriot01,C,32,CHI,2006,72,824.0,347,39,54,100,154,7,13,61,131,135,273,0.4945054945054945,0,0,0.0,135,273,0.4945054945054945,0.495,77,123,0.6260162601626016
Devin Harris,harride01,PG,22,DAL,2006,56,1275.0,554,177,26,99,125,53,16,84,121,190,405,0.4691358024691358,5,21,0.238095238095238,185,384,0.4817708333333333,0.475,169,236,0.7161016949152542
David Harrison,harrida01,C,23,IND,2006,67,1034.0,385,14,84,170,254,23,59,79,193,148,294,0.5034013605442177,0,0,0.0,148,294,0.5034013605442177,0.503,89,174,0.5114942528735632
Jason Hart,hartja01,PG,27,SAC,2006,66,818.0,218,70,12,59,71,31,5,43,85,86,221,0.3891402714932127,9,31,0.2903225806451613,77,190,0.4052631578947368,0.41,37,56,0.6607142857142857
Udonis Haslem,hasleud01,PF,25,MIA,2006,81,2491.0,757,95,167,467,634,50,17,80,216,300,591,0.5076142131979695,0,2,0.0,300,589,0.5093378607809848,0.508,157,199,0.7889447236180904
Trenton Hassell,hassetr01,SG,26,MIN,2006,77,2514.0,710,203,82,134,216,43,29,124,201,286,616,0.4642857142857143,7,23,0.3043478260869565,279,593,0.4704890387858347,0.47,131,176,0.7443181818181818
Chuck Hayes,hayesch01,PF,22,HOU,2006,40,535.0,147,14,67,112,179,26,14,12,76,59,105,0.5619047619047619,0,1,0.0,59,104,0.5673076923076923,0.562,29,45,0.6444444444444445
Jarvis Hayes,hayesja01,SG,24,WAS,2006,21,516.0,196,27,19,57,76,16,1,22,38,77,183,0.4207650273224044,17,47,0.3617021276595745,60,136,0.4411764705882353,0.467,25,30,0.8333333333333334
Brendan Haywood,haywobr01,C,26,WAS,2006,79,1879.0,575,46,200,267,467,30,104,97,232,222,432,0.5138888888888888,0,0,0.0,222,432,0.5138888888888888,0.514,131,224,0.5848214285714286
Luther Head,headlu01,SG,23,HOU,2006,80,2310.0,707,215,33,233,266,89,9,119,169,254,630,0.4031746031746032,113,313,0.3610223642172524,141,317,0.444794952681388,0.493,86,123,0.6991869918699187
Alan Henderson,hendeal01,C,33,CLE,2006,51,531.0,127,10,60,77,137,9,12,22,58,47,91,0.5164835164835165,0,0,0.0,47,91,0.5164835164835165,0.516,33,49,0.673469387755102
Nenê,hilarne01,PF,23,DEN,2006,1,3.0,0,0,0,0,0,0,0,2,1,0,1,0.0,0,0,0.0,0,1,0.0,0.0,0,0,0.0
Grant Hill,hillgr01,SF,33,ORL,2006,21,613.0,318,48,15,65,80,24,6,35,50,119,243,0.4897119341563786,2,8,0.25,117,235,0.4978723404255319,0.494,78,102,0.7647058823529411
Kirk Hinrich,hinriki01,PG,25,CHI,2006,81,2955.0,1284,514,29,259,288,94,21,188,251,451,1078,0.4183673469387755,126,341,0.3695014662756598,325,737,0.4409769335142469,0.477,256,314,0.8152866242038217
Julius Hodge,hodgeju01,SG,22,DEN,2006,14,33.0,13,6,5,2,7,2,0,8,7,5,13,0.3846153846153846,0,0,0.0,5,13,0.3846153846153846,0.385,3,8,0.375
Randy Holcomb,holcora01,SF,26,CHI,2006,4,11.0,2,0,1,0,1,0,0,0,2,1,1,1.0,0,0,0.0,1,1,1.0,1.0,0,0,0.0
Robert Horry,horryro01,PF,35,SAS,2006,63,1182.0,321,79,71,171,242,43,51,41,115,112,292,0.3835616438356164,53,144,0.3680555555555556,59,148,0.3986486486486486,0.474,44,68,0.6470588235294118
Eddie House,houseed01,PG,27,PHO,2006,81,1421.0,796,148,15,117,132,42,12,76,96,320,759,0.4216073781291172,123,316,0.3892405063291139,197,443,0.4446952595936794,0.503,33,41,0.8048780487804879
Dwight Howard,howardw01,PF,20,ORL,2006,82,3021.0,1292,125,288,734,1022,65,115,217,277,468,881,0.5312145289443814,0,2,0.0,468,879,0.5324232081911263,0.531,356,598,0.5953177257525084
Josh Howard,howarjo01,SF,25,DAL,2006,59,1915.0,923,111,123,248,371,68,26,79,167,350,743,0.4710632570659488,27,63,0.4285714285714285,323,680,0.475,0.489,196,267,0.7340823970037453
Juwan Howard,howarju01,PF,32,HOU,2006,80,2537.0,942,112,168,367,535,49,8,133,235,394,859,0.4586728754365541,0,4,0.0,394,855,0.4608187134502924,0.459,154,191,0.806282722513089
Troy Hudson,hudsotr01,PG,29,MIN,2006,36,800.0,342,106,8,36,44,12,4,40,55,127,333,0.3813813813813814,40,101,0.396039603960396,87,232,0.375,0.441,48,52,0.9230769230769232
Larry Hughes,hughela01,SG,27,CLE,2006,36,1281.0,558,131,26,135,161,53,21,99,117,192,469,0.4093816631130064,28,76,0.3684210526315789,164,393,0.4173027989821883,0.439,146,193,0.7564766839378239
Kris Humphries,humphkr01,PF,20,UTA,2006,62,619.0,188,30,56,101,157,23,16,31,82,77,203,0.3793103448275862,0,5,0.0,77,198,0.3888888888888889,0.379,34,65,0.5230769230769231
Lindsey Hunter,hunteli01,PG,35,DET,2006,30,353.0,87,62,10,30,40,19,1,20,44,37,100,0.37,11,43,0.2558139534883721,26,57,0.4561403508771929,0.425,2,4,0.5
Steven Hunter,huntest01,C,24,PHI,2006,69,1312.0,421,17,110,161,271,12,76,64,120,175,291,0.6013745704467354,0,0,0.0,175,291,0.6013745704467354,0.601,71,138,0.5144927536231884
Andre Iguodala,iguodan01,SF,22,PHI,2006,82,3086.0,1007,255,117,364,481,135,21,153,198,344,688,0.5,56,158,0.3544303797468354,288,530,0.5433962264150943,0.541,263,349,0.7535816618911175
Zydrunas Ilgauskas,ilgauzy01,C,30,CLE,2006,78,2283.0,1217,91,245,346,591,38,136,155,280,450,889,0.5061867266591676,0,5,0.0,450,884,0.5090497737556561,0.506,317,380,0.8342105263157895
D.J. Mbenga,mbengdj01,C,25,DAL,2006,43,237.0,74,2,19,37,56,6,25,16,47,32,60,0.5333333333333333,0,1,0.0,32,59,0.5423728813559322,0.533,10,20,0.5
Allen Iverson,iversal01,PG,30,PHI,2006,72,3103.0,2377,532,44,188,232,140,10,248,121,815,1822,0.4473106476399561,72,223,0.3228699551569506,743,1599,0.4646654158849281,0.467,675,829,0.8142340168878166
Royal Ivey,iveyro01,PG,24,ATL,2006,73,978.0,260,74,31,65,96,24,7,23,147,116,264,0.4393939393939394,4,10,0.4,112,254,0.4409448818897638,0.447,24,33,0.7272727272727273
Jarrett Jack,jackja01,SG,22,POR,2006,79,1599.0,526,219,18,142,160,41,2,102,138,189,428,0.441588785046729,20,76,0.2631578947368421,169,352,0.4801136363636363,0.465,128,160,0.8
Bobby Jackson,jacksbo01,PG,32,MEM,2006,71,1775.0,808,195,44,179,223,61,1,101,155,286,748,0.3823529411764705,129,332,0.3885542168674699,157,416,0.3774038461538461,0.469,107,146,0.7328767123287672
Jermaine Jackson,jacksje01,PG,29,MIL,2006,30,202.0,35,25,8,19,27,4,1,13,19,11,26,0.4230769230769231,1,4,0.25,10,22,0.4545454545454545,0.442,12,14,0.8571428571428571
Jim Jackson,jacksji01,SF,35,TOT,2006,40,512.0,121,35,11,65,76,12,6,35,51,47,160,0.29375,18,74,0.2432432432432432,29,86,0.3372093023255814,0.35,9,13,0.6923076923076923
Luke Jackson,jackslu02,SF,24,CLE,2006,36,315.0,96,25,16,24,40,11,2,31,30,29,85,0.3411764705882353,12,36,0.3333333333333333,17,49,0.3469387755102041,0.412,26,33,0.7878787878787878
Marc Jackson,jacksma02,C,31,TOT,2006,64,1027.0,415,44,86,131,217,13,8,65,126,174,369,0.4715447154471545,1,2,0.5,173,367,0.4713896457765668,0.473,66,82,0.8048780487804879
Stephen Jackson,jacksst02,SG,27,IND,2006,81,2910.0,1329,225,48,264,312,104,43,203,195,472,1148,0.4111498257839721,117,339,0.3451327433628318,355,809,0.4388133498145859,0.462,268,341,0.7859237536656891
Jerome James,jamesje01,C,30,NYK,2006,45,406.0,137,12,39,52,91,3,23,51,104,56,121,0.4628099173553719,0,0,0.0,56,121,0.4628099173553719,0.463,25,40,0.625
LeBron James,jamesle01,SF,21,CLE,2006,79,3361.0,2478,521,75,481,556,123,66,260,181,875,1823,0.4799780581459133,127,379,0.3350923482849604,748,1444,0.518005540166205,0.515,601,814,0.7383292383292384
Mike James,jamesmi01,PG,30,TOR,2006,79,2925.0,1604,460,45,217,262,72,3,206,214,576,1228,0.4690553745928338,169,382,0.4424083769633508,407,846,0.4810874704491725,0.538,283,338,0.8372781065088757
Antawn Jamison,jamisan01,SF,29,WAS,2006,82,3288.0,1684,158,167,598,765,90,12,137,189,660,1494,0.4417670682730923,147,373,0.3941018766756032,513,1121,0.4576271186440678,0.491,217,297,0.7306397306397306
Marko Jarić,jaricma01,PG,27,MIN,2006,75,2102.0,587,293,60,173,233,108,21,127,189,226,566,0.3992932862190813,40,133,0.3007518796992481,186,433,0.4295612009237875,0.435,95,138,0.6884057971014492
Šarūnas Jasikevičius,jasiksa01,PG,29,IND,2006,75,1557.0,547,227,19,134,153,40,4,116,108,170,429,0.3962703962703963,86,236,0.3644067796610169,84,193,0.4352331606217616,0.497,121,133,0.9097744360902256
Al Jefferson,jeffeal01,PF,21,BOS,2006,59,1062.0,464,30,97,202,299,30,46,62,166,189,379,0.4986807387862796,0,4,0.0,189,375,0.504,0.499,86,134,0.6417910447761194
Richard Jefferson,jefferi01,SF,25,NJN,2006,78,3059.0,1521,297,95,439,534,59,17,174,193,495,1005,0.4925373134328358,60,188,0.3191489361702128,435,817,0.5324357405140759,0.522,471,580,0.8120689655172414
Jared Jeffries,jeffrja01,PF,24,WAS,2006,77,1951.0,489,148,164,215,379,58,50,99,223,187,415,0.4506024096385542,16,50,0.32,171,365,0.4684931506849315,0.47,99,168,0.5892857142857143
Amir Johnson,johnsam01,SF,18,DET,2006,3,39.0,20,3,3,1,4,0,2,4,7,7,10,0.7,2,3,0.6666666666666666,5,7,0.7142857142857143,0.8,4,4,1.0
Anthony Johnson,johnsan02,PG,31,IND,2006,75,1981.0,691,324,31,137,168,63,22,115,132,267,603,0.4427860696517413,51,155,0.3290322580645161,216,448,0.4821428571428571,0.485,106,141,0.75177304964539
DerMarr Johnson,johnsde03,SG,25,DEN,2006,58,924.0,354,55,19,77,96,25,26,46,86,132,306,0.4313725490196078,56,160,0.35,76,146,0.5205479452054794,0.523,34,42,0.8095238095238095
Ervin Johnson,johnser02,C,38,MIL,2006,18,81.0,15,2,5,19,24,1,2,5,23,7,17,0.4117647058823529,0,0,0.0,7,17,0.4117647058823529,0.412,1,2,0.5
Joe Johnson,johnsjo02,SG,24,ATL,2006,82,3340.0,1653,536,98,237,335,103,31,267,187,632,1395,0.4530465949820788,128,360,0.3555555555555555,504,1035,0.4869565217391304,0.499,261,330,0.7909090909090909
Linton Johnson,johnsli01,SF,25,TOT,2006,36,524.0,153,14,40,82,122,12,12,28,61,61,149,0.4093959731543624,13,36,0.3611111111111111,48,113,0.4247787610619469,0.453,18,27,0.6666666666666666
Dahntay Jones,jonesda02,SF,25,MEM,2006,71,967.0,281,39,20,84,104,38,15,50,108,109,263,0.4144486692015209,3,21,0.1428571428571428,106,242,0.4380165289256198,0.42,60,93,0.6451612903225806
Damon Jones,jonesda01,PG,29,CLE,2006,82,2089.0,552,169,14,119,133,37,1,55,112,190,491,0.3869653767820774,140,371,0.3773584905660377,50,120,0.4166666666666667,0.53,32,50,0.64
Dwayne Jones,jonesdw02,PF,22,BOS,2006,14,87.0,14,2,10,21,31,1,3,3,14,4,10,0.4,0,0,0.0,4,10,0.4,0.4,6,13,0.4615384615384615
Eddie Jones,jonesed02,SG,34,MEM,2006,75,2437.0,885,177,35,244,279,131,27,93,201,292,722,0.4044321329639889,133,374,0.355614973262032,159,348,0.4568965517241379,0.497,168,215,0.7813953488372093
Fred Jones,jonesfr01,SG,26,IND,2006,68,1837.0,651,154,18,152,170,55,20,107,142,233,559,0.4168157423971377,63,187,0.3368983957219251,170,372,0.4569892473118279,0.473,122,160,0.7625
James Jones,jonesja02,SF,25,PHO,2006,75,1772.0,699,57,44,209,253,38,49,35,142,243,581,0.4182444061962134,110,285,0.3859649122807017,133,296,0.4493243243243243,0.513,103,121,0.8512396694214877
Jumaine Jones,jonesju01,PF,26,CHA,2006,76,2089.0,799,63,105,271,376,68,22,74,200,298,736,0.4048913043478261,115,335,0.3432835820895522,183,401,0.456359102244389,0.483,88,121,0.7272727272727273
Chris Kaman,kamanch01,C,23,LAC,2006,78,2560.0,932,79,187,563,750,45,108,176,269,369,706,0.5226628895184136,0,2,0.0,369,704,0.5241477272727273,0.523,194,252,0.7698412698412699
Jason Kapono,kaponja01,SF,24,MIA,2006,51,665.0,207,37,12,59,71,7,3,20,89,79,177,0.4463276836158192,21,53,0.3962264150943396,58,124,0.4677419354838709,0.506,28,33,0.8484848484848485
Mario Kasun,kasunma01,C,25,ORL,2006,28,213.0,80,3,24,36,60,2,3,15,69,31,69,0.4492753623188406,0,0,0.0,31,69,0.4492753623188406,0.449,18,23,0.782608695652174
Viktor Khryapa,khryavi01,SF,23,POR,2006,69,1492.0,403,88,114,193,307,50,29,84,209,158,342,0.4619883040935672,10,30,0.3333333333333333,148,312,0.4743589743589743,0.477,77,111,0.6936936936936937
Jason Kidd,kiddja01,PG,32,NJN,2006,80,2975.0,1065,672,86,494,580,150,29,192,157,366,905,0.4044198895027624,139,395,0.3518987341772152,227,510,0.4450980392156862,0.481,194,244,0.7950819672131147
Andrei Kirilenko,kirilan01,SF,24,UTA,2006,69,2604.0,1054,299,161,391,552,102,220,203,162,336,730,0.4602739726027397,36,117,0.3076923076923077,300,613,0.4893964110929853,0.485,346,495,0.6989898989898989
Linas Kleiza,kleizli01,PF,21,DEN,2006,61,519.0,213,15,38,78,116,10,13,16,87,77,173,0.4450867052023121,2,13,0.1538461538461538,75,160,0.46875,0.451,57,81,0.7037037037037037
Brevin Knight,knighbr01,PG,30,CHA,2006,69,2351.0,871,610,35,188,223,157,4,164,202,308,772,0.3989637305699481,3,13,0.2307692307692307,305,759,0.4018445322793149,0.401,252,314,0.802547770700637
Yaroslav Korolev,korolya01,SF,18,LAC,2006,24,127.0,27,9,5,8,13,3,0,6,11,9,30,0.3,2,7,0.2857142857142857,7,23,0.3043478260869565,0.333,7,10,0.7
Kyle Korver,korveky01,SF,24,PHI,2006,82,2563.0,939,163,27,243,270,65,26,98,224,327,761,0.4296977660972405,184,438,0.4200913242009132,143,323,0.4427244582043343,0.551,101,119,0.8487394957983193
Nenad Krstić,krstine01,PF,22,NJN,2006,80,2469.0,1080,88,182,331,513,32,63,133,297,447,881,0.5073779795686719,1,4,0.25,446,877,0.508551881413911,0.508,185,265,0.6981132075471698
Toni Kukoč,kukocto01,PF,37,MIL,2006,65,1018.0,317,139,26,124,150,33,17,66,87,116,298,0.3892617449664429,45,147,0.3061224489795918,71,151,0.4701986754966887,0.465,40,56,0.7142857142857143
Raef LaFrentz,lafrera01,PF,29,BOS,2006,82,2033.0,639,115,80,326,406,29,72,65,273,238,552,0.4311594202898551,112,286,0.3916083916083916,126,266,0.4736842105263157,0.533,51,75,0.68
Maciej Lampe,lampema01,C,20,TOT,2006,6,28.0,4,2,4,5,9,0,0,3,2,2,11,0.1818181818181818,0,0,0.0,2,11,0.1818181818181818,0.182,0,2,0.0
David Lee,leeda02,SF,22,NYK,2006,67,1129.0,345,43,109,194,303,30,20,51,124,137,230,0.5956521739130435,0,0,0.0,137,230,0.5956521739130435,0.596,71,123,0.5772357723577236
Voshon Lenard,lenarvo01,SG,32,TOT,2006,26,458.0,191,41,5,42,47,21,4,31,39,75,191,0.3926701570680628,25,78,0.3205128205128205,50,113,0.4424778761061947,0.458,16,31,0.5161290322580645
Rashard Lewis,lewisra02,SF,26,SEA,2006,78,2876.0,1568,182,111,279,390,102,50,141,191,538,1151,0.4674196350999131,142,370,0.3837837837837838,396,781,0.5070422535211268,0.529,350,428,0.8177570093457944
Randy Livingston,livinra01,PG,30,CHI,2006,5,22.0,0,1,1,3,4,1,0,1,6,0,2,0.0,0,0,0.0,0,2,0.0,0.0,0,0,0.0
Shaun Livingston,livinsh01,PG,20,LAC,2006,61,1525.0,352,273,41,142,183,46,32,111,160,149,349,0.4269340974212034,1,8,0.125,148,341,0.4340175953079179,0.428,53,77,0.6883116883116883
John Lucas III,lucasjo02,PG,23,HOU,2006,13,107.0,30,12,2,3,5,5,0,7,6,14,36,0.3888888888888889,2,9,0.2222222222222222,12,27,0.4444444444444444,0.417,0,0,0.0
Tyronn Lue,luety01,PG,28,ATL,2006,51,1234.0,560,157,13,69,82,26,3,75,113,192,418,0.4593301435406698,58,127,0.4566929133858268,134,291,0.4604810996563573,0.529,118,138,0.855072463768116
Arvydas Macijauskas,macijar01,SG,26,NOK,2006,19,135.0,44,5,3,7,10,7,0,8,10,14,41,0.3414634146341463,3,12,0.25,11,29,0.3793103448275862,0.378,13,15,0.8666666666666667
Mark Madsen,madsema01,C,30,MIN,2006,62,676.0,74,11,50,91,141,23,17,26,114,27,66,0.4090909090909091,0,7,0.0,27,59,0.4576271186440678,0.409,20,47,0.425531914893617
Corey Maggette,maggeco01,SF,26,LAC,2006,32,943.0,570,66,28,141,169,19,4,78,95,167,375,0.4453333333333333,24,71,0.3380281690140845,143,304,0.4703947368421052,0.477,212,256,0.828125
Jamaal Magloire,magloja01,C,27,MIL,2006,82,2465.0,752,56,220,558,778,29,80,166,276,287,615,0.4666666666666667,0,0,0.0,287,615,0.4666666666666667,0.467,178,333,0.5345345345345346
Stephon Marbury,marbust01,PG,28,NYK,2006,60,2193.0,977,382,25,150,175,63,4,157,143,349,774,0.4509043927648579,33,104,0.3173076923076923,316,670,0.4716417910447761,0.472,246,326,0.754601226993865
Shawn Marion,mariosh01,PF,27,PHO,2006,81,3263.0,1769,143,249,710,959,160,137,125,223,716,1365,0.5245421245421246,96,290,0.3310344827586207,620,1075,0.5767441860465117,0.56,241,298,0.8087248322147651
Sean Marks,marksse01,PF,30,SAS,2006,25,181.0,81,7,12,31,43,5,7,7,21,37,71,0.5211267605633803,0,3,0.0,37,68,0.5441176470588235,0.521,7,12,0.5833333333333334
Donyell Marshall,marshdo01,PF,32,CLE,2006,81,2077.0,750,60,105,387,492,59,41,90,160,265,671,0.3949329359165425,128,395,0.3240506329113924,137,276,0.4963768115942029,0.49,92,123,0.7479674796747967
Rawle Marshall,marshra01,SF,23,DAL,2006,23,241.0,71,10,8,23,31,8,7,15,17,24,60,0.4,1,3,0.3333333333333333,23,57,0.4035087719298245,0.408,22,29,0.7586206896551724
Darrick Martin,martida01,PG,34,TOR,2006,40,339.0,102,57,2,18,20,17,0,15,42,34,97,0.3505154639175257,16,40,0.4,18,57,0.3157894736842105,0.433,18,24,0.75
Kenyon Martin,martike01,PF,28,DEN,2006,56,1546.0,720,79,93,260,353,43,52,72,171,297,600,0.495,5,22,0.2272727272727272,292,578,0.5051903114186851,0.499,121,170,0.711764705882353
Kevin Martin,martike02,SG,22,SAC,2006,72,1913.0,778,97,58,203,261,55,9,81,138,262,546,0.4798534798534798,66,179,0.3687150837988827,196,367,0.5340599455040872,0.54,188,222,0.8468468468468469
Desmond Mason,masonde01,SF,28,NOK,2006,70,2102.0,757,66,64,234,298,42,17,113,136,275,690,0.3985507246376811,1,6,0.1666666666666666,274,684,0.4005847953216374,0.399,206,302,0.6821192052980133
Jason Maxiell,maxieja01,PF,22,DET,2006,26,159.0,60,3,12,16,28,4,5,11,14,23,54,0.4259259259259259,0,0,0.0,23,54,0.4259259259259259,0.426,14,42,0.3333333333333333
Sean May,mayse01,PF,21,CHA,2006,23,398.0,189,22,42,67,109,17,12,33,58,70,171,0.4093567251461988,0,5,0.0,70,166,0.4216867469879518,0.409,49,64,0.765625
Rashad McCants,mccanra01,SG,21,MIN,2006,79,1362.0,627,63,29,114,143,44,22,86,176,241,535,0.4504672897196262,67,180,0.3722222222222222,174,355,0.4901408450704225,0.513,78,106,0.7358490566037735
Walter McCarty,mccarwa01,SF,31,LAC,2006,36,353.0,88,23,15,53,68,8,5,19,52,33,99,0.3333333333333333,10,45,0.2222222222222222,23,54,0.4259259259259259,0.384,12,21,0.5714285714285714
Antonio McDyess,mcdyean01,PF,31,DET,2006,82,1733.0,638,90,156,280,436,46,48,76,220,285,560,0.5089285714285714,0,2,0.0,285,558,0.510752688172043,0.509,68,122,0.5573770491803278
Tracy McGrady,mcgratr01,SF,26,HOU,2006,47,1745.0,1147,225,46,261,307,59,41,120,88,410,1011,0.4055390702274975,73,234,0.3119658119658119,337,777,0.4337194337194337,0.442,254,340,0.7470588235294118
Jeff McInnis,mcinnje01,SG,31,NJN,2006,28,486.0,149,52,11,39,50,11,2,29,37,63,143,0.4405594405594406,3,16,0.1875,60,127,0.4724409448818897,0.451,20,29,0.6896551724137931
Aaron McKie,mckieaa01,PG,33,LAL,2006,14,121.0,7,11,3,17,20,5,0,2,7,3,12,0.25,0,2,0.0,3,10,0.3,0.25,1,2,0.5
Keith McLeod,mcleoke01,PG,26,UTA,2006,66,1232.0,370,151,11,67,78,42,9,76,131,120,340,0.3529411764705882,24,82,0.2926829268292683,96,258,0.3720930232558139,0.388,106,133,0.7969924812030075
Stanislav Medvedenko,medvest01,PF,26,LAL,2006,2,6.0,2,1,0,0,0,0,0,0,1,1,2,0.5,0,0,0.0,1,2,0.5,0.5,0,0,0.0
Chris Mihm,mihmch01,C,26,LAL,2006,59,1541.0,604,61,137,236,373,16,73,83,214,230,459,0.5010893246187363,0,0,0.0,230,459,0.5010893246187363,0.501,144,201,0.7164179104477612
Aaron Miles,milesaa01,PG,22,GSW,2006,19,118.0,16,24,0,14,14,4,1,11,13,6,18,0.3333333333333333,0,0,0.0,6,18,0.3333333333333333,0.333,4,4,1.0
C.J. Miles,milescj01,PG,18,UTA,2006,23,203.0,79,16,18,20,38,7,2,9,20,28,76,0.3684210526315789,5,20,0.25,23,56,0.4107142857142857,0.401,18,24,0.75
Darius Miles,milesda01,SF,24,POR,2006,40,1286.0,559,73,24,158,182,42,39,99,100,235,510,0.4607843137254901,2,10,0.2,233,500,0.466,0.463,87,163,0.5337423312883436
Darko Miličić,milicda01,C,20,TOT,2006,55,767.0,266,41,44,107,151,14,77,51,92,119,234,0.5085470085470085,0,2,0.0,119,232,0.5129310344827587,0.509,28,50,0.56
Andre Miller,millean02,PG,29,DEN,2006,82,2937.0,1126,674,92,259,351,106,18,256,213,404,872,0.463302752293578,5,27,0.1851851851851851,399,845,0.472189349112426,0.466,313,424,0.7382075471698113
Brad Miller,millebr01,C,29,SAC,2006,79,2923.0,1182,374,122,493,615,61,62,180,234,434,877,0.4948688711516533,34,88,0.3863636363636363,400,789,0.5069708491761724,0.514,280,338,0.8284023668639053
Mike Miller,millemi01,SG,25,MEM,2006,74,2268.0,1014,200,42,355,397,52,27,140,173,354,760,0.4657894736842105,138,339,0.4070796460176991,216,421,0.5130641330166271,0.557,168,210,0.8
Yao Ming,mingya01,C,25,HOU,2006,57,1949.0,1271,85,148,433,581,30,94,147,195,467,900,0.5188888888888888,0,1,0.0,467,899,0.5194660734149055,0.519,337,395,0.8531645569620253
Cuttino Mobley,moblecu01,SG,30,LAC,2006,79,2979.0,1170,238,50,291,341,93,36,145,208,429,1008,0.4255952380952381,83,245,0.3387755102040816,346,763,0.4534731323722149,0.467,229,273,0.8388278388278388
Nazr Mohammed,mohamna01,C,28,SAS,2006,80,1389.0,493,40,163,255,418,21,49,91,220,190,377,0.5039787798408488,0,0,0.0,190,377,0.5039787798408488,0.504,113,144,0.7847222222222222
Sergei Monia,moniase01,SF,22,TOT,2006,26,343.0,77,19,11,41,52,7,5,12,41,29,87,0.3333333333333333,9,34,0.2647058823529412,20,53,0.3773584905660377,0.385,10,14,0.7142857142857143
Mikki Moore,mooremi01,C,30,SEA,2006,47,583.0,154,27,44,86,130,7,15,40,92,54,124,0.4354838709677419,0,2,0.0,54,122,0.4426229508196721,0.435,46,62,0.7419354838709677
Terence Morris,morrite01,SF,27,ORL,2006,22,192.0,35,4,6,32,38,6,5,7,19,16,49,0.3265306122448979,0,2,0.0,16,47,0.3404255319148936,0.327,3,3,1.0
Alonzo Mourning,mournal01,C,35,MIA,2006,65,1302.0,509,11,125,234,359,13,173,79,177,188,315,0.5968253968253968,0,1,0.0,188,314,0.5987261146496815,0.597,133,224,0.59375
Troy Murphy,murphtr01,PF,25,GSW,2006,74,2516.0,1035,101,195,548,743,47,26,108,191,363,838,0.4331742243436754,58,181,0.3204419889502762,305,657,0.4642313546423135,0.468,251,319,0.786833855799373
Lamond Murray,murrala01,SF,32,NJN,2006,57,576.0,196,13,29,103,132,17,7,22,66,72,181,0.3977900552486187,27,78,0.3461538461538461,45,103,0.4368932038834951,0.472,25,40,0.625
Ronald Murray,murraro01,SG,26,TOT,2006,76,2112.0,851,197,33,120,153,68,11,135,133,321,768,0.41796875,37,141,0.2624113475177305,284,627,0.4529505582137161,0.442,172,242,0.7107438016528925
Dikembe Mutombo,mutomdi01,C,39,HOU,2006,64,955.0,169,4,100,206,306,17,57,35,128,50,95,0.5263157894736842,0,0,0.0,50,95,0.5263157894736842,0.526,69,91,0.7582417582417582
Boniface N'Dong,ndongbo01,C,28,LAC,2006,23,152.0,50,7,15,22,37,2,5,6,23,22,53,0.4150943396226415,0,1,0.0,22,52,0.4230769230769231,0.415,6,9,0.6666666666666666
Boštjan Nachbar,nachbbo01,PF-SF,25,TOT,2006,36,502.0,157,27,8,52,60,16,5,24,65,54,156,0.3461538461538461,19,71,0.2676056338028169,35,85,0.4117647058823529,0.407,30,44,0.6818181818181818
Lee Nailon,nailole01,PF,30,PHI,2006,22,237.0,93,7,23,19,42,8,4,10,32,40,80,0.5,0,0,0.0,40,80,0.5,0.5,13,15,0.8666666666666667
Eduardo Nájera,najered01,PF,29,DEN,2006,64,1449.0,347,52,128,197,325,53,34,54,165,127,301,0.4219269102990033,4,12,0.3333333333333333,123,289,0.4256055363321799,0.429,89,114,0.7807017543859649
Steve Nash,nashst01,PG,31,PHO,2006,79,2796.0,1489,826,47,286,333,61,12,276,120,541,1056,0.5123106060606061,150,342,0.4385964912280701,391,714,0.5476190476190477,0.583,257,279,0.921146953405018
Jameer Nelson,nelsoja01,PG,23,ORL,2006,62,1784.0,905,302,39,141,180,70,9,148,174,347,719,0.4826147426981919,70,165,0.4242424242424242,277,554,0.5,0.531,141,181,0.7790055248618785
Rasho Nesterović,nestera01,C,29,SAS,2006,80,1515.0,362,33,114,195,309,21,88,53,209,172,334,0.5149700598802395,0,2,0.0,172,332,0.5180722891566265,0.515,18,30,0.6
Ira Newble,newblir01,SG,31,CLE,2006,36,353.0,48,9,21,35,56,5,10,12,47,17,57,0.2982456140350877,3,13,0.2307692307692307,14,44,0.3181818181818182,0.325,11,16,0.6875
Andrés Nocioni,nocioan01,PF,26,CHI,2006,82,2239.0,1063,117,89,411,500,40,52,120,252,383,831,0.4608904933814681,93,238,0.3907563025210084,290,593,0.4890387858347386,0.517,204,242,0.8429752066115702
Moochie Norris,norrimo01,PG,32,TOT,2006,45,424.0,125,50,12,42,54,20,1,33,49,46,112,0.4107142857142857,4,14,0.2857142857142857,42,98,0.4285714285714285,0.429,29,42,0.6904761904761905
Dirk Nowitzki,nowitdi01,PF,27,DAL,2006,81,3089.0,2151,226,115,613,728,58,83,156,164,751,1564,0.4801790281329923,110,271,0.4059040590405904,641,1293,0.4957463263727765,0.515,539,598,0.9013377926421404
Jermaine O'Neal,onealje01,PF,27,IND,2006,51,1802.0,1024,133,102,374,476,27,117,151,177,380,805,0.4720496894409938,3,10,0.3,377,795,0.4742138364779874,0.474,261,368,0.7092391304347826
Shaquille O'Neal,onealsh01,C,33,MIA,2006,59,1806.0,1181,113,172,369,541,23,104,168,230,480,800,0.6,0,0,0.0,480,800,0.6,0.6,221,471,0.4692144373673036
Fabricio Oberto,obertfa01,C,30,SAS,2006,59,490.0,103,27,57,66,123,9,11,28,91,44,93,0.4731182795698925,0,2,0.0,44,91,0.4835164835164835,0.473,15,27,0.5555555555555556
Lamar Odom,odomla01,PF,26,LAL,2006,80,3221.0,1186,443,181,557,738,75,64,213,256,445,925,0.4810810810810811,80,215,0.3720930232558139,365,710,0.5140845070422535,0.524,216,313,0.6900958466453674
Emeka Okafor,okafoem01,PF,23,CHA,2006,26,874.0,344,31,94,167,261,22,50,53,88,131,316,0.4145569620253164,0,0,0.0,131,316,0.4145569620253164,0.415,82,125,0.656
Mehmet Okur,okurme01,PF,26,UTA,2006,82,2945.0,1472,194,211,535,746,40,73,163,285,519,1128,0.4601063829787234,80,234,0.3418803418803419,439,894,0.4910514541387024,0.496,354,454,0.7797356828193832
Kevin Ollie,ollieke01,SG,33,PHI,2006,70,1069.0,192,101,13,85,98,33,3,29,103,75,174,0.4310344827586206,1,3,0.3333333333333333,74,171,0.4327485380116959,0.434,41,49,0.8367346938775511
Michael Olowokandi,olowomi01,C,30,TOT,2006,48,919.0,238,23,50,170,220,22,33,55,122,107,240,0.4458333333333333,0,0,0.0,107,240,0.4458333333333333,0.446,24,47,0.5106382978723404
Greg Ostertag,ostergr01,C,32,UTA,2006,60,807.0,146,58,82,143,225,6,66,46,129,61,124,0.4919354838709677,0,0,0.0,61,124,0.4919354838709677,0.492,24,48,0.5
Bo Outlaw,outlabo01,PF,34,ORL,2006,32,355.0,75,14,31,46,77,10,12,17,50,35,58,0.603448275862069,0,0,0.0,35,58,0.603448275862069,0.603,5,8,0.625
Travis Outlaw,outlatr01,PF,21,POR,2006,69,1153.0,400,34,48,141,189,31,46,37,112,162,368,0.4402173913043478,14,53,0.2641509433962264,148,315,0.4698412698412698,0.459,62,89,0.6966292134831461
Andre Owens,owensan01,PG,25,UTA,2006,23,210.0,69,8,11,10,21,5,0,13,25,27,74,0.3648648648648648,3,16,0.1875,24,58,0.4137931034482758,0.385,12,18,0.6666666666666666
Zaza Pachulia,pachuza01,C,21,ATL,2006,78,2452.0,911,129,264,349,613,89,39,180,286,307,681,0.4508076358296622,0,2,0.0,307,679,0.4521354933726068,0.451,297,404,0.7351485148514851
Scott Padgett,padgesc01,PF,29,NJN,2006,62,718.0,211,41,56,109,165,28,12,21,90,71,201,0.3532338308457711,42,121,0.3471074380165289,29,80,0.3625,0.458,27,34,0.7941176470588235
Milt Palacio,palacmi01,PG,27,UTA,2006,71,1376.0,441,190,17,117,134,47,14,110,125,171,403,0.4243176178660049,1,16,0.0625,170,387,0.4392764857881137,0.426,98,150,0.6533333333333333
Jannero Pargo,pargoja01,PG,26,CHI,2006,57,646.0,274,94,8,53,61,24,2,61,57,109,292,0.3732876712328767,39,103,0.3786407766990291,70,189,0.3703703703703703,0.44,17,21,0.8095238095238095
Smush Parker,parkesm01,PG,24,LAL,2006,82,2773.0,941,302,37,234,271,140,16,147,213,348,779,0.4467265725288832,120,328,0.3658536585365853,228,451,0.5055432372505543,0.524,125,180,0.6944444444444444
Tony Parker,parketo01,PG,23,SAS,2006,80,2715.0,1510,460,38,223,261,83,4,249,161,623,1136,0.5484154929577465,11,36,0.3055555555555556,612,1100,0.5563636363636364,0.553,253,358,0.7067039106145251
Ruben Patterson,patteru01,SF-SG,30,TOT,2006,71,1792.0,858,127,118,126,244,76,21,150,150,327,635,0.5149606299212598,1,13,0.0769230769230769,326,622,0.5241157556270096,0.516,203,338,0.6005917159763313
Chris Paul,paulch01,PG,20,NOK,2006,78,2808.0,1258,611,61,339,400,175,6,183,218,407,947,0.4297782470960929,50,177,0.2824858757062147,357,770,0.4636363636363636,0.456,394,465,0.8473118279569892
Sasha Pavlović,pavloal01,SG,22,CLE,2006,53,813.0,241,25,16,64,80,19,6,42,103,87,212,0.410377358490566,35,96,0.3645833333333333,52,116,0.4482758620689655,0.493,32,49,0.6530612244897959
Gary Payton,paytoga01,PG,37,MIA,2006,81,2305.0,626,257,34,199,233,71,10,102,169,230,547,0.4204753199268738,66,230,0.2869565217391304,164,317,0.5173501577287066,0.481,100,126,0.7936507936507936
Kendrick Perkins,perkike01,C,21,BOS,2006,68,1332.0,354,69,140,264,404,21,105,107,199,137,266,0.5150375939849624,0,2,0.0,137,264,0.5189393939393939,0.515,80,130,0.6153846153846154
Morris Peterson,petermo01,SG,28,TOR,2006,82,3140.0,1374,190,65,316,381,104,15,126,223,478,1096,0.4361313868613138,177,448,0.3950892857142857,301,648,0.4645061728395062,0.517,241,294,0.8197278911564626
Johan Petro,petrojo01,C,20,SEA,2006,68,1282.0,353,15,109,187,296,25,51,60,213,153,300,0.51,0,0,0.0,153,300,0.51,0.51,47,75,0.6266666666666667
Eric Piatkowski,piatker01,SG,35,CHI,2006,29,228.0,59,13,4,19,23,6,1,11,20,24,61,0.3934426229508196,9,33,0.2727272727272727,15,28,0.5357142857142857,0.467,2,5,0.4
Paul Pierce,piercpa01,SF,28,BOS,2006,79,3084.0,2116,375,77,453,530,107,34,273,223,689,1462,0.4712722298221614,111,314,0.3535031847133758,578,1148,0.5034843205574913,0.509,627,812,0.7721674876847291
Mickaël Piétrus,pietrmi01,SF,23,GSW,2006,52,1179.0,481,44,58,105,163,33,10,78,132,169,418,0.4043062200956938,56,176,0.3181818181818182,113,242,0.4669421487603306,0.471,87,143,0.6083916083916084
Zoran Planinić,planizo01,PG,23,NJN,2006,56,596.0,191,53,14,60,74,20,4,43,91,66,183,0.360655737704918,13,56,0.2321428571428571,53,127,0.4173228346456692,0.396,46,66,0.696969696969697
Pavel Podkolzin,podkopa01,C,21,DAL,2006,1,18.0,3,0,0,7,7,0,1,2,0,0,2,0.0,0,0,0.0,0,2,0.0,0.0,3,6,0.5
Scot Pollard,pollasc01,C,30,IND,2006,45,771.0,169,24,73,145,218,37,20,26,115,70,154,0.4545454545454545,0,0,0.0,70,154,0.4545454545454545,0.455,29,38,0.7631578947368421
James Posey,poseyja01,SF,29,MIA,2006,67,1914.0,483,89,33,286,319,54,20,58,196,159,395,0.4025316455696202,117,290,0.4034482758620689,42,105,0.4,0.551,48,61,0.7868852459016393
Vitaly Potapenko,potapvi01,C,30,TOT,2006,33,353.0,84,9,27,37,64,2,2,16,50,37,71,0.5211267605633803,0,0,0.0,37,71,0.5211267605633803,0.521,10,17,0.5882352941176471
Josh Powell,poweljo01,PF,23,DAL,2006,37,429.0,110,9,28,53,81,7,4,22,52,37,81,0.4567901234567901,0,0,0.0,37,81,0.4567901234567901,0.457,36,45,0.8
Ronnie Price,pricero01,PG,22,SAC,2006,29,150.0,60,11,5,10,15,6,0,10,10,21,58,0.3620689655172414,6,27,0.2222222222222222,15,31,0.4838709677419355,0.414,12,12,1.0
Tayshaun Prince,princta01,SF,25,DET,2006,82,2898.0,1156,186,104,242,346,62,39,91,96,455,999,0.4554554554554554,64,183,0.3497267759562841,391,816,0.4791666666666667,0.487,182,238,0.7647058823529411
Laron Profit,profila01,SG,28,LAL,2006,25,279.0,104,15,8,35,43,11,5,24,25,40,84,0.4761904761904761,3,18,0.1666666666666666,37,66,0.5606060606060606,0.494,21,24,0.875
Joel Przybilla,przybjo01,C,26,POR,2006,56,1395.0,344,43,146,245,391,20,130,76,149,131,239,0.5481171548117155,0,0,0.0,131,239,0.5481171548117155,0.548,82,154,0.5324675324675324
Vladimir Radmanović,radmavl01,PF,25,TOT,2006,77,1974.0,755,136,64,294,358,61,29,93,210,262,643,0.4074650077760497,138,354,0.3898305084745763,124,289,0.4290657439446367,0.515,93,114,0.8157894736842105
Shavlik Randolph,randosh01,PF,22,PHI,2006,57,487.0,131,19,55,78,133,19,12,21,83,44,97,0.4536082474226804,0,0,0.0,44,97,0.4536082474226804,0.454,43,71,0.6056338028169014
Zach Randolph,randoza01,PF,24,POR,2006,74,2545.0,1333,144,193,399,592,57,14,165,185,536,1229,0.436126932465419,16,55,0.2909090909090909,520,1174,0.4429301533219761,0.443,245,343,0.7142857142857143
Theo Ratliff,ratlith01,C,32,POR,2006,55,1301.0,270,28,89,190,279,18,88,47,143,108,189,0.5714285714285714,0,0,0.0,108,189,0.5714285714285714,0.571,54,83,0.6506024096385542
Željko Rebrača,rebraze01,C,33,LAC,2006,29,412.0,135,9,13,51,64,5,19,24,59,52,96,0.5416666666666666,0,0,0.0,52,96,0.5416666666666666,0.542,31,41,0.7560975609756098
Michael Redd,reddmi01,SG,26,MIL,2006,80,3130.0,2028,229,78,264,342,95,5,170,157,682,1516,0.449868073878628,163,413,0.3946731234866828,519,1103,0.470534904805077,0.504,501,571,0.8774080560420315
Justin Reed,reedju01,SF,24,TOT,2006,72,997.0,325,41,53,71,124,23,15,52,163,119,295,0.4033898305084746,0,1,0.0,119,294,0.4047619047619047,0.403,87,120,0.725
Jason Richardson,richaja01,SG,25,GSW,2006,75,2877.0,1741,232,105,333,438,97,37,167,206,641,1438,0.4457579972183588,183,477,0.3836477987421384,458,961,0.4765868886576482,0.509,276,410,0.6731707317073171
Quentin Richardson,richaqu01,SF,25,NYK,2006,55,1442.0,451,88,65,165,230,39,6,56,134,163,459,0.355119825708061,64,188,0.3404255319148936,99,271,0.3653136531365313,0.425,61,91,0.6703296703296703
Luke Ridnour,ridnolu01,PG,24,SEA,2006,79,2625.0,910,550,47,188,235,123,22,162,178,334,799,0.4180225281602002,43,149,0.2885906040268456,291,650,0.4476923076923076,0.445,199,227,0.8766519823788547
Anthony Roberson,roberan02,PG,22,MEM,2006,16,88.0,35,5,0,6,6,1,0,3,6,14,31,0.4516129032258064,5,10,0.5,9,21,0.4285714285714285,0.532,2,2,1.0
Lawrence Roberts,roberla01,C,23,MEM,2006,33,181.0,51,5,26,23,49,8,2,5,30,20,44,0.4545454545454545,0,2,0.0,20,42,0.4761904761904761,0.455,11,23,0.4782608695652174
Bernard Robinson,robinbe01,SF,25,CHA,2006,66,1303.0,422,77,62,157,219,81,10,74,141,157,365,0.4301369863013699,2,21,0.0952380952380952,155,344,0.4505813953488372,0.433,106,134,0.7910447761194029
Clifford Robinson,robincl02,PF,39,NJN,2006,80,1863.0,550,89,55,212,267,44,40,62,206,219,513,0.4269005847953216,60,175,0.3428571428571428,159,338,0.4704142011834319,0.485,52,79,0.6582278481012658
Nate Robinson,robinna01,PG,21,NYK,2006,72,1544.0,670,147,56,111,167,59,1,114,201,230,565,0.4070796460176991,58,146,0.3972602739726027,172,419,0.4105011933174224,0.458,152,202,0.7524752475247525
Jalen Rose,roseja01,SF-SG,33,TOT,2006,72,1983.0,887,181,28,183,211,30,13,115,156,290,685,0.4233576642335766,59,172,0.3430232558139535,231,513,0.4502923976608187,0.466,248,318,0.779874213836478
Malik Rose,rosema01,PF,31,NYK,2006,72,1119.0,318,67,84,175,259,43,14,80,145,105,281,0.3736654804270463,1,1,1.0,104,280,0.3714285714285714,0.375,107,137,0.781021897810219
Quinton Ross,rossqu01,SF,24,LAC,2006,67,1515.0,317,79,38,132,170,51,16,47,155,130,308,0.422077922077922,0,7,0.0,130,301,0.4318936877076412,0.422,57,75,0.76
Michael Ruffin,ruffimi01,C,29,WAS,2006,76,1010.0,105,27,122,149,271,33,31,38,179,34,77,0.4415584415584415,0,2,0.0,34,75,0.4533333333333333,0.442,37,74,0.5
Kareem Rush,rushka01,SG,25,CHA,2006,47,1111.0,474,50,18,85,103,38,13,65,79,181,469,0.3859275053304904,57,164,0.3475609756097561,124,305,0.4065573770491803,0.447,55,77,0.7142857142857143
Bryon Russell,russebr01,SF,35,DEN,2006,1,3.0,0,1,0,1,1,0,0,0,0,0,0,0.0,0,0,0.0,0,0,0.0,0.0,0,0,0.0
John Salmons,salmojo01,SG,26,PHI,2006,82,2059.0,619,223,48,172,220,73,13,125,178,219,521,0.4203454894433781,26,87,0.2988505747126437,193,434,0.4447004608294931,0.445,155,200,0.775
Jamal Sampson,sampsja01,PF,22,SAC,2006,12,39.0,10,5,5,13,18,0,4,0,5,5,7,0.7142857142857143,0,0,0.0,5,7,0.7142857142857143,0.714,0,2,0.0
Melvin Sanders,sandeme01,SG,25,SAS,2006,16,113.0,41,3,4,19,23,5,0,8,20,16,33,0.4848484848484848,2,3,0.6666666666666666,14,30,0.4666666666666667,0.515,7,10,0.7
Brian Scalabrine,scalabr01,PF,27,BOS,2006,71,938.0,205,51,27,87,114,21,19,50,127,74,193,0.3834196891191709,31,87,0.3563218390804598,43,106,0.4056603773584906,0.464,26,36,0.7222222222222222
Alex Scales,scaleal01,SG,27,SAS,2006,1,0.0,0,0,0,0,0,0,0,0,0,0,0,0.0,0,0,0.0,0,0,0.0,0.0,0,0,0.0
Luke Schenscher,schenlu01,C,23,CHI,2006,20,149.0,36,7,8,21,29,1,3,5,21,16,26,0.6153846153846154,0,0,0.0,16,26,0.6153846153846154,0.615,4,13,0.3076923076923077
Ha Seung-Jin,seungha01,C,20,POR,2006,27,212.0,44,1,14,35,49,3,8,14,41,18,31,0.5806451612903226,0,0,0.0,18,31,0.5806451612903226,0.581,8,17,0.4705882352941176
Wayne Simien,simiewa01,PF,22,MIA,2006,43,414.0,146,7,38,50,88,13,1,24,70,58,120,0.4833333333333333,0,0,0.0,58,120,0.4833333333333333,0.483,30,34,0.8823529411764706
Bobby Simmons,simmobo01,SF,25,MIL,2006,75,2538.0,1002,172,91,242,333,86,21,123,254,366,808,0.452970297029703,105,250,0.42,261,558,0.4677419354838709,0.518,165,200,0.825
James Singleton,singlja01,SF,24,LAC,2006,59,753.0,203,29,63,134,197,19,21,28,95,77,151,0.5099337748344371,10,20,0.5,67,131,0.5114503816793893,0.543,39,50,0.78
Brian Skinner,skinnbr01,PF-C,29,TOT,2006,65,944.0,191,30,76,152,228,25,43,45,119,82,160,0.5125,0,0,0.0,82,160,0.5125,0.513,27,56,0.4821428571428571
Charles Smith,smithch04,SG,30,TOT,2006,22,210.0,80,9,3,13,16,5,6,4,28,30,72,0.4166666666666667,15,38,0.3947368421052631,15,34,0.4411764705882353,0.521,5,8,0.625
Donta Smith,smithdo04,SG,22,ATL,2006,23,127.0,38,9,3,11,14,8,0,4,20,15,27,0.5555555555555556,2,4,0.5,13,23,0.5652173913043478,0.593,6,12,0.5
J.R. Smith,smithjr01,SG,20,NOK,2006,55,989.0,423,58,19,91,110,37,4,54,90,144,366,0.3934426229508196,52,140,0.3714285714285714,92,226,0.4070796460176991,0.464,83,101,0.8217821782178217
Joe Smith,smithjo02,PF,30,MIL,2006,44,887.0,379,31,83,147,230,24,13,40,120,145,305,0.4754098360655737,0,2,0.0,145,303,0.4785478547854785,0.475,89,115,0.7739130434782608
Josh Smith,smithjo03,SF,20,ATL,2006,80,2559.0,902,191,176,355,531,64,208,162,260,329,774,0.4250645994832041,34,110,0.3090909090909091,295,664,0.4442771084337349,0.447,210,292,0.7191780821917808
Eric Snow,snower01,PG,32,CLE,2006,82,2351.0,391,346,38,160,198,76,19,116,218,163,399,0.4085213032581453,1,10,0.1,162,389,0.416452442159383,0.41,64,93,0.6881720430107527
Kirk Snyder,snydeki01,SG,22,NOK,2006,68,1310.0,542,102,55,106,161,29,23,70,106,205,453,0.4525386313465783,46,129,0.3565891472868217,159,324,0.4907407407407407,0.503,86,117,0.7350427350427351
Darius Songaila,songada01,PF,27,CHI,2006,62,1329.0,568,88,76,170,246,35,16,85,157,236,491,0.4806517311608961,2,5,0.4,234,486,0.4814814814814814,0.483,94,115,0.8173913043478261
Pape Sow,sowpa01,C,24,TOR,2006,42,590.0,147,8,54,92,146,21,19,30,118,53,123,0.4308943089430894,0,0,0.0,53,123,0.4308943089430894,0.431,41,57,0.7192982456140351
Jerry Stackhouse,stackje01,SG,31,DAL,2006,55,1525.0,715,160,32,121,153,37,10,121,96,242,603,0.4013266998341625,36,130,0.2769230769230769,206,473,0.4355179704016913,0.431,195,221,0.8823529411764706
DeShawn Stevenson,stevede01,SG,24,ORL,2006,82,2648.0,900,160,59,182,241,58,17,123,178,359,781,0.4596670934699103,2,15,0.1333333333333333,357,766,0.4660574412532637,0.461,180,242,0.743801652892562
Peja Stojaković,stojape01,SF,28,TOT,2006,71,2601.0,1290,136,79,336,415,45,10,103,171,445,1018,0.43713163064833,162,404,0.400990099009901,283,614,0.4609120521172638,0.517,238,260,0.9153846153846154
Awvee Storey,storeaw01,SF,28,WAS,2006,25,116.0,43,4,8,14,22,3,1,5,22,16,41,0.3902439024390244,3,7,0.4285714285714285,13,34,0.3823529411764705,0.427,8,14,0.5714285714285714
Damon Stoudamire,stoudda01,PG,32,MEM,2006,27,862.0,317,128,23,72,95,19,1,55,49,114,287,0.397212543554007,36,104,0.3461538461538461,78,183,0.4262295081967213,0.46,53,62,0.8548387096774194
Salim Stoudamire,stoudsa01,SG,23,ATL,2006,61,1236.0,589,75,12,104,116,27,3,82,118,204,492,0.4146341463414634,82,216,0.3796296296296296,122,276,0.4420289855072464,0.498,99,110,0.9
Amar'e Stoudemire,stoudam01,C,23,PHO,2006,3,50.0,26,2,6,10,16,1,3,1,4,9,27,0.3333333333333333,0,1,0.0,9,26,0.3461538461538461,0.333,8,9,0.8888888888888888
Mike Sweetney,sweetmi01,C,23,CHI,2006,66,1222.0,533,59,118,232,350,19,56,95,209,200,444,0.4504504504504504,0,0,0.0,200,444,0.4504504504504504,0.45,133,204,0.6519607843137255
Robert Swift,swiftro01,C,20,SEA,2006,47,987.0,301,8,94,170,264,15,56,49,142,124,241,0.5145228215767634,0,0,0.0,124,241,0.5145228215767634,0.515,53,91,0.5824175824175825
Stromile Swift,swiftst01,C,26,HOU,2006,66,1344.0,586,25,103,188,291,38,50,91,198,225,458,0.4912663755458515,0,2,0.0,225,456,0.4934210526315789,0.491,136,209,0.6507177033492823
Wally Szczerbiak,szczewa02,SF,28,TOT,2006,72,2729.0,1366,213,77,236,313,40,19,136,150,493,1012,0.4871541501976285,102,255,0.4,391,757,0.5165125495376486,0.538,278,310,0.896774193548387
Chris Taft,taftch01,C,20,GSW,2006,17,144.0,47,2,19,17,36,2,7,2,25,23,38,0.6052631578947368,0,0,0.0,23,38,0.6052631578947368,0.605,1,6,0.1666666666666666
Donell Taylor,taylodo01,SG,23,WAS,2006,51,465.0,140,45,16,37,53,30,4,34,47,53,136,0.3897058823529412,4,17,0.2352941176470588,49,119,0.4117647058823529,0.404,30,43,0.6976744186046512
Maurice Taylor,tayloma01,PF,29,NYK,2006,67,1210.0,422,53,65,164,229,21,14,103,177,182,389,0.467866323907455,0,1,0.0,182,388,0.4690721649484536,0.468,58,83,0.6987951807228916
Sebastian Telfair,telfase01,PG,20,POR,2006,68,1641.0,643,247,19,101,120,66,6,115,167,228,578,0.3944636678200692,57,162,0.3518518518518518,171,416,0.4110576923076923,0.444,130,175,0.7428571428571429
Jason Terry,terryja01,PG,28,DAL,2006,80,2798.0,1371,306,31,127,158,100,27,135,196,516,1099,0.4695177434030937,171,416,0.4110576923076923,345,683,0.5051244509516838,0.547,168,210,0.8
Billy Thomas,thomabi01,SG,30,WAS,2006,17,131.0,38,9,5,9,14,10,1,6,19,13,40,0.325,10,30,0.3333333333333333,3,10,0.3,0.45,2,2,1.0
Etan Thomas,thomaet01,C,27,WAS,2006,71,1121.0,337,14,99,180,279,20,68,51,148,131,246,0.532520325203252,0,0,0.0,131,246,0.532520325203252,0.533,75,125,0.6
James Thomas,thomaja02,PF,25,TOT,2006,22,150.0,28,1,12,27,39,0,3,7,35,10,19,0.5263157894736842,0,0,0.0,10,19,0.5263157894736842,0.526,8,14,0.5714285714285714
John Thomas,thomajo02,C,30,TOT,2006,16,127.0,15,2,10,10,20,3,2,8,17,6,15,0.4,0,0,0.0,6,15,0.4,0.4,3,4,0.75
Kenny Thomas,thomake01,PF,28,SAC,2006,82,2293.0,748,168,199,419,618,72,39,135,196,305,604,0.5049668874172185,0,1,0.0,305,603,0.5058043117744611,0.505,138,204,0.6764705882352942
Kurt Thomas,thomaku01,C,33,PHO,2006,53,1411.0,455,57,102,313,415,23,54,57,193,190,391,0.4859335038363171,0,0,0.0,190,391,0.4859335038363171,0.486,75,92,0.8152173913043478
Tim Thomas,thomati01,PF-SF,28,TOT,2006,29,666.0,300,20,22,109,131,16,7,33,78,113,262,0.4312977099236641,46,111,0.4144144144144144,67,151,0.4437086092715231,0.519,28,42,0.6666666666666666
Dijon Thompson,thompdi01,SG,22,PHO,2006,10,43.0,28,1,4,7,11,3,1,2,6,11,25,0.44,4,11,0.3636363636363636,7,14,0.5,0.52,2,2,1.0
Jamaal Tinsley,tinslja01,PG,27,IND,2006,42,1122.0,390,211,35,98,133,49,6,109,96,158,386,0.4093264248704663,16,70,0.2285714285714285,142,316,0.4493670886075949,0.43,58,91,0.6373626373626373
Jake Tsakalidis,tsakaja01,C,26,MEM,2006,51,732.0,257,13,78,134,212,14,32,39,107,100,165,0.6060606060606061,0,0,0.0,100,165,0.6060606060606061,0.606,57,87,0.6551724137931034
Nikoloz Tskitishvili,tskitni01,SF-PF,22,TOT,2006,17,99.0,36,3,9,13,22,1,2,6,8,13,37,0.3513513513513513,1,3,0.3333333333333333,12,34,0.3529411764705882,0.365,9,14,0.6428571428571429
Ronny Turiaf,turiaro01,C,23,LAL,2006,23,161.0,45,8,11,26,37,3,10,7,30,15,30,0.5,0,0,0.0,15,30,0.5,0.5,15,27,0.5555555555555556
Hedo Türkoğlu,turkohe01,SF,26,ORL,2006,78,2615.0,1165,216,70,263,333,70,21,130,234,398,877,0.4538198403648802,114,283,0.4028268551236749,284,594,0.4781144781144781,0.519,255,296,0.8614864864864865
Ime Udoka,udokaim01,SF,28,NYK,2006,8,114.0,22,6,3,14,17,1,0,2,8,9,24,0.375,1,3,0.3333333333333333,8,21,0.3809523809523809,0.396,3,6,0.5
Beno Udrih,udrihbe01,PG,23,SAS,2006,54,586.0,275,92,18,34,52,14,2,53,55,106,233,0.4549356223175965,24,70,0.3428571428571428,82,163,0.5030674846625767,0.506,39,50,0.78
Nick Van Exel,vanexni01,PG,34,SAS,2006,65,986.0,355,123,6,85,91,16,3,57,60,136,343,0.3965014577259475,55,154,0.3571428571428571,81,189,0.4285714285714285,0.477,28,41,0.6829268292682927
Keith Van Horn,vanhoke01,SF,30,DAL,2006,53,1090.0,472,37,54,138,192,31,11,71,121,164,387,0.4237726098191214,50,136,0.3676470588235294,114,251,0.4541832669322709,0.488,94,113,0.831858407079646
Anderson Varejão,varejan01,C,23,CLE,2006,48,760.0,219,19,77,158,235,31,19,27,118,79,150,0.5266666666666666,0,1,0.0,79,149,0.5302013422818792,0.527,61,119,0.5126050420168067
Jacque Vaughn,vaughja01,SG,30,NJN,2006,80,1234.0,274,123,16,75,91,42,1,52,140,107,245,0.436734693877551,1,6,0.1666666666666666,106,239,0.4435146443514644,0.439,59,81,0.7283950617283951
Charlie Villanueva,villach01,PF,21,TOR,2006,81,2361.0,1053,88,181,340,521,60,63,99,247,435,940,0.4627659574468085,70,214,0.3271028037383177,365,726,0.5027548209366391,0.5,113,160,0.70625
Jake Voskuhl,voskuja01,C,28,CHA,2006,51,818.0,270,39,62,121,183,26,23,33,157,114,261,0.4367816091954023,1,3,0.3333333333333333,113,258,0.437984496124031,0.439,41,60,0.6833333333333333
Jackson Vroman,vromaja01,PF,24,NOK,2006,41,406.0,73,11,33,53,86,12,11,21,78,26,66,0.3939393939393939,0,0,0.0,26,66,0.3939393939393939,0.394,21,44,0.4772727272727273
Sasha Vujačić,vujacsa01,PG,21,LAL,2006,82,1449.0,321,139,33,126,159,48,3,50,150,108,312,0.3461538461538461,59,172,0.3430232558139535,49,140,0.35,0.441,46,52,0.8846153846153846
Dwyane Wade,wadedw01,SG,24,MIA,2006,75,2892.0,2040,503,107,323,430,146,58,268,217,699,1413,0.494692144373673,13,76,0.1710526315789473,686,1337,0.5130890052356021,0.499,629,803,0.7833125778331258
Von Wafer,wafervo01,SG,20,LAL,2006,16,73.0,20,4,5,3,8,3,0,1,12,6,38,0.1578947368421052,2,17,0.1176470588235294,4,21,0.1904761904761904,0.184,6,8,0.75
Antoine Walker,walkean02,PF,29,MIA,2006,82,2199.0,1000,166,103,318,421,47,30,150,187,391,898,0.4354120267260579,137,383,0.3577023498694517,254,515,0.4932038834951456,0.512,81,129,0.627906976744186
Samaki Walker,walkesa01,PF,29,IND,2006,7,22.0,2,0,0,3,3,0,1,2,7,0,2,0.0,0,0,0.0,0,2,0.0,0.0,2,2,1.0
Ben Wallace,wallabe01,C,31,DET,2006,82,2890.0,597,158,301,622,923,146,181,88,164,237,465,0.5096774193548387,0,4,0.0,237,461,0.5140997830802603,0.51,123,296,0.4155405405405405
Gerald Wallace,wallage01,SF,23,CHA,2006,55,1895.0,836,96,123,289,412,138,115,99,150,317,589,0.5382003395585738,14,50,0.28,303,539,0.562152133580705,0.55,188,306,0.6143790849673203
Rasheed Wallace,wallara01,PF,31,DET,2006,80,2780.0,1209,182,90,457,547,82,130,85,232,459,1067,0.4301780693533271,155,434,0.3571428571428571,304,633,0.4802527646129542,0.503,136,183,0.7431693989071039
Matt Walsh,walshma01,SG,23,MIA,2006,2,3.0,2,0,0,0,0,0,0,1,0,1,1,1.0,0,0,0.0,1,1,1.0,1.0,0,2,0.0
Luke Walton,waltolu01,SF,25,LAL,2006,69,1333.0,345,156,88,159,247,41,15,78,119,135,328,0.4115853658536585,18,55,0.3272727272727272,117,273,0.4285714285714285,0.439,57,76,0.75
Hakim Warrick,warriha01,PF,23,MEM,2006,68,724.0,278,30,43,101,144,14,21,56,113,101,228,0.4429824561403508,0,0,0.0,101,228,0.4429824561403508,0.443,76,115,0.6608695652173913
Earl Watson,watsoea01,PG,26,TOT,2006,70,1578.0,623,289,24,134,158,68,10,136,159,219,509,0.4302554027504912,110,272,0.4044117647058823,109,237,0.459915611814346,0.538,75,111,0.6756756756756757
Chris Webber,webbech01,PF,32,PHI,2006,75,2893.0,1518,256,184,557,741,103,62,182,219,617,1422,0.4338959212376934,21,77,0.2727272727272727,596,1345,0.4431226765799256,0.441,263,348,0.7557471264367817
Martell Webster,webstma02,SF,19,POR,2006,61,1070.0,404,34,29,101,130,21,14,43,90,139,348,0.3994252873563218,65,182,0.3571428571428571,74,166,0.4457831325301205,0.493,61,71,0.8591549295774648
Bonzi Wells,wellsbo01,SG,29,SAC,2006,52,1684.0,707,144,142,259,401,94,25,126,156,284,613,0.4632952691680261,10,45,0.2222222222222222,274,568,0.4823943661971831,0.471,129,190,0.6789473684210526
Jiří Welsch,welscji01,SF,26,MIL,2006,58,866.0,251,62,22,89,111,34,1,41,65,86,222,0.3873873873873873,14,49,0.2857142857142857,72,173,0.4161849710982659,0.419,65,87,0.7471264367816092
David Wesley,wesleda01,SG,35,HOU,2006,71,2372.0,702,204,24,154,178,59,6,120,212,226,561,0.4028520499108734,99,271,0.3653136531365313,127,290,0.4379310344827586,0.491,151,187,0.8074866310160428
David West,westda01,PF,25,NOK,2006,74,2526.0,1262,92,168,380,548,61,64,105,214,530,1036,0.5115830115830116,3,11,0.2727272727272727,527,1025,0.5141463414634146,0.513,199,236,0.8432203389830508
Delonte West,westde01,PG,22,BOS,2006,71,2418.0,836,329,57,232,289,84,46,133,197,333,684,0.4868421052631579,84,218,0.3853211009174312,249,466,0.5343347639484979,0.548,86,101,0.8514851485148515
Robert Whaley,whalero01,C,23,UTA,2006,23,212.0,49,17,16,27,43,7,8,14,41,23,57,0.4035087719298245,0,0,0.0,23,57,0.4035087719298245,0.404,3,6,0.5
Chris Wilcox,wilcoch01,C-PF,23,TOT,2006,77,1529.0,626,52,118,292,410,33,34,72,183,257,450,0.5711111111111111,0,2,0.0,257,448,0.5736607142857143,0.571,112,153,0.7320261437908496
Damien Wilkins,wilkida02,SF,26,SEA,2006,82,1525.0,536,107,79,113,192,72,12,85,144,193,435,0.4436781609195402,14,56,0.25,179,379,0.4722955145118733,0.46,136,162,0.8395061728395061
Mike Wilks,wilksmi01,PG,26,TOT,2006,47,348.0,86,32,9,30,39,14,1,24,34,29,90,0.3222222222222222,3,19,0.1578947368421052,26,71,0.3661971830985915,0.339,25,41,0.6097560975609756
Aaron Williams,williaa01,C,34,TOT,2006,48,791.0,222,17,64,117,181,17,21,30,138,91,176,0.5170454545454546,0,0,0.0,91,176,0.5170454545454546,0.517,40,58,0.6896551724137931
Alvin Williams,willial02,PG,31,TOR,2006,1,10.0,1,0,0,3,3,0,0,0,0,0,3,0.0,0,2,0.0,0,1,0.0,0.0,1,2,0.5
Deron Williams,willide01,PG,21,UTA,2006,80,2307.0,864,359,35,159,194,60,17,145,233,339,805,0.4211180124223602,91,219,0.4155251141552511,248,586,0.4232081911262799,0.478,95,135,0.7037037037037037
Eric Williams,willier01,SF,33,TOR,2006,28,352.0,91,15,10,40,50,7,2,15,55,29,75,0.3866666666666666,5,18,0.2777777777777778,24,57,0.4210526315789473,0.42,28,38,0.7368421052631579
Jason Williams,willija02,PG,30,MIA,2006,59,1874.0,728,287,6,133,139,53,5,100,101,268,606,0.4422442244224422,107,288,0.3715277777777778,161,318,0.5062893081761006,0.531,85,98,0.8673469387755102
Lou Williams,willilo02,PG,19,PHI,2006,30,145.0,56,10,3,16,19,5,0,13,13,23,52,0.4423076923076923,2,9,0.2222222222222222,21,43,0.4883720930232558,0.462,8,13,0.6153846153846154
Marvin Williams,willima02,PF,19,ATL,2006,79,1952.0,672,63,122,261,383,48,24,83,227,235,531,0.4425612052730697,13,53,0.2452830188679245,222,478,0.4644351464435146,0.455,189,253,0.7470355731225297
Mo Williams,willima01,PG,23,MIL,2006,58,1531.0,703,230,30,113,143,52,7,105,146,267,629,0.424483306836248,73,191,0.3821989528795811,194,438,0.4429223744292237,0.483,96,113,0.8495575221238938
Corliss Williamson,willico02,SF,32,SAC,2006,37,362.0,126,14,21,46,67,7,4,30,56,43,103,0.4174757281553398,2,2,1.0,41,101,0.4059405940594059,0.427,38,49,0.7755102040816326
Loren Woods,woodslo01,C,27,TOR,2006,27,324.0,62,4,44,66,110,9,23,16,49,28,59,0.4745762711864407,0,1,0.0,28,58,0.4827586206896552,0.475,6,14,0.4285714285714285
Qyntel Woods,woodsqy01,SF,24,NYK,2006,49,1013.0,329,47,44,146,190,32,13,61,96,129,254,0.5078740157480315,22,60,0.3666666666666666,107,194,0.5515463917525774,0.551,49,76,0.6447368421052632
Metta World Peace,artesro01,SF,26,TOT,2006,56,2207.0,984,203,75,211,286,122,41,131,164,350,867,0.4036908881199538,78,253,0.308300395256917,272,614,0.4429967426710097,0.449,206,305,0.6754098360655738
Antoine Wright,wrighan01,SG,21,NJN,2006,39,370.0,70,12,8,22,30,4,3,21,42,29,81,0.3580246913580246,1,15,0.0666666666666666,28,66,0.4242424242424242,0.364,11,22,0.5
Bracey Wright,wrighbr02,SG,21,MIN,2006,7,135.0,62,5,3,15,18,1,0,8,8,21,51,0.4117647058823529,6,17,0.3529411764705882,15,34,0.4411764705882353,0.471,14,16,0.875
Dorell Wright,wrighdo01,SF,20,MIA,2006,20,132.0,58,8,2,30,32,3,1,14,12,20,43,0.4651162790697674,3,6,0.5,17,37,0.4594594594594595,0.5,15,17,0.8823529411764706
Lorenzen Wright,wrighlo02,C,30,MEM,2006,78,1689.0,454,48,142,253,395,52,46,67,201,194,406,0.4778325123152709,0,2,0.0,194,404,0.4801980198019802,0.478,66,117,0.5641025641025641
Derrick Zimmerman,zimmede01,PG,24,NJN,2006,2,32.0,4,7,1,3,4,0,0,4,4,2,3,0.6666666666666666,0,0,0.0,2,3,0.6666666666666666,0.667,0,0,0.0
Shareef Abdur-Rahim,abdursh01,C,30,SAC,2007,80,2015.0,793,109,122,276,398,53,40,116,243,310,654,0.4740061162079511,3,20,0.15,307,634,0.4842271293375394,0.476,170,234,0.7264957264957265
Hassan Adams,adamsha01,SG,22,NJN,2007,61,495.0,174,13,35,42,77,17,4,22,47,75,135,0.5555555555555556,0,1,0.0,75,134,0.5597014925373134,0.556,24,36,0.6666666666666666
Maurice Ager,agerma01,SG,22,DAL,2007,32,214.0,69,7,1,20,21,4,3,15,27,22,70,0.3142857142857143,5,15,0.3333333333333333,17,55,0.3090909090909091,0.35,20,33,0.6060606060606061
LaMarcus Aldridge,aldrila01,C,21,POR,2007,63,1392.0,565,24,144,168,312,22,73,43,186,241,479,0.5031315240083507,0,2,0.0,241,477,0.5052410901467506,0.503,83,115,0.7217391304347827
Malik Allen,allenma01,PF,28,CHI,2007,60,638.0,242,16,42,77,119,17,16,21,85,107,258,0.4147286821705426,0,1,0.0,107,257,0.4163424124513619,0.415,28,34,0.8235294117647058
Ray Allen,allenra02,SG,31,SEA,2007,55,2219.0,1454,228,57,190,247,82,11,154,113,505,1153,0.437987857762359,165,443,0.3724604966139955,340,710,0.4788732394366197,0.51,279,309,0.9029126213592232
Tony Allen,allento01,SG,25,BOS,2007,33,805.0,379,56,35,89,124,49,12,75,87,133,259,0.5135135135135135,8,33,0.2424242424242424,125,226,0.5530973451327433,0.529,105,134,0.7835820895522388
Rafer Alston,alstora01,PG,30,HOU,2007,82,3040.0,1088,444,29,253,282,129,10,170,195,383,1020,0.3754901960784313,192,529,0.3629489603024575,191,491,0.3890020366598778,0.47,130,177,0.7344632768361582
Lou Amundson,amundlo01,PF,24,TOT,2007,11,89.0,16,1,13,15,28,1,8,5,15,6,15,0.4,0,0,0.0,6,15,0.4,0.4,4,10,0.4
Alan Anderson,anderal01,SG,24,CHA,2007,17,256.0,98,21,11,21,32,7,0,22,33,37,81,0.4567901234567901,5,20,0.25,32,61,0.5245901639344263,0.488,19,23,0.8260869565217391
Derek Anderson,anderde01,SF,32,CHA,2007,50,1190.0,399,133,29,84,113,52,7,56,115,126,294,0.4285714285714285,54,152,0.3552631578947368,72,142,0.5070422535211268,0.52,93,106,0.8773584905660378
Carmelo Anthony,anthoca01,SF,22,DEN,2007,65,2486.0,1881,249,143,248,391,77,23,234,203,691,1453,0.4755677907777013,40,149,0.2684563758389262,651,1304,0.4992331288343558,0.489,459,568,0.8080985915492958
Rafael Araújo,araujra01,C,26,UTA,2007,28,248.0,72,10,22,44,66,6,2,17,39,27,65,0.4153846153846154,0,0,0.0,27,65,0.4153846153846154,0.415,18,29,0.6206896551724138
Gilbert Arenas,arenagi01,PG,25,WAS,2007,74,2942.0,2105,443,61,277,338,139,13,236,249,647,1548,0.4179586563307493,205,584,0.351027397260274,442,964,0.45850622406639,0.484,606,718,0.8440111420612814
Trevor Ariza,arizatr01,SG,21,ORL,2007,57,1278.0,506,65,98,151,249,59,19,84,134,200,371,0.5390835579514824,0,7,0.0,200,364,0.5494505494505495,0.539,106,171,0.6198830409356725
Darrell Armstrong,armstda01,PG,38,IND,2007,81,1275.0,457,191,34,101,135,70,6,76,102,156,377,0.4137931034482758,72,214,0.3364485981308411,84,163,0.5153374233128835,0.509,73,93,0.7849462365591398
Hilton Armstrong,armsthi01,C,22,NOK,2007,56,634.0,176,10,58,91,149,12,26,35,79,68,125,0.544,0,0,0.0,68,125,0.544,0.544,40,67,0.5970149253731343
Carlos Arroyo,arroyca01,PG,27,ORL,2007,72,1304.0,552,202,31,103,134,39,2,90,131,203,478,0.4246861924686193,14,51,0.2745098039215686,189,427,0.4426229508196721,0.439,132,166,0.7951807228915663
Chucky Atkins,atkinch01,PG,32,MEM,2007,75,2064.0,988,346,18,121,139,50,4,127,136,310,715,0.4335664335664335,116,306,0.3790849673202614,194,409,0.4743276283618582,0.515,252,311,0.8102893890675241
James Augustine,augusja01,PF,22,ORL,2007,2,7.0,2,2,1,2,3,0,0,0,2,1,3,0.3333333333333333,0,0,0.0,1,3,0.3333333333333333,0.333,0,0,0.0
Kelenna Azubuike,azubuke01,SG,23,GSW,2007,41,669.0,291,28,26,68,94,22,10,39,49,98,220,0.4454545454545454,34,79,0.430379746835443,64,141,0.4539007092198581,0.523,61,78,0.782051282051282
Renaldo Balkman,balkmre01,SF,22,NYK,2007,68,1064.0,334,44,97,197,294,57,44,49,146,139,275,0.5054545454545455,5,27,0.1851851851851851,134,248,0.5403225806451613,0.515,51,90,0.5666666666666667
Marcus Banks,banksma01,PG,25,PHO,2007,45,503.0,221,60,10,28,38,23,3,40,70,84,196,0.4285714285714285,5,29,0.1724137931034483,79,167,0.4730538922155688,0.441,48,60,0.8
Leandro Barbosa,barbole01,SG,24,PHO,2007,80,2613.0,1444,317,22,192,214,96,15,146,210,529,1111,0.4761476147614761,190,438,0.4337899543378995,339,673,0.5037147102526003,0.562,196,232,0.8448275862068966
J.J. Barea,bareajo01,PG,22,DAL,2007,33,191.0,78,24,7,18,25,1,1,14,19,28,78,0.358974358974359,6,21,0.2857142857142857,22,57,0.3859649122807017,0.397,16,24,0.6666666666666666
Andrea Bargnani,bargnan01,PF,21,TOR,2007,65,1629.0,751,50,52,203,255,32,53,107,180,267,625,0.4272,100,268,0.373134328358209,167,357,0.4677871148459384,0.507,117,142,0.823943661971831
Matt Barnes,barnema02,PF,26,GSW,2007,76,1813.0,746,156,91,259,350,73,41,105,188,275,628,0.4378980891719745,106,290,0.3655172413793103,169,338,0.5,0.522,90,123,0.7317073170731707
Andre Barrett,barrean01,PG,24,CHI,2007,6,29.0,8,7,1,4,5,0,0,4,4,4,8,0.5,0,0,0.0,4,8,0.5,0.5,0,0,0.0
Earl Barron,barroea01,C,25,MIA,2007,28,203.0,65,5,19,22,41,6,4,11,21,24,83,0.2891566265060241,0,1,0.0,24,82,0.2926829268292683,0.289,17,18,0.9444444444444444
Brent Barry,barrybr01,SG,35,SAS,2007,75,1631.0,635,138,17,143,160,56,12,61,88,202,425,0.4752941176470588,128,287,0.445993031358885,74,138,0.5362318840579711,0.626,103,117,0.8803418803418803
Brandon Bass,bassbr01,PF,21,NOK,2007,21,162.0,42,3,13,30,43,2,3,10,16,15,44,0.3409090909090909,0,1,0.0,15,43,0.3488372093023256,0.341,12,16,0.75
Maceo Baston,bastoma01,PF,31,IND,2007,47,405.0,138,16,21,53,74,12,18,32,65,49,76,0.6447368421052632,3,7,0.4285714285714285,46,69,0.6666666666666666,0.664,37,47,0.7872340425531915
Esteban Batista,batises01,PF,23,ATL,2007,13,81.0,20,4,7,23,30,3,0,4,13,8,16,0.5,0,0,0.0,8,16,0.5,0.5,4,7,0.5714285714285714
Tony Battie,battito01,PF,30,ORL,2007,66,1575.0,404,35,92,252,344,29,30,61,185,176,360,0.4888888888888889,0,1,0.0,176,359,0.49025069637883,0.489,52,77,0.6753246753246753
Shane Battier,battish01,SF,28,HOU,2007,82,2988.0,829,175,67,271,338,79,60,72,190,292,654,0.4464831804281345,157,373,0.420911528150134,135,281,0.4804270462633452,0.567,88,113,0.7787610619469026
Charlie Bell,bellch01,SG,27,MIL,2007,82,2848.0,1110,247,57,181,238,97,4,104,213,426,974,0.4373716632443531,127,361,0.3518005540166205,299,613,0.4877650897226753,0.503,131,168,0.7797619047619048
Raja Bell,bellra01,SG,30,PHO,2007,78,2917.0,1143,196,48,203,251,50,22,83,233,410,950,0.431578947368421,205,496,0.4133064516129032,205,454,0.4515418502202643,0.539,118,152,0.7763157894736842
Mike Bibby,bibbymi01,PG,28,SAC,2007,82,2784.0,1403,388,39,224,263,88,6,197,139,471,1166,0.4039451114922813,173,481,0.3596673596673597,298,685,0.4350364963503649,0.478,288,347,0.829971181556196
Andris Biedriņš,biedran01,C,20,GSW,2007,82,2382.0,783,88,251,511,762,67,136,119,304,348,581,0.5989672977624785,0,0,0.0,348,581,0.5989672977624785,0.599,87,167,0.5209580838323353
Chauncey Billups,billuch01,PG,30,DET,2007,70,2533.0,1191,502,23,214,237,84,17,140,161,348,815,0.4269938650306748,109,316,0.3449367088607595,239,499,0.4789579158316633,0.494,386,437,0.8832951945080092
Steve Blake,blakest01,PG,26,TOT,2007,82,2225.0,528,408,21,148,169,61,8,129,121,209,509,0.4106090373280943,67,208,0.3221153846153846,142,301,0.4717607973421927,0.476,43,64,0.671875
Will Blalock,blalowi01,PG,23,DET,2007,14,166.0,25,17,6,9,15,5,0,12,9,9,30,0.3,1,5,0.2,8,25,0.32,0.317,6,6,1.0
Andray Blatche,blatcan01,PF,20,WAS,2007,56,682.0,206,39,77,114,191,17,32,49,94,86,197,0.4365482233502538,4,27,0.1481481481481481,82,170,0.4823529411764706,0.447,30,49,0.6122448979591837
Mark Blount,blounma01,C,31,MIN,2007,82,2544.0,1010,67,136,369,505,43,58,159,239,427,839,0.5089392133492253,9,31,0.2903225806451613,418,808,0.5173267326732673,0.514,147,195,0.7538461538461538
Keith Bogans,boganke01,SG,26,ORL,2007,59,990.0,298,59,16,77,93,28,2,46,98,99,245,0.4040816326530612,53,137,0.3868613138686131,46,108,0.4259259259259259,0.512,47,63,0.746031746031746
Andrew Bogut,bogutan01,C,22,MIL,2007,66,2258.0,809,198,168,416,584,49,35,150,216,348,629,0.5532591414944356,1,5,0.2,347,624,0.5560897435897436,0.554,112,194,0.5773195876288659
Matt Bonner,bonnema01,PF,26,SAS,2007,56,653.0,275,22,64,92,156,17,11,25,67,106,237,0.4472573839662447,36,94,0.3829787234042553,70,143,0.4895104895104895,0.523,27,38,0.7105263157894737
Josh Boone,boonejo01,PF,22,NJN,2007,61,669.0,254,10,64,112,176,11,21,33,94,99,171,0.5789473684210527,0,0,0.0,99,171,0.5789473684210527,0.579,56,103,0.5436893203883495
Calvin Booth,boothca01,C,30,WAS,2007,44,380.0,69,18,27,54,81,4,29,9,71,31,66,0.4696969696969697,1,2,0.5,30,64,0.46875,0.477,6,10,0.6
Carlos Boozer,boozeca01,PF,25,UTA,2007,74,2557.0,1549,221,235,632,867,70,21,194,217,647,1154,0.5606585788561526,0,0,0.0,647,1154,0.5606585788561526,0.561,255,372,0.6854838709677419
Chris Bosh,boshch01,C,22,TOR,2007,69,2658.0,1561,175,186,555,741,39,90,179,163,543,1094,0.4963436928702011,12,35,0.3428571428571428,531,1059,0.5014164305949008,0.502,463,590,0.7847457627118644
Bruce Bowen,bowenbr01,SF,35,SAS,2007,82,2464.0,510,117,23,200,223,62,25,65,175,189,467,0.4047109207708779,89,232,0.3836206896551724,100,235,0.425531914893617,0.5,43,73,0.589041095890411
Earl Boykins,boykiea01,PG,30,TOT,2007,66,2031.0,961,291,49,90,139,56,2,120,92,323,769,0.4200260078023407,95,239,0.3974895397489539,228,530,0.430188679245283,0.482,220,245,0.8979591836734694
Cedric Bozeman,bozemce01,SG,23,ATL,2007,23,199.0,26,9,3,20,23,5,2,9,32,11,39,0.282051282051282,2,13,0.1538461538461538,9,26,0.3461538461538461,0.308,2,6,0.3333333333333333
Elton Brand,brandel01,PF,27,LAC,2007,80,3077.0,1642,235,268,476,744,77,179,202,238,645,1211,0.532617671345995,1,1,1.0,644,1210,0.5322314049586777,0.533,351,461,0.7613882863340564
Ronnie Brewer,brewero02,SG,21,UTA,2007,56,675.0,260,24,37,38,75,37,6,24,44,102,193,0.5284974093264249,0,9,0.0,102,184,0.5543478260869565,0.528,56,83,0.6746987951807228
Primož Brezec,brezepr01,C,27,CHA,2007,58,838.0,288,23,80,104,184,11,23,38,161,122,274,0.4452554744525547,1,3,0.3333333333333333,121,271,0.4464944649446494,0.447,43,68,0.6323529411764706
Andre Brown,brownan01,PF,25,SEA,2007,38,271.0,93,2,26,48,74,6,4,29,26,42,74,0.5675675675675675,0,1,0.0,42,73,0.5753424657534246,0.568,9,15,0.6
Dee Brown,brownde03,PG,22,UTA,2007,49,450.0,94,83,8,32,40,22,7,31,51,32,98,0.3265306122448979,6,28,0.2142857142857142,26,70,0.3714285714285714,0.357,24,37,0.6486486486486487
Devin Brown,brownde02,SG,28,NOK,2007,58,1662.0,670,149,55,196,251,44,9,91,139,233,555,0.4198198198198198,81,227,0.3568281938325991,152,328,0.4634146341463415,0.493,123,155,0.7935483870967742
Kwame Brown,brownkw01,C,24,LAL,2007,41,1132.0,345,75,81,163,244,39,49,76,124,143,242,0.5909090909090909,0,1,0.0,143,241,0.5933609958506224,0.591,59,134,0.4402985074626865
P.J. Brown,brownpj01,PF,37,CHI,2007,72,1456.0,436,48,129,218,347,24,52,85,187,170,418,0.4066985645933014,0,2,0.0,170,416,0.4086538461538461,0.407,96,122,0.7868852459016393
Shannon Brown,brownsh01,SG,21,CLE,2007,23,202.0,73,10,6,15,21,7,3,14,24,28,74,0.3783783783783784,7,25,0.28,21,49,0.4285714285714285,0.426,10,14,0.7142857142857143
Kobe Bryant,bryanko01,SG,28,LAL,2007,77,3140.0,2430,413,75,364,439,111,36,255,205,813,1757,0.462720546385885,137,398,0.3442211055276382,676,1359,0.4974245768947756,0.502,667,768,0.8684895833333334
Greg Buckner,buckngr01,SG,30,DAL,2007,76,1372.0,305,70,35,123,158,47,7,40,152,123,299,0.411371237458194,32,103,0.3106796116504854,91,196,0.4642857142857143,0.465,27,34,0.7941176470588235
Pat Burke,burkepa01,C,33,PHO,2007,23,164.0,60,5,12,35,47,3,2,7,19,23,65,0.3538461538461538,6,22,0.2727272727272727,17,43,0.3953488372093023,0.4,8,13,0.6153846153846154
Caron Butler,butleca01,SF,26,WAS,2007,63,2474.0,1203,233,147,320,467,134,17,181,188,451,975,0.4625641025641026,18,72,0.25,433,903,0.4795127353266888,0.472,283,328,0.8628048780487805
Jackie Butler,butleja01,C,21,SAS,2007,11,103.0,41,5,6,16,22,2,0,10,16,16,35,0.4571428571428571,0,0,0.0,16,35,0.4571428571428571,0.457,9,10,0.9
Rasual Butler,butlera01,SF,27,NOK,2007,81,2223.0,818,63,42,214,256,40,54,67,148,314,788,0.398477157360406,134,363,0.3691460055096419,180,425,0.4235294117647059,0.484,56,87,0.6436781609195402
Andrew Bynum,bynuman01,C,19,LAL,2007,82,1793.0,637,94,139,345,484,12,128,115,249,247,443,0.5575620767494357,0,3,0.0,247,440,0.5613636363636364,0.558,143,214,0.6682242990654206
José Calderón,caldejo01,PG,25,TOR,2007,77,1614.0,668,387,21,113,134,63,5,110,136,263,505,0.5207920792079208,25,75,0.3333333333333333,238,430,0.5534883720930233,0.546,117,143,0.8181818181818182
Marcus Camby,cambyma01,C,32,DEN,2007,70,2369.0,785,223,164,652,816,87,231,122,183,312,659,0.4734446130500758,0,2,0.0,312,657,0.4748858447488584,0.473,161,221,0.7285067873303167
Brian Cardinal,cardibr01,PF,29,MEM,2007,28,313.0,127,31,13,46,59,22,1,23,42,42,85,0.4941176470588235,18,44,0.4090909090909091,24,41,0.5853658536585366,0.6,25,27,0.925925925925926
Rodney Carney,carnero01,SF,22,PHI,2007,67,1169.0,442,26,39,89,128,38,23,43,118,182,392,0.4642857142857143,25,72,0.3472222222222222,157,320,0.490625,0.496,53,87,0.6091954022988506
Matt Carroll,carroma01,SG,26,CHA,2007,72,1878.0,869,91,35,172,207,53,9,73,176,285,658,0.4331306990881459,111,267,0.4157303370786517,174,391,0.4450127877237851,0.517,188,208,0.903846153846154
Anthony Carter,cartean01,PG,31,DEN,2007,2,37.0,6,11,0,3,3,0,1,6,4,3,8,0.375,0,2,0.0,3,6,0.5,0.375,0,0,0.0
Vince Carter,cartevi01,SG,30,NJN,2007,82,3126.0,2070,393,114,378,492,82,30,217,266,726,1598,0.4543178973717146,156,437,0.3569794050343249,570,1161,0.4909560723514212,0.503,462,576,0.8020833333333334
Sam Cassell,cassesa01,PG,37,LAC,2007,58,1407.0,714,270,27,140,167,28,8,101,126,261,625,0.4176,32,109,0.2935779816513761,229,516,0.4437984496124031,0.443,160,182,0.8791208791208791
Kelvin Cato,catoke01,C,32,NYK,2007,18,95.0,22,0,12,19,31,3,10,6,10,7,22,0.3181818181818182,0,0,0.0,7,22,0.3181818181818182,0.318,8,12,0.6666666666666666
Tyson Chandler,chandty01,C,24,NOK,2007,73,2525.0,690,66,320,584,904,37,129,126,244,292,468,0.6239316239316239,0,1,0.0,292,467,0.6252676659528907,0.624,106,201,0.527363184079602
Josh Childress,childjo01,SG,23,ATL,2007,55,2024.0,715,127,123,217,340,58,36,80,118,261,518,0.5038610038610039,26,77,0.3376623376623376,235,441,0.5328798185941043,0.529,167,210,0.7952380952380952
Doug Christie,chrisdo01,SG,36,LAC,2007,7,82.0,13,8,3,8,11,3,1,5,11,5,17,0.2941176470588235,1,6,0.1666666666666666,4,11,0.3636363636363636,0.324,2,3,0.6666666666666666
Speedy Claxton,claxtsp01,PG,28,ATL,2007,42,1054.0,221,185,12,69,81,72,4,75,131,91,278,0.3273381294964029,6,28,0.2142857142857142,85,250,0.34,0.338,33,60,0.55
Jarron Collins,collija03,C,28,UTA,2007,82,913.0,204,60,71,100,171,13,8,37,147,75,170,0.4411764705882353,0,0,0.0,75,170,0.4411764705882353,0.441,54,83,0.6506024096385542
Jason Collins,collija04,PF,28,NJN,2007,80,1844.0,169,46,90,226,316,40,38,73,273,55,151,0.3642384105960264,0,2,0.0,55,149,0.3691275167785235,0.364,59,127,0.4645669291338583
Mardy Collins,collima01,SF,22,NYK,2007,52,777.0,235,83,28,76,104,32,3,57,75,87,228,0.3815789473684211,13,47,0.2765957446808511,74,181,0.4088397790055249,0.41,48,82,0.5853658536585366
Nick Collison,collini01,C,26,SEA,2007,82,2378.0,790,82,229,437,666,48,66,123,289,318,636,0.5,0,2,0.0,318,634,0.501577287066246,0.5,154,199,0.7738693467336684
Will Conroy,conrowi01,PG-SG,24,TOT,2007,7,52.0,0,9,3,4,7,0,0,2,7,0,3,0.0,0,0,0.0,0,3,0.0,0.0,0,4,0.0
Brian Cook,cookbr01,PF,26,LAL,2007,65,1018.0,450,65,61,154,215,25,27,51,134,185,408,0.4534313725490196,46,115,0.4,139,293,0.4744027303754266,0.51,34,47,0.723404255319149
Jamal Crawford,crawfja01,SG,26,NYK,2007,59,2198.0,1039,259,44,145,189,57,8,162,114,354,886,0.3995485327313769,103,322,0.3198757763975155,251,564,0.4450354609929078,0.458,228,272,0.8382352941176471
Austin Croshere,croshau01,PF,31,DAL,2007,61,727.0,227,44,33,153,186,14,6,33,68,78,222,0.3513513513513513,26,91,0.2857142857142857,52,131,0.3969465648854962,0.41,45,52,0.8653846153846154
Eddy Curry,curryed01,C,24,NYK,2007,81,2849.0,1576,68,195,376,571,34,40,295,265,585,1016,0.5757874015748031,1,1,1.0,584,1015,0.5753694581280788,0.576,405,659,0.6145675265553869
Samuel Dalembert,dalemsa01,C,25,PHI,2007,82,2535.0,879,64,239,494,733,47,159,161,287,356,658,0.541033434650456,0,2,0.0,356,656,0.5426829268292683,0.541,167,224,0.7455357142857143
Erick Dampier,dampier01,C,31,DAL,2007,76,1915.0,537,44,217,349,566,24,82,107,239,209,334,0.625748502994012,0,0,0.0,209,334,0.625748502994012,0.626,119,191,0.6230366492146597
Antonio Daniels,daniean01,SG,31,WAS,2007,80,1761.0,571,290,18,133,151,39,9,69,79,172,389,0.442159383033419,19,63,0.3015873015873015,153,326,0.4693251533742331,0.467,208,250,0.832
Marquis Daniels,daniema01,SG,26,IND,2007,45,800.0,320,57,26,56,82,27,7,55,56,129,281,0.4590747330960854,6,26,0.2307692307692307,123,255,0.4823529411764706,0.47,56,80,0.7
Baron Davis,davisba01,PG,27,GSW,2007,63,2221.0,1264,509,51,225,276,135,29,193,181,452,1030,0.4388349514563107,85,280,0.3035714285714285,367,750,0.4893333333333333,0.48,275,369,0.7452574525745257
Dale Davis,davisda01,C,37,DET,2007,46,464.0,83,12,59,78,137,10,34,15,59,33,74,0.4459459459459459,0,0,0.0,33,74,0.4459459459459459,0.446,17,26,0.6538461538461539
Paul Davis,davispa01,C,22,LAC,2007,31,180.0,51,7,21,23,44,6,5,8,28,22,52,0.4230769230769231,0,0,0.0,22,52,0.4230769230769231,0.423,7,10,0.7
Ricky Davis,davisri01,SF,27,MIN,2007,81,3021.0,1374,385,54,261,315,80,23,210,189,506,1089,0.4646464646464646,123,310,0.3967741935483871,383,779,0.4916559691912708,0.521,239,285,0.8385964912280702
Carlos Delfino,delfica01,SG,24,DET,2007,82,1372.0,428,88,67,199,266,46,8,61,97,156,376,0.4148936170212766,46,138,0.3333333333333333,110,238,0.4621848739495798,0.476,70,89,0.7865168539325843
Luol Deng,denglu01,SF,21,CHI,2007,82,3071.0,1540,204,148,431,579,97,48,153,167,630,1218,0.5172413793103449,1,7,0.1428571428571428,629,1211,0.5194054500412882,0.518,279,359,0.7771587743732591
Boris Diaw,diawbo01,PF,24,PHO,2007,73,2268.0,709,352,91,226,317,28,38,154,177,306,569,0.5377855887521968,15,45,0.3333333333333333,291,524,0.5553435114503816,0.551,82,120,0.6833333333333333
Yakhouba Diawara,diawaya01,SG,24,DEN,2007,64,1177.0,284,55,27,83,110,30,7,37,132,100,292,0.3424657534246575,49,170,0.288235294117647,51,122,0.4180327868852459,0.426,35,53,0.660377358490566
Dan Dickau,dickada01,PG,28,POR,2007,50,444.0,166,70,7,36,43,14,1,27,55,54,151,0.3576158940397351,16,61,0.2622950819672131,38,90,0.4222222222222222,0.411,42,53,0.7924528301886793
Travis Diener,dienetr01,PG,24,ORL,2007,26,288.0,98,35,3,15,18,4,0,13,27,34,80,0.425,18,50,0.36,16,30,0.5333333333333333,0.538,12,15,0.8
Ike Diogu,dioguik01,PF,23,TOT,2007,59,760.0,366,25,75,128,203,8,26,67,122,127,266,0.4774436090225564,0,0,0.0,127,266,0.4774436090225564,0.477,112,140,0.8
DeSagana Diop,diopde01,C,25,DAL,2007,81,1480.0,190,30,166,272,438,40,113,63,244,71,151,0.4701986754966887,0,1,0.0,71,150,0.4733333333333333,0.47,48,86,0.5581395348837209
Juan Dixon,dixonju01,SG,28,TOT,2007,81,1926.0,778,123,27,131,158,76,9,101,177,299,703,0.4253200568990042,79,226,0.3495575221238938,220,477,0.4612159329140461,0.482,101,116,0.8706896551724138
Michael Doleac,doleami01,C,29,MIA,2007,56,698.0,200,22,44,111,155,18,15,30,96,82,175,0.4685714285714286,0,1,0.0,82,174,0.4712643678160919,0.469,36,41,0.8780487804878049
Keyon Dooling,doolike01,SG,26,ORL,2007,66,1435.0,521,112,22,64,86,52,15,72,125,188,458,0.4104803493449782,31,96,0.3229166666666667,157,362,0.4337016574585635,0.444,114,141,0.8085106382978723
Quincy Douby,doubyqu01,PG,22,SAC,2007,42,359.0,119,15,11,26,37,15,4,15,21,48,126,0.3809523809523809,12,50,0.24,36,76,0.4736842105263157,0.429,11,15,0.7333333333333333
Chris Duhon,duhonch01,PG,24,CHI,2007,78,1906.0,558,310,23,146,169,69,6,105,150,197,483,0.4078674948240166,88,245,0.3591836734693877,109,238,0.4579831932773109,0.499,76,101,0.7524752475247525
Tim Duncan,duncati01,C,30,SAS,2007,80,2726.0,1599,273,213,633,846,66,190,224,203,618,1131,0.5464190981432361,1,9,0.1111111111111111,617,1122,0.5499108734402852,0.547,362,568,0.6373239436619719
Mike Dunleavy,dunlemi02,SG-PF,26,TOT,2007,82,2580.0,1049,228,84,347,431,84,22,149,203,384,850,0.4517647058823529,70,224,0.3125,314,626,0.5015974440894568,0.493,211,269,0.7843866171003717
Ronald Dupree,duprero01,SF,26,DET,2007,19,94.0,25,5,5,12,17,5,1,3,12,11,31,0.3548387096774194,0,0,0.0,11,31,0.3548387096774194,0.355,3,9,0.3333333333333333
Monta Ellis,ellismo01,SG,21,GSW,2007,77,2638.0,1272,319,62,181,243,132,21,221,210,480,1010,0.4752475247524752,39,143,0.2727272727272727,441,867,0.5086505190311419,0.495,273,358,0.7625698324022346
Francisco Elson,elsonfr01,C,30,SAS,2007,70,1332.0,350,55,81,255,336,31,59,86,184,144,282,0.5106382978723404,0,2,0.0,144,280,0.5142857142857142,0.511,62,80,0.775
Melvin Ely,elyme01,PF-C,28,TOT,2007,30,309.0,89,18,15,38,53,6,8,28,51,29,80,0.3625,0,0,0.0,29,80,0.3625,0.363,31,47,0.6595744680851063
Maurice Evans,evansma01,SG,28,LAL,2007,76,1732.0,638,74,93,128,221,38,14,57,126,234,542,0.4317343173431734,48,133,0.3609022556390977,186,409,0.4547677261613692,0.476,122,155,0.7870967741935484
Reggie Evans,evansre01,PF,26,DEN,2007,66,1127.0,325,45,156,304,460,42,16,95,144,117,215,0.5441860465116279,0,0,0.0,117,215,0.5441860465116279,0.544,91,183,0.4972677595628415
Daniel Ewing,ewingda01,PG,23,LAC,2007,61,712.0,179,90,9,64,73,32,4,50,62,65,161,0.4037267080745341,14,44,0.3181818181818182,51,117,0.4358974358974359,0.447,35,45,0.7777777777777778
Jordan Farmar,farmajo01,PG,20,LAL,2007,72,1090.0,320,137,22,97,119,44,7,73,77,124,294,0.4217687074829932,45,137,0.3284671532846715,79,157,0.5031847133757962,0.498,27,38,0.7105263157894737
Desmon Farmer,farmede01,SG,25,SEA,2007,8,32.0,13,9,0,1,1,1,0,1,2,5,15,0.3333333333333333,2,8,0.25,3,7,0.4285714285714285,0.4,1,1,1.0
Raymond Felton,feltora01,PG,22,CHA,2007,78,2832.0,1093,545,51,216,267,118,10,230,180,393,1024,0.3837890625,103,312,0.3301282051282051,290,712,0.4073033707865168,0.434,204,256,0.796875
Michael Finley,finlemi01,SF,33,SAS,2007,82,1823.0,740,108,34,189,223,32,16,46,76,273,663,0.4117647058823529,104,286,0.3636363636363636,169,377,0.4482758620689655,0.49,90,98,0.9183673469387756
Derek Fisher,fishede01,SG,32,UTA,2007,82,2287.0,826,274,30,119,149,83,6,120,234,258,675,0.3822222222222222,48,156,0.3076923076923077,210,519,0.4046242774566474,0.418,262,307,0.8534201954397395
T.J. Ford,fordtj01,PG,23,TOR,2007,75,2243.0,1047,595,53,183,236,101,8,231,186,393,902,0.4356984478935698,21,69,0.3043478260869565,372,833,0.446578631452581,0.447,240,293,0.8191126279863481
Danny Fortson,fortsda01,C,30,SEA,2007,14,158.0,40,1,13,30,43,1,0,15,38,15,30,0.5,0,1,0.0,15,29,0.5172413793103449,0.5,10,13,0.7692307692307693
Jeff Foster,fosteje01,C,30,IND,2007,75,1740.0,322,57,253,356,609,62,37,70,202,122,260,0.4692307692307692,0,1,0.0,122,259,0.471042471042471,0.469,78,122,0.639344262295082
Randy Foye,foyera01,PG,23,MIN,2007,82,1879.0,832,232,49,169,218,53,21,152,184,300,691,0.4341534008683068,68,185,0.3675675675675676,232,506,0.458498023715415,0.483,164,192,0.8541666666666666
Adonal Foyle,foylead01,C,31,GSW,2007,48,475.0,107,19,51,75,126,11,50,23,61,48,85,0.5647058823529412,0,0,0.0,48,85,0.5647058823529412,0.565,11,25,0.44
Steve Francis,francst01,SG,29,NYK,2007,44,1237.0,497,170,33,124,157,41,12,100,126,140,343,0.4081632653061224,42,111,0.3783783783783784,98,232,0.4224137931034483,0.469,175,211,0.8293838862559242
Matt Freije,freijma01,PF,25,ATL,2007,19,147.0,40,7,8,16,24,3,1,3,13,16,54,0.2962962962962963,3,22,0.1363636363636363,13,32,0.40625,0.324,5,6,0.8333333333333334
Channing Frye,fryech01,PF,23,NYK,2007,72,1896.0,684,67,91,304,395,36,42,100,216,298,689,0.432510885341074,3,18,0.1666666666666666,295,671,0.4396423248882265,0.435,85,108,0.7870370370370371
Dan Gadzuric,gadzuda01,C,28,MIL,2007,54,840.0,258,29,94,152,246,22,32,49,141,108,228,0.4736842105263157,0,1,0.0,108,227,0.4757709251101321,0.474,42,90,0.4666666666666667
Jorge Garbajosa,garbajo01,PF,29,TOR,2007,67,1909.0,567,125,48,282,330,78,15,64,90,222,529,0.4196597353497164,66,193,0.3419689119170984,156,336,0.4642857142857143,0.482,57,78,0.7307692307692307
Francisco García,garcifr01,SF,25,SAC,2007,79,1410.0,474,87,53,152,205,45,43,70,190,163,380,0.4289473684210526,53,149,0.3557046979865771,110,231,0.4761904761904761,0.499,95,114,0.8333333333333334
Kevin Garnett,garneke01,PF,30,MIN,2007,76,2995.0,1704,313,183,792,975,89,126,205,184,638,1341,0.4757643549589858,12,56,0.2142857142857142,626,1285,0.4871595330739299,0.48,416,498,0.8353413654618473
Pat Garrity,garripa01,PF,30,ORL,2007,33,277.0,71,14,12,30,42,7,0,14,37,22,70,0.3142857142857143,11,32,0.34375,11,38,0.2894736842105263,0.393,16,18,0.8888888888888888
Pau Gasol,gasolpa01,C,26,MEM,2007,59,2133.0,1226,201,149,432,581,29,126,162,137,462,858,0.5384615384615384,3,11,0.2727272727272727,459,847,0.5419126328217237,0.54,299,400,0.7475
Rudy Gay,gayru01,SF,20,MEM,2007,78,2103.0,846,100,93,255,348,71,74,140,192,321,760,0.4223684210526315,52,143,0.3636363636363636,269,617,0.4359805510534846,0.457,152,209,0.7272727272727273
Mickaël Gelabale,gelabmi01,SF,23,SEA,2007,70,1239.0,321,56,59,114,173,24,22,49,108,122,264,0.4621212121212121,11,47,0.2340425531914893,111,217,0.511520737327189,0.483,66,82,0.8048780487804879
Devean George,georgde01,SF,29,DAL,2007,60,1283.0,381,33,57,156,213,46,23,51,143,146,370,0.3945945945945946,53,150,0.3533333333333333,93,220,0.4227272727272727,0.466,36,48,0.75
Daniel Gibson,gibsoda01,PG,20,CLE,2007,60,988.0,276,69,28,64,92,23,8,44,94,98,231,0.4242424242424242,52,124,0.4193548387096774,46,107,0.4299065420560747,0.537,28,39,0.717948717948718
Manu Ginóbili,ginobma01,SG,29,SAS,2007,75,2060.0,1240,263,59,268,327,109,27,157,155,396,854,0.4637002341920375,128,323,0.3962848297213622,268,531,0.504708097928437,0.539,320,372,0.8602150537634409
Gordan Giriček,giricgo01,SG,29,UTA,2007,61,1188.0,475,63,24,105,129,28,5,64,122,176,381,0.4619422572178477,52,122,0.4262295081967213,124,259,0.4787644787644787,0.53,71,87,0.8160919540229885
Andreas Glyniadakis,glynian01,C,25,SEA,2007,13,81.0,17,1,2,6,8,0,0,9,19,8,17,0.4705882352941176,0,0,0.0,8,17,0.4705882352941176,0.471,1,2,0.5
Ryan Gomes,gomesry01,PF,24,BOS,2007,73,2275.0,881,119,125,282,407,48,13,105,169,338,723,0.4674965421853388,16,42,0.3809523809523809,322,681,0.4728340675477239,0.479,189,233,0.8111587982832618
Drew Gooden,goodedr01,PF,25,CLE,2007,80,2238.0,885,88,263,418,681,70,28,115,210,371,784,0.4732142857142857,1,6,0.1666666666666666,370,778,0.4755784061696658,0.474,142,199,0.7135678391959799
Ben Gordon,gordobe01,SG,23,CHI,2007,82,2704.0,1753,296,35,223,258,64,17,249,252,609,1338,0.4551569506726457,155,375,0.4133333333333333,454,963,0.4714434060228453,0.513,380,440,0.8636363636363636
Joey Graham,grahajo01,SF,24,TOR,2007,79,1319.0,503,44,55,193,248,30,4,49,161,192,388,0.4948453608247423,9,31,0.2903225806451613,183,357,0.5126050420168067,0.506,110,131,0.8396946564885496
Stephen Graham,grahast01,SG,24,POR,2007,14,165.0,45,5,6,15,21,4,1,13,25,17,40,0.425,3,11,0.2727272727272727,14,29,0.4827586206896552,0.463,8,9,0.8888888888888888
Danny Granger,grangda01,SF,23,IND,2007,82,2785.0,1142,114,114,267,381,67,61,135,245,398,868,0.4585253456221198,110,288,0.3819444444444444,288,580,0.496551724137931,0.522,236,294,0.8027210884353742
Gerald Green,greenge01,SF,21,BOS,2007,81,1780.0,843,83,68,140,208,41,24,120,198,310,739,0.4194857916102841,95,258,0.3682170542635659,215,481,0.446985446985447,0.484,128,159,0.8050314465408805
Willie Green,greenwi01,SG,25,PHI,2007,74,1842.0,839,112,42,116,158,56,4,106,144,357,868,0.4112903225806452,51,157,0.3248407643312102,306,711,0.430379746835443,0.441,74,111,0.6666666666666666
Orien Greene,greenor01,SG,24,IND,2007,41,254.0,63,22,12,32,44,17,4,28,38,23,62,0.3709677419354839,2,11,0.1818181818181818,21,51,0.4117647058823529,0.387,15,25,0.6
Lynn Greer,greerly01,SG,27,MIL,2007,41,432.0,167,53,2,25,27,17,1,18,32,61,141,0.4326241134751773,18,52,0.3461538461538461,43,89,0.4831460674157303,0.496,27,32,0.84375
Adrian Griffin,griffad01,SF,32,CHI,2007,54,585.0,137,59,40,69,109,32,4,38,78,61,129,0.4728682170542636,0,6,0.0,61,123,0.4959349593495935,0.473,15,19,0.7894736842105263
Eddie Griffin,griffed01,PF,24,MIN,2007,13,92.0,18,4,7,18,25,0,7,6,8,7,27,0.2592592592592592,0,1,0.0,7,26,0.2692307692307692,0.259,4,5,0.8
Mike Hall,hallmi01,SF,22,WAS,2007,2,13.0,2,1,1,1,2,0,0,0,1,1,4,0.25,0,0,0.0,1,4,0.25,0.25,0,0,0.0
Richard Hamilton,hamilri01,SG,28,DET,2007,75,2763.0,1485,285,75,207,282,59,15,159,232,547,1170,0.4675213675213675,44,129,0.3410852713178294,503,1041,0.4831892411143131,0.486,347,403,0.8610421836228288
Matt Harpring,harprma01,SF,30,UTA,2007,77,1965.0,894,99,117,236,353,52,11,118,232,322,656,0.4908536585365853,13,39,0.3333333333333333,309,617,0.5008103727714749,0.501,237,309,0.7669902912621359
Al Harrington,harrial01,PF,26,TOT,2007,78,2563.0,1285,149,151,345,496,65,24,169,269,495,1083,0.4570637119113573,127,293,0.4334470989761092,368,790,0.4658227848101265,0.516,168,242,0.6942148760330579
Junior Harrington,harriju01,PG,26,MEM,2007,29,543.0,152,89,12,56,68,21,5,52,79,57,137,0.4160583941605839,7,26,0.2692307692307692,50,111,0.4504504504504504,0.442,31,46,0.6739130434782609
Othella Harrington,harriot01,PF,33,CHA,2007,26,220.0,67,6,13,25,38,1,1,15,49,25,56,0.4464285714285714,0,0,0.0,25,56,0.4464285714285714,0.446,17,22,0.7727272727272727
Devin Harris,harride01,PG,23,DAL,2007,80,2081.0,813,296,45,151,196,96,21,146,242,292,593,0.4924114671163575,14,50,0.28,278,543,0.5119705340699816,0.504,215,261,0.8237547892720306
David Harrison,harrida01,C,24,IND,2007,24,190.0,71,6,9,33,42,5,12,26,47,30,58,0.5172413793103449,0,0,0.0,30,58,0.5172413793103449,0.517,11,22,0.5
Jason Hart,hartja01,PG,28,TOT,2007,36,846.0,249,103,14,84,98,44,1,38,83,100,224,0.4464285714285714,7,29,0.2413793103448276,93,195,0.4769230769230769,0.462,42,47,0.8936170212765957
Udonis Haslem,hasleud01,PF,26,MIA,2007,79,2483.0,844,97,188,466,654,49,26,110,236,353,717,0.4923291492329149,0,4,0.0,353,713,0.4950911640953717,0.492,138,203,0.6798029556650246
Trenton Hassell,hassetr01,SG,27,MIN,2007,76,2223.0,512,203,83,160,243,22,26,80,144,217,443,0.4898419864559819,6,25,0.24,211,418,0.5047846889952153,0.497,72,92,0.782608695652174
Chuck Hayes,hayesch01,PF,23,HOU,2007,78,1714.0,439,47,204,317,521,70,18,64,281,192,335,0.573134328358209,0,0,0.0,192,335,0.573134328358209,0.573,55,89,0.6179775280898876
Jarvis Hayes,hayesja01,SF,25,WAS,2007,81,1626.0,585,80,42,168,210,48,13,56,160,224,546,0.4102564102564102,66,183,0.360655737704918,158,363,0.4352617079889807,0.471,71,84,0.8452380952380952
Brendan Haywood,haywobr01,C,27,WAS,2007,77,1740.0,511,47,195,282,477,34,88,90,208,198,355,0.5577464788732395,0,0,0.0,198,355,0.5577464788732395,0.558,115,210,0.5476190476190477
Luther Head,headlu01,SG,24,HOU,2007,80,2211.0,872,194,31,221,252,76,5,137,133,306,700,0.4371428571428571,177,401,0.4413965087281795,129,299,0.431438127090301,0.564,83,105,0.7904761904761904
Alan Henderson,hendeal01,PF,34,PHI,2007,38,418.0,119,10,48,59,107,9,12,12,62,43,67,0.6417910447761194,0,0,0.0,43,67,0.6417910447761194,0.642,33,47,0.7021276595744681
Walter Herrmann,herrmwa01,PF,27,CHA,2007,48,936.0,442,26,28,111,139,17,7,32,76,174,330,0.5272727272727272,53,115,0.4608695652173913,121,215,0.5627906976744186,0.608,41,53,0.7735849056603774
Nenê,hilarne01,C,24,DEN,2007,64,1715.0,783,77,150,299,449,62,59,127,209,294,516,0.5697674418604651,0,1,0.0,294,515,0.570873786407767,0.57,195,283,0.6890459363957597
Grant Hill,hillgr01,SG,34,ORL,2007,65,2009.0,934,138,53,184,237,61,25,144,146,342,660,0.5181818181818182,2,12,0.1666666666666666,340,648,0.5246913580246914,0.52,248,324,0.7654320987654321
Kirk Hinrich,hinriki01,PG,26,CHI,2007,80,2839.0,1327,500,32,242,274,100,23,191,274,475,1061,0.4476908576814326,140,337,0.4154302670623145,335,724,0.462707182320442,0.514,237,284,0.8345070422535211
Robert Hite,hitero01,SG,23,MIA,2007,12,136.0,51,8,4,12,16,3,2,6,8,19,60,0.3166666666666666,5,23,0.217391304347826,14,37,0.3783783783783784,0.358,8,12,0.6666666666666666
Julius Hodge,hodgeju01,SG,23,TOT,2007,9,65.0,15,12,2,6,8,4,0,3,6,6,12,0.5,0,0,0.0,6,12,0.5,0.5,3,4,0.75
Ryan Hollins,holliry01,C,22,CHA,2007,27,185.0,64,1,11,20,31,4,7,16,40,20,36,0.5555555555555556,0,0,0.0,20,36,0.5555555555555556,0.556,24,40,0.6
Robert Horry,horryro01,PF,36,SAS,2007,68,1124.0,268,77,73,156,229,45,41,44,105,90,251,0.3585657370517928,50,149,0.3355704697986577,40,102,0.392156862745098,0.458,38,64,0.59375
Eddie House,houseed01,SG,28,NJN,2007,56,946.0,468,67,14,78,92,27,3,27,69,180,421,0.4275534441805225,75,175,0.4285714285714285,105,246,0.4268292682926829,0.517,33,36,0.9166666666666666
Dwight Howard,howardw01,C,21,ORL,2007,82,3023.0,1443,158,283,725,1008,70,156,317,245,526,873,0.6025200458190149,1,2,0.5,525,871,0.6027554535017221,0.603,390,666,0.5855855855855856
Josh Howard,howarjo01,SF,26,DAL,2007,70,2455.0,1321,127,130,345,475,82,56,123,180,493,1075,0.4586046511627907,92,239,0.3849372384937238,401,836,0.4796650717703349,0.501,243,294,0.826530612244898
Juwan Howard,howarju01,PF,33,HOU,2007,80,2123.0,773,131,138,332,470,29,8,112,205,309,665,0.4646616541353383,0,0,0.0,309,665,0.4646616541353383,0.465,155,188,0.824468085106383
Troy Hudson,hudsotr01,PG,30,MIN,2007,34,554.0,202,73,8,40,48,14,2,40,23,74,195,0.3794871794871794,28,80,0.35,46,115,0.4,0.451,26,32,0.8125
Larry Hughes,hughela01,SG,28,CLE,2007,70,2596.0,1045,256,41,226,267,89,26,154,164,381,953,0.3997901364113326,74,222,0.3333333333333333,307,731,0.4199726402188782,0.439,209,309,0.6763754045307443
Kris Humphries,humphkr01,PF,21,TOR,2007,60,670.0,227,18,78,109,187,14,21,32,98,87,185,0.4702702702702703,0,0,0.0,87,185,0.4702702702702703,0.47,53,79,0.6708860759493671
Lindsey Hunter,hunteli01,PG,36,DET,2007,52,745.0,256,93,9,38,47,34,7,35,56,94,244,0.3852459016393442,38,119,0.3193277310924369,56,125,0.448,0.463,30,33,0.9090909090909092
Steven Hunter,huntest01,PF,25,PHI,2007,70,1605.0,450,26,114,221,335,13,76,65,137,188,326,0.5766871165644172,0,0,0.0,188,326,0.5766871165644172,0.577,74,151,0.4900662251655629
Andre Iguodala,iguodan01,SG,23,PHI,2007,76,3062.0,1386,432,77,357,434,152,33,261,200,443,991,0.4470232088799192,48,155,0.3096774193548387,395,836,0.4724880382775119,0.471,452,551,0.8203266787658802
Zydrunas Ilgauskas,ilgauzy01,C,31,CLE,2007,78,2130.0,925,123,242,357,599,48,98,141,257,385,793,0.4854981084489281,0,1,0.0,385,792,0.4861111111111111,0.485,155,192,0.8072916666666666
Mile Ilić,ilicmi01,C,22,NJN,2007,5,6.0,0,0,0,1,1,0,0,3,1,0,3,0.0,0,0,0.0,0,3,0.0,0.0,0,0,0.0
D.J. Mbenga,mbengdj01,C,26,DAL,2007,21,79.0,17,6,3,8,11,3,5,5,17,5,16,0.3125,0,0,0.0,5,16,0.3125,0.313,7,8,0.875
Ersan İlyasova,ilyaser01,PF,19,MIL,2007,66,973.0,402,49,58,131,189,27,17,51,147,139,363,0.3829201101928374,54,148,0.3648648648648648,85,215,0.3953488372093023,0.457,70,89,0.7865168539325843
Allen Iverson,iversal01,SG-PG,31,TOT,2007,65,2761.0,1709,468,23,170,193,123,13,268,95,581,1313,0.4424980959634425,62,197,0.3147208121827411,519,1116,0.4650537634408602,0.466,485,610,0.7950819672131147
Royal Ivey,iveyro01,PG,25,ATL,2007,53,539.0,157,45,15,36,51,24,4,31,62,64,143,0.4475524475524475,5,16,0.3125,59,127,0.4645669291338583,0.465,24,35,0.6857142857142857
Jarrett Jack,jackja01,PG,23,POR,2007,79,2651.0,946,417,18,190,208,86,9,187,202,320,705,0.4539007092198581,63,180,0.35,257,525,0.4895238095238095,0.499,243,279,0.8709677419354839
Bobby Jackson,jacksbo01,SG,33,NOK,2007,56,1330.0,592,141,42,136,178,50,6,78,98,204,518,0.3938223938223938,54,165,0.3272727272727272,150,353,0.4249291784702549,0.446,130,168,0.7738095238095238
Luke Jackson,jackslu02,SF,25,TOT,2007,13,138.0,48,13,2,8,10,5,1,7,15,19,43,0.4418604651162791,5,17,0.2941176470588235,14,26,0.5384615384615384,0.5,5,9,0.5555555555555556
Marc Jackson,jacksma02,PF,32,NOK,2007,56,1025.0,408,58,62,130,192,21,7,65,89,159,388,0.4097938144329897,0,1,0.0,159,387,0.4108527131782946,0.41,90,103,0.8737864077669902
Stephen Jackson,jacksst02,SF-SG,28,TOT,2007,75,2479.0,1161,287,61,161,222,84,34,183,200,409,944,0.4332627118644068,100,311,0.3215434083601286,309,633,0.4881516587677725,0.486,243,299,0.8127090301003345
Jerome James,jamesje01,C,31,NYK,2007,41,273.0,76,3,21,45,66,6,15,23,73,33,79,0.4177215189873418,0,0,0.0,33,79,0.4177215189873418,0.418,10,18,0.5555555555555556
LeBron James,jamesle01,SF,22,CLE,2007,78,3190.0,2132,470,83,443,526,125,55,250,171,772,1621,0.4762492288710672,99,310,0.3193548387096774,673,1311,0.513348588863463,0.507,489,701,0.6975748930099858
Mike James,jamesmi01,PG,31,MIN,2007,82,2069.0,828,297,25,138,163,55,7,129,171,297,703,0.422475106685633,80,215,0.3720930232558139,217,488,0.444672131147541,0.479,154,184,0.8369565217391305
Antawn Jamison,jamisan01,PF,30,WAS,2007,70,2662.0,1388,136,134,428,562,80,36,104,194,512,1139,0.4495171202809482,138,379,0.3641160949868074,374,760,0.4921052631578947,0.51,226,307,0.7361563517915309
Marko Jarić,jaricma01,SG,28,MIN,2007,70,1555.0,371,145,54,130,184,75,16,88,172,136,325,0.4184615384615384,32,85,0.3764705882352941,104,240,0.4333333333333333,0.468,67,88,0.7613636363636364
Šarūnas Jasikevičius,jasiksa01,SG-PG,30,TOT,2007,63,973.0,386,172,15,54,69,26,1,90,75,128,322,0.3975155279503105,44,130,0.3384615384615385,84,192,0.4375,0.466,86,95,0.9052631578947368
Al Jefferson,jeffeal01,C,22,BOS,2007,69,2319.0,1107,88,237,519,756,48,106,136,232,453,882,0.5136054421768708,0,1,0.0,453,881,0.5141884222474461,0.514,201,295,0.6813559322033899
Richard Jefferson,jefferi01,SF,26,NJN,2007,55,1956.0,897,148,48,192,240,34,8,120,123,303,665,0.4556390977443609,52,145,0.3586206896551724,251,520,0.4826923076923077,0.495,239,326,0.7331288343558282
Jared Jeffries,jeffrja01,SF,25,NYK,2007,55,1307.0,223,67,111,127,238,44,30,61,150,95,206,0.4611650485436893,2,20,0.1,93,186,0.5,0.466,31,68,0.4558823529411764
Alexander Johnson,johnsal01,PF,23,MEM,2007,59,753.0,260,17,50,131,181,25,35,47,137,91,169,0.5384615384615384,0,0,0.0,91,169,0.5384615384615384,0.538,78,118,0.6610169491525424
Amir Johnson,johnsam01,PF,19,DET,2007,8,124.0,47,3,15,22,37,5,13,9,19,18,33,0.5454545454545454,0,3,0.0,18,30,0.6,0.545,11,14,0.7857142857142857
Anthony Johnson,johnsan02,PG,32,TOT,2007,67,1301.0,355,201,22,79,101,33,3,76,119,142,343,0.4139941690962099,25,73,0.3424657534246575,117,270,0.4333333333333333,0.45,46,61,0.7540983606557377
DerMarr Johnson,johnsde03,SF,26,DEN,2007,39,419.0,135,17,10,47,57,16,12,27,39,50,154,0.3246753246753247,19,88,0.2159090909090909,31,66,0.4696969696969697,0.386,16,21,0.7619047619047619
Joe Johnson,johnsjo02,SG,25,ATL,2007,57,2359.0,1426,249,53,186,239,60,11,176,115,536,1139,0.4705882352941176,119,312,0.3814102564102564,417,827,0.5042321644498187,0.523,235,314,0.7484076433121019
Linton Johnson,johnsli01,PF,26,NOK,2007,54,720.0,226,18,52,111,163,33,18,27,101,93,190,0.4894736842105263,10,30,0.3333333333333333,83,160,0.51875,0.516,30,37,0.8108108108108109
Bobby Jones,jonesbo02,SF,23,PHI,2007,44,336.0,110,16,22,35,57,11,1,18,59,43,93,0.4623655913978494,1,9,0.1111111111111111,42,84,0.5,0.468,23,41,0.5609756097560976
Dahntay Jones,jonesda02,SG,26,MEM,2007,78,1671.0,583,68,47,106,153,39,22,92,192,220,461,0.4772234273318872,5,12,0.4166666666666667,215,449,0.4788418708240534,0.483,138,174,0.7931034482758621
Damon Jones,jonesda01,PG,30,CLE,2007,60,1173.0,393,94,9,57,66,16,2,36,53,137,355,0.3859154929577464,89,231,0.3852813852813853,48,124,0.3870967741935484,0.511,30,44,0.6818181818181818
Dwayne Jones,jonesdw02,PF,23,CLE,2007,4,18.0,3,0,1,5,6,0,0,2,3,0,1,0.0,0,0,0.0,0,1,0.0,0.0,3,6,0.5
Eddie Jones,jonesed02,SG,35,TOT,2007,64,1594.0,493,109,31,159,190,68,10,47,124,178,422,0.4218009478672986,78,222,0.3513513513513513,100,200,0.5,0.514,59,75,0.7866666666666666
Fred Jones,jonesfr01,SG,27,TOT,2007,63,1319.0,412,108,23,92,115,48,16,67,121,139,361,0.3850415512465374,39,128,0.3046875,100,233,0.4291845493562232,0.439,95,114,0.8333333333333334
James Jones,jonesja02,SF,26,PHO,2007,76,1376.0,485,45,33,143,176,28,42,28,115,162,440,0.3681818181818181,90,238,0.3781512605042016,72,202,0.3564356435643564,0.47,71,81,0.8765432098765432
Jumaine Jones,jonesju01,SF,27,PHO,2007,18,138.0,40,1,6,17,23,5,1,7,19,14,51,0.2745098039215686,10,32,0.3125,4,19,0.2105263157894736,0.373,2,2,1.0
Solomon Jones,jonesso01,PF,22,ATL,2007,58,666.0,189,11,49,87,136,11,42,25,124,65,128,0.5078125,0,1,0.0,65,127,0.5118110236220472,0.508,59,75,0.7866666666666666
Chris Kaman,kamanch01,C,24,LAC,2007,75,2176.0,754,79,160,428,588,41,116,147,251,294,652,0.450920245398773,0,1,0.0,294,651,0.4516129032258064,0.451,166,224,0.7410714285714286
Jason Kapono,kaponja01,SF,25,MIA,2007,67,1767.0,730,81,26,154,180,38,2,70,135,278,563,0.4937833037300178,108,210,0.5142857142857142,170,353,0.4815864022662889,0.59,66,74,0.8918918918918919
Viktor Khryapa,khryavi01,PF,24,CHI,2007,33,231.0,73,21,20,37,57,10,1,16,53,27,70,0.3857142857142857,0,6,0.0,27,64,0.421875,0.386,19,26,0.7307692307692307
Jason Kidd,kiddja01,PG,33,NJN,2007,80,2933.0,1041,736,135,520,655,127,23,213,146,369,908,0.4063876651982379,124,361,0.3434903047091412,245,547,0.4478976234003656,0.475,179,230,0.7782608695652173
Tarence Kinsey,kinseta01,SG,22,MEM,2007,48,967.0,369,41,29,68,97,53,1,46,57,139,304,0.4572368421052631,13,46,0.2826086956521739,126,258,0.4883720930232558,0.479,78,98,0.7959183673469388
Andrei Kirilenko,kirilan01,SF,25,UTA,2007,70,2049.0,584,202,88,241,329,74,144,135,172,197,418,0.4712918660287081,16,75,0.2133333333333333,181,343,0.5276967930029155,0.49,174,239,0.7280334728033473
Linas Kleiza,kleizli01,PF,22,DEN,2007,79,1488.0,598,45,77,189,266,28,14,79,200,200,474,0.4219409282700422,83,221,0.3755656108597285,117,253,0.4624505928853755,0.509,115,135,0.8518518518518519
Brevin Knight,knighbr01,PG,31,CHA,2007,45,1273.0,408,296,14,101,115,67,3,95,113,152,363,0.418732782369146,1,18,0.0555555555555555,151,345,0.4376811594202898,0.42,103,128,0.8046875
Yaroslav Korolev,korolya01,SF,19,LAC,2007,10,41.0,12,4,1,2,3,3,0,1,0,4,16,0.25,1,5,0.2,3,11,0.2727272727272727,0.281,3,6,0.5
Kyle Korver,korveky01,SF,25,PHI,2007,74,2288.0,1067,105,30,229,259,57,20,117,188,372,845,0.4402366863905325,132,307,0.4299674267100977,240,538,0.4460966542750929,0.518,191,209,0.9138755980861244
Nenad Krstić,krstine01,C,23,NJN,2007,26,848.0,426,46,51,125,176,10,24,52,88,170,323,0.5263157894736842,0,1,0.0,170,322,0.5279503105590062,0.526,86,121,0.7107438016528925
Raef LaFrentz,lafrera01,PF,30,POR,2007,27,352.0,100,8,25,45,70,7,11,13,57,39,102,0.3823529411764705,2,23,0.0869565217391304,37,79,0.4683544303797468,0.392,20,26,0.7692307692307693
James Lang,langja01,C,23,WAS,2007,11,55.0,11,2,5,6,11,0,3,2,14,4,9,0.4444444444444444,0,0,0.0,4,9,0.4444444444444444,0.444,3,5,0.6
David Lee,leeda02,PF,23,NYK,2007,58,1731.0,621,104,196,406,602,48,23,92,155,240,400,0.6,0,0,0.0,240,400,0.6,0.6,141,173,0.815028901734104
Rashard Lewis,lewisra02,SF,27,SEA,2007,60,2348.0,1342,145,91,305,396,68,39,118,143,463,1005,0.4606965174129353,151,387,0.3901808785529715,312,618,0.5048543689320388,0.536,265,315,0.8412698412698413
Randy Livingston,livinra01,PG,31,SEA,2007,4,26.0,0,4,1,0,1,0,0,1,2,0,3,0.0,0,0,0.0,0,3,0.0,0.0,0,0,0.0
Shaun Livingston,livinsh01,PG,21,LAC,2007,54,1611.0,503,274,56,128,184,59,29,108,135,208,449,0.4632516703786191,5,16,0.3125,203,433,0.4688221709006928,0.469,82,116,0.7068965517241379
Kyle Lowry,lowryky01,PG,20,MEM,2007,10,175.0,56,32,12,19,31,14,1,12,20,14,38,0.3684210526315789,3,8,0.375,11,30,0.3666666666666666,0.408,25,28,0.8928571428571429
John Lucas III,lucasjo02,PG,24,HOU,2007,47,383.0,154,33,9,27,36,17,0,15,38,62,156,0.3974358974358974,15,59,0.2542372881355932,47,97,0.4845360824742268,0.446,15,19,0.7894736842105263
Tyronn Lue,luety01,PG,29,ATL,2007,56,1488.0,636,201,19,85,104,24,0,85,101,218,524,0.416030534351145,56,161,0.3478260869565217,162,363,0.4462809917355372,0.469,144,163,0.8834355828220859
Mark Madsen,madsema01,C,31,MIN,2007,56,473.0,61,10,35,52,87,10,10,21,100,23,43,0.5348837209302325,0,0,0.0,23,43,0.5348837209302325,0.535,15,29,0.5172413793103449
Corey Maggette,maggeco01,SF,27,LAC,2007,75,2291.0,1266,208,90,352,442,65,14,201,244,367,808,0.4542079207920792,13,65,0.2,354,743,0.4764468371467025,0.462,519,633,0.8199052132701422
Jamaal Magloire,magloja01,C,28,POR,2007,81,1703.0,529,30,151,341,492,21,66,129,226,199,395,0.5037974683544304,0,0,0.0,199,395,0.5037974683544304,0.504,131,242,0.5413223140495868
Renaldo Major,majorre01,PF,24,GSW,2007,1,27.0,5,0,0,2,2,2,0,1,4,2,10,0.2,0,0,0.0,2,10,0.2,0.2,1,2,0.5
Stephon Marbury,marbust01,PG,29,NYK,2007,74,2748.0,1210,403,36,177,213,71,10,179,185,395,952,0.4149159663865546,123,345,0.3565217391304348,272,607,0.4481054365733113,0.48,297,386,0.7694300518134715
Shawn Marion,mariosh01,SF,28,PHO,2007,80,3010.0,1403,134,172,613,785,156,122,114,216,561,1071,0.5238095238095238,80,252,0.3174603174603174,481,819,0.5873015873015873,0.561,201,248,0.8104838709677419
Damir Markota,markoda01,PF,21,MIL,2007,30,170.0,51,6,11,20,31,3,1,15,22,19,52,0.3653846153846153,6,16,0.375,13,36,0.3611111111111111,0.423,7,11,0.6363636363636364
Sean Marks,marksse01,PF,31,PHO,2007,3,17.0,6,0,0,3,3,0,1,0,4,2,6,0.3333333333333333,0,1,0.0,2,5,0.4,0.333,2,2,1.0
Donyell Marshall,marshdo01,PF,33,CLE,2007,81,1360.0,566,46,86,237,323,39,43,67,130,209,493,0.4239350912778905,95,271,0.3505535055350554,114,222,0.5135135135135135,0.52,53,80,0.6625
Rawle Marshall,marshra01,SG,24,IND,2007,40,361.0,99,13,8,21,29,12,5,19,22,32,89,0.3595505617977528,4,18,0.2222222222222222,28,71,0.3943661971830985,0.382,31,45,0.6888888888888889
Darrick Martin,martida01,PG,35,TOR,2007,31,220.0,94,43,2,10,12,3,0,12,22,33,94,0.351063829787234,13,37,0.3513513513513513,20,57,0.3508771929824561,0.42,15,21,0.7142857142857143
Kenyon Martin,martike01,PF,29,DEN,2007,2,63.0,19,1,6,14,20,0,0,5,10,8,16,0.5,0,1,0.0,8,15,0.5333333333333333,0.5,3,12,0.25
Kevin Martin,martike02,SG,23,SAC,2007,80,2818.0,1618,173,69,273,342,98,11,135,181,505,1067,0.4732895970009372,127,333,0.3813813813813814,378,734,0.5149863760217984,0.533,481,570,0.843859649122807
Desmond Mason,masonde01,SF,29,NOK,2007,75,2575.0,1028,115,124,221,345,52,22,192,174,407,900,0.4522222222222222,0,0,0.0,407,900,0.4522222222222222,0.452,214,323,0.6625386996904025
Roger Mason,masonro01,SG,26,WAS,2007,62,492.0,165,35,7,38,45,13,6,19,66,59,179,0.329608938547486,33,102,0.3235294117647059,26,77,0.3376623376623376,0.422,14,16,0.875
Jason Maxiell,maxieja01,C,23,DET,2007,67,943.0,334,14,88,98,186,30,60,53,110,131,262,0.5,0,0,0.0,131,262,0.5,0.5,72,137,0.5255474452554745
Sean May,mayse01,PF,22,CHA,2007,35,838.0,416,66,73,160,233,19,24,56,100,164,328,0.5,2,3,0.6666666666666666,162,325,0.4984615384615384,0.503,86,112,0.7678571428571429
Rashad McCants,mccanra01,SG,22,MIN,2007,37,554.0,184,38,14,33,47,26,7,40,71,62,177,0.3502824858757062,20,75,0.2666666666666666,42,102,0.4117647058823529,0.407,40,58,0.6896551724137931
Chris McCray,mccrach01,SG,22,MIL,2007,5,12.0,0,0,0,0,0,0,0,2,1,0,3,0.0,0,0,0.0,0,3,0.0,0.0,0,0,0.0
Antonio McDyess,mcdyean01,PF,32,DET,2007,82,1729.0,664,72,165,331,496,61,65,75,240,284,540,0.5259259259259259,0,0,0.0,284,540,0.5259259259259259,0.526,96,139,0.6906474820143885
Ivan McFarlin,mcfariv01,PF,24,PHI,2007,11,41.0,15,1,7,4,11,0,0,1,8,5,13,0.3846153846153846,0,1,0.0,5,12,0.4166666666666667,0.385,5,7,0.7142857142857143
Tracy McGrady,mcgratr01,SG,27,HOU,2007,71,2539.0,1747,458,56,322,378,92,36,213,136,638,1480,0.431081081081081,126,381,0.3307086614173228,512,1099,0.4658780709736124,0.474,345,488,0.7069672131147541
Jeff McInnis,mcinnje01,PG,32,CHA,2007,38,702.0,165,124,14,48,62,14,0,42,72,71,181,0.3922651933701657,1,8,0.125,70,173,0.4046242774566474,0.395,22,32,0.6875
Aaron McKie,mckieaa01,SF,34,LAL,2007,10,131.0,22,13,1,17,18,4,0,8,14,11,17,0.6470588235294118,0,0,0.0,11,17,0.6470588235294118,0.647,0,0,0.0
Keith McLeod,mcleoke01,PG,27,TOT,2007,48,718.0,231,90,4,39,43,24,5,46,51,73,188,0.3882978723404255,16,45,0.3555555555555555,57,143,0.3986013986013986,0.431,69,78,0.8846153846153846
Stanislav Medvedenko,medvest01,C,27,ATL,2007,14,81.0,42,2,4,10,14,0,2,5,16,12,29,0.4137931034482758,1,2,0.5,11,27,0.4074074074074074,0.431,17,20,0.85
Pops Mensah-Bonsu,mensapo01,PF,23,DAL,2007,12,71.0,29,0,9,12,21,1,0,9,8,11,17,0.6470588235294118,0,0,0.0,11,17,0.6470588235294118,0.647,7,18,0.3888888888888889
C.J. Miles,milescj01,SG,19,UTA,2007,37,373.0,101,25,11,24,35,11,4,28,60,40,116,0.3448275862068966,7,32,0.21875,33,84,0.3928571428571428,0.375,14,23,0.6086956521739131
Darko Miličić,milicda01,PF,21,ORL,2007,80,1913.0,639,90,145,292,437,44,140,124,219,249,548,0.4543795620437956,0,1,0.0,249,547,0.4552102376599634,0.454,141,230,0.6130434782608696
Andre Miller,millean02,PG,30,TOT,2007,80,2966.0,1075,625,97,255,352,110,10,222,184,424,909,0.4664466446644664,5,35,0.1428571428571428,419,874,0.4794050343249428,0.469,222,283,0.784452296819788
Brad Miller,millebr01,C,30,SAC,2007,63,1783.0,568,224,79,322,401,38,39,108,155,224,494,0.4534412955465587,5,33,0.1515151515151515,219,461,0.4750542299349241,0.459,115,149,0.7718120805369127
Mike Miller,millemi01,SG,26,MEM,2007,70,2740.0,1293,298,52,326,378,54,18,179,138,465,1010,0.4603960396039604,202,498,0.4056224899598393,263,512,0.513671875,0.56,161,203,0.7931034482758621
Paul Millsap,millspa01,PF,21,UTA,2007,82,1472.0,559,62,183,240,423,67,74,94,236,209,398,0.5251256281407035,1,3,0.3333333333333333,208,395,0.5265822784810127,0.526,140,208,0.6730769230769231
Yao Ming,mingya01,C,26,HOU,2007,48,1624.0,1202,94,101,351,452,17,94,167,159,423,819,0.5164835164835165,0,2,0.0,423,817,0.5177478580171359,0.516,356,413,0.8619854721549637
Cuttino Mobley,moblecu01,SG,31,LAC,2007,78,2841.0,1077,198,52,215,267,92,24,145,186,388,882,0.4399092970521542,101,246,0.4105691056910569,287,636,0.4512578616352201,0.497,200,239,0.8368200836820083
Nazr Mohammed,mohamna01,C,29,DET,2007,51,773.0,286,9,89,140,229,27,40,43,133,118,222,0.5315315315315315,0,0,0.0,118,222,0.5315315315315315,0.532,50,82,0.6097560975609756
Mikki Moore,mooremi01,C,31,NJN,2007,79,2082.0,776,74,145,258,403,46,60,113,261,308,506,0.6086956521739131,0,1,0.0,308,505,0.6099009900990099,0.609,160,235,0.6808510638297872
Randolph Morris,morrira01,C,21,NYK,2007,5,44.0,4,1,1,8,9,2,1,2,4,1,6,0.1666666666666666,0,0,0.0,1,6,0.1666666666666666,0.167,2,6,0.3333333333333333
Adam Morrison,morriad01,PF,22,CHA,2007,78,2326.0,917,163,54,176,230,28,6,130,179,355,944,0.3760593220338983,87,258,0.3372093023255814,268,686,0.39067055393586,0.422,120,169,0.7100591715976331
Alonzo Mourning,mournal01,C,36,MIA,2007,77,1572.0,661,18,126,224,350,13,178,129,219,238,425,0.56,0,0,0.0,238,425,0.56,0.56,185,308,0.6006493506493507
Troy Murphy,murphtr01,PF,26,TOT,2007,68,1852.0,698,126,100,314,414,46,42,78,196,266,581,0.4578313253012048,58,147,0.3945578231292517,208,434,0.4792626728110599,0.508,108,145,0.7448275862068966
Ronald Murray,murraro01,SG,27,DET,2007,69,1477.0,465,187,26,87,113,49,13,90,96,177,438,0.4041095890410959,24,83,0.2891566265060241,153,355,0.4309859154929577,0.432,87,120,0.725
Dikembe Mutombo,mutomdi01,C,40,HOU,2007,75,1289.0,230,13,164,324,488,22,76,38,156,85,153,0.5555555555555556,0,0,0.0,85,153,0.5555555555555556,0.556,60,87,0.6896551724137931
Boštjan Nachbar,nachbbo01,SF,26,NJN,2007,76,1532.0,696,61,27,226,253,30,26,69,183,226,495,0.4565656565656565,112,265,0.4226415094339623,114,230,0.4956521739130435,0.57,132,164,0.8048780487804879
Eduardo Nájera,najered01,PF,30,DEN,2007,75,1658.0,497,64,131,179,310,73,26,56,207,204,354,0.576271186440678,1,12,0.0833333333333333,203,342,0.5935672514619883,0.578,88,123,0.7154471544715447
Steve Nash,nashst01,PG,32,PHO,2007,76,2682.0,1412,884,30,239,269,57,6,287,117,517,971,0.5324407826982492,156,343,0.4548104956268221,361,628,0.5748407643312102,0.613,222,247,0.8987854251012146
Jameer Nelson,nelsoja01,PG,24,ORL,2007,77,2331.0,1000,330,50,186,236,73,5,184,225,376,875,0.4297142857142857,65,194,0.3350515463917525,311,681,0.4566813509544787,0.467,183,221,0.8280542986425339
Rasho Nesterović,nestera01,C,30,TOR,2007,80,1676.0,494,74,115,245,360,37,84,56,193,230,421,0.5463182897862233,0,1,0.0,230,420,0.5476190476190477,0.546,34,50,0.68
Ira Newble,newblir01,SF,32,CLE,2007,15,129.0,46,2,13,17,30,6,0,3,17,16,37,0.4324324324324324,8,15,0.5333333333333333,8,22,0.3636363636363636,0.541,6,10,0.6
Andrés Nocioni,nocioan01,PF,27,CHI,2007,53,1406.0,749,57,42,259,301,27,24,104,164,273,584,0.4674657534246575,80,209,0.3827751196172249,193,375,0.5146666666666667,0.536,123,145,0.8482758620689655
David Noel,noelda01,PF,22,MIL,2007,68,792.0,184,65,42,81,123,25,9,40,77,65,177,0.3672316384180791,17,53,0.320754716981132,48,124,0.3870967741935484,0.415,37,43,0.8604651162790697
Steve Novak,novakst01,SF,23,HOU,2007,35,191.0,51,6,4,22,26,5,0,4,21,18,50,0.36,13,39,0.3333333333333333,5,11,0.4545454545454545,0.49,2,2,1.0
Dirk Nowitzki,nowitdi01,PF,28,DAL,2007,78,2820.0,1916,263,122,571,693,52,62,167,171,673,1341,0.5018642803877703,72,173,0.4161849710982659,601,1168,0.514554794520548,0.529,498,551,0.9038112522686026
Patrick O'Bryant,obryapa01,C,20,GSW,2007,16,119.0,31,9,7,14,21,6,8,8,26,10,32,0.3125,0,0,0.0,10,32,0.3125,0.313,11,17,0.6470588235294118
Jermaine O'Neal,onealje01,C,28,IND,2007,69,2459.0,1339,167,153,508,661,50,182,203,232,498,1141,0.4364592462751972,0,7,0.0,498,1134,0.4391534391534391,0.436,343,447,0.767337807606264
Shaquille O'Neal,onealsh01,C,34,MIA,2007,40,1135.0,690,79,97,200,297,8,55,95,139,283,479,0.5908141962421712,0,0,0.0,283,479,0.5908141962421712,0.591,124,294,0.4217687074829932
Fabricio Oberto,obertfa01,C,31,SAS,2007,79,1365.0,349,68,131,237,368,25,24,69,213,158,281,0.5622775800711743,0,0,0.0,158,281,0.5622775800711743,0.562,33,51,0.6470588235294118
Lamar Odom,odomla01,PF,27,LAL,2007,56,2202.0,890,270,102,445,547,53,32,163,182,319,681,0.4684287812041116,54,182,0.2967032967032967,265,499,0.531062124248497,0.508,198,283,0.6996466431095406
Emeka Okafor,okafoem01,C,24,CHA,2007,67,2329.0,963,80,258,499,757,57,172,111,210,394,740,0.5324324324324324,0,0,0.0,394,740,0.5324324324324324,0.532,175,295,0.5932203389830508
Mehmet Okur,okurme01,C,27,UTA,2007,80,2664.0,1405,156,160,419,579,36,38,125,257,490,1061,0.4618284637134778,129,336,0.3839285714285714,361,725,0.4979310344827586,0.523,296,387,0.7648578811369509
Kevin Ollie,ollieke01,PG,34,PHI,2007,53,919.0,199,130,8,66,74,21,1,47,76,81,187,0.4331550802139037,0,2,0.0,81,185,0.4378378378378378,0.433,37,45,0.8222222222222222
Michael Olowokandi,olowomi01,C,31,BOS,2007,24,234.0,40,5,14,34,48,8,13,17,48,19,46,0.4130434782608695,0,0,0.0,19,46,0.4130434782608695,0.413,2,3,0.6666666666666666
Bo Outlaw,outlabo01,PF,35,ORL,2007,41,460.0,81,16,47,59,106,17,6,21,57,34,51,0.6666666666666666,0,0,0.0,34,51,0.6666666666666666,0.667,13,22,0.5909090909090909
Travis Outlaw,outlatr01,PF,22,POR,2007,67,1532.0,645,52,65,152,217,61,74,66,150,246,567,0.4338624338624338,10,37,0.2702702702702703,236,530,0.4452830188679245,0.443,143,181,0.7900552486187845
Zaza Pachulia,pachuza01,C,22,ATL,2007,72,2026.0,875,106,199,301,500,77,36,162,267,291,614,0.4739413680781759,0,1,0.0,291,613,0.4747145187601957,0.474,293,373,0.7855227882037533
Scott Padgett,padgesc01,PF,30,TOT,2007,31,231.0,46,8,16,38,54,5,3,9,35,16,56,0.2857142857142857,8,33,0.2424242424242424,8,23,0.3478260869565217,0.357,6,13,0.4615384615384615
Jannero Pargo,pargoja01,PG,27,NOK,2007,82,1710.0,751,203,20,160,180,53,4,122,121,283,692,0.4089595375722543,81,209,0.3875598086124402,202,483,0.4182194616977225,0.467,104,122,0.8524590163934426
Anthony Parker,parkean01,SG,31,TOR,2007,73,2437.0,903,153,60,223,283,73,11,71,135,328,687,0.4774381368267831,115,261,0.4406130268199233,213,426,0.5,0.561,132,158,0.8354430379746836
Smush Parker,parkesm01,PG,25,LAL,2007,82,2457.0,907,228,45,161,206,119,10,153,211,342,785,0.4356687898089172,110,301,0.3654485049833887,232,484,0.4793388429752066,0.506,113,175,0.6457142857142857
Tony Parker,parketo01,PG,24,SAS,2007,77,2499.0,1429,420,34,216,250,82,6,191,137,570,1096,0.5200729927007299,15,38,0.3947368421052631,555,1058,0.5245746691871456,0.527,274,350,0.7828571428571428
Ruben Patterson,patteru01,SF,31,MIL,2007,81,2508.0,1194,232,190,250,440,110,25,199,232,475,867,0.5478662053056517,3,19,0.1578947368421052,472,848,0.5566037735849056,0.55,241,376,0.6409574468085106
Chris Paul,paulch01,PG,21,NOK,2007,64,2353.0,1104,569,54,226,280,118,3,161,154,381,871,0.4374282433983926,50,143,0.3496503496503496,331,728,0.4546703296703296,0.466,292,357,0.8179271708683473
Sasha Pavlović,pavloal01,SG,23,CLE,2007,67,1534.0,604,105,23,135,158,55,17,102,145,222,490,0.4530612244897959,60,148,0.4054054054054054,162,342,0.4736842105263157,0.514,100,126,0.7936507936507936
Gary Payton,paytoga01,PG,38,MIA,2007,68,1503.0,358,201,18,114,132,43,3,66,117,144,366,0.3934426229508196,32,123,0.2601626016260163,112,243,0.4609053497942387,0.437,38,57,0.6666666666666666
Kendrick Perkins,perkike01,C,22,BOS,2007,72,1576.0,324,94,113,259,372,23,96,113,214,132,269,0.4907063197026022,0,3,0.0,132,266,0.4962406015037593,0.491,60,100,0.6
Morris Peterson,petermo01,SF,29,TOR,2007,71,1515.0,634,47,32,205,237,45,12,53,126,222,517,0.4294003868471953,106,295,0.3593220338983051,116,222,0.5225225225225225,0.532,84,123,0.6829268292682927
Johan Petro,petrojo01,C,21,SEA,2007,81,1510.0,502,45,92,243,335,39,47,82,237,226,438,0.5159817351598174,0,0,0.0,226,438,0.5159817351598174,0.516,50,77,0.6493506493506493
Eric Piatkowski,piatker01,SG,36,PHO,2007,11,73.0,27,4,2,7,9,0,1,5,6,9,25,0.36,7,18,0.3888888888888889,2,7,0.2857142857142857,0.5,2,2,1.0
Paul Pierce,piercpa01,SG,29,BOS,2007,47,1740.0,1173,194,39,238,277,48,13,152,122,373,850,0.4388235294117647,107,275,0.3890909090909091,266,575,0.4626086956521739,0.502,320,402,0.7960199004975125
Mickaël Piétrus,pietrmi01,SF,24,GSW,2007,72,1937.0,801,62,81,246,327,48,55,105,220,286,586,0.4880546075085324,93,240,0.3875,193,346,0.5578034682080925,0.567,136,210,0.6476190476190476
Kevinn Pinkney,pinknke01,PF,23,BOS,2007,6,100.0,31,5,7,8,15,3,3,4,12,12,27,0.4444444444444444,1,2,0.5,11,25,0.44,0.463,6,9,0.6666666666666666
Scot Pollard,pollasc01,C,31,CLE,2007,24,109.0,24,3,15,16,31,4,1,4,27,11,26,0.4230769230769231,0,0,0.0,11,26,0.4230769230769231,0.423,2,4,0.5
James Posey,poseyja01,SF,30,MIA,2007,71,1919.0,550,94,66,291,357,71,23,55,193,186,432,0.4305555555555556,97,259,0.3745173745173745,89,173,0.5144508670520231,0.543,81,98,0.826530612244898
Vitaly Potapenko,potapvi01,C,31,SAC,2007,3,13.0,0,0,0,2,2,0,0,2,3,0,4,0.0,0,0,0.0,0,4,0.0,0.0,0,0,0.0
Leon Powe,powele01,C,23,BOS,2007,63,720.0,264,10,97,118,215,14,22,47,104,79,177,0.4463276836158192,0,2,0.0,79,175,0.4514285714285714,0.446,106,144,0.7361111111111112
Josh Powell,poweljo01,PF,24,TOT,2007,37,353.0,116,21,24,64,88,5,12,29,61,43,93,0.4623655913978494,0,0,0.0,43,93,0.4623655913978494,0.462,30,42,0.7142857142857143
Roger Powell,powelro01,SF,24,UTA,2007,3,13.0,2,0,3,0,3,0,0,3,2,0,3,0.0,0,1,0.0,0,2,0.0,0.0,2,2,1.0
Ronnie Price,pricero01,PG,23,SAC,2007,58,563.0,192,48,15,56,71,28,4,33,64,67,172,0.3895348837209302,21,65,0.3230769230769231,46,107,0.4299065420560747,0.451,37,55,0.6727272727272727
Tayshaun Prince,princta01,SF,26,DET,2007,82,3001.0,1171,227,144,285,429,51,55,98,116,459,997,0.4603811434302908,81,210,0.3857142857142857,378,787,0.4803049555273189,0.501,172,224,0.7678571428571429
Joel Przybilla,przybjo01,C,27,POR,2007,43,701.0,84,12,59,109,168,10,67,40,124,37,78,0.4743589743589743,0,0,0.0,37,78,0.4743589743589743,0.474,10,27,0.3703703703703703
Chris Quinn,quinnch01,PG,23,MIA,2007,42,408.0,141,65,6,24,30,15,0,21,32,48,131,0.366412213740458,20,57,0.3508771929824561,28,74,0.3783783783783784,0.443,25,37,0.6756756756756757
Vladimir Radmanović,radmavl01,PF,26,LAL,2007,55,986.0,361,66,53,127,180,25,18,69,125,134,316,0.4240506329113924,40,118,0.3389830508474576,94,198,0.4747474747474747,0.487,53,73,0.726027397260274
Shavlik Randolph,randosh01,PF,23,PHI,2007,13,179.0,58,4,19,35,54,7,10,9,23,23,48,0.4791666666666667,0,0,0.0,23,48,0.4791666666666667,0.479,12,22,0.5454545454545454
Zach Randolph,randoza01,PF,25,POR,2007,68,2425.0,1608,147,199,489,688,53,15,215,184,600,1286,0.4665629860031104,14,48,0.2916666666666667,586,1238,0.4733441033925686,0.472,394,481,0.8191268191268192
Theo Ratliff,ratlith01,C,33,BOS,2007,2,44.0,5,0,2,5,7,1,3,1,6,1,3,0.3333333333333333,0,0,0.0,1,3,0.3333333333333333,0.333,3,4,0.75
Allan Ray,rayal01,SG,22,BOS,2007,47,710.0,290,43,18,51,69,20,3,42,85,100,259,0.3861003861003861,48,116,0.4137931034482758,52,143,0.3636363636363636,0.479,42,55,0.7636363636363637
Michael Redd,reddmi01,SF,27,MIL,2007,53,2036.0,1416,124,42,154,196,63,9,122,78,477,1025,0.4653658536585366,117,306,0.3823529411764705,360,719,0.5006954102920723,0.522,345,416,0.8293269230769231
J.J. Redick,redicjj01,PG,22,ORL,2007,42,622.0,252,36,10,42,52,12,0,21,52,80,195,0.4102564102564102,38,98,0.3877551020408163,42,97,0.4329896907216495,0.508,54,60,0.9
Justin Reed,reedju01,PF,25,MIN,2007,41,318.0,106,17,15,31,46,5,3,22,44,40,107,0.3738317757009345,0,0,0.0,40,107,0.3738317757009345,0.374,26,30,0.8666666666666667
Jared Reiner,reineja01,C,24,MIL,2007,27,244.0,33,13,21,50,71,5,6,14,45,15,43,0.3488372093023256,0,0,0.0,15,43,0.3488372093023256,0.349,3,10,0.3
Jason Richardson,richaja01,SG,26,GSW,2007,51,1675.0,814,172,71,188,259,54,32,82,129,306,734,0.4168937329700272,110,301,0.3654485049833887,196,433,0.4526558891454965,0.492,92,140,0.6571428571428571
Jeremy Richardson,richaje01,SG-SF,22,TOT,2007,6,20.0,8,0,1,1,2,1,0,1,2,3,6,0.5,2,3,0.6666666666666666,1,3,0.3333333333333333,0.667,0,0,0.0
Quentin Richardson,richaqu01,SF,26,NYK,2007,49,1621.0,636,108,65,287,352,36,7,70,133,228,545,0.418348623853211,97,258,0.375968992248062,131,287,0.4564459930313589,0.507,83,120,0.6916666666666667
Luke Ridnour,ridnolu01,PG,25,SEA,2007,71,2091.0,779,368,28,136,164,83,19,156,181,301,695,0.4330935251798561,49,139,0.3525179856115107,252,556,0.4532374100719424,0.468,128,159,0.8050314465408805
Anthony Roberson,roberan02,PG,23,GSW,2007,20,227.0,111,10,2,19,21,12,0,13,27,44,104,0.4230769230769231,21,55,0.3818181818181818,23,49,0.4693877551020408,0.524,2,3,0.6666666666666666
Lawrence Roberts,roberla01,PF,24,MEM,2007,54,969.0,283,30,101,160,261,36,13,36,133,94,208,0.4519230769230769,0,2,0.0,94,206,0.4563106796116505,0.452,95,131,0.7251908396946565
Bernard Robinson,robinbe01,SG-SF,26,TOT,2007,31,278.0,61,19,10,38,48,17,2,16,32,19,62,0.3064516129032258,0,2,0.0,19,60,0.3166666666666666,0.306,23,27,0.8518518518518519
Clifford Robinson,robincl02,C,40,NJN,2007,50,955.0,203,51,31,91,122,12,23,30,98,81,218,0.3715596330275229,25,66,0.3787878787878788,56,152,0.3684210526315789,0.429,16,36,0.4444444444444444
Nate Robinson,robinna01,PG,22,NYK,2007,64,1356.0,645,90,55,97,152,50,6,72,160,227,523,0.4340344168260038,83,213,0.3896713615023474,144,310,0.4645161290322581,0.513,108,139,0.7769784172661871
Sergio Rodríguez,rodrise01,PG,20,POR,2007,67,862.0,247,218,20,71,91,35,2,77,72,101,239,0.4225941422594142,24,85,0.2823529411764706,77,154,0.5,0.473,21,26,0.8076923076923077
Rajon Rondo,rondora01,PG,20,BOS,2007,78,1831.0,501,297,74,218,292,128,8,137,181,188,450,0.4177777777777778,6,29,0.2068965517241379,182,421,0.4323040380047506,0.424,119,184,0.6467391304347826
Jalen Rose,roseja01,SF,34,PHO,2007,29,246.0,108,16,3,20,23,5,2,9,22,38,86,0.4418604651162791,21,47,0.4468085106382978,17,39,0.4358974358974359,0.564,11,12,0.9166666666666666
Malik Rose,rosema01,PF,32,NYK,2007,65,810.0,192,65,47,128,175,26,9,65,120,74,186,0.3978494623655914,2,8,0.25,72,178,0.4044943820224719,0.403,42,52,0.8076923076923077
Quinton Ross,rossqu01,SG,25,LAC,2007,81,1700.0,424,86,60,130,190,70,32,33,179,177,379,0.467018469656992,2,10,0.2,175,369,0.4742547425474255,0.47,68,87,0.7816091954022989
Brandon Roy,roybr01,SG,22,POR,2007,57,2015.0,955,230,58,192,250,67,10,116,139,349,765,0.4562091503267974,55,146,0.3767123287671233,294,619,0.4749596122778675,0.492,202,241,0.8381742738589212
Michael Ruffin,ruffimi01,PF,30,WAS,2007,30,271.0,17,6,35,27,62,6,8,12,43,5,18,0.2777777777777778,0,0,0.0,5,18,0.2777777777777778,0.278,7,19,0.3684210526315789
John Salmons,salmojo01,SG,27,SAC,2007,79,2135.0,671,254,47,217,264,73,27,119,177,236,517,0.4564796905222437,40,112,0.3571428571428571,196,405,0.4839506172839506,0.495,159,204,0.7794117647058824
Jamal Sampson,sampsja01,C,23,DEN,2007,22,125.0,24,5,15,33,48,2,7,10,17,9,14,0.6428571428571429,0,1,0.0,9,13,0.6923076923076923,0.643,6,14,0.4285714285714285
Brian Scalabrine,scalabr01,PF,28,BOS,2007,54,1027.0,216,59,24,81,105,23,18,44,130,77,191,0.4031413612565445,44,110,0.4,33,81,0.4074074074074074,0.518,18,23,0.782608695652174
Luke Schenscher,schenlu01,C,24,POR,2007,11,118.0,19,1,10,15,25,2,4,4,25,7,23,0.3043478260869565,0,0,0.0,7,23,0.3043478260869565,0.304,5,7,0.7142857142857143
Thabo Sefolosha,sefolth01,SG,22,CHI,2007,71,868.0,256,60,35,118,153,33,11,60,100,109,256,0.42578125,15,42,0.3571428571428571,94,214,0.4392523364485981,0.455,23,45,0.5111111111111111
Mouhamed Sene,senesa01,C,20,SEA,2007,28,169.0,53,0,16,29,45,3,12,11,33,18,49,0.3673469387755102,0,0,0.0,18,49,0.3673469387755102,0.367,17,29,0.5862068965517241
Wayne Simien,simiewa01,PF,23,MIA,2007,8,93.0,23,4,5,6,11,2,0,3,13,9,23,0.391304347826087,0,0,0.0,9,23,0.391304347826087,0.391,5,7,0.7142857142857143
Cedric Simmons,simmoce01,PF,21,NOK,2007,43,534.0,126,12,44,63,107,8,23,22,75,55,132,0.4166666666666667,0,0,0.0,55,132,0.4166666666666667,0.417,16,33,0.4848484848484848
James Singleton,singlja01,PF,25,LAC,2007,53,376.0,85,17,36,70,106,15,17,17,45,30,82,0.3658536585365853,3,14,0.2142857142857142,27,68,0.3970588235294117,0.384,22,29,0.7586206896551724
Brian Skinner,skinnbr01,PF,30,MIL,2007,67,1523.0,294,58,106,279,385,18,64,75,195,124,253,0.4901185770750988,0,0,0.0,124,253,0.4901185770750988,0.49,46,79,0.5822784810126582
Uroš Slokar,slokaur01,C,23,TOR,2007,20,72.0,38,1,7,7,14,1,2,9,11,14,26,0.5384615384615384,1,2,0.5,13,24,0.5416666666666666,0.558,9,13,0.6923076923076923
Craig Smith,smithcr01,PF,23,MIN,2007,82,1537.0,608,49,149,267,416,51,18,74,223,246,463,0.531317494600432,0,6,0.0,246,457,0.5382932166301969,0.531,116,186,0.6236559139784946
J.R. Smith,smithjr01,SG,21,DEN,2007,63,1471.0,819,91,30,113,143,49,9,85,147,284,644,0.4409937888198758,149,382,0.3900523560209424,135,262,0.5152671755725191,0.557,102,126,0.8095238095238095
Joe Smith,smithjo02,PF,31,TOT,2007,65,1503.0,553,49,120,280,400,37,27,76,148,214,477,0.4486373165618448,0,5,0.0,214,472,0.4533898305084746,0.449,125,148,0.8445945945945946
Josh Smith,smithjo03,SF,21,ATL,2007,72,2647.0,1178,236,165,456,621,101,207,227,241,436,993,0.4390735146022155,38,152,0.25,398,841,0.4732461355529131,0.458,268,387,0.6925064599483204
Steven Smith,smithst03,PF,23,PHI,2007,8,28.0,5,0,1,5,6,1,0,2,4,2,8,0.25,0,0,0.0,2,8,0.25,0.25,1,2,0.5
Eric Snow,snower01,PG,33,CLE,2007,82,1929.0,342,330,35,153,188,55,16,111,185,135,324,0.4166666666666667,0,4,0.0,135,320,0.421875,0.417,72,113,0.6371681415929203
Kirk Snyder,snydeki01,SF,23,HOU,2007,39,563.0,192,39,17,66,83,11,12,26,51,66,146,0.4520547945205479,11,44,0.25,55,102,0.5392156862745098,0.49,49,75,0.6533333333333333
Darius Songaila,songada01,PF,28,WAS,2007,37,700.0,282,38,44,90,134,17,10,43,105,118,225,0.5244444444444445,0,2,0.0,118,223,0.5291479820627802,0.524,46,54,0.8518518518518519
Pape Sow,sowpa01,C,25,TOR,2007,7,34.0,10,2,6,5,11,1,1,1,2,3,9,0.3333333333333333,0,0,0.0,3,9,0.3333333333333333,0.333,4,6,0.6666666666666666
Vassilis Spanoulis,spanova01,SG,24,HOU,2007,31,272.0,85,28,5,17,22,7,1,29,33,23,72,0.3194444444444444,5,29,0.1724137931034483,18,43,0.4186046511627907,0.354,34,42,0.8095238095238095
Jerry Stackhouse,stackje01,SF,32,DAL,2007,67,1615.0,804,187,39,106,145,51,10,117,78,280,654,0.4281345565749235,62,162,0.382716049382716,218,492,0.4430894308943089,0.476,182,215,0.8465116279069768
DeShawn Stevenson,stevede01,SG,25,WAS,2007,82,2419.0,920,218,55,161,216,65,19,119,155,347,753,0.4608233731739707,74,183,0.4043715846994535,273,570,0.4789473684210526,0.51,152,216,0.7037037037037037
Peja Stojaković,stojape01,SF,29,NOK,2007,13,425.0,231,11,11,43,54,8,4,19,29,83,196,0.423469387755102,34,84,0.4047619047619047,49,112,0.4375,0.51,31,38,0.8157894736842105
Damon Stoudamire,stoudda01,PG,33,MEM,2007,62,1501.0,467,299,31,108,139,47,2,101,95,171,437,0.391304347826087,59,175,0.3371428571428571,112,262,0.4274809160305343,0.459,66,83,0.7951807228915663
Salim Stoudamire,stoudsa01,SG,24,ATL,2007,61,1034.0,471,61,6,68,74,21,2,55,88,177,425,0.4164705882352941,56,155,0.3612903225806451,121,270,0.4481481481481481,0.482,61,68,0.8970588235294118
Amar'e Stoudemire,stoudam01,C,24,PHO,2007,82,2689.0,1671,84,222,564,786,78,110,232,295,607,1055,0.5753554502369668,0,3,0.0,607,1052,0.5769961977186312,0.575,457,585,0.7811965811965812
Mike Sweetney,sweetmi01,C,24,CHI,2007,48,385.0,153,28,45,75,120,9,11,42,79,58,134,0.4328358208955223,0,0,0.0,58,134,0.4328358208955223,0.433,37,66,0.5606060606060606
Stromile Swift,swiftst01,C,27,MEM,2007,54,1029.0,419,17,85,165,250,30,62,69,146,161,346,0.4653179190751445,0,5,0.0,161,341,0.4721407624633431,0.465,97,134,0.7238805970149254
Wally Szczerbiak,szczewa02,SF,29,BOS,2007,32,900.0,479,55,16,82,98,18,3,54,65,161,388,0.4149484536082474,44,106,0.4150943396226415,117,282,0.4148936170212766,0.472,113,126,0.8968253968253969
Donell Taylor,taylodo01,SG,24,WAS,2007,47,369.0,126,45,14,39,53,17,3,25,34,56,140,0.4,3,17,0.1764705882352941,53,123,0.4308943089430894,0.411,11,21,0.5238095238095238
Maurice Taylor,tayloma01,PF,30,SAC,2007,12,103.0,24,5,10,18,28,4,1,6,16,8,28,0.2857142857142857,0,0,0.0,8,28,0.2857142857142857,0.286,8,13,0.6153846153846154
Sebastian Telfair,telfase01,PG,21,BOS,2007,78,1578.0,479,218,17,91,108,43,11,98,166,176,474,0.3713080168776371,37,128,0.2890625,139,346,0.4017341040462427,0.41,90,110,0.8181818181818182
Jason Terry,terryja01,SG,29,DAL,2007,81,2846.0,1350,422,41,190,231,81,17,152,170,514,1063,0.4835371589840075,162,370,0.4378378378378378,352,693,0.5079365079365079,0.56,160,199,0.8040201005025126
Etan Thomas,thomaet01,C,28,WAS,2007,65,1246.0,395,29,136,241,377,22,89,71,162,159,277,0.5740072202166066,0,0,0.0,159,277,0.5740072202166066,0.574,77,138,0.5579710144927537
Kenny Thomas,thomake01,PF,29,SAC,2007,62,1412.0,331,76,134,243,377,43,16,90,141,146,303,0.4818481848184818,0,1,0.0,146,302,0.4834437086092715,0.482,39,76,0.5131578947368421
Kurt Thomas,thomaku01,C,34,PHO,2007,67,1208.0,308,24,86,293,379,24,29,35,156,126,259,0.4864864864864865,0,1,0.0,126,258,0.4883720930232558,0.486,56,71,0.7887323943661971
Tim Thomas,thomati01,PF,29,LAC,2007,76,2054.0,836,171,63,315,378,55,28,106,228,299,723,0.4135546334716459,136,356,0.3820224719101123,163,367,0.444141689373297,0.508,102,144,0.7083333333333334
Tyrus Thomas,thomaty01,PF,20,CHI,2007,72,966.0,374,40,89,180,269,46,76,94,162,134,282,0.475177304964539,0,2,0.0,134,280,0.4785714285714286,0.475,106,175,0.6057142857142858
Dijon Thompson,thompdi01,SF,23,ATL,2007,6,50.0,17,2,3,5,8,0,0,1,2,6,15,0.4,0,2,0.0,6,13,0.4615384615384615,0.4,5,6,0.8333333333333334
Jamaal Tinsley,tinslja01,PG,28,IND,2007,72,2243.0,925,494,60,180,240,117,25,200,190,346,889,0.3892013498312711,61,193,0.3160621761658031,285,696,0.4094827586206896,0.424,172,239,0.7196652719665272
Jake Tsakalidis,tsakaja01,C,27,TOT,2007,36,390.0,84,5,42,62,104,8,12,24,51,29,72,0.4027777777777778,0,0,0.0,29,72,0.4027777777777778,0.403,26,39,0.6666666666666666
P.J. Tucker,tuckepj01,SF,21,TOR,2007,17,83.0,30,3,11,12,23,2,0,6,12,11,22,0.5,0,0,0.0,11,22,0.5,0.5,8,14,0.5714285714285714
Ronny Turiaf,turiaro01,C,24,LAL,2007,72,1087.0,383,63,88,171,259,17,78,52,202,147,268,0.5485074626865671,0,1,0.0,147,267,0.550561797752809,0.549,89,134,0.664179104477612
Hedo Türkoğlu,turkohe01,SF,27,ORL,2007,73,2268.0,970,233,57,236,293,70,16,143,221,345,823,0.4191980558930741,109,281,0.3879003558718861,236,542,0.4354243542435424,0.485,171,219,0.7808219178082192
Ime Udoka,udokaim01,SF,29,POR,2007,75,2144.0,629,112,95,184,279,71,17,73,207,237,514,0.4610894941634241,89,219,0.4063926940639269,148,295,0.5016949152542373,0.548,66,89,0.7415730337078652
Beno Udrih,udrihbe01,PG,24,SAS,2007,73,948.0,340,122,11,71,82,27,1,56,70,127,344,0.3691860465116279,33,115,0.2869565217391304,94,229,0.4104803493449782,0.417,53,60,0.8833333333333333
Anderson Varejão,varejan01,C,24,CLE,2007,81,1932.0,547,75,191,354,545,76,52,67,269,191,401,0.4763092269326683,0,9,0.0,191,392,0.4872448979591837,0.476,165,268,0.6156716417910447
Jacque Vaughn,vaughja01,PG,31,SAS,2007,64,760.0,192,131,8,60,68,24,2,40,74,71,167,0.4251497005988024,1,2,0.5,70,165,0.4242424242424242,0.428,49,65,0.7538461538461538
Charlie Villanueva,villach01,PF,22,MIL,2007,39,984.0,462,36,62,166,228,24,12,54,108,180,383,0.4699738903394256,29,86,0.3372093023255814,151,297,0.5084175084175084,0.508,73,89,0.8202247191011236
Marcus Vinicius,vincima01,SF,22,NOK,2007,13,103.0,22,5,2,9,11,2,1,6,10,7,15,0.4666666666666667,3,7,0.4285714285714285,4,8,0.5,0.567,5,7,0.7142857142857143
Jake Voskuhl,voskuja01,C,29,CHA,2007,73,1043.0,319,44,84,172,256,30,24,56,199,121,255,0.4745098039215686,0,0,0.0,121,255,0.4745098039215686,0.475,77,113,0.6814159292035398
Sasha Vujačić,vujacsa01,SG,22,LAL,2007,73,935.0,313,64,28,79,107,41,1,30,103,105,268,0.3917910447761194,60,161,0.3726708074534161,45,107,0.4205607476635514,0.504,43,49,0.8775510204081632
Dwyane Wade,wadedw01,SG,25,MIA,2007,51,1931.0,1397,384,51,188,239,107,62,216,117,472,962,0.4906444906444906,21,79,0.2658227848101265,451,883,0.5107587768969423,0.502,432,535,0.8074766355140187
Von Wafer,wafervo01,SF,21,LAC,2007,1,1.0,0,0,0,0,0,0,0,0,0,0,1,0.0,0,1,0.0,0,0,0.0,0.0,0,0,0.0
Dajuan Wagner,wagneda02,SG,23,GSW,2007,1,7.0,4,1,0,0,0,0,0,1,1,1,1,1.0,1,1,1.0,0,0,0.0,1.5,1,2,0.5
Antoine Walker,walkean02,PF,30,MIA,2007,78,1818.0,660,130,92,247,339,48,17,141,173,265,668,0.3967065868263473,84,305,0.2754098360655738,181,363,0.4986225895316804,0.46,46,105,0.4380952380952381
Ben Wallace,wallabe01,C,32,CHI,2007,77,2697.0,494,186,303,518,821,111,156,101,153,192,424,0.4528301886792453,1,5,0.2,191,419,0.4558472553699284,0.454,109,267,0.4082397003745318
Gerald Wallace,wallage01,SF,24,CHA,2007,72,2640.0,1304,185,142,376,518,144,69,160,209,478,952,0.5021008403361344,39,120,0.325,439,832,0.5276442307692307,0.523,309,447,0.6912751677852349
Rasheed Wallace,wallara01,C,32,DET,2007,75,2419.0,926,127,90,453,543,75,118,94,225,357,843,0.4234875444839858,104,296,0.3513513513513513,253,547,0.4625228519195612,0.485,108,137,0.7883211678832117
Luke Walton,waltolu01,SF,26,LAL,2007,60,1982.0,684,257,87,215,302,60,21,118,117,264,557,0.473967684021544,48,124,0.3870967741935484,216,433,0.4988452655889145,0.517,108,145,0.7448275862068966
Hakim Warrick,warriha01,PF,24,MEM,2007,82,2152.0,1045,75,130,290,420,43,30,161,232,373,712,0.523876404494382,0,8,0.0,373,704,0.5298295454545454,0.524,299,388,0.770618556701031
Earl Watson,watsoea01,PG,27,SEA,2007,77,2152.0,726,437,34,151,185,99,23,167,152,263,687,0.3828238719068413,92,280,0.3285714285714285,171,407,0.4201474201474201,0.45,108,147,0.7346938775510204
Chris Webber,webbech01,PF,33,TOT,2007,61,1821.0,684,188,124,313,437,60,41,107,143,289,639,0.4522691705790297,4,11,0.3636363636363636,285,628,0.4538216560509554,0.455,102,160,0.6375
Martell Webster,webstma02,SF,20,POR,2007,82,1759.0,574,52,43,197,240,35,19,76,126,195,492,0.3963414634146341,91,250,0.364,104,242,0.4297520661157025,0.489,93,132,0.7045454545454546
Bonzi Wells,wellsbo01,SF,30,HOU,2007,28,590.0,217,31,26,94,120,24,13,57,62,85,207,0.4106280193236715,1,7,0.1428571428571428,84,200,0.42,0.413,46,82,0.5609756097560976
David Wesley,wesleda01,SG,36,CLE,2007,35,352.0,73,37,3,32,35,12,4,17,32,22,75,0.2933333333333333,9,38,0.2368421052631578,13,37,0.3513513513513513,0.353,20,28,0.7142857142857143
David West,westda01,PF,26,NOK,2007,52,1900.0,949,114,126,298,424,42,38,98,143,377,792,0.476010101010101,8,25,0.32,369,767,0.4810951760104302,0.481,187,227,0.8237885462555066
Delonte West,westde01,SG,23,BOS,2007,69,2219.0,845,304,32,176,208,74,34,140,152,306,717,0.4267782426778242,65,178,0.3651685393258427,241,539,0.4471243042671614,0.472,168,197,0.8527918781725888
James White,whiteja02,SG,24,SAS,2007,6,137.0,50,5,3,17,20,3,1,5,7,18,41,0.4390243902439024,2,7,0.2857142857142857,16,34,0.4705882352941176,0.463,12,15,0.8
Chris Wilcox,wilcoch01,PF,24,SEA,2007,82,2586.0,1106,82,178,451,629,70,38,127,248,433,819,0.5286935286935287,0,6,0.0,433,813,0.5325953259532595,0.529,240,351,0.6837606837606838
Damien Wilkins,wilkida02,SF,27,SEA,2007,82,2037.0,724,156,87,142,229,92,16,116,157,262,602,0.4352159468438538,50,122,0.4098360655737705,212,480,0.4416666666666666,0.477,150,170,0.8823529411764706
Mike Wilks,wilksmi01,PG,27,SEA,2007,47,534.0,170,79,15,39,54,15,4,31,53,66,141,0.4680851063829787,5,15,0.3333333333333333,61,126,0.4841269841269841,0.486,33,42,0.7857142857142857
Aaron Williams,williaa01,PF,35,LAC,2007,38,374.0,76,7,27,58,85,7,14,18,56,29,53,0.5471698113207547,0,1,0.0,29,52,0.5576923076923077,0.547,18,22,0.8181818181818182
Alvin Williams,willial02,PG,32,LAC,2007,2,10.0,2,3,1,0,1,2,0,3,0,0,2,0.0,0,1,0.0,0,1,0.0,0.0,2,4,0.5
Deron Williams,willide01,PG,22,UTA,2007,80,2950.0,1297,745,41,226,267,78,13,246,254,494,1083,0.4561403508771929,82,255,0.3215686274509804,412,828,0.4975845410628019,0.494,227,296,0.7668918918918919
Eric Williams,willier01,SF,34,TOT,2007,21,121.0,54,7,3,14,17,3,0,7,12,19,47,0.4042553191489361,8,19,0.4210526315789473,11,28,0.3928571428571428,0.489,8,14,0.5714285714285714
Jason Williams,willija02,PG,31,MIA,2007,61,1865.0,664,322,18,123,141,58,1,100,68,235,569,0.4130052724077329,100,295,0.3389830508474576,135,274,0.4927007299270073,0.501,94,103,0.912621359223301
Justin Williams,williju01,C,22,SAC,2007,26,333.0,131,2,51,64,115,5,16,15,51,54,88,0.6136363636363636,0,1,0.0,54,87,0.6206896551724138,0.614,23,63,0.365079365079365
Lou Williams,willilo02,PG,20,PHI,2007,61,688.0,262,110,17,53,70,22,1,46,42,93,211,0.4407582938388625,12,37,0.3243243243243243,81,174,0.4655172413793103,0.469,64,92,0.6956521739130435
Marcus Williams,willima03,PG,21,NJN,2007,79,1315.0,534,260,29,134,163,29,2,142,96,208,526,0.3954372623574144,46,163,0.2822085889570552,162,363,0.4462809917355372,0.439,72,85,0.8470588235294118
Marvin Williams,willima02,PF,20,ATL,2007,64,2179.0,839,121,84,253,337,52,30,127,191,306,706,0.43342776203966,11,45,0.2444444444444444,295,661,0.4462934947049924,0.441,216,265,0.8150943396226416
Mo Williams,willima01,PG,24,MIL,2007,68,2472.0,1174,416,54,275,329,85,6,203,201,468,1049,0.446139180171592,79,228,0.3464912280701754,389,821,0.4738124238733252,0.484,159,186,0.8548387096774194
Shammond Williams,willish01,PG,31,LAL,2007,30,345.0,94,31,11,29,40,12,0,13,20,35,86,0.4069767441860465,20,50,0.4,15,36,0.4166666666666667,0.523,4,6,0.6666666666666666
Shawne Williams,willish03,SG,20,IND,2007,46,556.0,180,22,33,50,83,6,8,24,69,75,160,0.46875,19,52,0.3653846153846153,56,108,0.5185185185185185,0.528,11,20,0.55
Shelden Williams,willish02,PF,23,ATL,2007,81,1514.0,444,44,131,304,435,52,39,96,199,166,365,0.4547945205479452,2,4,0.5,164,361,0.4542936288088642,0.458,110,144,0.7638888888888888
Corliss Williamson,willico02,PF,33,SAC,2007,68,1337.0,620,39,63,158,221,29,15,97,183,236,463,0.509719222462203,0,2,0.0,236,461,0.5119305856832972,0.51,148,207,0.714975845410628
Kevin Willis,willike02,PF,44,DAL,2007,5,43.0,12,1,2,6,8,2,1,2,11,5,13,0.3846153846153846,0,0,0.0,5,13,0.3846153846153846,0.385,2,2,1.0
Metta World Peace,artesro01,SF,27,SAC,2007,70,2641.0,1316,235,102,352,454,149,43,146,205,458,1040,0.4403846153846154,93,260,0.3576923076923077,365,780,0.4679487179487179,0.485,307,415,0.7397590361445783
Antoine Wright,wrighan01,SG,22,NJN,2007,63,1137.0,283,55,38,137,175,30,10,43,120,110,251,0.4382470119521912,19,59,0.3220338983050847,91,192,0.4739583333333333,0.476,44,73,0.6027397260273972
Bracey Wright,wrighbr02,SG,22,MIN,2007,19,190.0,67,15,7,14,21,9,1,6,6,24,60,0.4,6,20,0.3,18,40,0.45,0.45,13,18,0.7222222222222222
Dorell Wright,wrighdo01,SF,21,MIA,2007,66,1292.0,393,95,40,232,272,41,46,65,112,162,364,0.445054945054945,5,34,0.1470588235294117,157,330,0.4757575757575757,0.452,64,86,0.7441860465116279
Lorenzen Wright,wrighlo02,C,31,ATL,2007,67,1035.0,173,40,85,131,216,28,28,39,204,82,183,0.448087431693989,0,0,0.0,82,183,0.448087431693989,0.448,9,32,0.28125
Shareef Abdur-Rahim,abdursh01,PF,31,SAC,2008,6,51.0,10,4,6,4,10,1,0,1,9,3,14,0.2142857142857142,0,0,0.0,3,14,0.2142857142857142,0.214,4,4,1.0
Arron Afflalo,afflaar01,SG,22,DET,2008,75,970.0,276,52,36,101,137,31,8,34,83,99,241,0.4107883817427386,10,48,0.2083333333333333,89,193,0.4611398963730569,0.432,68,87,0.7816091954022989
Maurice Ager,agerma01,SG,23,TOT,2008,26,165.0,51,8,4,9,13,0,1,6,17,21,65,0.3230769230769231,3,19,0.1578947368421052,18,46,0.391304347826087,0.346,6,12,0.5
Blake Ahearn,ahearbl01,PG,23,MIA,2008,12,177.0,70,19,1,18,19,6,0,16,20,15,57,0.2631578947368421,10,34,0.2941176470588235,5,23,0.217391304347826,0.351,30,31,0.967741935483871
LaMarcus Aldridge,aldrila01,PF,22,POR,2008,76,2649.0,1350,122,220,358,578,55,94,126,240,561,1160,0.4836206896551724,1,7,0.1428571428571428,560,1153,0.4856895056374675,0.484,227,298,0.761744966442953
Malik Allen,allenma01,PF,29,TOT,2008,73,1096.0,338,44,66,130,196,19,31,45,149,157,327,0.4801223241590214,1,2,0.5,156,325,0.48,0.482,23,25,0.92
Ray Allen,allenra02,SG,32,BOS,2008,73,2624.0,1273,225,75,193,268,65,16,127,147,439,986,0.4452332657200811,180,452,0.3982300884955752,259,534,0.4850187265917603,0.537,215,237,0.9071729957805909
Tony Allen,allento01,SG,26,BOS,2008,75,1373.0,494,114,34,134,168,62,21,109,168,169,389,0.4344473007712082,18,57,0.3157894736842105,151,332,0.4548192771084337,0.458,138,181,0.7624309392265194
Lance Allred,allrela01,C,26,CLE,2008,3,10.0,3,0,0,1,1,0,0,0,1,1,4,0.25,0,0,0.0,1,4,0.25,0.25,1,2,0.5
Morris Almond,almonmo01,SG,22,UTA,2008,9,39.0,13,3,0,2,2,1,0,2,5,4,15,0.2666666666666666,1,4,0.25,3,11,0.2727272727272727,0.3,4,6,0.6666666666666666
Rafer Alston,alstora01,PG,31,HOU,2008,74,2526.0,969,392,28,232,260,98,18,160,139,364,924,0.3939393939393939,143,407,0.3513513513513513,221,517,0.4274661508704062,0.471,98,137,0.7153284671532847
Lou Amundson,amundlo01,PF,25,PHI,2008,16,64.0,18,0,7,5,12,1,1,2,13,8,16,0.5,0,0,0.0,8,16,0.5,0.5,2,7,0.2857142857142857
Chris Andersen,anderch01,C,29,NOH,2008,5,34.0,6,0,2,7,9,0,4,1,6,2,7,0.2857142857142857,0,0,0.0,2,7,0.2857142857142857,0.286,2,4,0.5
Derek Anderson,anderde01,SG,33,CHA,2008,28,396.0,141,44,9,43,52,12,1,25,49,47,125,0.376,19,52,0.3653846153846153,28,73,0.3835616438356164,0.452,28,38,0.7368421052631579
Carmelo Anthony,anthoca01,SF,23,DEN,2008,77,2806.0,1978,259,178,393,571,98,39,253,253,728,1481,0.4915597569209993,58,164,0.3536585365853658,670,1317,0.5087319665907365,0.511,464,590,0.7864406779661017
Joel Anthony,anthojo01,PF,25,MIA,2008,24,498.0,85,3,38,55,93,9,31,17,55,28,60,0.4666666666666667,0,0,0.0,28,60,0.4666666666666667,0.467,29,49,0.5918367346938775
Gilbert Arenas,arenagi01,PG,26,WAS,2008,13,425.0,252,66,6,45,51,23,1,49,30,78,196,0.3979591836734694,22,78,0.282051282051282,56,118,0.4745762711864407,0.454,74,96,0.7708333333333334
Trevor Ariza,arizatr01,SF,22,TOT,2008,35,546.0,192,44,30,78,108,31,11,23,45,69,136,0.5073529411764706,5,18,0.2777777777777778,64,118,0.5423728813559322,0.526,49,75,0.6533333333333333
Darrell Armstrong,armstda01,PG,39,NJN,2008,50,549.0,123,73,17,50,67,28,2,41,53,40,110,0.3636363636363636,23,69,0.3333333333333333,17,41,0.4146341463414634,0.468,20,30,0.6666666666666666
Hilton Armstrong,armsthi01,C,23,NOH,2008,65,732.0,178,23,65,98,163,15,34,59,130,67,148,0.4527027027027027,0,0,0.0,67,148,0.4527027027027027,0.453,44,70,0.6285714285714286
Carlos Arroyo,arroyca01,PG,28,ORL,2008,62,1269.0,430,219,10,103,113,26,2,77,85,157,348,0.4511494252873563,29,84,0.3452380952380952,128,264,0.4848484848484848,0.493,87,102,0.8529411764705882
Chucky Atkins,atkinch01,SG,33,DEN,2008,24,352.0,113,47,3,28,31,9,1,10,27,42,122,0.3442622950819672,25,79,0.3164556962025316,17,43,0.3953488372093023,0.447,4,9,0.4444444444444444
James Augustine,augusja01,PF,23,ORL,2008,25,149.0,40,2,16,14,30,5,2,6,18,18,34,0.5294117647058824,0,0,0.0,18,34,0.5294117647058824,0.529,4,8,0.5
Kelenna Azubuike,azubuke01,SG,24,GSW,2008,81,1732.0,692,75,107,217,324,45,34,58,159,261,587,0.444633730834753,71,195,0.3641025641025641,190,392,0.4846938775510204,0.505,99,138,0.717391304347826
Renaldo Balkman,balkmre01,SF,23,NYK,2008,65,952.0,224,40,83,133,216,44,30,37,132,91,186,0.489247311827957,1,12,0.0833333333333333,90,174,0.5172413793103449,0.492,41,95,0.431578947368421
Marcus Banks,banksma01,PG,26,TOT,2008,36,569.0,239,61,4,41,45,14,13,37,65,86,191,0.450261780104712,40,102,0.392156862745098,46,89,0.5168539325842697,0.555,27,35,0.7714285714285715
Leandro Barbosa,barbole01,SG,25,PHO,2008,82,2421.0,1283,216,40,191,231,75,18,117,195,472,1021,0.4622918707149853,164,422,0.3886255924170616,308,599,0.5141903171953256,0.543,175,213,0.8215962441314554
J.J. Barea,bareajo01,PG,23,DAL,2008,44,460.0,191,58,4,43,47,14,1,35,48,71,170,0.4176470588235294,21,54,0.3888888888888889,50,116,0.4310344827586206,0.479,28,35,0.8
Andrea Bargnani,bargnan01,PF,22,TOR,2008,78,1861.0,792,89,50,238,288,23,37,88,211,280,725,0.3862068965517241,90,261,0.3448275862068966,190,464,0.4094827586206896,0.448,142,169,0.8402366863905325
Matt Barnes,barnema02,PF,27,GSW,2008,73,1414.0,486,139,94,230,324,48,36,85,159,187,442,0.4230769230769231,53,181,0.292817679558011,134,261,0.5134099616858238,0.483,59,79,0.7468354430379747
Andre Barrett,barrean01,PG,25,LAC,2008,4,25.0,6,7,0,1,1,0,0,1,1,2,5,0.4,1,3,0.3333333333333333,1,2,0.5,0.5,1,2,0.5
Earl Barron,barroea01,C,26,MIA,2008,46,889.0,326,29,67,131,198,19,8,48,114,132,327,0.4036697247706422,1,13,0.0769230769230769,131,314,0.4171974522292994,0.405,61,87,0.7011494252873564
Brent Barry,barrybr01,SF,36,SAS,2008,31,554.0,221,54,12,43,55,17,3,18,43,77,160,0.48125,48,112,0.4285714285714285,29,48,0.6041666666666666,0.631,19,20,0.95
Brandon Bass,bassbr01,C,22,DAL,2008,79,1557.0,654,58,120,227,347,22,48,82,150,246,493,0.4989858012170385,0,4,0.0,246,489,0.5030674846625767,0.499,162,197,0.8223350253807107
Maceo Baston,bastoma01,PF,32,TOR,2008,15,103.0,41,3,9,17,26,2,4,4,20,17,25,0.68,0,0,0.0,17,25,0.68,0.68,7,10,0.7
Shane Battier,battish01,SF,29,HOU,2008,80,2907.0,744,155,131,276,407,77,90,78,196,265,619,0.4281098546042003,139,369,0.3766937669376693,126,250,0.504,0.54,75,101,0.7425742574257426
Marco Belinelli,belinma01,SG,21,GSW,2008,33,241.0,95,15,3,11,14,5,0,12,15,36,93,0.3870967741935484,16,41,0.3902439024390244,20,52,0.3846153846153846,0.473,7,9,0.7777777777777778
Charlie Bell,bellch01,SG,28,MIL,2008,68,1628.0,514,210,31,136,167,52,2,76,121,185,486,0.3806584362139917,74,217,0.3410138248847926,111,269,0.4126394052044609,0.457,70,87,0.8045977011494253
Raja Bell,bellra01,SG,31,PHO,2008,75,2646.0,889,168,47,227,274,54,27,65,220,317,753,0.4209827357237716,176,439,0.4009111617312073,141,314,0.4490445859872611,0.538,79,91,0.8681318681318682
Mike Bibby,bibbymi01,PG,29,TOT,2008,48,1573.0,667,290,16,144,160,54,4,119,97,248,603,0.4112769485903814,93,248,0.375,155,355,0.4366197183098591,0.488,78,100,0.78
Andris Biedriņš,biedran01,C,21,GSW,2008,76,2078.0,796,75,256,488,744,56,94,85,262,340,543,0.6261510128913443,0,0,0.0,340,543,0.6261510128913443,0.626,116,187,0.6203208556149733
Chauncey Billups,billuch01,PG,31,DET,2008,78,2522.0,1324,529,42,170,212,101,17,160,130,393,877,0.4481185860889395,137,342,0.4005847953216374,256,535,0.4785046728971963,0.526,401,437,0.9176201372997712
Steve Blake,blakest01,PG,27,POR,2008,81,2424.0,692,413,31,164,195,55,4,113,133,261,640,0.4078125,121,298,0.4060402684563758,140,342,0.4093567251461988,0.502,49,64,0.765625
Andray Blatche,blatcan01,PF,21,WAS,2008,82,1675.0,618,92,164,261,425,53,114,112,258,254,536,0.4738805970149253,3,13,0.2307692307692307,251,523,0.4799235181644359,0.477,107,154,0.6948051948051948
Mark Blount,blounma01,C,32,MIA,2008,69,1542.0,581,41,69,194,263,33,34,70,133,238,515,0.4621359223300971,17,44,0.3863636363636363,221,471,0.4692144373673036,0.479,88,138,0.6376811594202898
Keith Bogans,boganke01,SG,27,ORL,2008,82,2198.0,711,104,42,224,266,59,10,53,164,241,588,0.4098639455782313,148,409,0.3618581907090464,93,179,0.5195530726256983,0.536,81,110,0.7363636363636363
Andrew Bogut,bogutan01,C,23,MIL,2008,78,2720.0,1119,199,245,518,763,64,135,172,254,465,910,0.510989010989011,0,7,0.0,465,903,0.5149501661129569,0.511,189,322,0.5869565217391305
Matt Bonner,bonnema01,PF,27,SAS,2008,68,853.0,326,32,53,139,192,14,17,39,111,121,291,0.415807560137457,46,137,0.3357664233576642,75,154,0.487012987012987,0.495,38,44,0.8636363636363636
Josh Boone,boonejo01,PF,23,NJN,2008,70,1773.0,575,55,192,317,509,36,61,68,155,238,434,0.5483870967741935,0,0,0.0,238,434,0.5483870967741935,0.548,99,217,0.456221198156682
Calvin Booth,boothca01,C,31,PHI,2008,31,204.0,24,8,6,32,38,6,18,4,35,9,27,0.3333333333333333,0,0,0.0,9,27,0.3333333333333333,0.333,6,10,0.6
Carlos Boozer,boozeca01,PF,26,UTA,2008,81,2827.0,1708,233,197,647,844,100,41,210,293,709,1297,0.5466461063993832,0,1,0.0,709,1296,0.5470679012345679,0.547,290,393,0.7379134860050891
Chris Bosh,boshch01,C,23,TOR,2008,67,2425.0,1496,171,174,409,583,63,67,153,157,507,1027,0.4936708860759494,10,25,0.4,497,1002,0.4960079840319361,0.499,472,559,0.8443649373881932
Bruce Bowen,bowenbr01,SF,36,SAS,2008,81,2448.0,483,91,33,201,234,54,22,46,177,174,428,0.4065420560747663,90,215,0.4186046511627907,84,213,0.3943661971830985,0.512,45,69,0.6521739130434783
Ryan Bowen,bowenry01,SF,32,NOH,2008,53,660.0,114,25,55,45,100,32,11,15,77,49,100,0.49,0,1,0.0,49,99,0.494949494949495,0.49,16,29,0.5517241379310345
Earl Boykins,boykiea01,PG,31,CHA,2008,36,577.0,185,96,9,25,34,13,0,41,21,61,172,0.3546511627906977,14,44,0.3181818181818182,47,128,0.3671875,0.395,49,59,0.8305084745762712
Elton Brand,brandel01,PF,28,LAC,2008,8,274.0,141,16,21,43,64,3,15,17,21,52,114,0.4561403508771929,0,0,0.0,52,114,0.4561403508771929,0.456,37,47,0.7872340425531915
Corey Brewer,breweco01,SF,21,MIN,2008,79,1803.0,459,111,82,210,292,76,25,89,188,182,486,0.3744855967078189,7,36,0.1944444444444444,175,450,0.3888888888888889,0.382,88,110,0.8
Ronnie Brewer,brewero02,SG,22,UTA,2008,76,2088.0,914,134,97,121,218,129,19,69,110,354,634,0.5583596214511041,11,50,0.22,343,584,0.5873287671232876,0.567,195,257,0.7587548638132295
Primož Brezec,brezepr01,C,28,TOT,2008,50,475.0,112,11,30,51,81,3,7,24,83,44,94,0.4680851063829787,0,0,0.0,44,94,0.4680851063829787,0.468,24,40,0.6
Aaron Brooks,brookaa01,PG,23,HOU,2008,51,608.0,264,87,13,43,56,13,5,44,69,93,225,0.4133333333333333,36,109,0.3302752293577982,57,116,0.4913793103448275,0.493,42,49,0.8571428571428571
Andre Brown,brownan01,PF,26,MEM,2008,33,286.0,100,8,37,55,92,7,4,14,38,39,78,0.5,0,0,0.0,39,78,0.5,0.5,22,49,0.4489795918367347
Devin Brown,brownde02,SG,29,CLE,2008,78,1762.0,586,175,65,198,263,52,7,99,144,217,531,0.4086629001883239,45,146,0.3082191780821918,172,385,0.4467532467532467,0.451,107,142,0.7535211267605634
Kwame Brown,brownkw01,C,25,TOT,2008,38,713.0,184,45,51,137,188,22,23,51,82,72,142,0.5070422535211268,0,0,0.0,72,142,0.5070422535211268,0.507,40,98,0.4081632653061224
P.J. Brown,brownpj01,PF,38,BOS,2008,18,209.0,39,10,29,39,68,5,8,10,29,14,41,0.3414634146341463,0,1,0.0,14,40,0.35,0.341,11,16,0.6875
Shannon Brown,brownsh01,SG,22,TOT,2008,21,240.0,114,17,6,14,20,11,3,24,29,44,126,0.3492063492063492,9,30,0.3,35,96,0.3645833333333333,0.385,17,29,0.5862068965517241
Kobe Bryant,bryanko01,SG,29,LAL,2008,82,3192.0,2323,441,94,423,517,151,40,257,227,775,1690,0.4585798816568047,150,415,0.3614457831325301,625,1275,0.4901960784313725,0.503,623,742,0.839622641509434
Greg Buckner,buckngr01,SG,31,MIN,2008,31,520.0,124,39,10,55,65,21,2,29,63,45,117,0.3846153846153846,15,50,0.3,30,67,0.4477611940298507,0.449,19,22,0.8636363636363636
Caron Butler,butleca01,SF,27,WAS,2008,58,2314.0,1180,284,93,295,388,128,20,150,160,439,943,0.4655355249204665,66,185,0.3567567567567568,373,758,0.4920844327176781,0.501,236,262,0.900763358778626
Rasual Butler,butlera01,SF,28,NOH,2008,51,875.0,252,36,16,84,100,15,21,10,66,91,260,0.35,44,133,0.3308270676691729,47,127,0.3700787401574803,0.435,26,31,0.8387096774193549
Andrew Bynum,bynuman01,C,20,LAL,2008,35,1008.0,460,61,105,251,356,12,72,52,98,189,297,0.6363636363636364,0,0,0.0,189,297,0.6363636363636364,0.636,82,118,0.6949152542372882
José Calderón,caldejo01,PG,26,TOR,2008,82,2484.0,922,678,34,202,236,87,6,126,134,367,707,0.5190947666195191,79,184,0.4293478260869565,288,523,0.5506692160611855,0.575,109,120,0.9083333333333332
Marcus Camby,cambyma01,C,33,DEN,2008,79,2758.0,721,259,230,807,1037,85,285,118,216,286,635,0.4503937007874016,6,20,0.3,280,615,0.4552845528455284,0.455,143,202,0.7079207920792079
Brian Cardinal,cardibr01,PF,30,MEM,2008,37,440.0,124,22,26,70,96,10,2,23,62,43,126,0.3412698412698413,25,81,0.3086419753086419,18,45,0.4,0.44,13,19,0.6842105263157895
Rodney Carney,carnero01,SF,23,PHI,2008,70,1039.0,409,32,50,99,149,39,23,34,96,158,392,0.4030612244897959,38,120,0.3166666666666666,120,272,0.4411764705882353,0.452,55,81,0.6790123456790124
Matt Carroll,carroma01,SG,27,CHA,2008,80,2016.0,720,73,33,193,226,46,19,58,187,252,589,0.4278438030560271,105,241,0.4356846473029045,147,348,0.4224137931034483,0.517,111,138,0.8043478260869565
Anthony Carter,cartean01,PG,32,DEN,2008,70,1960.0,545,388,27,173,200,107,28,124,172,218,476,0.4579831932773109,45,129,0.3488372093023256,173,347,0.4985590778097982,0.505,64,85,0.7529411764705882
Vince Carter,cartevi01,SG,31,NJN,2008,76,2959.0,1622,389,112,341,453,93,33,181,241,587,1287,0.4560994560994561,98,273,0.358974358974359,489,1014,0.4822485207100592,0.494,350,429,0.8158508158508159
Sam Cassell,cassesa01,PG,38,TOT,2008,55,1274.0,616,214,17,119,136,37,6,97,98,233,532,0.43796992481203,23,76,0.3026315789473684,210,456,0.4605263157894737,0.46,127,144,0.8819444444444444
Tyson Chandler,chandty01,C,25,NOH,2008,79,2783.0,929,81,322,606,928,45,84,136,243,377,605,0.6231404958677685,0,1,0.0,377,604,0.6241721854304636,0.623,175,295,0.5932203389830508
Wilson Chandler,chandwi01,SF,20,NYK,2008,35,685.0,255,33,38,89,127,15,16,27,83,106,242,0.4380165289256198,9,30,0.3,97,212,0.4575471698113207,0.457,34,54,0.6296296296296297
Josh Childress,childjo01,SF,24,ATL,2008,76,2274.0,898,117,174,199,373,71,43,98,129,327,573,0.5706806282722513,22,60,0.3666666666666666,305,513,0.594541910331384,0.59,222,275,0.8072727272727273
Jarron Collins,collija03,C,29,UTA,2008,70,702.0,118,37,40,76,116,10,6,22,106,36,82,0.4390243902439024,0,1,0.0,36,81,0.4444444444444444,0.439,46,74,0.6216216216216216
Jason Collins,collija04,C,29,TOT,2008,74,1172.0,140,25,64,114,178,23,25,48,194,53,113,0.4690265486725664,0,1,0.0,53,112,0.4732142857142857,0.469,34,74,0.4594594594594595
Mardy Collins,collima01,SG,23,NYK,2008,46,634.0,145,89,19,56,75,24,8,56,56,57,175,0.3257142857142857,8,32,0.25,49,143,0.3426573426573426,0.349,23,38,0.6052631578947368
Nick Collison,collini01,PF,27,SEA,2008,78,2223.0,767,113,254,476,730,47,60,118,250,322,641,0.5023400936037441,0,2,0.0,322,639,0.5039123630672926,0.502,123,167,0.7365269461077845
Mike Conley,conlemi01,PG,20,MEM,2008,53,1381.0,498,222,21,118,139,44,2,89,85,189,442,0.4276018099547511,30,91,0.3296703296703296,159,351,0.452991452991453,0.462,90,123,0.7317073170731707
Brian Cook,cookbr01,PF,27,TOT,2008,51,629.0,238,27,28,81,109,13,12,39,93,88,234,0.376068376068376,43,115,0.3739130434782609,45,119,0.3781512605042016,0.468,19,21,0.9047619047619048
Daequan Cook,cookda02,SG,20,MIA,2008,59,1441.0,518,75,20,157,177,23,9,63,157,196,514,0.3813229571984435,79,238,0.3319327731092437,117,276,0.4239130434782608,0.458,47,57,0.8245614035087719
Jamal Crawford,crawfja01,SG,27,NYK,2008,80,3190.0,1645,398,37,170,207,81,17,192,144,570,1391,0.4097771387491014,176,494,0.3562753036437247,394,897,0.439241917502787,0.473,329,381,0.863517060367454
Javaris Crittenton,crittja01,SG,20,TOT,2008,50,679.0,278,51,27,83,110,19,2,55,47,98,233,0.4206008583690987,10,37,0.2702702702702703,88,196,0.4489795918367347,0.442,72,104,0.6923076923076923
Austin Croshere,croshau01,PF,32,GSW,2008,44,457.0,173,30,33,71,104,8,6,22,60,61,137,0.4452554744525547,22,61,0.360655737704918,39,76,0.5131578947368421,0.526,29,32,0.90625
Eddy Curry,curryed01,C,25,NYK,2008,59,1530.0,781,32,111,164,275,14,29,126,157,297,544,0.5459558823529411,0,0,0.0,297,544,0.5459558823529411,0.546,187,300,0.6233333333333333
Samuel Dalembert,dalemsa01,C,26,PHI,2008,82,2724.0,864,45,304,545,849,40,192,155,269,339,661,0.5128593040847201,0,1,0.0,339,660,0.5136363636363637,0.513,186,263,0.7072243346007605
Erick Dampier,dampier01,C,32,DAL,2008,72,1755.0,440,63,207,332,539,24,106,80,226,178,277,0.6425992779783394,0,0,0.0,178,277,0.6425992779783394,0.643,84,146,0.5753424657534246
Antonio Daniels,daniean01,PG,32,WAS,2008,71,2161.0,597,340,23,180,203,69,2,91,78,205,447,0.4586129753914988,17,74,0.2297297297297297,188,373,0.5040214477211796,0.478,170,219,0.776255707762557
Marquis Daniels,daniema01,SG,27,IND,2008,74,1546.0,606,137,66,146,212,79,18,112,121,241,561,0.4295900178253119,27,102,0.2647058823529412,214,459,0.4662309368191721,0.454,97,139,0.697841726618705
Jermareo Davidson,davidje01,SF,23,CHA,2008,38,322.0,120,13,21,41,62,7,15,17,46,51,125,0.408,0,0,0.0,51,125,0.408,0.408,18,28,0.6428571428571429
Baron Davis,davisba01,PG,28,GSW,2008,82,3196.0,1791,623,96,289,385,191,43,232,247,650,1526,0.4259501965923984,173,525,0.3295238095238095,477,1001,0.4765234765234765,0.483,318,424,0.75
Glen Davis,davisgl01,C,22,BOS,2008,69,940.0,313,28,95,113,208,31,20,65,160,107,221,0.4841628959276018,0,0,0.0,107,221,0.4841628959276018,0.484,99,150,0.66
Paul Davis,davispa01,PF,23,LAC,2008,22,194.0,54,10,25,22,47,6,6,9,33,24,65,0.3692307692307692,0,0,0.0,24,65,0.3692307692307692,0.369,6,10,0.6
Ricky Davis,davisri01,SF,28,MIA,2008,82,2963.0,1130,276,55,298,353,87,14,191,187,420,971,0.4325437693099897,135,333,0.4054054054054054,285,638,0.4467084639498432,0.502,155,197,0.7868020304568528
Carlos Delfino,delfica01,SG,25,TOR,2008,82,1928.0,738,145,66,293,359,69,11,75,177,251,632,0.3971518987341772,120,314,0.3821656050955414,131,318,0.4119496855345912,0.492,116,156,0.7435897435897436
Luol Deng,denglu01,SF,22,CHI,2008,63,2128.0,1070,155,136,258,394,57,29,120,117,429,896,0.4787946428571428,8,22,0.3636363636363636,421,874,0.4816933638443936,0.483,204,265,0.769811320754717
Boris Diaw,diawbo01,PF,25,PHO,2008,82,2308.0,725,317,97,281,378,61,39,155,166,308,646,0.4767801857585139,13,41,0.3170731707317073,295,605,0.4876033057851239,0.487,96,129,0.7441860465116279
Yakhouba Diawara,diawaya01,SG,25,DEN,2008,54,542.0,153,37,23,39,62,8,3,16,61,55,134,0.4104477611940298,21,66,0.3181818181818182,34,68,0.5,0.489,22,31,0.7096774193548387
Guillermo Díaz,diazgu01,SG,22,LAC,2008,6,18.0,5,1,2,0,2,0,0,0,0,1,4,0.25,0,1,0.0,1,3,0.3333333333333333,0.25,3,5,0.6
Dan Dickau,dickada01,PG,29,LAC,2008,67,1040.0,352,172,13,84,97,32,3,55,108,124,296,0.4189189189189189,36,108,0.3333333333333333,88,188,0.4680851063829787,0.48,68,82,0.8292682926829268
Kaniel Dickens,dickeka01,PF,29,CLE,2008,5,12.0,2,1,0,1,1,0,1,0,1,1,3,0.3333333333333333,0,0,0.0,1,3,0.3333333333333333,0.333,0,0,0.0
Travis Diener,dienetr01,PG,25,IND,2008,66,1356.0,456,251,26,89,115,35,4,55,107,159,430,0.3697674418604651,74,233,0.3175965665236051,85,197,0.4314720812182741,0.456,64,71,0.9014084507042254
Ike Diogu,dioguik01,PF,24,IND,2008,30,305.0,168,10,38,47,85,7,3,20,43,64,134,0.4776119402985074,0,0,0.0,64,134,0.4776119402985074,0.478,40,47,0.851063829787234
DeSagana Diop,diopde01,C,26,TOT,2008,79,1295.0,226,40,160,232,392,26,88,58,146,94,180,0.5222222222222223,0,0,0.0,94,180,0.5222222222222223,0.522,38,70,0.5428571428571428
Juan Dixon,dixonju01,PG,29,TOT,2008,53,668.0,263,97,15,60,75,21,2,54,62,106,258,0.4108527131782946,30,72,0.4166666666666667,76,186,0.4086021505376344,0.469,21,26,0.8076923076923077
Michael Doleac,doleami01,C,30,MIN,2008,24,257.0,57,7,16,33,49,10,10,12,44,28,63,0.4444444444444444,0,0,0.0,28,63,0.4444444444444444,0.444,1,2,0.5
Keyon Dooling,doolike01,PG,27,ORL,2008,72,1334.0,581,133,7,94,101,36,5,61,131,198,423,0.4680851063829787,22,65,0.3384615384615385,176,358,0.4916201117318435,0.494,163,193,0.844559585492228
Quincy Douby,doubyqu01,PG,23,SAC,2008,74,876.0,354,53,17,66,83,30,12,59,80,132,335,0.3940298507462687,42,122,0.3442622950819672,90,213,0.4225352112676056,0.457,48,52,0.9230769230769232
Jared Dudley,dudleja01,PF,22,CHA,2008,73,1384.0,422,81,121,165,286,55,10,50,128,163,348,0.4683908045977011,9,41,0.2195121951219512,154,307,0.501628664495114,0.481,87,118,0.7372881355932204
Chris Duhon,duhonch01,PG,25,CHI,2008,66,1490.0,385,263,19,97,116,48,2,71,92,133,344,0.3866279069767442,54,155,0.3483870967741935,79,189,0.4179894179894179,0.465,65,80,0.8125
Tim Duncan,duncati01,C,31,SAS,2008,78,2651.0,1508,218,237,644,881,56,152,178,185,585,1178,0.4966044142614601,0,4,0.0,585,1174,0.4982964224872231,0.497,338,463,0.7300215982721382
Mike Dunleavy,dunlemi02,SG,27,IND,2008,82,2953.0,1565,288,59,365,424,86,31,190,208,532,1117,0.4762757385854969,165,389,0.4241645244215938,367,728,0.5041208791208791,0.55,336,403,0.8337468982630273
Ronald Dupree,duprero01,SF,27,TOT,2008,5,21.0,4,1,1,7,8,1,0,0,0,1,3,0.3333333333333333,0,0,0.0,1,3,0.3333333333333333,0.333,2,2,1.0
Kevin Durant,duranke01,SG,19,SEA,2008,80,2768.0,1624,192,70,278,348,78,75,232,122,587,1366,0.4297218155197657,59,205,0.2878048780487804,528,1161,0.4547803617571059,0.451,391,448,0.8727678571428571
Monta Ellis,ellismo01,SG,22,GSW,2008,81,3071.0,1636,315,133,271,404,124,27,173,195,652,1227,0.5313773431132844,12,52,0.2307692307692307,640,1175,0.5446808510638298,0.536,320,417,0.7673860911270983
Francisco Elson,elsonfr01,C,31,TOT,2008,63,813.0,210,24,50,150,200,15,20,47,96,92,236,0.3898305084745763,0,1,0.0,92,235,0.3914893617021276,0.39,26,37,0.7027027027027027
Melvin Ely,elyme01,C,29,NOH,2008,52,621.0,202,22,28,117,145,7,18,42,79,85,180,0.4722222222222222,0,0,0.0,85,180,0.4722222222222222,0.472,32,58,0.5517241379310345
Maurice Evans,evansma01,SG,29,TOT,2008,75,1720.0,664,81,92,126,218,46,10,40,142,262,545,0.4807339449541284,81,209,0.3875598086124402,181,336,0.5386904761904762,0.555,59,83,0.7108433734939759
Reggie Evans,evansre01,PF,27,PHI,2008,81,1879.0,425,65,224,387,611,86,8,108,213,152,346,0.4393063583815029,1,1,1.0,151,345,0.4376811594202898,0.441,120,257,0.4669260700389105
Jordan Farmar,farmajo01,PG,21,LAL,2008,82,1690.0,749,225,39,144,183,77,5,108,105,291,631,0.4611727416798732,114,307,0.3713355048859935,177,324,0.5462962962962963,0.552,53,78,0.6794871794871795
Nick Fazekas,fazekni01,PF,22,TOT,2008,26,269.0,107,11,34,55,89,8,11,13,25,46,82,0.5609756097560976,0,2,0.0,46,80,0.575,0.561,15,22,0.6818181818181818
Raymond Felton,feltora01,PG,23,CHA,2008,79,2972.0,1140,583,37,199,236,96,12,213,184,412,997,0.4132397191574724,56,200,0.28,356,797,0.4466750313676286,0.441,260,325,0.8
Kyrylo Fesenko,fesenky01,C,21,UTA,2008,9,70.0,14,2,14,11,25,0,3,8,19,6,16,0.375,0,0,0.0,6,16,0.375,0.375,2,4,0.5
Michael Finley,finlemi01,SG,34,SAS,2008,82,2204.0,826,114,27,227,254,29,10,56,93,315,761,0.4139290407358738,132,357,0.3697478991596639,183,404,0.452970297029703,0.501,64,80,0.8
Derek Fisher,fishede01,PG,33,LAL,2008,82,2249.0,956,239,24,146,170,86,3,90,188,339,777,0.4362934362934363,112,276,0.4057971014492754,227,501,0.4530938123752495,0.508,166,188,0.8829787234042553
T.J. Ford,fordtj01,PG,24,TOR,2008,51,1199.0,617,313,23,77,100,54,0,102,93,246,524,0.4694656488549618,15,51,0.2941176470588235,231,473,0.4883720930232558,0.484,110,125,0.88
Jeff Foster,fosteje01,C,31,IND,2008,77,1884.0,496,129,264,404,668,56,32,62,221,205,373,0.5495978552278821,0,3,0.0,205,370,0.5540540540540541,0.55,86,145,0.593103448275862
Randy Foye,foyera01,PG,24,MIN,2008,39,1259.0,510,164,13,115,128,36,3,79,102,198,462,0.4285714285714285,61,148,0.4121621621621621,137,314,0.4363057324840764,0.495,53,65,0.8153846153846154
Adonal Foyle,foylead01,C,32,ORL,2008,82,774.0,156,18,71,137,208,16,45,32,94,70,153,0.457516339869281,0,0,0.0,70,153,0.457516339869281,0.458,16,34,0.4705882352941176
Richie Frahm,frahmri01,SG,30,LAC,2008,10,163.0,47,8,4,10,14,2,0,6,7,20,54,0.3703703703703703,7,25,0.28,13,29,0.4482758620689655,0.435,0,2,0.0
Steve Francis,francst01,PG,30,HOU,2008,10,199.0,55,30,8,15,23,9,5,14,25,19,57,0.3333333333333333,4,17,0.2352941176470588,15,40,0.375,0.368,13,23,0.5652173913043478
Channing Frye,fryech01,C,24,POR,2008,78,1342.0,530,57,107,247,354,29,27,55,208,221,453,0.4878587196467991,3,10,0.3,218,443,0.492099322799097,0.491,85,109,0.7798165137614679
Dan Gadzuric,gadzuda01,C,29,MIL,2008,51,534.0,161,11,67,77,144,20,24,34,83,64,154,0.4155844155844156,0,1,0.0,64,153,0.4183006535947712,0.416,33,63,0.5238095238095238
Jorge Garbajosa,garbajo01,PF,30,TOR,2008,7,74.0,22,3,2,13,15,3,0,1,2,8,25,0.32,6,16,0.375,2,9,0.2222222222222222,0.44,0,0,0.0
Francisco García,garcifr01,SF,26,SAC,2008,79,2096.0,971,128,52,212,264,96,50,128,232,348,752,0.4627659574468085,113,289,0.3910034602076124,235,463,0.5075593952483801,0.538,162,208,0.7788461538461539
Thomas Gardner,gardnth01,SG,22,CHI,2008,4,45.0,21,1,3,1,4,0,0,4,4,9,23,0.391304347826087,3,12,0.25,6,11,0.5454545454545454,0.457,0,2,0.0
Kevin Garnett,garneke01,PF,31,BOS,2008,71,2328.0,1337,244,135,520,655,100,89,138,163,534,990,0.5393939393939394,0,11,0.0,534,979,0.5454545454545454,0.539,269,336,0.8005952380952381
Pat Garrity,garripa01,PF,31,ORL,2008,31,284.0,66,13,9,35,44,6,1,17,35,27,80,0.3375,8,37,0.2162162162162162,19,43,0.4418604651162791,0.388,4,5,0.8
Pau Gasol,gasolpa01,C,27,TOT,2008,66,2351.0,1246,211,155,398,553,30,98,124,139,475,890,0.5337078651685393,4,16,0.25,471,874,0.5389016018306636,0.536,292,362,0.8066298342541437
Rudy Gay,gayru01,SF,21,MEM,2008,81,3000.0,1632,158,140,359,499,111,79,190,230,625,1355,0.4612546125461255,134,387,0.3462532299741602,491,968,0.5072314049586777,0.511,248,316,0.7848101265822784
Mickaël Gelabale,gelabmi01,SG,24,SEA,2008,39,465.0,168,33,16,42,58,10,9,27,31,69,157,0.4394904458598726,16,37,0.4324324324324324,53,120,0.4416666666666666,0.49,14,18,0.7777777777777778
Devean George,georgde01,SF,30,DAL,2008,53,821.0,194,35,28,109,137,19,13,24,90,74,207,0.357487922705314,22,68,0.3235294117647059,52,139,0.3741007194244604,0.411,24,34,0.7058823529411765
Daniel Gibson,gibsoda01,PG,21,CLE,2008,58,1765.0,605,145,30,104,134,47,14,76,163,201,465,0.432258064516129,118,268,0.4402985074626865,83,197,0.4213197969543147,0.559,85,105,0.8095238095238095
Eddie Gill,gilled01,PG,29,TOT,2008,14,154.0,38,22,1,21,22,7,2,9,18,12,31,0.3870967741935484,5,15,0.3333333333333333,7,16,0.4375,0.468,9,9,1.0
Manu Ginóbili,ginobma01,SG,30,SAS,2008,74,2299.0,1442,332,63,291,354,109,33,200,173,453,984,0.4603658536585366,156,389,0.4010282776349614,297,595,0.4991596638655462,0.54,380,442,0.8597285067873304
Gordan Giriček,giricgo01,SG,30,TOT,2008,56,831.0,325,62,16,80,96,24,4,52,82,133,302,0.4403973509933774,36,99,0.3636363636363636,97,203,0.4778325123152709,0.5,23,26,0.8846153846153846
Ryan Gomes,gomesry01,PF,25,MIN,2008,82,2434.0,1033,145,133,342,475,65,10,96,154,392,857,0.4574095682613769,59,179,0.329608938547486,333,678,0.4911504424778761,0.492,190,229,0.8296943231441049
Drew Gooden,goodedr01,PF,26,TOT,2008,69,2122.0,826,81,175,415,590,48,53,122,203,332,740,0.4486486486486487,0,6,0.0,332,734,0.4523160762942779,0.449,162,215,0.7534883720930232
Ben Gordon,gordobe01,SG,24,CHI,2008,72,2291.0,1336,213,40,181,221,55,8,150,171,464,1069,0.4340505144995322,142,346,0.4104046242774566,322,723,0.4453665283540802,0.5,266,293,0.9078498293515358
Marcin Gortat,gortama01,C,23,ORL,2008,6,41.0,18,2,8,8,16,1,1,2,4,8,17,0.4705882352941176,0,0,0.0,8,17,0.4705882352941176,0.471,2,3,0.6666666666666666
Joey Graham,grahajo01,SF,25,TOR,2008,38,331.0,138,15,18,49,67,3,0,23,47,49,113,0.4336283185840708,2,3,0.6666666666666666,47,110,0.4272727272727272,0.442,38,45,0.8444444444444444
Stephen Graham,grahast01,SF,25,IND,2008,22,128.0,87,9,4,18,22,4,1,10,14,34,58,0.5862068965517241,7,14,0.5,27,44,0.6136363636363636,0.647,12,16,0.75
Danny Granger,grangda01,SF,24,IND,2008,80,2876.0,1567,166,93,393,486,95,84,171,290,537,1205,0.445643153526971,171,423,0.4042553191489361,366,782,0.4680306905370844,0.517,322,378,0.8518518518518519
Aaron Gray,grayaa01,C,23,CHI,2008,61,613.0,262,41,70,98,168,21,16,57,117,103,204,0.5049019607843137,0,1,0.0,103,203,0.5073891625615764,0.505,56,99,0.5656565656565656
Gerald Green,greenge01,SF,22,TOT,2008,30,362.0,153,29,13,51,64,8,4,32,45,52,151,0.3443708609271523,15,39,0.3846153846153846,37,112,0.3303571428571428,0.394,34,41,0.8292682926829268
Jeff Green,greenje02,SF,21,SEA,2008,80,2253.0,838,119,101,278,379,46,49,158,198,320,749,0.4272363150867824,21,76,0.2763157894736842,299,673,0.4442793462109955,0.441,177,238,0.7436974789915967
Taurean Green,greenta01,SG-PG,21,TOT,2008,17,74.0,27,11,0,10,10,2,0,9,5,7,25,0.28,2,11,0.1818181818181818,5,14,0.3571428571428571,0.32,11,12,0.9166666666666666
Willie Green,greenwi01,SG,26,PHI,2008,74,1970.0,921,151,32,150,182,54,22,109,119,379,870,0.435632183908046,51,179,0.2849162011173184,328,691,0.4746743849493487,0.465,112,148,0.7567567567567568
Orien Greene,greenor01,SG,25,SAC,2008,7,61.0,6,3,0,6,6,3,1,7,9,3,11,0.2727272727272727,0,1,0.0,3,10,0.3,0.273,0,0,0.0
Adrian Griffin,griffad01,SG-SF,33,TOT,2008,35,307.0,65,27,28,31,59,17,2,21,27,30,76,0.3947368421052631,0,0,0.0,30,76,0.3947368421052631,0.395,5,9,0.5555555555555556
Richard Hamilton,hamilri01,SG,29,DET,2008,72,2424.0,1244,299,75,160,235,73,10,132,171,499,1030,0.4844660194174757,62,141,0.4397163120567376,437,889,0.4915635545556805,0.515,184,221,0.832579185520362
Anfernee Hardaway,hardaan01,SF,36,MIA,2008,16,325.0,60,35,3,32,35,19,1,13,24,22,60,0.3666666666666666,8,19,0.4210526315789473,14,41,0.3414634146341463,0.433,8,9,0.8888888888888888
Matt Harpring,harprma01,SF,31,UTA,2008,76,1374.0,622,82,96,144,240,45,14,95,162,237,474,0.5,2,10,0.2,235,464,0.5064655172413793,0.502,146,205,0.7121951219512195
Al Harrington,harrial01,C,27,GSW,2008,81,2190.0,1102,132,107,332,439,74,16,90,266,401,923,0.4344528710725894,153,408,0.375,248,515,0.4815533980582524,0.517,147,190,0.7736842105263158
Othella Harrington,harriot01,C,34,CHA,2008,22,166.0,46,4,11,31,42,1,4,11,34,18,42,0.4285714285714285,0,0,0.0,18,42,0.4285714285714285,0.429,10,16,0.625
Devin Harris,harride01,PG,24,TOT,2008,64,2022.0,946,369,28,145,173,90,10,161,190,321,693,0.4632034632034632,56,167,0.3353293413173652,265,526,0.5038022813688213,0.504,248,301,0.8239202657807309
Mike Harris,harrimi01,PF,24,HOU,2008,17,159.0,62,3,24,30,54,6,3,9,16,27,54,0.5,0,2,0.0,27,52,0.5192307692307693,0.5,8,13,0.6153846153846154
David Harrison,harrida01,C,25,IND,2008,55,702.0,229,14,43,75,118,20,59,58,164,90,170,0.5294117647058824,0,0,0.0,90,170,0.5294117647058824,0.529,49,96,0.5104166666666666
Jason Hart,hartja01,PG,29,UTA,2008,57,606.0,165,86,5,50,55,30,3,28,75,58,180,0.3222222222222222,11,31,0.3548387096774194,47,149,0.3154362416107382,0.353,38,45,0.8444444444444444
Udonis Haslem,hasleud01,PF,27,MIA,2008,49,1805.0,589,68,107,336,443,39,18,67,145,237,507,0.4674556213017751,0,0,0.0,237,507,0.4674556213017751,0.467,115,142,0.8098591549295775
Trenton Hassell,hassetr01,SG,28,TOT,2008,63,773.0,123,41,20,63,83,13,3,22,90,57,135,0.4222222222222222,2,9,0.2222222222222222,55,126,0.4365079365079365,0.43,7,10,0.7
Spencer Hawes,hawessp01,C,19,SAC,2008,71,931.0,334,44,68,162,230,14,40,56,128,146,318,0.4591194968553459,4,21,0.1904761904761904,142,297,0.4781144781144781,0.465,38,58,0.6551724137931034
Chuck Hayes,hayesch01,PF,24,HOU,2008,79,1575.0,237,91,132,295,427,85,43,62,212,113,221,0.5113122171945701,0,3,0.0,113,218,0.518348623853211,0.511,11,24,0.4583333333333333
Jarvis Hayes,hayesja01,SF,26,DET,2008,82,1287.0,552,62,35,143,178,47,6,47,137,217,504,0.4305555555555556,73,194,0.3762886597938144,144,310,0.4645161290322581,0.503,45,60,0.75
Brendan Haywood,haywobr01,C,28,WAS,2008,80,2228.0,848,71,273,303,576,31,133,108,216,316,599,0.5275459098497496,0,0,0.0,316,599,0.5275459098497496,0.528,216,294,0.7346938775510204
Luther Head,headlu01,SG,25,HOU,2008,73,1379.0,557,138,18,117,135,44,9,70,75,206,477,0.4318658280922431,79,225,0.3511111111111111,127,252,0.503968253968254,0.515,66,81,0.8148148148148148
Walter Herrmann,herrmwa01,PF,28,TOT,2008,45,373.0,153,18,22,51,73,7,1,12,24,56,144,0.3888888888888889,20,64,0.3125,36,80,0.45,0.458,21,25,0.84
Nenê,hilarne01,PF,25,DEN,2008,16,266.0,85,15,30,57,87,9,14,21,46,29,71,0.4084507042253521,0,1,0.0,29,70,0.4142857142857143,0.408,27,49,0.5510204081632653
Grant Hill,hillgr01,SF,35,PHO,2008,70,2222.0,919,203,74,279,353,65,56,96,153,358,712,0.5028089887640449,33,104,0.3173076923076923,325,608,0.5345394736842105,0.526,170,196,0.8673469387755102
Kirk Hinrich,hinriki01,PG,27,CHI,2008,75,2380.0,862,452,28,216,244,87,19,157,224,330,797,0.4140526976160602,84,240,0.35,246,557,0.4416517055655296,0.467,118,142,0.8309859154929577
Ryan Hollins,holliry01,PF,23,CHA,2008,60,532.0,147,14,53,54,107,10,30,25,96,46,94,0.4893617021276595,0,0,0.0,46,94,0.4893617021276595,0.489,55,82,0.6707317073170732
Al Horford,horfoal01,C,21,ATL,2008,81,2540.0,821,124,248,537,785,60,76,137,267,333,668,0.498502994011976,0,5,0.0,333,663,0.502262443438914,0.499,155,212,0.7311320754716981
Robert Horry,horryro01,PF,37,SAS,2008,45,583.0,112,47,35,74,109,21,19,22,55,38,119,0.3193277310924369,18,70,0.2571428571428571,20,49,0.4081632653061224,0.395,18,28,0.6428571428571429
Eddie House,houseed01,PG,29,BOS,2008,78,1480.0,584,152,19,148,167,59,10,76,114,217,531,0.4086629001883239,117,298,0.3926174496644295,100,233,0.4291845493562232,0.519,33,36,0.9166666666666666
Dwight Howard,howardw01,C,22,ORL,2008,82,3088.0,1695,110,279,882,1161,74,176,263,274,583,974,0.5985626283367557,0,4,0.0,583,970,0.6010309278350515,0.599,529,897,0.5897435897435898
Josh Howard,howarjo01,SF,27,DAL,2008,76,2757.0,1513,164,120,412,532,59,32,114,202,567,1247,0.454691259021652,67,210,0.319047619047619,500,1037,0.4821600771456123,0.482,312,384,0.8125
Juwan Howard,howarju01,PF,34,DAL,2008,50,353.0,57,17,21,60,81,5,2,17,62,23,64,0.359375,0,0,0.0,23,64,0.359375,0.359,11,14,0.7857142857142857
Troy Hudson,hudsotr01,PG,31,GSW,2008,9,93.0,28,9,0,7,7,3,0,7,4,9,31,0.2903225806451613,4,12,0.3333333333333333,5,19,0.2631578947368421,0.355,6,6,1.0
Larry Hughes,hughela01,PG-SG,29,TOT,2008,68,2020.0,827,181,39,191,230,99,17,116,139,305,801,0.3807740324594257,67,194,0.345360824742268,238,607,0.3920922570016474,0.423,150,188,0.7978723404255319
Kris Humphries,humphkr01,PF,22,TOR,2008,70,925.0,397,28,90,169,259,25,28,47,107,161,333,0.4834834834834834,0,2,0.0,161,331,0.486404833836858,0.483,75,124,0.6048387096774194
Lindsey Hunter,hunteli01,PG,37,DET,2008,24,215.0,58,33,4,9,13,13,2,13,30,22,64,0.34375,7,26,0.2692307692307692,15,38,0.3947368421052631,0.398,7,9,0.7777777777777778
Steven Hunter,huntest01,C,26,DEN,2008,19,120.0,39,0,10,19,29,0,6,7,20,15,28,0.5357142857142857,0,0,0.0,15,28,0.5357142857142857,0.536,9,20,0.45
Andre Iguodala,iguodan01,SF,24,PHI,2008,82,3242.0,1630,391,85,361,446,171,49,214,187,582,1277,0.4557556773688332,101,307,0.3289902280130293,481,970,0.4958762886597938,0.495,365,506,0.7213438735177866
Zydrunas Ilgauskas,ilgauzy01,C,32,CLE,2008,73,2222.0,1029,104,263,419,682,34,120,135,247,417,879,0.4744027303754266,0,1,0.0,417,878,0.4749430523917995,0.474,195,243,0.8024691358024691
D.J. Mbenga,mbengdj01,C,27,TOT,2008,42,326.0,83,10,28,44,72,7,26,12,70,39,84,0.4642857142857143,0,0,0.0,39,84,0.4642857142857143,0.464,5,12,0.4166666666666667
Allen Iverson,iversal01,SG,32,DEN,2008,82,3424.0,2164,586,47,196,243,160,12,245,109,712,1556,0.4575835475578406,95,275,0.3454545454545454,617,1281,0.4816549570647931,0.488,645,797,0.8092848180677541
Royal Ivey,iveyro01,PG,26,MIL,2008,75,1437.0,418,160,38,80,118,45,7,75,166,149,378,0.3941798941798942,35,107,0.3271028037383177,114,271,0.4206642066420664,0.44,85,117,0.7264957264957265
Jarrett Jack,jackja01,SG,24,POR,2008,82,2229.0,814,313,31,203,234,61,1,178,129,267,620,0.4306451612903226,65,190,0.3421052631578947,202,430,0.4697674418604651,0.483,215,248,0.8669354838709677
Bobby Jackson,jacksbo01,SG-PG,34,TOT,2008,72,1389.0,553,139,33,148,181,45,5,59,96,204,506,0.4031620553359684,81,226,0.3584070796460177,123,280,0.4392857142857143,0.483,64,81,0.7901234567901234
Luke Jackson,jackslu02,SF,26,MIA,2008,14,228.0,79,17,7,26,33,8,0,9,22,26,80,0.325,11,30,0.3666666666666666,15,50,0.3,0.394,16,23,0.6956521739130435
Stephen Jackson,jacksst02,SF,29,GSW,2008,73,2855.0,1466,300,67,251,318,92,29,197,171,488,1204,0.4053156146179402,182,501,0.3632734530938123,306,703,0.4352773826458037,0.481,308,370,0.8324324324324325
Casey Jacobsen,jacobca01,SG,26,MEM,2008,53,547.0,107,20,12,53,65,5,1,16,34,39,115,0.3391304347826087,16,72,0.2222222222222222,23,43,0.5348837209302325,0.409,13,17,0.7647058823529411
Jerome James,jamesje01,C,32,NYK,2008,2,5.0,4,0,0,3,3,0,0,0,0,1,1,1.0,0,0,0.0,1,1,1.0,1.0,2,2,1.0
LeBron James,jamesle01,SF,23,CLE,2008,75,3027.0,2250,539,133,459,592,138,81,255,165,794,1642,0.4835566382460414,113,359,0.3147632311977716,681,1283,0.5307872174590803,0.518,549,771,0.7120622568093385
Mike James,jamesmi01,PG,32,TOT,2008,54,720.0,272,60,14,55,69,21,2,36,56,101,290,0.3482758620689655,31,97,0.3195876288659793,70,193,0.3626943005181347,0.402,39,48,0.8125
Antawn Jamison,jamisan01,PF,31,WAS,2008,79,3061.0,1689,120,215,591,806,106,34,113,195,618,1417,0.4361326746647848,120,354,0.3389830508474576,498,1063,0.4684854186265287,0.478,333,438,0.7602739726027398
Marko Jarić,jaricma01,SG,29,MIN,2008,75,2189.0,621,311,38,184,222,97,32,128,180,227,528,0.4299242424242424,46,127,0.3622047244094488,181,401,0.4513715710723192,0.473,121,163,0.7423312883435583
Al Jefferson,jeffeal01,C,23,MIN,2008,82,2919.0,1726,117,308,603,911,74,119,167,222,721,1441,0.5003469812630118,0,5,0.0,721,1436,0.5020891364902507,0.5,284,394,0.7208121827411168
Richard Jefferson,jefferi01,SF,27,NJN,2008,82,3200.0,1857,252,93,249,342,76,21,199,225,619,1328,0.4661144578313253,77,213,0.3615023474178404,542,1115,0.4860986547085202,0.495,542,679,0.7982326951399117
Jared Jeffries,jeffrja01,SF,26,NYK,2008,73,1325.0,269,66,118,125,243,36,23,64,132,108,270,0.4,4,25,0.16,104,245,0.4244897959183673,0.407,49,93,0.5268817204301075
Yi Jianlian,jianlyi01,PF,20,MIL,2008,66,1647.0,566,55,106,238,344,36,56,90,153,219,520,0.4211538461538461,6,21,0.2857142857142857,213,499,0.4268537074148296,0.427,122,145,0.8413793103448276
Alexander Johnson,johnsal01,PF,24,MIA,2008,43,549.0,179,13,32,62,94,13,10,42,80,61,125,0.488,0,0,0.0,61,125,0.488,0.488,57,83,0.6867469879518072
Amir Johnson,johnsam01,PF,20,DET,2008,62,764.0,221,29,87,148,235,24,82,39,141,92,165,0.5575757575757576,0,0,0.0,92,165,0.5575757575757576,0.558,37,55,0.6727272727272727
Anthony Johnson,johnsan02,PG,33,TOT,2008,69,1531.0,387,262,22,115,137,52,9,84,115,155,355,0.4366197183098591,42,93,0.4516129032258064,113,262,0.4312977099236641,0.496,35,43,0.813953488372093
DerMarr Johnson,johnsde03,SF,27,SAS,2008,5,28.0,17,1,0,1,1,1,0,0,4,7,14,0.5,3,9,0.3333333333333333,4,5,0.8,0.607,0,2,0.0
Joe Johnson,johnsjo02,SG,26,ATL,2008,82,3343.0,1779,474,83,284,367,84,18,223,168,647,1497,0.4321977287909151,169,444,0.3806306306306306,478,1053,0.4539411206077873,0.489,316,379,0.8337730870712401
Linton Johnson,johnsli01,PF,27,TOT,2008,8,63.0,21,4,5,9,14,0,1,5,11,9,19,0.4736842105263157,1,3,0.3333333333333333,8,16,0.5,0.5,2,2,1.0
Bobby Jones,jonesbo02,SF,24,TOT,2008,47,531.0,178,28,29,63,92,15,3,28,85,60,140,0.4285714285714285,18,53,0.3396226415094339,42,87,0.4827586206896552,0.493,40,51,0.7843137254901961
Dahntay Jones,jonesda02,SG,27,SAC,2008,25,206.0,81,12,7,28,35,8,6,10,28,23,53,0.4339622641509434,1,6,0.1666666666666666,22,47,0.4680851063829787,0.443,34,51,0.6666666666666666
Damon Jones,jonesda01,SG,31,CLE,2008,67,1336.0,437,126,5,67,72,19,1,36,66,151,363,0.4159779614325068,115,276,0.4166666666666667,36,87,0.4137931034482758,0.574,20,28,0.7142857142857143
Dwayne Jones,jonesdw02,PF,24,CLE,2008,56,472.0,78,10,69,71,140,10,25,17,88,25,47,0.5319148936170213,0,1,0.0,25,46,0.5434782608695652,0.532,28,58,0.4827586206896552
Eddie Jones,jonesed02,SG,36,DAL,2008,47,922.0,176,69,18,114,132,26,8,29,72,66,180,0.3666666666666666,34,116,0.293103448275862,32,64,0.5,0.461,10,14,0.7142857142857143
Fred Jones,jonesfr01,SG,28,NYK,2008,70,1757.0,532,166,30,140,170,48,18,78,140,182,432,0.4212962962962963,74,192,0.3854166666666667,108,240,0.45,0.507,94,126,0.746031746031746
James Jones,jonesja02,SF,27,POR,2008,58,1276.0,463,34,43,118,161,24,15,28,96,143,327,0.437308868501529,91,205,0.4439024390243902,52,122,0.4262295081967213,0.576,86,98,0.8775510204081632
Solomon Jones,jonesso01,PF,23,ATL,2008,35,145.0,35,0,19,23,42,3,5,11,28,12,30,0.4,0,2,0.0,12,28,0.4285714285714285,0.4,11,20,0.55
Chris Kaman,kamanch01,C,25,LAC,2008,56,2083.0,878,107,173,538,711,33,155,164,179,338,700,0.4828571428571429,0,4,0.0,338,696,0.4856321839080459,0.483,202,265,0.7622641509433963
Jason Kapono,kaponja01,SF,26,TOR,2008,81,1530.0,580,65,31,89,120,34,2,58,131,243,498,0.4879518072289157,57,118,0.4830508474576271,186,380,0.4894736842105263,0.545,37,43,0.8604651162790697
Coby Karl,karlco01,SG,24,LAL,2008,17,71.0,30,9,3,11,14,4,2,5,4,9,26,0.3461538461538461,4,13,0.3076923076923077,5,13,0.3846153846153846,0.423,8,10,0.8
Viktor Khryapa,khryavi01,PF,25,CHI,2008,9,105.0,32,8,6,14,20,6,0,6,11,12,31,0.3870967741935484,0,1,0.0,12,30,0.4,0.387,8,14,0.5714285714285714
Jason Kidd,kiddja01,PG,34,TOT,2008,80,2906.0,864,806,94,506,600,136,26,266,165,305,793,0.3846153846153846,119,312,0.3814102564102564,186,481,0.3866943866943867,0.46,135,165,0.8181818181818182
Tarence Kinsey,kinseta01,SG,23,MEM,2008,11,96.0,40,2,3,9,12,3,0,3,11,16,38,0.4210526315789473,3,7,0.4285714285714285,13,31,0.4193548387096774,0.461,5,6,0.8333333333333334
Andrei Kirilenko,kirilan01,SF,26,UTA,2008,72,2217.0,792,285,121,218,339,86,109,140,165,275,544,0.5055147058823529,44,116,0.3793103448275862,231,428,0.5397196261682243,0.546,198,257,0.7704280155642024
Linas Kleiza,kleizli01,SF,23,DEN,2008,79,1889.0,880,95,92,241,333,44,19,89,181,311,659,0.471927162367223,94,277,0.3393501805054151,217,382,0.5680628272251309,0.543,164,213,0.7699530516431925
Brevin Knight,knighbr01,PG,32,LAC,2008,74,1674.0,338,328,15,127,142,100,11,71,160,138,342,0.4035087719298245,0,6,0.0,138,336,0.4107142857142857,0.404,62,71,0.8732394366197183
Kyle Korver,korveky01,SG-PF,26,TOT,2008,75,1732.0,740,101,21,151,172,42,29,75,192,255,575,0.4434782608695652,111,296,0.375,144,279,0.5161290322580645,0.54,119,130,0.9153846153846154
Nenad Krstić,krstine01,C,24,NJN,2008,45,812.0,298,27,35,165,200,9,17,41,111,123,300,0.41,0,2,0.0,123,298,0.412751677852349,0.41,52,69,0.7536231884057971
Raef LaFrentz,lafrera01,C,31,POR,2008,39,291.0,65,6,28,39,67,12,17,10,59,27,61,0.4426229508196721,0,4,0.0,27,57,0.4736842105263157,0.443,11,19,0.5789473684210527
Carl Landry,landrca01,PF,24,HOU,2008,42,711.0,342,21,96,111,207,17,7,26,98,135,219,0.6164383561643836,0,1,0.0,135,218,0.6192660550458715,0.616,72,109,0.6605504587155964
Keith Langford,langfke01,SG,24,SAS,2008,2,10.0,2,0,0,2,2,0,0,0,1,1,4,0.25,0,0,0.0,1,4,0.25,0.25,0,0,0.0
Stéphane Lasme,lasmest01,PF-SF,25,TOT,2008,16,303.0,83,3,26,27,53,13,22,15,35,32,71,0.4507042253521127,0,0,0.0,32,71,0.4507042253521127,0.451,19,32,0.59375
Acie Law,lawac01,PG,23,ATL,2008,56,865.0,235,113,12,45,57,29,0,56,73,95,237,0.4008438818565401,7,34,0.2058823529411764,88,203,0.4334975369458128,0.416,38,48,0.7916666666666666
David Lee,leeda02,PF,24,NYK,2008,81,2356.0,876,95,242,482,724,55,29,97,210,341,618,0.551779935275081,0,2,0.0,341,616,0.5535714285714286,0.552,194,237,0.8185654008438819
Rashard Lewis,lewisra02,PF,28,ORL,2008,81,3076.0,1476,196,97,340,437,99,38,140,214,516,1135,0.4546255506607929,226,553,0.4086799276672694,290,582,0.4982817869415807,0.554,218,260,0.8384615384615385
Kyle Lowry,lowryky01,PG,21,MEM,2008,82,2089.0,791,296,41,209,250,92,22,127,185,256,592,0.4324324324324324,36,140,0.2571428571428571,220,452,0.4867256637168141,0.463,243,348,0.6982758620689655
Tyronn Lue,luety01,PG,30,TOT,2008,50,736.0,290,74,9,45,54,11,1,27,66,113,253,0.4466403162055335,39,86,0.4534883720930232,74,167,0.4431137724550898,0.524,25,32,0.78125
Mark Madsen,madsema01,PF,32,MIN,2008,20,151.0,9,4,18,20,38,3,2,9,25,3,19,0.1578947368421052,0,0,0.0,3,19,0.1578947368421052,0.158,3,12,0.25
Corey Maggette,maggeco01,SF,28,LAC,2008,70,2502.0,1547,189,78,316,394,71,7,195,210,458,1000,0.458,78,203,0.3842364532019704,380,797,0.4767879548306148,0.497,553,681,0.8120411160058737
Jamaal Magloire,magloja01,C,29,TOT,2008,31,286.0,56,7,19,70,89,1,10,30,50,18,55,0.3272727272727272,0,0,0.0,18,55,0.3272727272727272,0.327,20,44,0.4545454545454545
Ian Mahinmi,mahinia01,C,21,SAS,2008,6,23.0,21,1,0,5,5,0,4,2,4,6,12,0.5,0,0,0.0,6,12,0.5,0.5,9,9,1.0
Stephon Marbury,marbust01,PG,30,NYK,2008,24,805.0,333,113,17,42,59,21,2,48,57,111,265,0.4188679245283019,28,74,0.3783783783783784,83,191,0.4345549738219895,0.472,83,116,0.7155172413793104
Shawn Marion,mariosh01,PF,29,TOT,2008,63,2315.0,972,138,136,507,643,125,85,86,150,400,787,0.5082592121982211,66,198,0.3333333333333333,334,589,0.567062818336163,0.55,106,150,0.7066666666666667
Sean Marks,marksse01,C,32,PHO,2008,19,130.0,59,4,9,27,36,3,10,8,23,23,43,0.5348837209302325,1,4,0.25,22,39,0.5641025641025641,0.547,12,19,0.631578947368421
Donyell Marshall,marshdo01,PF,34,TOT,2008,26,340.0,98,10,24,52,76,6,16,15,31,32,98,0.3265306122448979,15,53,0.2830188679245283,17,45,0.3777777777777777,0.403,19,22,0.8636363636363636
Darrick Martin,martida01,PG,36,TOR,2008,17,141.0,27,21,3,4,7,6,0,1,12,10,43,0.2325581395348837,2,16,0.125,8,27,0.2962962962962963,0.256,5,6,0.8333333333333334
Kenyon Martin,martike01,PF,30,DEN,2008,71,2159.0,877,90,105,356,461,88,85,91,235,376,699,0.5379113018597997,2,11,0.1818181818181818,374,688,0.5436046511627907,0.539,123,212,0.5801886792452831
Kevin Martin,martike02,SG,24,SAC,2008,61,2216.0,1443,129,48,225,273,62,5,131,150,417,914,0.4562363238512035,107,266,0.4022556390977443,310,648,0.4783950617283951,0.515,502,578,0.8685121107266436
Desmond Mason,masonde01,SF,30,MIL,2008,59,1702.0,574,121,75,181,256,40,30,83,106,230,477,0.4821802935010482,0,0,0.0,230,477,0.4821802935010482,0.482,114,173,0.6589595375722543
Roger Mason,masonro01,PG,27,WAS,2008,80,1708.0,724,134,17,113,130,40,18,69,140,266,600,0.4433333333333333,130,327,0.3975535168195718,136,273,0.4981684981684982,0.552,62,71,0.8732394366197183
Jason Maxiell,maxieja01,C,24,DET,2008,82,1768.0,651,46,177,256,433,21,94,71,183,240,446,0.5381165919282511,0,1,0.0,240,445,0.5393258426966292,0.538,171,270,0.6333333333333333
Rashad McCants,mccanra01,SG,23,MIN,2008,75,2020.0,1114,162,50,156,206,66,18,172,234,428,944,0.4533898305084746,142,349,0.4068767908309456,286,595,0.480672268907563,0.529,116,155,0.7483870967741936
Jelani McCoy,mccoyje01,C,30,DEN,2008,6,33.0,3,0,1,6,7,0,5,4,7,1,1,1.0,0,0,0.0,1,1,1.0,1.0,1,2,0.5
Antonio McDyess,mcdyean01,PF,33,DET,2008,78,2285.0,683,89,204,462,666,61,53,75,246,293,600,0.4883333333333333,0,2,0.0,293,598,0.4899665551839465,0.488,97,156,0.6217948717948718
Tracy McGrady,mcgratr01,SG,28,HOU,2008,66,2440.0,1427,387,42,297,339,68,30,160,91,548,1307,0.4192807957153787,86,295,0.2915254237288135,462,1012,0.4565217391304347,0.452,245,358,0.6843575418994413
Dominic McGuire,mcguido01,SG,22,WAS,2008,70,695.0,93,40,53,86,139,20,26,40,76,39,103,0.3786407766990291,1,6,0.1666666666666666,38,97,0.3917525773195876,0.383,14,32,0.4375
Jeff McInnis,mcinnje01,PG,33,CHA,2008,54,1410.0,242,220,16,80,96,23,3,76,120,108,249,0.4337349397590361,3,19,0.1578947368421052,105,230,0.4565217391304347,0.44,23,30,0.7666666666666667
Josh McRoberts,mcrobjo01,PF,20,POR,2008,8,28.0,12,2,2,8,10,1,0,2,1,6,10,0.6,0,1,0.0,6,9,0.6666666666666666,0.6,0,0,0.0
Chris Mihm,mihmch01,C,28,LAL,2008,23,278.0,82,13,28,49,77,4,14,17,42,32,95,0.3368421052631579,0,0,0.0,32,95,0.3368421052631579,0.337,18,27,0.6666666666666666
C.J. Miles,milescj01,SG,20,UTA,2008,60,689.0,297,53,16,62,78,32,8,27,98,113,236,0.4788135593220339,30,77,0.3896103896103896,83,159,0.5220125786163522,0.542,41,52,0.7884615384615384
Darko Miličić,milicda01,C,22,MEM,2008,70,1663.0,505,58,127,297,424,32,114,101,185,219,500,0.438,0,1,0.0,219,499,0.438877755511022,0.438,67,121,0.5537190082644629
Andre Miller,millean02,PG,31,PHI,2008,82,3016.0,1398,565,95,229,324,105,6,206,181,569,1156,0.4922145328719723,3,34,0.088235294117647,566,1122,0.5044563279857398,0.494,257,333,0.7717717717717718
Brad Miller,millebr01,C,31,SAC,2008,72,2513.0,964,264,167,514,681,69,74,164,247,337,728,0.4629120879120879,28,90,0.3111111111111111,309,638,0.4843260188087774,0.482,262,309,0.8478964401294499
Mike Miller,millemi01,SG,27,MEM,2008,70,2474.0,1147,240,51,416,467,35,16,182,145,414,824,0.5024271844660194,155,359,0.4317548746518105,259,465,0.556989247311828,0.596,164,212,0.7735849056603774
Paul Millsap,millspa01,PF,22,UTA,2008,82,1702.0,661,81,167,293,460,72,73,87,269,253,502,0.5039840637450199,0,4,0.0,253,498,0.5080321285140562,0.504,155,229,0.6768558951965066
Yao Ming,mingya01,C,27,HOU,2008,55,2044.0,1209,129,172,422,594,25,111,183,171,432,852,0.5070422535211268,0,2,0.0,432,850,0.508235294117647,0.507,345,406,0.8497536945812808
Cuttino Mobley,moblecu01,SG,32,LAC,2008,77,2702.0,984,202,50,225,275,78,34,123,152,377,870,0.4333333333333333,67,192,0.3489583333333333,310,678,0.4572271386430678,0.472,163,199,0.8190954773869347
Nazr Mohammed,mohamna01,C,30,TOT,2008,82,1650.0,639,72,194,300,494,45,60,101,230,272,528,0.5151515151515151,0,1,0.0,272,527,0.5161290322580645,0.515,95,163,0.5828220858895705
Jamario Moon,moonja01,SF,27,TOR,2008,78,2166.0,661,90,92,392,484,80,108,51,152,279,575,0.4852173913043478,40,122,0.3278688524590163,239,453,0.5275938189845475,0.52,63,85,0.7411764705882353
Mikki Moore,mooremi01,PF,32,SAC,2008,82,2385.0,698,84,160,334,494,35,46,110,310,282,489,0.5766871165644172,0,2,0.0,282,487,0.5790554414784395,0.577,134,182,0.7362637362637363
Randolph Morris,morrira01,C,22,NYK,2008,18,181.0,56,2,12,25,37,4,2,9,37,21,58,0.3620689655172414,0,0,0.0,21,58,0.3620689655172414,0.362,14,29,0.4827586206896552
Alonzo Mourning,mournal01,C,37,MIA,2008,25,389.0,149,7,34,59,93,4,42,25,56,52,95,0.5473684210526316,0,0,0.0,52,95,0.5473684210526316,0.547,45,76,0.5921052631578947
Troy Murphy,murphtr01,PF,27,IND,2008,75,2106.0,916,165,108,435,543,49,32,96,217,315,693,0.4545454545454545,94,236,0.3983050847457627,221,457,0.4835886214442013,0.522,192,241,0.7966804979253111
Ronald Murray,murraro01,PG,28,TOT,2008,42,874.0,396,144,23,60,83,38,4,84,50,154,367,0.4196185286103542,20,63,0.3174603174603174,134,304,0.4407894736842105,0.447,68,98,0.6938775510204082
Dikembe Mutombo,mutomdi01,C,41,HOU,2008,39,619.0,118,5,68,131,199,11,48,17,55,43,80,0.5375,0,0,0.0,43,80,0.5375,0.538,32,45,0.7111111111111111
Boštjan Nachbar,nachbbo01,PF,27,NJN,2008,75,1660.0,738,88,56,204,260,44,21,85,182,245,609,0.4022988505747126,94,262,0.3587786259541984,151,347,0.4351585014409221,0.479,154,196,0.7857142857142857
Eduardo Nájera,najered01,PF,31,DEN,2008,78,1664.0,464,95,113,224,337,69,40,59,199,174,368,0.4728260869565217,53,147,0.3605442176870748,121,221,0.5475113122171946,0.545,63,89,0.7078651685393258
Steve Nash,nashst01,PG,33,PHO,2008,81,2780.0,1371,898,28,254,282,53,5,295,113,485,962,0.5041580041580042,179,381,0.4698162729658792,306,581,0.5266781411359724,0.597,222,245,0.9061224489795918
Juan Carlos Navarro,navarju01,SG,27,MEM,2008,82,2117.0,896,177,34,176,210,48,1,134,94,308,766,0.402088772845953,156,432,0.3611111111111111,152,334,0.4550898203592814,0.504,124,146,0.8493150684931506
Jameer Nelson,nelsoja01,PG,25,ORL,2008,69,1961.0,755,383,28,215,243,63,4,141,167,283,603,0.4693200663349917,64,154,0.4155844155844156,219,449,0.487750556792873,0.522,125,151,0.8278145695364238
Rasho Nesterović,nestera01,C,31,TOR,2008,71,1486.0,552,82,130,212,342,20,52,60,132,257,467,0.550321199143469,1,3,0.3333333333333333,256,464,0.5517241379310345,0.551,37,49,0.7551020408163265
Ira Newble,newblir01,SG-SF,33,TOT,2008,49,698.0,188,18,47,78,125,28,8,34,69,76,174,0.4367816091954023,16,49,0.3265306122448979,60,125,0.48,0.483,20,26,0.7692307692307693
Demetris Nichols,nichode01,SF,23,TOT,2008,14,44.0,15,1,0,5,5,0,3,4,4,6,23,0.2608695652173913,3,13,0.2307692307692307,3,10,0.3,0.326,0,0,0.0
Joakim Noah,noahjo01,C,22,CHI,2008,74,1534.0,488,84,174,242,416,68,64,89,173,177,367,0.4822888283378747,0,1,0.0,177,366,0.4836065573770491,0.482,134,194,0.6907216494845361
Andrés Nocioni,nocioan01,SF,28,CHI,2008,82,2021.0,1080,95,48,294,342,25,43,133,245,379,877,0.4321550741163056,126,346,0.3641618497109826,253,531,0.4764595103578154,0.504,196,243,0.8065843621399177
Steve Novak,novakst01,SF,24,HOU,2008,35,264.0,135,6,4,31,35,2,3,4,17,49,102,0.4803921568627451,34,71,0.4788732394366197,15,31,0.4838709677419355,0.647,3,4,0.75
Dirk Nowitzki,nowitdi01,PF,29,DAL,2008,77,2769.0,1817,266,95,564,659,51,71,160,198,630,1314,0.4794520547945205,79,220,0.359090909090909,551,1094,0.5036563071297989,0.51,478,544,0.8786764705882353
Patrick O'Bryant,obryapa01,C,21,GSW,2008,24,99.0,35,4,10,19,29,4,9,7,27,16,29,0.5517241379310345,0,0,0.0,16,29,0.5517241379310345,0.552,3,5,0.6
Jermaine O'Neal,onealje01,C,29,IND,2008,42,1206.0,571,93,82,201,283,20,87,106,129,225,512,0.439453125,0,5,0.0,225,507,0.4437869822485207,0.439,121,163,0.7423312883435583
Shaquille O'Neal,onealsh01,C,35,TOT,2008,61,1748.0,832,93,166,388,554,32,88,181,228,331,558,0.5931899641577061,0,0,0.0,331,558,0.5931899641577061,0.593,170,338,0.5029585798816568
Fabricio Oberto,obertfa01,C,32,SAS,2008,82,1644.0,397,95,153,277,430,37,20,51,203,180,296,0.6081081081081081,0,1,0.0,180,295,0.6101694915254238,0.608,37,61,0.6065573770491803
Lamar Odom,odomla01,PF,28,LAL,2008,77,2921.0,1094,273,197,622,819,75,72,156,222,417,795,0.5245283018867924,31,113,0.2743362831858407,386,682,0.5659824046920822,0.544,229,328,0.698170731707317
Emeka Okafor,okafoem01,C,25,CHA,2008,82,2718.0,1133,70,255,621,876,62,138,164,241,460,860,0.5348837209302325,0,0,0.0,460,860,0.5348837209302325,0.535,213,374,0.56951871657754
Mehmet Okur,okurme01,C,28,UTA,2008,72,2390.0,1047,145,132,424,556,55,29,104,236,374,841,0.4447086801426873,114,294,0.3877551020408163,260,547,0.4753199268738574,0.512,185,230,0.8043478260869565
Kevin Ollie,ollieke01,SG,35,PHI,2008,40,300.0,70,38,4,15,19,10,0,5,28,29,69,0.4202898550724637,0,1,0.0,29,68,0.4264705882352941,0.42,12,15,0.8
Bo Outlaw,outlabo01,PF,36,ORL,2008,2,7.0,4,0,0,0,0,0,0,1,1,2,3,0.6666666666666666,0,0,0.0,2,3,0.6666666666666666,0.667,0,0,0.0
Travis Outlaw,outlatr01,PF,23,POR,2008,82,2186.0,1092,106,96,280,376,59,63,107,173,417,964,0.4325726141078838,40,101,0.396039603960396,377,863,0.436848203939745,0.453,218,294,0.7414965986394558
Andre Owens,owensan01,PG,27,IND,2008,31,392.0,123,47,13,34,47,13,3,24,37,40,107,0.3738317757009345,18,40,0.45,22,67,0.3283582089552239,0.458,25,34,0.7352941176470589
Zaza Pachulia,pachuza01,C,23,ATL,2008,62,944.0,322,36,89,159,248,24,13,69,140,107,245,0.436734693877551,0,3,0.0,107,242,0.4421487603305785,0.437,108,153,0.7058823529411765
Jannero Pargo,pargoja01,SG,28,NOH,2008,80,1497.0,644,192,26,104,130,50,5,93,123,254,652,0.3895705521472393,65,186,0.3494623655913978,189,466,0.4055793991416309,0.439,71,81,0.8765432098765432
Anthony Parker,parkean01,SG,32,TOR,2008,82,2634.0,1025,183,50,284,334,79,17,87,157,395,829,0.4764776839565742,133,304,0.4375,262,525,0.4990476190476191,0.557,102,125,0.816
Smush Parker,parkesm01,PG,26,TOT,2008,28,592.0,165,84,4,47,51,24,6,44,60,64,184,0.3478260869565217,18,78,0.2307692307692307,46,106,0.4339622641509434,0.397,19,28,0.6785714285714286
Tony Parker,parketo01,PG,25,SAS,2008,69,2312.0,1295,411,30,191,221,55,8,164,93,515,1043,0.4937679769894535,17,66,0.2575757575757575,498,977,0.5097236438075742,0.502,248,347,0.7146974063400576
Ruben Patterson,patteru01,SF,32,LAC,2008,20,327.0,102,17,24,40,64,21,7,27,37,39,86,0.4534883720930232,0,2,0.0,39,84,0.4642857142857143,0.453,24,43,0.5581395348837209
Chris Paul,paulch01,PG,22,NOH,2008,80,3006.0,1684,925,62,259,321,217,4,201,185,630,1291,0.487993803253292,92,249,0.3694779116465863,538,1042,0.5163147792706334,0.524,332,390,0.8512820512820513
Sasha Pavlović,pavloal01,SG,24,CLE,2008,51,1188.0,379,82,35,93,128,29,6,55,117,146,403,0.3622828784119106,34,114,0.2982456140350877,112,289,0.3875432525951557,0.404,53,77,0.6883116883116883
Oleksiy Pecherov,pecheol01,C,22,WAS,2008,35,320.0,125,7,21,45,66,6,5,17,30,44,125,0.352,17,60,0.2833333333333333,27,65,0.4153846153846154,0.42,20,31,0.6451612903225806
Kendrick Perkins,perkike01,C,23,BOS,2008,78,1912.0,542,84,145,329,474,31,114,125,242,214,348,0.6149425287356322,0,1,0.0,214,347,0.6167146974063401,0.615,114,183,0.6229508196721312
Kosta Perović,perovko01,C,22,GSW,2008,7,38.0,10,1,6,7,13,0,2,1,6,3,10,0.3,0,0,0.0,3,10,0.3,0.3,4,6,0.6666666666666666
Morris Peterson,petermo01,SG,30,NOH,2008,76,1796.0,608,67,36,170,206,47,7,41,125,215,516,0.4166666666666667,113,287,0.3937282229965156,102,229,0.445414847161572,0.526,65,85,0.7647058823529411
Johan Petro,petrojo01,C,22,SEA,2008,72,1310.0,432,32,98,272,370,35,42,73,173,184,439,0.4191343963553531,0,1,0.0,184,438,0.4200913242009132,0.419,64,87,0.735632183908046
Eric Piatkowski,piatker01,SF,37,PHO,2008,16,113.0,39,10,1,11,12,0,1,6,11,12,33,0.3636363636363636,11,26,0.4230769230769231,1,7,0.1428571428571428,0.53,4,4,1.0
Paul Pierce,piercpa01,SF,30,BOS,2008,80,2874.0,1570,363,53,358,411,101,36,221,200,509,1098,0.4635701275045537,143,365,0.3917808219178082,366,733,0.4993178717598908,0.529,409,485,0.843298969072165
Mickaël Piétrus,pietrmi01,SF,25,GSW,2008,66,1316.0,472,49,67,175,242,66,43,48,200,170,387,0.4392764857881137,66,183,0.360655737704918,104,204,0.5098039215686274,0.525,66,98,0.673469387755102
Scot Pollard,pollasc01,C,32,BOS,2008,22,173.0,39,3,14,23,37,3,6,5,43,12,23,0.5217391304347826,0,0,0.0,12,23,0.5217391304347826,0.522,15,22,0.6818181818181818
James Posey,poseyja01,PF,31,BOS,2008,74,1821.0,545,114,30,292,322,72,19,65,182,173,414,0.4178743961352657,106,279,0.3799283154121863,67,135,0.4962962962962963,0.546,93,115,0.808695652173913
Leon Powe,powele01,C,24,BOS,2008,56,809.0,445,15,95,132,227,15,16,43,127,154,269,0.5724907063197026,0,1,0.0,154,268,0.5746268656716418,0.572,137,193,0.7098445595854922
Josh Powell,poweljo01,C,25,LAC,2008,64,1228.0,353,47,115,216,331,14,23,65,130,145,315,0.4603174603174603,0,3,0.0,145,312,0.4647435897435897,0.46,63,87,0.7241379310344828
Kasib Powell,powelka01,SF,26,MIA,2008,11,304.0,84,18,8,36,44,9,2,5,18,35,95,0.3684210526315789,8,33,0.2424242424242424,27,62,0.4354838709677419,0.411,6,9,0.6666666666666666
Ronnie Price,pricero01,PG,24,UTA,2008,61,588.0,228,78,8,38,46,32,3,30,83,88,204,0.4313725490196078,26,75,0.3466666666666667,62,129,0.4806201550387597,0.495,26,38,0.6842105263157895
Tayshaun Prince,princta01,SF,27,DET,2008,82,2694.0,1080,268,109,289,398,42,33,91,90,421,940,0.4478723404255319,53,146,0.363013698630137,368,794,0.4634760705289673,0.476,185,241,0.7676348547717843
Gabe Pruitt,pruitga01,PG,21,BOS,2008,15,95.0,32,13,1,7,8,5,0,5,10,14,39,0.358974358974359,3,12,0.25,11,27,0.4074074074074074,0.397,1,2,0.5
Joel Przybilla,przybjo01,C,28,POR,2008,77,1819.0,371,27,195,454,649,13,93,95,234,144,250,0.576,0,1,0.0,144,249,0.5783132530120482,0.576,83,122,0.680327868852459
Chris Quinn,quinnch01,PG,24,MIA,2008,60,1340.0,465,178,11,107,118,46,4,55,90,158,373,0.4235924932975871,64,159,0.4025157232704403,94,214,0.4392523364485981,0.509,85,98,0.8673469387755102
Vladimir Radmanović,radmavl01,SF,27,LAL,2008,65,1483.0,543,123,56,159,215,46,12,73,147,198,437,0.4530892448512585,95,234,0.405982905982906,103,203,0.5073891625615764,0.562,52,65,0.8
Shavlik Randolph,randosh01,PF,24,PHI,2008,9,27.0,8,3,9,2,11,1,3,2,5,4,14,0.2857142857142857,0,0,0.0,4,14,0.2857142857142857,0.286,0,0,0.0
Zach Randolph,randoza01,C,26,NYK,2008,69,2244.0,1217,140,184,526,710,59,16,186,194,486,1058,0.4593572778827977,22,80,0.275,464,978,0.4744376278118609,0.47,223,289,0.7716262975778547
Theo Ratliff,ratlith01,C-PF,34,TOT,2008,26,437.0,111,14,32,57,89,7,37,21,59,41,85,0.4823529411764706,0,1,0.0,41,84,0.4880952380952381,0.482,29,43,0.6744186046511628
Michael Redd,reddmi01,SG,28,MIL,2008,72,2702.0,1632,247,85,224,309,65,13,181,120,550,1243,0.4424778761061947,130,359,0.362116991643454,420,884,0.4751131221719457,0.495,402,490,0.8204081632653061
J.J. Redick,redicjj01,SG,23,ORL,2008,34,276.0,140,16,1,22,23,4,0,15,29,48,108,0.4444444444444444,17,43,0.3953488372093023,31,65,0.4769230769230769,0.523,27,34,0.7941176470588235
Chris Richard,richach01,C,23,MIN,2008,52,556.0,98,18,52,83,135,10,12,24,83,41,87,0.4712643678160919,0,0,0.0,41,87,0.4712643678160919,0.471,16,27,0.5925925925925926
Jason Richardson,richaja01,SF,27,CHA,2008,82,3149.0,1788,258,80,361,441,116,57,166,241,648,1468,0.44141689373297,243,599,0.4056761268781302,405,869,0.4660529344073648,0.524,249,331,0.7522658610271903
Jeremy Richardson,richaje01,SG-SF,23,TOT,2008,27,132.0,41,2,1,8,9,3,0,6,13,16,44,0.3636363636363636,7,19,0.3684210526315789,9,25,0.36,0.443,2,2,1.0
Quentin Richardson,richaqu01,SF,27,NYK,2008,65,1841.0,527,116,56,259,315,44,15,69,153,199,555,0.3585585585585585,69,214,0.322429906542056,130,341,0.3812316715542522,0.421,60,88,0.6818181818181818
Luke Ridnour,ridnolu01,PG,26,SEA,2008,61,1223.0,393,241,13,81,94,37,14,80,120,147,368,0.3994565217391304,21,71,0.2957746478873239,126,297,0.4242424242424242,0.428,78,91,0.8571428571428571
Nate Robinson,robinna01,PG,23,NYK,2008,72,1883.0,913,212,51,171,222,60,1,103,186,331,782,0.4232736572890025,97,292,0.3321917808219178,234,490,0.4775510204081633,0.485,154,196,0.7857142857142857
Sergio Rodríguez,rodrise01,PG,21,POR,2008,72,628.0,180,123,13,45,58,24,0,53,57,69,196,0.3520408163265306,17,58,0.293103448275862,52,138,0.3768115942028985,0.395,25,38,0.6578947368421053
Rajon Rondo,rondora01,PG,21,BOS,2008,77,2306.0,814,393,78,244,322,129,13,147,187,351,713,0.4922861150070126,5,19,0.2631578947368421,346,694,0.4985590778097982,0.496,107,175,0.6114285714285714
Malik Rose,rosema01,PF,33,NYK,2008,49,494.0,171,28,31,72,103,16,7,40,80,66,180,0.3666666666666666,2,7,0.2857142857142857,64,173,0.3699421965317919,0.372,37,51,0.7254901960784313
Quinton Ross,rossqu01,SG,26,LAC,2008,76,1505.0,311,88,54,118,172,43,33,29,132,131,335,0.3910447761194029,9,21,0.4285714285714285,122,314,0.3885350318471338,0.404,40,60,0.6666666666666666
Brandon Roy,roybr01,SG,23,POR,2008,74,2792.0,1416,430,81,267,348,79,16,136,147,531,1170,0.4538461538461538,73,215,0.3395348837209302,458,955,0.4795811518324607,0.485,281,373,0.7533512064343163
Michael Ruffin,ruffimi01,C,31,MIL,2008,46,632.0,91,24,90,96,186,31,19,19,93,33,62,0.532258064516129,0,0,0.0,33,62,0.532258064516129,0.532,25,63,0.3968253968253968
Kareem Rush,rushka01,SG,27,IND,2008,71,1504.0,588,89,19,149,168,42,19,62,108,228,569,0.4007029876977153,102,262,0.3893129770992366,126,307,0.4104234527687296,0.49,30,42,0.7142857142857143
John Salmons,salmojo01,SG,28,SAC,2008,81,2517.0,1015,208,76,273,349,93,31,170,171,381,799,0.4768460575719649,39,120,0.325,342,679,0.5036818851251841,0.501,214,260,0.823076923076923
Cheikh Samb,sambch01,C,23,DET,2008,4,31.0,7,0,3,4,7,1,2,1,8,3,4,0.75,0,0,0.0,3,4,0.75,0.75,1,2,0.5
Brian Scalabrine,scalabr01,PF,29,BOS,2008,48,512.0,88,40,22,57,79,9,8,26,63,29,94,0.3085106382978723,15,46,0.3260869565217391,14,48,0.2916666666666667,0.388,15,20,0.75
Luis Scola,scolalu01,PF,27,HOU,2008,82,2024.0,847,106,174,351,525,60,19,105,235,345,670,0.5149253731343284,0,3,0.0,345,667,0.5172413793103449,0.515,157,235,0.6680851063829787
Thabo Sefolosha,sefolth01,SG,23,CHI,2008,69,1436.0,464,129,50,205,255,61,30,93,128,180,421,0.4275534441805225,29,88,0.3295454545454545,151,333,0.4534534534534534,0.462,75,104,0.7211538461538461
Mouhamed Sene,senesa01,C,21,SEA,2008,13,62.0,30,1,7,9,16,0,7,0,9,11,24,0.4583333333333333,0,0,0.0,11,24,0.4583333333333333,0.458,8,17,0.4705882352941176
Ramon Sessions,sessira01,PG,21,MIL,2008,17,450.0,137,127,8,50,58,17,3,36,26,51,117,0.4358974358974359,3,7,0.4285714285714285,48,110,0.4363636363636363,0.449,32,41,0.7804878048780488
Bobby Simmons,simmobo01,SF,27,MIL,2008,70,1521.0,531,80,67,159,226,50,5,78,140,209,496,0.4213709677419355,60,171,0.3508771929824561,149,325,0.4584615384615385,0.482,53,70,0.7571428571428571
Cedric Simmons,simmoce01,PF,22,TOT,2008,14,87.0,8,0,6,12,18,2,5,6,8,4,14,0.2857142857142857,0,0,0.0,4,14,0.2857142857142857,0.286,0,10,0.0
Courtney Sims,simsco01,C,24,IND,2008,3,11.0,0,1,1,1,2,0,0,0,2,0,1,0.0,0,0,0.0,0,1,0.0,0.0,0,0,0.0
Brian Skinner,skinnbr01,C,31,PHO,2008,66,844.0,219,15,63,175,238,21,77,39,112,92,198,0.4646464646464646,2,3,0.6666666666666666,90,195,0.4615384615384615,0.47,33,63,0.5238095238095238
Craig Smith,smithcr01,PF,24,MIN,2008,77,1547.0,727,60,123,230,353,36,17,89,217,297,528,0.5625,0,9,0.0,297,519,0.5722543352601156,0.563,133,200,0.665
J.R. Smith,smithjr01,SG,22,DEN,2008,74,1421.0,907,128,43,109,152,62,12,112,144,311,674,0.4614243323442136,157,390,0.4025641025641026,154,284,0.5422535211267606,0.578,128,178,0.7191011235955056
Jason Smith,smithja02,PF,21,PHI,2008,76,1107.0,340,20,77,153,230,22,50,48,142,141,310,0.4548387096774193,4,14,0.2857142857142857,137,296,0.4628378378378378,0.461,54,82,0.6585365853658537
Joe Smith,smithjo02,PF,32,TOT,2008,77,1726.0,778,66,163,238,401,34,47,71,186,312,653,0.4777947932618683,0,3,0.0,312,650,0.48,0.478,154,204,0.7549019607843137
Josh Smith,smithjo03,PF,22,ATL,2008,81,2873.0,1394,272,161,506,667,123,227,245,269,518,1133,0.4571932921447484,25,99,0.2525252525252525,493,1034,0.4767891682785299,0.468,333,469,0.7100213219616205
Eric Snow,snower01,PG,34,CLE,2008,22,305.0,22,42,4,16,20,10,4,10,30,6,38,0.1578947368421052,0,2,0.0,6,36,0.1666666666666666,0.158,10,22,0.4545454545454545
Kirk Snyder,snydeki01,SF-PF,24,TOT,2008,36,761.0,261,64,30,96,126,20,15,52,55,96,189,0.5079365079365079,5,23,0.217391304347826,91,166,0.5481927710843374,0.521,64,88,0.7272727272727273
Darius Songaila,songada01,C,29,WAS,2008,80,1554.0,495,135,81,190,271,53,16,86,181,214,467,0.4582441113490364,0,2,0.0,214,465,0.4602150537634408,0.458,67,73,0.9178082191780822
Jerry Stackhouse,stackje01,SG,33,DAL,2008,58,1412.0,618,145,33,100,133,28,10,86,82,213,526,0.4049429657794677,60,184,0.3260869565217391,153,342,0.4473684210526316,0.462,132,148,0.8918918918918919
DeShawn Stevenson,stevede01,SG,26,WAS,2008,82,2564.0,917,252,37,198,235,65,15,102,110,301,780,0.3858974358974359,158,413,0.3825665859564164,143,367,0.3896457765667575,0.487,157,197,0.7969543147208121
Peja Stojaković,stojape01,SF,30,NOH,2008,77,2711.0,1263,96,64,267,331,57,10,61,127,451,1026,0.4395711500974659,231,524,0.4408396946564885,220,502,0.4382470119521912,0.552,130,140,0.9285714285714286
Awvee Storey,storeaw01,SG,30,MIL,2008,26,259.0,92,16,31,23,54,7,1,10,41,39,89,0.4382022471910112,0,7,0.0,39,82,0.4756097560975609,0.438,14,29,0.4827586206896552
Damon Stoudamire,stoudda01,PG,34,TOT,2008,60,1037.0,317,165,20,98,118,30,2,80,76,120,337,0.3560830860534125,50,149,0.3355704697986577,70,188,0.3723404255319149,0.43,27,34,0.7941176470588235
Salim Stoudamire,stoudsa01,PG,25,ATL,2008,35,402.0,200,28,4,20,24,7,5,21,34,65,180,0.3611111111111111,29,85,0.3411764705882353,36,95,0.3789473684210526,0.442,41,50,0.82
Amar'e Stoudemire,stoudam01,C,25,PHO,2008,79,2677.0,1989,118,178,541,719,64,163,174,294,714,1211,0.5895953757225434,5,31,0.1612903225806451,709,1180,0.6008474576271187,0.592,556,691,0.804630969609262
D.J. Strawberry,strawdj01,SG,22,PHO,2008,33,270.0,73,30,9,19,28,12,6,11,36,29,92,0.3152173913043478,6,25,0.24,23,67,0.3432835820895522,0.348,9,19,0.4736842105263157
Rodney Stuckey,stuckro01,PG,21,DET,2008,57,1081.0,436,160,32,97,129,49,6,78,113,153,382,0.4005235602094241,3,16,0.1875,150,366,0.4098360655737705,0.404,127,156,0.8141025641025641
Robert Swift,swiftro01,C,22,SEA,2008,8,98.0,14,1,6,12,18,5,6,10,16,6,17,0.3529411764705882,0,0,0.0,6,17,0.3529411764705882,0.353,2,2,1.0
Stromile Swift,swiftst01,PF,28,TOT,2008,56,844.0,343,26,64,135,199,15,54,51,113,135,265,0.5094339622641509,0,2,0.0,135,263,0.5133079847908745,0.509,73,109,0.6697247706422018
Wally Szczerbiak,szczewa02,SF,30,TOT,2008,75,1736.0,861,104,34,183,217,23,12,76,103,311,722,0.4307479224376731,90,218,0.4128440366972477,221,504,0.4384920634920635,0.493,149,175,0.8514285714285714
Sebastian Telfair,telfase01,PG,22,MIN,2008,60,1933.0,556,355,16,119,135,59,11,111,171,223,556,0.4010791366906475,32,114,0.2807017543859649,191,442,0.4321266968325792,0.43,78,105,0.7428571428571429
Jason Terry,terryja01,SG,30,DAL,2008,82,2579.0,1269,264,30,178,208,88,18,92,170,471,1008,0.4672619047619047,136,363,0.3746556473829201,335,645,0.5193798449612403,0.535,191,223,0.8565022421524664
Billy Thomas,thomabi01,SF,32,TOT,2008,11,42.0,14,0,0,2,2,1,0,4,4,4,17,0.2352941176470588,4,16,0.25,0,1,0.0,0.353,2,2,1.0
Kenny Thomas,thomake01,PF,30,SAC,2008,23,281.0,32,13,18,43,61,6,1,21,38,16,38,0.4210526315789473,0,0,0.0,16,38,0.4210526315789473,0.421,0,5,0.0
Kurt Thomas,thomaku01,C-PF,35,TOT,2008,70,1584.0,443,67,130,377,507,56,57,46,188,195,396,0.4924242424242424,0,1,0.0,195,395,0.4936708860759494,0.492,53,80,0.6625
Tim Thomas,thomati01,PF,30,LAC,2008,63,1940.0,780,171,62,261,323,40,29,98,192,291,705,0.4127659574468085,83,271,0.3062730627306273,208,434,0.4792626728110599,0.472,115,153,0.7516339869281046
Tyrus Thomas,thomaty01,PF,21,CHI,2008,74,1330.0,502,90,102,240,342,48,72,77,170,186,440,0.4227272727272727,1,6,0.1666666666666666,185,434,0.4262672811059907,0.424,129,174,0.7413793103448276
Al Thornton,thornal01,PF,24,LAC,2008,79,2158.0,1005,98,98,260,358,46,43,128,195,374,871,0.4293915040183697,43,130,0.3307692307692307,331,741,0.446693657219973,0.454,214,288,0.7430555555555556
Jamaal Tinsley,tinslja01,PG,29,IND,2008,39,1293.0,464,326,24,117,141,66,10,130,97,176,463,0.3801295896328294,40,141,0.2836879432624113,136,322,0.422360248447205,0.423,72,100,0.72
Alando Tucker,tuckeal02,SF,23,PHO,2008,6,48.0,22,0,4,4,8,0,1,0,2,8,22,0.3636363636363636,1,4,0.25,7,18,0.3888888888888889,0.386,5,6,0.8333333333333334
Ronny Turiaf,turiaro01,C,25,LAL,2008,78,1458.0,516,128,95,211,306,28,108,72,199,188,397,0.473551637279597,0,1,0.0,188,396,0.4747474747474747,0.474,140,186,0.7526881720430108
Hedo Türkoğlu,turkohe01,SF,28,ORL,2008,82,3026.0,1602,409,83,388,471,74,25,246,244,556,1219,0.4561115668580804,166,415,0.4,390,804,0.4850746268656716,0.524,324,391,0.8286445012787724
Ime Udoka,udokaim01,PF,30,SAS,2008,73,1316.0,423,63,36,192,228,56,17,58,127,159,375,0.424,61,165,0.3696969696969697,98,210,0.4666666666666667,0.505,44,58,0.7586206896551724
Beno Udrih,udrihbe01,PG,25,SAC,2008,65,2080.0,834,282,34,183,217,56,10,148,138,328,708,0.4632768361581921,53,137,0.3868613138686131,275,571,0.4816112084063047,0.501,125,147,0.8503401360544217
Anderson Varejão,varejan01,C,25,CLE,2008,48,1320.0,321,53,134,265,399,37,26,59,134,136,295,0.4610169491525424,0,2,0.0,136,293,0.4641638225255973,0.461,49,82,0.5975609756097561
Jacque Vaughn,vaughja01,PG,32,SAS,2008,74,1139.0,306,159,13,61,74,23,1,54,97,121,283,0.4275618374558304,3,10,0.3,118,273,0.4322344322344322,0.433,61,80,0.7625
Charlie Villanueva,villach01,PF,23,MIL,2008,76,1829.0,886,78,145,321,466,30,35,107,174,354,814,0.4348894348894349,55,185,0.2972972972972973,299,629,0.4753577106518283,0.469,123,157,0.7834394904458599
Marcus Vinicius,vincima01,SF,23,NOH,2008,13,69.0,28,2,1,7,8,1,1,3,4,9,20,0.45,5,12,0.4166666666666667,4,8,0.5,0.575,5,11,0.4545454545454545
Jake Voskuhl,voskuja01,C,30,MIL,2008,44,386.0,98,13,30,67,97,9,21,29,83,37,80,0.4625,0,0,0.0,37,80,0.4625,0.463,24,29,0.8275862068965517
Sasha Vujačić,vujacsa01,SG,23,LAL,2008,72,1279.0,632,72,19,135,154,36,5,52,107,219,482,0.454356846473029,118,270,0.437037037037037,101,212,0.4764150943396226,0.577,76,91,0.8351648351648352
Dwyane Wade,wadedw01,SG,26,MIA,2008,51,1954.0,1254,354,45,169,214,87,37,224,137,439,937,0.4685165421558164,22,77,0.2857142857142857,417,860,0.4848837209302326,0.48,354,467,0.7580299785867237
Von Wafer,wafervo01,SG,22,TOT,2008,29,154.0,46,7,1,18,19,2,3,13,7,17,61,0.2786885245901639,4,26,0.1538461538461538,13,35,0.3714285714285714,0.311,8,12,0.6666666666666666
Antoine Walker,walkean02,PF,31,MIN,2008,46,892.0,368,45,56,112,168,33,8,46,80,136,375,0.3626666666666667,61,188,0.324468085106383,75,187,0.4010695187165775,0.444,35,66,0.5303030303030303
Ben Wallace,wallabe01,C-PF,33,TOT,2008,72,2205.0,348,105,234,370,604,88,117,67,121,138,352,0.3920454545454545,0,4,0.0,138,348,0.396551724137931,0.392,72,169,0.4260355029585799
Gerald Wallace,wallage01,PF,25,CHA,2008,62,2376.0,1200,216,58,315,373,131,58,180,189,408,908,0.4493392070484581,71,221,0.3212669683257919,337,687,0.4905385735080058,0.488,313,428,0.7313084112149533
Rasheed Wallace,wallara01,C,33,DET,2008,77,2346.0,979,137,84,427,511,91,129,86,213,376,870,0.432183908045977,112,315,0.3555555555555555,264,555,0.4756756756756757,0.497,115,150,0.7666666666666667
Luke Walton,waltolu01,SF,27,LAL,2008,74,1729.0,535,218,85,206,291,60,18,100,133,215,478,0.4497907949790795,28,84,0.3333333333333333,187,394,0.4746192893401015,0.479,77,109,0.7064220183486238
Hakim Warrick,warriha01,PF,25,MEM,2008,75,1754.0,852,53,123,233,356,36,28,85,156,328,653,0.5022970903522205,13,48,0.2708333333333333,315,605,0.5206611570247934,0.512,183,260,0.7038461538461539
Darius Washington,washida01,SG,22,SAS,2008,18,146.0,53,15,4,16,20,5,0,14,16,21,48,0.4375,4,12,0.3333333333333333,17,36,0.4722222222222222,0.479,7,13,0.5384615384615384
Darryl Watkins,watkida01,C,23,SAC,2008,9,71.0,12,0,5,7,12,2,2,7,8,5,15,0.3333333333333333,0,0,0.0,5,15,0.3333333333333333,0.333,2,5,0.4
C.J. Watson,watsocj01,PG,23,GSW,2008,32,368.0,118,35,13,19,32,15,0,18,19,43,101,0.4257425742574257,9,26,0.3461538461538461,34,75,0.4533333333333333,0.47,23,29,0.7931034482758621
Earl Watson,watsoea01,PG,28,SEA,2008,78,2269.0,838,531,43,182,225,69,11,175,158,339,747,0.4538152610441767,49,132,0.3712121212121212,290,615,0.4715447154471545,0.487,111,145,0.7655172413793103
Chris Webber,webbech01,PF,34,GSW,2008,9,126.0,35,18,2,30,32,4,6,11,17,15,31,0.4838709677419355,0,0,0.0,15,31,0.4838709677419355,0.484,5,12,0.4166666666666667
Martell Webster,webstma02,SF,21,POR,2008,75,2132.0,799,90,54,242,296,42,28,83,159,277,656,0.4222560975609756,123,317,0.3880126182965299,154,339,0.4542772861356932,0.516,122,166,0.7349397590361446
Bonzi Wells,wellsbo01,SG,31,TOT,2008,73,1562.0,662,97,84,247,331,75,32,103,157,252,569,0.4428822495606327,12,50,0.24,240,519,0.4624277456647399,0.453,146,227,0.6431718061674009
David West,westda01,PF,27,NOH,2008,76,2870.0,1564,177,180,495,675,62,99,165,208,629,1305,0.481992337164751,6,25,0.24,623,1280,0.48671875,0.484,300,353,0.8498583569405099
Delonte West,westde01,PG,24,TOT,2008,61,1533.0,507,229,31,162,193,59,29,117,103,196,475,0.4126315789473684,48,135,0.3555555555555555,148,340,0.4352941176470588,0.463,67,91,0.7362637362637363
Mario West,westma02,SG,23,ATL,2008,64,269.0,59,13,26,22,48,12,4,9,61,21,49,0.4285714285714285,0,4,0.0,21,45,0.4666666666666667,0.429,17,26,0.6538461538461539
Chris Wilcox,wilcoch01,PF,25,SEA,2008,62,1739.0,828,74,126,307,433,46,36,103,174,334,638,0.5235109717868338,0,3,0.0,334,635,0.525984251968504,0.524,160,248,0.6451612903225806
Damien Wilkins,wilkida02,SF,28,SEA,2008,76,1843.0,698,150,72,173,245,62,19,89,128,271,673,0.4026745913818722,50,155,0.3225806451612903,221,518,0.4266409266409266,0.44,106,144,0.7361111111111112
Mike Wilks,wilksmi01,PG,28,TOT,2008,15,188.0,41,14,5,14,19,9,0,9,13,17,36,0.4722222222222222,3,8,0.375,14,28,0.5,0.514,4,4,1.0
Aaron Williams,williaa01,C,36,LAC,2008,30,297.0,68,9,15,46,61,12,15,13,44,27,55,0.4909090909090909,0,0,0.0,27,55,0.4909090909090909,0.491,14,18,0.7777777777777778
Deron Williams,willide01,PG,23,UTA,2008,82,3059.0,1545,862,34,209,243,90,23,279,200,566,1117,0.5067144136078783,83,210,0.3952380952380952,483,907,0.5325248070562293,0.544,330,411,0.8029197080291971
Jason Williams,willija02,PG,32,MIA,2008,67,1886.0,588,307,12,118,130,83,5,91,93,211,550,0.3836363636363636,97,275,0.3527272727272727,114,275,0.4145454545454545,0.472,69,80,0.8625
Justin Williams,williju01,C,23,TOT,2008,23,123.0,34,0,20,29,49,5,5,4,17,13,29,0.4482758620689655,0,0,0.0,13,29,0.4482758620689655,0.448,8,26,0.3076923076923077
Lou Williams,willilo02,PG,21,PHI,2008,80,1862.0,920,253,41,126,167,81,13,125,130,319,752,0.4242021276595745,55,153,0.3594771241830065,264,599,0.4407345575959933,0.461,227,290,0.7827586206896552
Marcus Williams,willima03,PG,22,NJN,2008,53,854.0,313,140,14,87,101,25,3,75,52,111,293,0.378839590443686,54,142,0.380281690140845,57,151,0.3774834437086092,0.471,37,47,0.7872340425531915
Marcus Williams,willima04,PF-SF,21,TOT,2008,11,36.0,10,3,4,8,12,1,1,0,3,5,20,0.25,0,0,0.0,5,20,0.25,0.25,0,0,0.0
Marvin Williams,willima02,SF,21,ATL,2008,80,2765.0,1185,137,119,338,457,81,33,127,225,424,918,0.4618736383442265,1,10,0.1,423,908,0.4658590308370044,0.462,336,409,0.8215158924205379
Mo Williams,willima01,PG,25,MIL,2008,66,2410.0,1137,419,37,193,230,78,10,182,188,441,919,0.4798694232861806,89,231,0.3852813852813853,352,688,0.5116279069767442,0.528,166,194,0.8556701030927835
Sean Williams,willise01,C,21,NJN,2008,73,1278.0,409,28,115,207,322,28,106,70,193,164,305,0.5377049180327869,0,0,0.0,164,305,0.5377049180327869,0.538,81,133,0.6090225563909775
Shawne Williams,willish03,SF,21,IND,2008,65,967.0,437,59,54,122,176,26,26,58,132,159,372,0.4274193548387097,43,137,0.3138686131386861,116,235,0.4936170212765957,0.485,76,106,0.7169811320754716
Shelden Williams,willish02,PF,24,TOT,2008,64,776.0,255,19,68,137,205,22,21,35,110,92,212,0.4339622641509434,0,2,0.0,92,210,0.4380952380952381,0.434,71,105,0.6761904761904762
Loren Woods,woodslo01,C,29,HOU,2008,7,17.0,6,2,0,1,1,0,0,0,2,3,5,0.6,0,0,0.0,3,5,0.6,0.6,0,0,0.0
Metta World Peace,artesro01,SF,28,SAC,2008,57,2172.0,1168,199,101,227,328,133,38,148,159,436,962,0.4532224532224532,84,221,0.3800904977375565,352,741,0.4750337381916329,0.497,212,295,0.7186440677966102
Antoine Wright,wrighan01,SG,23,TOT,2008,56,1232.0,350,80,40,107,147,28,21,50,127,136,329,0.4133738601823708,32,110,0.2909090909090909,104,219,0.4748858447488584,0.462,46,67,0.6865671641791045
Brandan Wright,wrighbr03,PF,20,GSW,2008,38,376.0,151,9,38,61,99,6,22,13,36,62,112,0.5535714285714286,0,0,0.0,62,112,0.5535714285714286,0.554,27,40,0.675
Dorell Wright,wrighdo01,SF,22,MIA,2008,44,1104.0,347,60,48,172,220,29,41,29,79,143,293,0.4880546075085324,4,11,0.3636363636363636,139,282,0.4929078014184397,0.495,57,69,0.8260869565217391
Julian Wright,wrighju01,SF,20,NOH,2008,57,640.0,223,40,33,84,117,29,12,34,43,90,169,0.5325443786982249,10,24,0.4166666666666667,80,145,0.5517241379310345,0.562,33,52,0.6346153846153846
Lorenzen Wright,wrighlo02,C,32,TOT,2008,18,161.0,15,4,8,30,38,3,3,4,31,6,21,0.2857142857142857,0,0,0.0,6,21,0.2857142857142857,0.286,3,6,0.5
Nick Young,youngni01,SG,22,WAS,2008,75,1158.0,561,63,23,92,115,35,7,94,130,210,478,0.4393305439330544,40,100,0.4,170,378,0.4497354497354497,0.481,101,124,0.8145161290322581
Thaddeus Young,youngth01,PF,19,PHI,2008,74,1554.0,610,58,120,192,312,73,8,64,126,264,490,0.5387755102040817,6,19,0.3157894736842105,258,471,0.5477707006369427,0.545,76,103,0.7378640776699029
Alex Acker,ackeral01,SG,26,TOT,2009,25,199.0,72,12,8,16,24,5,4,7,9,30,76,0.3947368421052631,7,20,0.35,23,56,0.4107142857142857,0.441,5,10,0.5
Hassan Adams,adamsha01,SG,24,TOR,2009,12,52.0,11,1,1,6,7,1,1,4,4,4,13,0.3076923076923077,0,0,0.0,4,13,0.3076923076923077,0.308,3,6,0.5
Arron Afflalo,afflaar01,SG,23,DET,2009,74,1234.0,363,44,30,104,134,28,13,43,144,131,300,0.4366666666666666,43,107,0.4018691588785046,88,193,0.4559585492227979,0.508,58,71,0.8169014084507042
Maurice Ager,agerma01,SG,24,NJN,2009,20,97.0,34,3,3,7,10,1,2,4,17,15,43,0.3488372093023256,0,6,0.0,15,37,0.4054054054054054,0.349,4,8,0.5
Blake Ahearn,ahearbl01,PG,24,SAS,2009,3,19.0,8,2,0,1,1,1,0,1,3,2,6,0.3333333333333333,2,4,0.5,0,2,0.0,0.5,2,2,1.0
Alexis Ajinça,ajincal01,PF,20,CHA,2009,31,182.0,70,3,9,21,30,7,6,12,34,25,69,0.3623188405797101,0,2,0.0,25,67,0.373134328358209,0.362,20,28,0.7142857142857143
LaMarcus Aldridge,aldrila01,PF,23,POR,2009,81,3004.0,1470,157,234,371,605,77,77,121,207,601,1243,0.4835076427996782,7,28,0.25,594,1215,0.4888888888888889,0.486,261,334,0.781437125748503
Joe Alexander,alexajo01,SF,22,MIL,2009,59,716.0,278,42,44,71,115,15,29,52,107,102,245,0.4163265306122449,16,46,0.3478260869565217,86,199,0.4321608040201005,0.449,58,83,0.6987951807228916
Malik Allen,allenma01,PF,30,MIL,2009,49,579.0,156,35,35,68,103,7,12,20,89,73,170,0.4294117647058823,0,1,0.0,73,169,0.4319526627218935,0.429,10,21,0.4761904761904761
Ray Allen,allenra02,SG,33,BOS,2009,79,2876.0,1434,218,66,212,278,69,13,134,157,499,1040,0.4798076923076923,199,486,0.4094650205761317,300,554,0.5415162454873647,0.575,237,249,0.9518072289156626
Tony Allen,allento01,SG,27,BOS,2009,46,887.0,359,66,22,82,104,54,23,77,98,137,284,0.4823943661971831,6,27,0.2222222222222222,131,257,0.5097276264591439,0.493,79,109,0.7247706422018348
Morris Almond,almonmo01,SG,23,UTA,2009,25,255.0,92,7,9,27,36,4,4,16,31,33,81,0.4074074074074074,5,17,0.2941176470588235,28,64,0.4375,0.438,21,26,0.8076923076923077
Rafer Alston,alstora01,PG,32,TOT,2009,77,2447.0,900,406,33,194,227,108,10,140,135,316,820,0.3853658536585366,112,331,0.338368580060423,204,489,0.4171779141104294,0.454,156,208,0.75
Lou Amundson,amundlo01,PF,26,PHO,2009,76,1044.0,321,28,128,142,270,32,65,56,154,134,250,0.536,0,1,0.0,134,249,0.5381526104417671,0.536,53,120,0.4416666666666666
Chris Andersen,anderch01,C,30,DEN,2009,71,1460.0,452,31,163,279,442,41,175,69,174,160,292,0.547945205479452,2,10,0.2,158,282,0.5602836879432624,0.551,130,181,0.7182320441988951
Ryan Anderson,anderry01,PF,20,NJN,2009,66,1312.0,487,52,104,207,311,44,20,63,157,160,407,0.3931203931203931,69,189,0.365079365079365,91,218,0.4174311926605504,0.478,98,116,0.8448275862068966
Carmelo Anthony,anthoca01,SF,24,DEN,2009,66,2277.0,1504,222,106,344,450,75,24,199,195,535,1207,0.4432477216238608,63,170,0.3705882352941176,472,1037,0.455159112825458,0.469,371,468,0.7927350427350427
Joel Anthony,anthojo01,C,26,MIA,2009,65,1048.0,144,27,89,108,197,20,93,41,139,57,118,0.4830508474576271,0,0,0.0,57,118,0.4830508474576271,0.483,30,46,0.6521739130434783
Gilbert Arenas,arenagi01,PG,27,WAS,2009,2,63.0,26,20,1,8,9,0,1,1,4,6,23,0.2608695652173913,2,7,0.2857142857142857,4,16,0.25,0.304,12,16,0.75
Trevor Ariza,arizatr01,SF,23,LAL,2009,82,1999.0,729,145,111,241,352,137,24,87,166,274,596,0.4597315436241611,61,191,0.3193717277486911,213,405,0.5259259259259259,0.511,120,169,0.7100591715976331
Hilton Armstrong,armsthi01,C,24,NOH,2009,70,1092.0,338,29,81,114,195,26,45,80,181,138,246,0.5609756097560976,0,2,0.0,138,244,0.5655737704918032,0.561,62,98,0.6326530612244898
Darrell Arthur,arthuda01,PF,20,MEM,2009,76,1464.0,422,43,108,238,346,52,52,47,206,191,436,0.4380733944954128,0,2,0.0,191,434,0.4400921658986175,0.438,40,60,0.6666666666666666
Chucky Atkins,atkinch01,PG,34,TOT,2009,33,412.0,98,59,5,19,24,10,2,23,27,34,113,0.3008849557522124,15,57,0.2631578947368421,19,56,0.3392857142857143,0.367,15,16,0.9375
D.J. Augustin,augusdj01,PG,21,CHA,2009,72,1908.0,850,250,17,116,133,42,2,119,140,267,621,0.429951690821256,108,246,0.4390243902439024,159,375,0.424,0.517,208,233,0.8927038626609443
Kelenna Azubuike,azubuke01,SF,25,GSW,2009,74,2375.0,1063,117,112,258,370,57,50,95,183,392,845,0.463905325443787,94,210,0.4476190476190476,298,635,0.4692913385826772,0.52,185,229,0.8078602620087336
Renaldo Balkman,balkmre01,PF,24,DEN,2009,53,780.0,264,34,86,117,203,47,23,35,98,110,197,0.5583756345177665,2,7,0.2857142857142857,108,190,0.5684210526315789,0.563,42,65,0.6461538461538462
Marcus Banks,banksma01,PG,27,TOT,2009,22,206.0,56,28,1,17,18,11,2,14,26,21,57,0.3684210526315789,3,19,0.1578947368421052,18,38,0.4736842105263157,0.395,11,18,0.6111111111111112
Leandro Barbosa,barbole01,SG,26,PHO,2009,70,1705.0,993,162,34,147,181,82,7,93,115,366,759,0.4822134387351778,90,240,0.375,276,519,0.5317919075144508,0.542,171,194,0.8814432989690721
J.J. Barea,bareajo01,SG,24,DAL,2009,79,1600.0,617,269,36,141,177,37,5,105,121,246,557,0.4416517055655296,55,154,0.3571428571428571,191,403,0.4739454094292804,0.491,70,93,0.7526881720430108
Andrea Bargnani,bargnan01,PF,23,TOR,2009,78,2453.0,1202,94,70,346,416,34,97,135,242,431,958,0.4498956158663883,119,291,0.40893470790378,312,667,0.4677661169415292,0.512,221,266,0.8308270676691729
Matt Barnes,barnema02,PF,28,PHO,2009,77,2082.0,788,212,79,342,421,52,26,130,209,285,674,0.4228486646884273,117,341,0.3431085043988269,168,333,0.5045045045045045,0.51,101,136,0.7426470588235294
Brent Barry,barrybr01,SG,37,HOU,2009,56,857.0,208,78,17,77,94,24,3,48,45,70,172,0.4069767441860465,49,131,0.3740458015267175,21,41,0.5121951219512195,0.549,19,20,0.95
Brandon Bass,bassbr01,C,23,DAL,2009,81,1574.0,686,43,129,238,367,27,55,86,140,252,508,0.4960629921259842,0,6,0.0,252,502,0.50199203187251,0.496,182,210,0.8666666666666667
Maceo Baston,bastoma01,PF,33,IND,2009,27,217.0,67,7,22,30,52,6,10,12,39,25,46,0.5434782608695652,0,1,0.0,25,45,0.5555555555555556,0.543,17,27,0.6296296296296297
Tony Battie,battito01,PF,32,ORL,2009,77,1202.0,372,31,92,186,278,26,25,46,112,158,323,0.4891640866873065,2,9,0.2222222222222222,156,314,0.4968152866242038,0.492,54,82,0.6585365853658537
Shane Battier,battish01,SG,30,HOU,2009,60,2031.0,436,137,52,233,285,48,54,49,114,145,354,0.4096045197740113,91,237,0.3839662447257383,54,117,0.4615384615384615,0.538,55,67,0.8208955223880597
Nicolas Batum,batumni01,SF,20,POR,2009,79,1454.0,426,74,84,136,220,50,40,50,139,161,361,0.445983379501385,62,168,0.369047619047619,99,193,0.5129533678756477,0.532,42,52,0.8076923076923077
Jerryd Bayless,bayleje01,PG,20,POR,2009,53,655.0,228,78,8,49,57,16,2,56,81,69,189,0.365079365079365,7,27,0.2592592592592592,62,162,0.382716049382716,0.384,83,103,0.8058252427184466
Michael Beasley,beaslmi01,PF,20,MIA,2009,81,2009.0,1123,83,110,329,439,41,37,121,184,452,957,0.4723092998955068,33,81,0.4074074074074074,419,876,0.478310502283105,0.49,186,241,0.7717842323651453
Marco Belinelli,belinma01,SG,22,GSW,2009,42,882.0,372,88,10,61,71,36,1,59,73,140,317,0.4416403785488959,52,131,0.3969465648854962,88,186,0.4731182795698925,0.524,40,52,0.7692307692307693
Charlie Bell,bellch01,SG,29,MIL,2009,70,1783.0,587,151,32,102,134,50,7,76,138,217,524,0.4141221374045801,87,240,0.3625,130,284,0.4577464788732394,0.497,66,80,0.825
Raja Bell,bellra01,SG,32,TOT,2009,67,2315.0,799,142,41,202,243,50,8,86,166,299,684,0.4371345029239766,114,271,0.4206642066420664,185,413,0.4479418886198547,0.52,87,102,0.8529411764705882
Mike Bibby,bibbymi01,PG,30,ATL,2009,79,2740.0,1176,392,38,240,278,98,11,128,145,437,1005,0.4348258706467661,167,428,0.3901869158878505,270,577,0.4679376083188908,0.518,135,171,0.7894736842105263
Andris Biedriņš,biedran01,C,22,GSW,2009,62,1863.0,735,121,223,470,693,63,96,110,236,308,533,0.5778611632270169,0,1,0.0,308,532,0.5789473684210527,0.578,119,216,0.5509259259259259
Chauncey Billups,billuch01,PG,32,TOT,2009,79,2789.0,1400,506,32,207,239,93,18,177,161,410,980,0.4183673469387755,162,397,0.4080604534005038,248,583,0.425385934819897,0.501,418,458,0.9126637554585152
Steve Blake,blakest01,PG,28,POR,2009,69,2188.0,757,348,28,145,173,69,4,108,126,277,647,0.4281298299845441,140,328,0.4268292682926829,137,319,0.4294670846394984,0.536,63,75,0.84
Andray Blatche,blatcan01,C,22,WAS,2009,71,1703.0,713,118,126,252,378,53,74,117,211,297,630,0.4714285714285714,5,21,0.238095238095238,292,609,0.4794745484400657,0.475,114,162,0.7037037037037037
Mark Blount,blounma01,C,33,MIA,2009,20,207.0,79,4,10,31,41,1,7,14,17,30,78,0.3846153846153846,11,27,0.4074074074074074,19,51,0.3725490196078431,0.455,8,13,0.6153846153846154
Keith Bogans,boganke01,SG,28,TOT,2009,65,1272.0,364,64,31,171,202,43,4,41,105,119,324,0.3672839506172839,74,218,0.3394495412844037,45,106,0.4245283018867924,0.481,52,57,0.912280701754386
Andrew Bogut,bogutan01,C,24,MIL,2009,36,1124.0,422,72,117,252,369,23,37,86,130,183,317,0.5772870662460567,0,0,0.0,183,317,0.5772870662460567,0.577,56,98,0.5714285714285714
Matt Bonner,bonnema01,PF,28,SAS,2009,81,1928.0,667,82,97,289,386,47,26,37,190,266,536,0.4962686567164179,118,268,0.4402985074626865,148,268,0.5522388059701493,0.606,17,23,0.7391304347826086
Josh Boone,boonejo01,C,24,NJN,2009,62,995.0,258,31,104,154,258,22,48,31,106,113,214,0.5280373831775701,0,0,0.0,113,214,0.5280373831775701,0.528,32,85,0.3764705882352941
Calvin Booth,boothca01,C,32,TOT,2009,8,56.0,16,0,5,6,11,1,2,1,10,5,10,0.5,0,0,0.0,5,10,0.5,0.5,6,8,0.75
Carlos Boozer,boozeca01,PF,27,UTA,2009,37,1197.0,599,79,111,274,385,39,7,79,132,251,512,0.490234375,0,0,0.0,251,512,0.490234375,0.49,97,139,0.697841726618705
Chris Bosh,boshch01,C,24,TOR,2009,77,2928.0,1746,191,215,556,771,67,77,174,189,615,1263,0.4869358669833729,12,49,0.2448979591836734,603,1214,0.4967051070840197,0.492,504,617,0.8168557536466775
Bruce Bowen,bowenbr01,SF,37,SAS,2009,80,1506.0,214,40,16,129,145,36,13,25,123,79,187,0.4224598930481283,42,98,0.4285714285714285,37,89,0.4157303370786517,0.535,14,26,0.5384615384615384
Ryan Bowen,bowenry01,SF,33,NOH,2009,21,219.0,47,9,10,14,24,14,5,5,37,22,38,0.5789473684210527,0,0,0.0,22,38,0.5789473684210527,0.579,3,5,0.6
Elton Brand,brandel01,PF,29,PHI,2009,29,920.0,399,37,77,177,254,17,45,68,78,163,365,0.4465753424657534,0,0,0.0,163,365,0.4465753424657534,0.447,73,108,0.6759259259259259
Corey Brewer,breweco01,SF,22,MIN,2009,15,307.0,93,25,18,31,49,15,3,13,37,37,90,0.4111111111111111,5,12,0.4166666666666667,32,78,0.4102564102564102,0.439,14,19,0.7368421052631579
Ronnie Brewer,brewero02,SF,23,UTA,2009,81,2605.0,1111,179,101,199,300,138,30,110,128,421,828,0.5084541062801933,22,85,0.2588235294117647,399,743,0.5370121130551817,0.522,247,352,0.7017045454545454
Aaron Brooks,brookaa01,PG,24,HOU,2009,80,1998.0,894,238,33,124,157,46,8,125,152,316,783,0.4035759897828863,113,309,0.3656957928802589,203,474,0.4282700421940928,0.476,149,172,0.8662790697674418
Andre Brown,brownan01,PF,27,CHA,2009,4,41.0,4,1,7,5,12,1,0,5,9,1,7,0.1428571428571428,0,0,0.0,1,7,0.1428571428571428,0.143,2,2,1.0
Bobby Brown,brownbo02,SG-PG,24,TOT,2009,68,931.0,361,117,14,38,52,21,3,63,95,141,360,0.3916666666666666,45,130,0.3461538461538461,96,230,0.417391304347826,0.454,34,43,0.7906976744186046
Dee Brown,brownde03,PG,24,TOT,2009,19,261.0,46,36,7,22,29,10,0,17,28,18,49,0.3673469387755102,7,24,0.2916666666666667,11,25,0.44,0.439,3,5,0.6
Devin Brown,brownde02,SG,30,NOH,2009,63,869.0,328,54,31,88,119,32,5,54,81,111,313,0.3546325878594249,28,97,0.2886597938144329,83,216,0.3842592592592592,0.399,78,100,0.78
Kwame Brown,brownkw01,C,26,DET,2009,58,999.0,243,32,91,199,290,24,24,50,138,90,169,0.5325443786982249,0,0,0.0,90,169,0.5325443786982249,0.533,63,122,0.5163934426229508
Shannon Brown,brownsh01,SG,23,TOT,2009,48,477.0,202,38,11,33,44,22,7,38,42,78,165,0.4727272727272727,14,37,0.3783783783783784,64,128,0.5,0.515,32,39,0.8205128205128205
Kobe Bryant,bryanko01,SG,30,LAL,2009,82,2960.0,2201,399,90,339,429,120,37,210,189,800,1712,0.4672897196261682,118,336,0.3511904761904761,682,1376,0.4956395348837209,0.502,483,564,0.8563829787234043
Greg Buckner,buckngr01,SF,32,MEM,2009,63,878.0,155,57,32,98,130,29,8,38,108,61,159,0.3836477987421384,13,51,0.2549019607843137,48,108,0.4444444444444444,0.425,20,25,0.8
Caron Butler,butleca01,SG,28,WAS,2009,67,2585.0,1392,290,118,296,414,106,20,210,165,491,1085,0.4525345622119816,65,210,0.3095238095238095,426,875,0.4868571428571429,0.482,345,402,0.8582089552238806
Rasual Butler,butlera01,SF,29,NOH,2009,82,2614.0,922,75,49,222,271,51,61,59,159,348,803,0.4333748443337484,140,359,0.3899721448467966,208,444,0.4684684684684684,0.521,86,110,0.7818181818181819
Andrew Bynum,bynuman01,C,21,LAL,2009,50,1446.0,714,71,137,261,398,18,90,85,157,281,502,0.5597609561752988,0,0,0.0,281,502,0.5597609561752988,0.56,152,215,0.7069767441860465
Will Bynum,bynumwi01,PG,26,DET,2009,57,803.0,410,157,19,56,75,34,2,76,85,156,342,0.4561403508771929,3,19,0.1578947368421052,153,323,0.4736842105263157,0.461,95,119,0.7983193277310925
José Calderón,caldejo01,PG,27,TOR,2009,68,2333.0,873,607,16,178,194,74,7,143,114,320,644,0.4968944099378882,82,202,0.4059405940594059,238,442,0.5384615384615384,0.561,151,154,0.9805194805194806
Marcus Camby,cambyma01,C,34,LAC,2009,62,1925.0,641,127,161,529,690,51,132,93,129,254,496,0.5120967741935484,1,4,0.25,253,492,0.5142276422764228,0.513,132,182,0.7252747252747253
Brian Cardinal,cardibr01,PF,31,MIN,2009,64,909.0,190,76,39,103,142,37,13,48,135,65,169,0.3846153846153846,30,92,0.3260869565217391,35,77,0.4545454545454545,0.473,30,35,0.8571428571428571
Rodney Carney,carnero01,SG,24,MIN,2009,67,1199.0,481,26,36,90,126,45,29,43,94,176,423,0.4160756501182033,79,226,0.3495575221238938,97,197,0.4923857868020304,0.509,50,66,0.7575757575757576
Matt Carroll,carroma01,SG,28,TOT,2009,55,616.0,164,27,7,62,69,21,6,33,67,65,171,0.3801169590643274,13,53,0.2452830188679245,52,118,0.4406779661016949,0.418,21,25,0.84
Anthony Carter,cartean01,PG,33,DEN,2009,78,1787.0,412,364,40,165,205,96,13,155,142,167,386,0.4326424870466321,21,88,0.2386363636363636,146,298,0.4899328859060403,0.46,57,78,0.7307692307692307
Vince Carter,cartevi01,SG,32,NJN,2009,80,2946.0,1662,376,74,336,410,82,38,166,234,588,1345,0.437174721189591,151,392,0.3852040816326531,437,953,0.4585519412381951,0.493,335,410,0.8170731707317073
Mario Chalmers,chalmma01,PG,22,MIA,2009,82,2626.0,818,403,37,191,228,160,8,165,240,278,662,0.4199395770392749,114,311,0.3665594855305466,164,351,0.4672364672364672,0.506,148,193,0.7668393782383419
Tyson Chandler,chandty01,C,26,NOH,2009,45,1445.0,397,22,163,230,393,15,56,70,144,160,283,0.5653710247349824,0,0,0.0,160,283,0.5653710247349824,0.565,77,133,0.5789473684210527
Wilson Chandler,chandwi01,SF,21,NYK,2009,82,2735.0,1184,170,91,354,445,71,75,139,250,455,1054,0.4316888045540797,103,314,0.3280254777070063,352,740,0.4756756756756757,0.481,171,215,0.7953488372093023
Speedy Claxton,claxtsp01,PG,30,ATL,2009,2,15.0,5,3,0,0,0,0,0,0,1,2,7,0.2857142857142857,0,0,0.0,2,7,0.2857142857142857,0.286,1,2,0.5
Jarron Collins,collija03,C,30,UTA,2009,26,201.0,40,7,20,17,37,2,1,9,35,16,35,0.4571428571428571,0,0,0.0,16,35,0.4571428571428571,0.457,8,11,0.7272727272727273
Jason Collins,collija04,C,30,MIN,2009,31,422.0,57,11,28,42,70,9,13,12,73,22,70,0.3142857142857143,0,0,0.0,22,70,0.3142857142857143,0.314,13,28,0.4642857142857143
Mardy Collins,collima01,PG-SG,24,TOT,2009,48,890.0,251,111,31,76,107,31,10,58,80,105,247,0.4251012145748988,13,31,0.4193548387096774,92,216,0.4259259259259259,0.451,28,46,0.6086956521739131
Nick Collison,collini01,C,28,OKC,2009,71,1831.0,584,66,181,308,489,51,50,73,239,243,428,0.5677570093457944,0,2,0.0,243,426,0.5704225352112676,0.568,98,136,0.7205882352941176
Mike Conley,conlemi01,PG,21,MEM,2009,82,2508.0,895,354,25,251,276,90,8,143,146,323,730,0.4424657534246575,88,217,0.4055299539170507,235,513,0.4580896686159844,0.503,161,197,0.817258883248731
Brian Cook,cookbr01,PF,28,TOT,2009,30,171.0,74,5,7,25,32,3,3,13,26,28,76,0.3684210526315789,13,30,0.4333333333333333,15,46,0.3260869565217391,0.454,5,6,0.8333333333333334
Daequan Cook,cookda02,SF,21,MIA,2009,75,1833.0,686,71,19,170,189,39,10,42,125,242,645,0.3751937984496124,153,395,0.3873417721518987,89,250,0.356,0.494,49,56,0.875
Jamal Crawford,crawfja01,PG-SG,28,TOT,2009,65,2479.0,1280,288,23,170,193,57,13,148,92,419,1022,0.4099804305283757,142,394,0.3604060913705584,277,628,0.4410828025477707,0.479,300,344,0.872093023255814
Joe Crawford,crawfjo01,SF,22,NYK,2009,2,23.0,9,1,1,3,4,1,0,0,2,3,10,0.3,1,4,0.25,2,6,0.3333333333333333,0.35,2,2,1.0
Javaris Crittenton,crittja01,PG-SG,21,TOT,2009,63,1174.0,317,150,57,109,166,40,6,82,101,131,285,0.4596491228070175,2,15,0.1333333333333333,129,270,0.4777777777777778,0.463,53,92,0.5760869565217391
Austin Croshere,croshau01,PF,33,TOT,2009,14,100.0,40,9,11,23,34,1,1,6,5,14,39,0.358974358974359,5,15,0.3333333333333333,9,24,0.375,0.423,7,12,0.5833333333333334
Eddy Curry,curryed01,C,26,NYK,2009,3,12.0,5,0,0,4,4,0,0,2,5,2,2,1.0,0,0,0.0,2,2,1.0,1.0,1,3,0.3333333333333333
Samuel Dalembert,dalemsa01,C,27,PHI,2009,82,2036.0,523,18,214,487,701,33,146,117,248,216,434,0.4976958525345622,0,2,0.0,216,432,0.5,0.498,91,124,0.7338709677419355
Erick Dampier,dampier01,C,33,DAL,2009,80,1836.0,454,77,216,349,565,24,95,74,191,182,280,0.65,0,0,0.0,182,280,0.65,0.65,90,141,0.6382978723404256
Antonio Daniels,daniean01,PG,33,TOT,2009,74,1021.0,300,177,5,72,77,26,1,62,55,99,236,0.4194915254237288,22,60,0.3666666666666666,77,176,0.4375,0.466,80,100,0.8
Marquis Daniels,daniema01,SF,28,IND,2009,54,1700.0,733,114,80,168,248,62,26,94,120,311,689,0.4513788098693759,18,90,0.2,293,599,0.4891485809682804,0.464,93,129,0.7209302325581395
Jermareo Davidson,davidje01,SF,24,GSW,2009,14,111.0,42,1,10,24,34,2,3,5,12,17,35,0.4857142857142857,0,0,0.0,17,35,0.4857142857142857,0.486,8,17,0.4705882352941176
Baron Davis,davisba01,PG,29,LAC,2009,65,2248.0,968,501,46,192,238,108,35,193,193,355,959,0.3701772679874869,99,328,0.3018292682926829,256,631,0.4057052297939778,0.422,159,210,0.7571428571428571
Glen Davis,davisgl01,C,23,BOS,2009,76,1637.0,530,69,121,180,301,53,19,71,230,199,450,0.4422222222222222,2,5,0.4,197,445,0.4426966292134831,0.444,130,178,0.7303370786516854
Paul Davis,davispa01,PF,24,LAC,2009,27,320.0,107,12,28,39,67,10,3,13,44,40,98,0.4081632653061224,0,1,0.0,40,97,0.4123711340206185,0.408,27,34,0.7941176470588235
Ricky Davis,davisri01,SG,29,LAC,2009,36,785.0,232,82,9,51,60,19,5,39,63,83,245,0.3387755102040816,35,111,0.3153153153153153,48,134,0.3582089552238806,0.41,31,36,0.8611111111111112
Luol Deng,denglu01,SF,23,CHI,2009,49,1665.0,690,94,80,215,295,60,25,72,85,265,591,0.4483925549915397,8,20,0.4,257,571,0.4500875656742557,0.455,152,191,0.7958115183246073
Boris Diaw,diawbo01,PF,26,TOT,2009,81,2754.0,1072,333,118,314,432,61,53,215,202,448,884,0.5067873303167421,75,181,0.4143646408839779,373,703,0.5305832147937412,0.549,101,147,0.6870748299319728
Yakhouba Diawara,diawaya01,SF,26,MIA,2009,63,851.0,213,27,26,56,82,13,6,16,75,76,217,0.3502304147465437,51,163,0.3128834355828221,25,54,0.4629629629629629,0.468,10,19,0.5263157894736842
Travis Diener,dienetr01,PG,26,IND,2009,55,719.0,206,122,6,80,86,26,5,21,42,74,179,0.4134078212290503,46,118,0.3898305084745763,28,61,0.4590163934426229,0.542,12,15,0.8
Ike Diogu,dioguik01,PF,25,TOT,2009,29,215.0,119,3,26,30,56,3,3,12,23,39,74,0.527027027027027,1,2,0.5,38,72,0.5277777777777778,0.534,40,53,0.7547169811320755
DeSagana Diop,diopde01,C,27,TOT,2009,75,1036.0,170,32,114,159,273,29,56,39,128,74,171,0.4327485380116959,0,0,0.0,74,171,0.4327485380116959,0.433,22,66,0.3333333333333333
Juan Dixon,dixonju01,PG,30,WAS,2009,50,816.0,261,118,8,59,67,35,6,70,74,101,256,0.39453125,25,75,0.3333333333333333,76,181,0.4198895027624309,0.443,34,39,0.8717948717948718
Keyon Dooling,doolike01,PG,28,NJN,2009,77,2074.0,748,270,24,131,155,71,8,105,135,261,598,0.4364548494983277,99,235,0.4212765957446808,162,363,0.4462809917355372,0.519,127,154,0.8246753246753247
Joey Dorsey,dorsejo01,PF,25,HOU,2009,3,6.0,2,1,0,1,1,0,0,0,0,1,2,0.5,0,0,0.0,1,2,0.5,0.5,0,0,0.0
Quincy Douby,doubyqu01,PG,24,TOT,2009,27,300.0,115,25,6,26,32,5,5,13,27,42,110,0.3818181818181818,14,46,0.3043478260869565,28,64,0.4375,0.445,17,19,0.8947368421052632
Chris Douglas-Roberts,douglch01,SG,22,NJN,2009,44,585.0,216,52,14,36,50,12,7,31,34,81,176,0.4602272727272727,3,12,0.25,78,164,0.4756097560975609,0.469,51,62,0.8225806451612904
Goran Dragić,dragigo01,PG,22,PHO,2009,55,728.0,246,111,33,70,103,29,3,73,87,88,224,0.3928571428571428,20,54,0.3703703703703703,68,170,0.4,0.438,50,65,0.7692307692307693
Jared Dudley,dudleja01,SF,23,TOT,2009,68,1155.0,372,56,82,123,205,57,8,43,105,136,285,0.4771929824561403,29,74,0.3918918918918919,107,211,0.5071090047393365,0.528,71,105,0.6761904761904762
Chris Duhon,duhonch01,PG,26,NYK,2009,79,2906.0,880,566,45,201,246,72,7,221,126,287,681,0.42143906020558,127,325,0.3907692307692307,160,356,0.449438202247191,0.515,179,209,0.8564593301435407
Tim Duncan,duncati01,C,32,SAS,2009,75,2524.0,1450,264,201,599,800,38,126,165,173,558,1107,0.5040650406504065,0,2,0.0,558,1105,0.5049773755656108,0.504,334,483,0.6915113871635611
Mike Dunleavy,dunlemi02,SG,28,IND,2009,18,495.0,271,44,14,54,68,12,9,38,36,93,232,0.4008620689655172,32,90,0.3555555555555555,61,142,0.4295774647887324,0.47,53,65,0.8153846153846154
Kevin Durant,duranke01,SF,20,OKC,2009,74,2885.0,1871,205,77,405,482,96,53,225,134,661,1390,0.4755395683453237,97,230,0.4217391304347826,564,1160,0.4862068965517241,0.51,452,524,0.8625954198473282
Monta Ellis,ellismo01,SG,23,GSW,2009,25,892.0,474,93,14,94,108,39,8,67,67,194,430,0.4511627906976744,8,26,0.3076923076923077,186,404,0.4603960396039604,0.46,78,94,0.8297872340425532
Francisco Elson,elsonfr01,C,32,MIL,2009,59,977.0,200,32,100,129,229,36,36,48,144,83,169,0.4911242603550296,1,4,0.25,82,165,0.4969696969696969,0.494,33,39,0.8461538461538461
Melvin Ely,elyme01,C,30,NOH,2009,31,373.0,97,18,30,34,64,2,9,23,58,37,95,0.3894736842105263,0,0,0.0,37,95,0.3894736842105263,0.389,23,36,0.6388888888888888
Maurice Evans,evansma01,SF,30,ATL,2009,80,1840.0,574,54,88,155,243,50,10,43,163,208,482,0.4315352697095436,98,248,0.3951612903225806,110,234,0.4700854700854701,0.533,60,73,0.821917808219178
Reggie Evans,evansre01,PF,28,PHI,2009,79,1137.0,262,26,135,226,361,41,8,69,161,79,178,0.4438202247191011,0,1,0.0,79,177,0.4463276836158192,0.444,104,175,0.5942857142857143
Jordan Farmar,farmajo01,PG,22,LAL,2009,65,1192.0,416,155,22,95,117,57,10,87,105,161,412,0.3907766990291262,49,146,0.3356164383561644,112,266,0.4210526315789473,0.45,45,77,0.5844155844155844
Desmon Farmer,farmede01,SG,27,SAS,2009,3,54.0,13,2,0,6,6,0,0,4,6,4,14,0.2857142857142857,3,12,0.25,1,2,0.5,0.393,2,2,1.0
Raymond Felton,feltora01,PG,24,CHA,2009,82,3086.0,1162,553,54,256,310,126,30,228,191,442,1083,0.4081255771006463,59,207,0.2850241545893719,383,876,0.4372146118721461,0.435,219,272,0.8051470588235294
Rudy Fernández,fernaru01,SG,23,POR,2009,78,1993.0,815,159,47,160,207,69,12,86,111,268,630,0.4253968253968254,159,398,0.3994974874371859,109,232,0.4698275862068966,0.552,120,143,0.8391608391608392
Kyrylo Fesenko,fesenky01,C,22,UTA,2009,21,156.0,49,4,14,23,37,7,15,9,35,21,36,0.5833333333333334,0,0,0.0,21,36,0.5833333333333334,0.583,7,21,0.3333333333333333
Michael Finley,finlemi01,SF,35,SAS,2009,81,2336.0,784,114,26,244,270,37,17,61,82,301,689,0.4368650217706821,131,319,0.4106583072100313,170,370,0.4594594594594595,0.532,51,62,0.8225806451612904
Derek Fisher,fishede01,PG,34,LAL,2009,82,2441.0,814,261,25,163,188,95,6,72,187,292,688,0.4244186046511627,120,302,0.3973509933774834,172,386,0.4455958549222797,0.512,110,130,0.8461538461538461
T.J. Ford,fordtj01,PG,25,IND,2009,74,2258.0,1106,392,59,200,259,89,16,180,180,413,913,0.452354874041621,35,104,0.3365384615384615,378,809,0.4672435105067985,0.472,245,281,0.8718861209964412
Jeff Foster,fosteje01,C,32,IND,2009,74,1828.0,452,130,215,293,508,53,49,88,229,177,353,0.5014164305949008,2,7,0.2857142857142857,175,346,0.5057803468208093,0.504,96,146,0.6575342465753424
Randy Foye,foyera01,SG,25,MIN,2009,70,2494.0,1139,303,34,180,214,72,26,150,201,399,981,0.4067278287461773,111,308,0.3603896103896103,288,673,0.4279346210995542,0.463,230,272,0.8455882352941176
Adonal Foyle,foylead01,C,33,TOT,2009,10,62.0,17,1,9,17,26,0,8,3,5,7,11,0.6363636363636364,0,0,0.0,7,11,0.6363636363636364,0.636,3,6,0.5
Channing Frye,fryech01,PF,25,POR,2009,63,746.0,263,24,41,99,140,17,16,29,106,113,267,0.4232209737827715,11,33,0.3333333333333333,102,234,0.4358974358974359,0.444,26,36,0.7222222222222222
Dan Gadzuric,gadzuda01,C,30,MIL,2009,67,941.0,271,39,95,160,255,32,43,41,162,117,244,0.4795081967213114,0,2,0.0,117,242,0.4834710743801653,0.48,37,68,0.5441176470588235
Danilo Gallinari,gallida01,SG,20,NYK,2009,28,412.0,170,15,13,42,55,14,4,15,48,56,125,0.448,32,72,0.4444444444444444,24,53,0.4528301886792453,0.576,26,27,0.9629629629629628
Francisco García,garcifr01,SF,27,SAC,2009,65,1975.0,824,150,56,162,218,80,67,112,196,295,665,0.4436090225563909,88,221,0.3981900452488687,207,444,0.4662162162162162,0.51,146,178,0.8202247191011236
Thomas Gardner,gardnth01,SG,23,ATL,2009,16,98.0,24,2,0,7,7,4,1,3,4,9,36,0.25,4,23,0.1739130434782608,5,13,0.3846153846153846,0.306,2,4,0.5
Kevin Garnett,garneke01,PF,32,BOS,2009,57,1772.0,899,144,78,407,485,63,68,90,128,393,740,0.5310810810810811,2,8,0.25,391,732,0.5341530054644809,0.532,111,132,0.8409090909090909
Marc Gasol,gasolma01,C,24,MEM,2009,82,2521.0,975,143,201,404,605,63,90,164,265,350,661,0.529500756429652,0,1,0.0,350,660,0.5303030303030303,0.53,275,375,0.7333333333333333
Pau Gasol,gasolpa01,C,28,LAL,2009,81,2999.0,1528,284,262,518,780,52,81,157,172,592,1045,0.5665071770334928,1,2,0.5,591,1043,0.5666347075743049,0.567,343,439,0.7813211845102506
Rudy Gay,gayru01,SF,22,MEM,2009,79,2945.0,1493,135,109,328,437,98,59,203,221,572,1262,0.4532488114104596,85,242,0.3512396694214876,487,1020,0.4774509803921569,0.487,264,344,0.7674418604651163
Devean George,georgde01,SF,31,DAL,2009,43,708.0,147,15,25,53,78,23,11,17,57,54,142,0.380281690140845,22,76,0.2894736842105263,32,66,0.4848484848484848,0.458,17,22,0.7727272727272727
Daniel Gibson,gibsoda01,PG,22,CLE,2009,75,1795.0,586,132,31,124,155,44,16,61,163,206,527,0.3908918406072106,108,283,0.381625441696113,98,244,0.4016393442622951,0.493,66,86,0.7674418604651163
J.R. Giddens,giddejr01,SF,23,BOS,2009,6,8.0,4,0,2,1,3,1,0,1,1,2,3,0.6666666666666666,0,0,0.0,2,3,0.6666666666666666,0.667,0,0,0.0
Eddie Gill,gilled01,PG,30,MIL,2009,6,43.0,14,11,0,4,4,3,1,5,10,6,9,0.6666666666666666,2,3,0.6666666666666666,4,6,0.6666666666666666,0.778,0,0,0.0
Manu Ginóbili,ginobma01,SG,31,SAS,2009,44,1181.0,683,157,24,174,198,64,16,88,90,223,491,0.4541751527494908,69,209,0.3301435406698564,154,282,0.5460992907801419,0.524,168,190,0.8842105263157894
Ryan Gomes,gomesry01,SF,26,MIN,2009,82,2614.0,1092,135,106,286,392,63,22,128,183,420,974,0.4312114989733059,106,285,0.3719298245614035,314,689,0.455732946298984,0.486,146,181,0.8066298342541437
Drew Gooden,goodedr01,PF,27,TOT,2009,51,1264.0,605,48,113,249,362,30,18,76,144,237,506,0.4683794466403162,0,4,0.0,237,502,0.4721115537848606,0.468,131,156,0.8397435897435898
Ben Gordon,gordobe01,SG,25,CHI,2009,82,2999.0,1699,279,52,231,283,71,22,200,184,598,1315,0.4547528517110266,173,422,0.4099526066350711,425,893,0.4759238521836506,0.521,330,382,0.8638743455497382
Eric Gordon,gordoer01,SG,20,LAC,2009,78,2677.0,1252,215,45,156,201,78,35,164,172,411,901,0.4561598224195338,131,337,0.3887240356083086,280,564,0.4964539007092198,0.529,299,350,0.8542857142857143
Marcin Gortat,gortama01,PF,24,ORL,2009,63,794.0,239,14,96,190,286,18,53,25,111,106,187,0.5668449197860963,1,1,1.0,105,186,0.5645161290322581,0.57,26,45,0.5777777777777777
Joey Graham,grahajo01,SF,26,TOR,2009,78,1541.0,597,48,95,197,292,35,12,74,191,231,480,0.48125,3,16,0.1875,228,464,0.4913793103448275,0.484,132,160,0.825
Stephen Graham,grahast01,SG,26,IND,2009,52,684.0,282,33,21,75,96,10,4,45,82,106,256,0.4140625,20,66,0.303030303030303,86,190,0.4526315789473684,0.453,50,62,0.8064516129032258
Danny Granger,grangda01,SF,25,IND,2009,67,2424.0,1728,183,49,292,341,69,97,165,207,571,1277,0.447141738449491,182,450,0.4044444444444444,389,827,0.4703748488512696,0.518,404,460,0.8782608695652174
Aaron Gray,grayaa01,C,24,CHI,2009,56,715.0,196,46,84,136,220,14,18,40,135,81,167,0.4850299401197604,0,1,0.0,81,166,0.4879518072289157,0.485,34,59,0.576271186440678
Gerald Green,greenge01,SG,23,DAL,2009,38,376.0,199,15,14,40,54,10,5,33,51,79,180,0.4388888888888889,14,46,0.3043478260869565,65,134,0.4850746268656716,0.478,27,32,0.84375
Jeff Green,greenje02,PF,22,OKC,2009,78,2873.0,1290,155,120,399,519,81,33,173,202,476,1068,0.445692883895131,96,247,0.388663967611336,380,821,0.4628501827040195,0.491,242,307,0.7882736156351792
Willie Green,greenwi01,SG,27,PHI,2009,81,1828.0,685,158,29,97,126,53,13,64,154,286,658,0.4346504559270516,51,161,0.3167701863354037,235,497,0.4728370221327967,0.473,62,85,0.7294117647058823
Donté Greene,greendo01,SF,20,SAC,2009,55,725.0,209,30,19,67,86,16,14,37,68,77,236,0.326271186440678,26,100,0.26,51,136,0.375,0.381,29,34,0.8529411764705882
Hamed Haddadi,haddaha01,C,23,MEM,2009,19,120.0,48,8,16,31,47,1,12,9,20,15,31,0.4838709677419355,0,0,0.0,15,31,0.4838709677419355,0.484,18,30,0.6
Malik Hairston,hairsma01,SG,21,SAS,2009,15,155.0,50,13,11,17,28,6,7,12,19,24,49,0.4897959183673469,0,1,0.0,24,48,0.5,0.49,2,7,0.2857142857142857
Richard Hamilton,hamilri01,SG,30,DET,2009,67,2279.0,1225,297,44,163,207,40,4,133,176,466,1043,0.4467881112176414,70,190,0.3684210526315789,396,853,0.4642438452520516,0.48,223,263,0.8479087452471483
Matt Harpring,harprma01,SG,32,UTA,2009,63,693.0,277,28,47,76,123,29,9,29,102,111,241,0.4605809128630705,0,2,0.0,111,239,0.4644351464435146,0.461,55,72,0.7638888888888888
Al Harrington,harrial01,PF,28,TOT,2009,73,2546.0,1469,102,99,356,455,88,22,161,227,532,1212,0.4389438943894389,171,470,0.3638297872340426,361,742,0.4865229110512129,0.509,234,295,0.7932203389830509
Devin Harris,harride01,PG,25,NJN,2009,69,2494.0,1470,476,30,201,231,114,13,212,164,455,1039,0.4379210779595765,64,220,0.2909090909090909,391,819,0.4774114774114774,0.469,496,605,0.8198347107438017
Jason Hart,hartja01,PG,30,TOT,2009,39,348.0,78,48,13,33,46,12,4,22,39,30,94,0.3191489361702128,0,6,0.0,30,88,0.3409090909090909,0.319,18,23,0.782608695652174
Udonis Haslem,hasleud01,PF,28,MIA,2009,75,2560.0,794,85,169,449,618,43,25,82,204,333,643,0.5178849144634525,0,0,0.0,333,643,0.5178849144634525,0.518,128,170,0.7529411764705882
Trenton Hassell,hassetr01,SF,29,NJN,2009,53,1094.0,194,51,50,96,146,21,16,30,92,86,191,0.450261780104712,2,8,0.25,84,183,0.4590163934426229,0.455,20,25,0.8
Spencer Hawes,hawessp01,C,20,SAC,2009,77,2259.0,876,149,148,401,549,44,93,160,249,373,800,0.46625,40,115,0.3478260869565217,333,685,0.4861313868613138,0.491,90,136,0.6617647058823529
Chuck Hayes,hayesch01,C,25,HOU,2009,71,858.0,91,42,74,176,250,34,19,25,134,42,113,0.3716814159292035,0,4,0.0,42,109,0.3853211009174312,0.372,7,19,0.3684210526315789
Jarvis Hayes,hayesja01,SF,27,NJN,2009,74,1832.0,644,54,27,240,267,52,7,49,162,257,577,0.4454072790294627,94,244,0.3852459016393442,163,333,0.4894894894894895,0.527,36,52,0.6923076923076923
Brendan Haywood,haywobr01,C,29,WAS,2009,6,175.0,58,8,13,31,44,4,15,9,14,24,50,0.48,0,0,0.0,24,50,0.48,0.48,10,21,0.4761904761904761
Luther Head,headlu01,PG-SG,26,TOT,2009,32,498.0,149,58,6,46,52,17,2,25,37,55,144,0.3819444444444444,20,54,0.3703703703703703,35,90,0.3888888888888889,0.451,19,24,0.7916666666666666
Walter Herrmann,herrmwa01,SF,29,DET,2009,59,630.0,224,22,28,79,107,7,4,17,43,82,207,0.3961352657004831,41,120,0.3416666666666667,41,87,0.4712643678160919,0.495,19,25,0.76
Roy Hibbert,hibbero01,C,22,IND,2009,70,1009.0,494,49,115,128,243,20,76,55,215,198,420,0.4714285714285714,0,0,0.0,198,420,0.4714285714285714,0.471,98,147,0.6666666666666666
J.J. Hickson,hicksjj01,C,20,CLE,2009,62,705.0,245,9,52,113,165,14,30,45,81,100,194,0.5154639175257731,0,0,0.0,100,194,0.5154639175257731,0.515,45,67,0.6716417910447762
Nenê,hilarne01,C,26,DEN,2009,77,2510.0,1123,108,183,415,598,95,101,147,278,428,709,0.6036671368124118,1,5,0.2,427,704,0.6065340909090909,0.604,266,368,0.7228260869565217
George Hill,hillge01,PG,22,SAS,2009,77,1270.0,438,136,30,128,158,45,21,74,150,150,372,0.4032258064516129,24,73,0.3287671232876712,126,299,0.4214046822742475,0.435,114,146,0.7808219178082192
Grant Hill,hillgr01,SF,36,PHO,2009,82,2445.0,985,186,64,341,405,90,54,126,182,390,745,0.5234899328859061,24,76,0.3157894736842105,366,669,0.547085201793722,0.54,181,224,0.8080357142857143
Steven Hill,hillst01,PF,23,OKC,2009,1,2.0,2,0,2,1,3,0,0,0,0,1,1,1.0,0,0,0.0,1,1,1.0,1.0,0,0,0.0
Kirk Hinrich,hinriki01,SG,28,CHI,2009,51,1339.0,503,197,16,107,123,66,19,87,126,183,419,0.4367541766109785,69,169,0.408284023668639,114,250,0.456,0.519,68,86,0.7906976744186046
Ryan Hollins,holliry01,C,24,TOT,2009,45,444.0,143,7,46,51,97,7,32,24,78,50,94,0.5319148936170213,0,0,0.0,50,94,0.5319148936170213,0.532,43,72,0.5972222222222222
Al Horford,horfoal01,C,22,ATL,2009,67,2242.0,773,163,145,479,624,53,95,103,190,312,594,0.5252525252525253,0,1,0.0,312,593,0.5261382799325464,0.525,149,205,0.7268292682926829
Eddie House,houseed01,PG,30,BOS,2009,81,1479.0,691,92,11,146,157,61,7,55,113,249,560,0.4446428571428571,151,340,0.4441176470588235,98,220,0.4454545454545454,0.579,42,53,0.7924528301886793
Dwight Howard,howardw01,C,23,ORL,2009,79,2821.0,1624,112,336,757,1093,77,231,240,270,560,979,0.5720122574055159,0,2,0.0,560,977,0.5731832139201638,0.572,504,849,0.5936395759717314
Josh Howard,howarjo01,SF,28,DAL,2009,52,1663.0,936,83,59,204,263,55,30,89,135,353,783,0.4508301404853129,58,168,0.3452380952380952,295,615,0.4796747967479675,0.488,172,220,0.7818181818181819
Juwan Howard,howarju01,SF-PF,35,TOT,2009,42,472.0,173,26,30,46,76,7,6,26,71,75,147,0.5102040816326531,0,0,0.0,75,147,0.5102040816326531,0.51,23,34,0.6764705882352942
Larry Hughes,hughela01,SF-SG,30,TOT,2009,55,1479.0,640,119,16,143,159,72,14,71,96,224,557,0.4021543985637343,75,193,0.38860103626943,149,364,0.4093406593406593,0.469,117,145,0.8068965517241379
Kris Humphries,humphkr01,SF,23,TOR,2009,29,265.0,114,10,24,46,70,8,6,8,31,38,90,0.4222222222222222,0,0,0.0,38,90,0.4222222222222222,0.422,38,48,0.7916666666666666
Lindsey Hunter,hunteli01,PG,38,CHI,2009,28,266.0,73,37,2,10,12,20,1,19,28,27,82,0.3292682926829268,16,48,0.3333333333333333,11,34,0.3235294117647059,0.427,3,5,0.6
Othello Hunter,hunteot01,PF,22,ATL,2009,16,92.0,22,1,9,15,24,2,5,2,11,11,20,0.55,0,0,0.0,11,20,0.55,0.55,0,5,0.0
Andre Iguodala,iguodan01,SF,25,PHI,2009,82,3269.0,1541,434,92,379,471,131,36,222,152,542,1147,0.4725370531822144,80,261,0.3065134099616858,462,886,0.5214446952595937,0.507,377,521,0.7236084452975048
Zydrunas Ilgauskas,ilgauzy01,C,33,CLE,2009,65,1765.0,838,64,157,333,490,28,84,90,183,342,724,0.4723756906077348,15,39,0.3846153846153846,327,685,0.4773722627737226,0.483,139,174,0.7988505747126436
D.J. Mbenga,mbengdj01,C,28,LAL,2009,23,181.0,61,9,9,22,31,10,24,13,33,27,57,0.4736842105263157,0,1,0.0,27,56,0.4821428571428571,0.474,7,8,0.875
Allen Iverson,iversal01,PG-SG,33,TOT,2009,57,2093.0,995,283,30,143,173,88,6,146,86,348,834,0.4172661870503597,28,99,0.2828282828282828,320,735,0.4353741496598639,0.434,271,347,0.7809798270893372
Royal Ivey,iveyro01,SG,27,PHI,2009,71,861.0,211,43,19,57,76,36,7,23,76,69,208,0.3317307692307692,39,114,0.3421052631578947,30,94,0.3191489361702128,0.425,34,43,0.7906976744186046
Jarrett Jack,jackja01,SG,25,IND,2009,82,2716.0,1074,338,44,232,276,88,17,184,179,386,853,0.4525205158264947,78,221,0.3529411764705882,308,632,0.4873417721518987,0.498,224,263,0.8517110266159695
Bobby Jackson,jacksbo01,PG,35,SAC,2009,71,1484.0,532,143,42,158,200,62,4,66,100,193,485,0.3979381443298969,60,197,0.3045685279187817,133,288,0.4618055555555556,0.46,86,101,0.8514851485148515
Darnell Jackson,jacksda01,PF,23,CLE,2009,51,430.0,98,8,32,55,87,10,4,14,77,37,86,0.4302325581395348,0,2,0.0,37,84,0.4404761904761904,0.43,24,35,0.6857142857142857
Stephen Jackson,jacksst02,SF,30,GSW,2009,59,2339.0,1223,381,70,233,303,88,31,229,153,413,997,0.4142427281845536,103,305,0.3377049180327869,310,692,0.4479768786127168,0.466,294,356,0.8258426966292135
Jerome James,jamesje01,C,33,NYK,2009,2,10.0,6,0,1,2,3,1,1,1,2,3,8,0.375,0,0,0.0,3,8,0.375,0.375,0,0,0.0
LeBron James,jamesle01,SF,24,CLE,2009,81,3054.0,2304,587,106,507,613,137,93,241,139,789,1613,0.4891506509609423,132,384,0.34375,657,1229,0.5345809601301872,0.53,594,762,0.7795275590551181
Mike James,jamesmi01,PG,33,TOT,2009,61,1649.0,531,201,25,108,133,44,6,94,108,197,514,0.3832684824902724,69,184,0.375,128,330,0.3878787878787879,0.45,68,82,0.8292682926829268
Antawn Jamison,jamisan01,PF,32,WAS,2009,81,3096.0,1801,153,196,525,721,95,25,125,218,674,1441,0.4677307425399028,112,319,0.3510971786833856,562,1122,0.5008912655971479,0.507,341,452,0.754424778761062
Marko Jarić,jaricma01,SG,30,MEM,2009,53,605.0,136,74,23,42,65,29,11,49,62,48,145,0.3310344827586207,11,28,0.3928571428571428,37,117,0.3162393162393162,0.369,29,41,0.7073170731707317
Nathan Jawai,jawaina01,PF,22,TOR,2009,6,19.0,2,0,1,1,2,0,0,2,3,1,4,0.25,0,0,0.0,1,4,0.25,0.25,0,0,0.0
Al Jefferson,jeffeal01,C,24,MIN,2009,50,1836.0,1156,79,172,376,548,39,83,92,141,485,975,0.4974358974358974,0,4,0.0,485,971,0.4994850669412976,0.497,186,252,0.7380952380952381
Dontell Jefferson,jeffedo01,SG,25,CHA,2009,6,84.0,29,9,1,11,12,4,1,6,9,11,22,0.5,1,2,0.5,10,20,0.5,0.523,6,9,0.6666666666666666
Richard Jefferson,jefferi01,SF,28,MIL,2009,82,2939.0,1607,199,57,317,374,66,14,165,252,537,1222,0.439443535188216,116,292,0.3972602739726027,421,930,0.4526881720430107,0.487,417,518,0.805019305019305
Jared Jeffries,jeffrja01,SF,27,NYK,2009,56,1310.0,296,80,128,103,231,47,33,65,153,120,273,0.4395604395604395,1,12,0.0833333333333333,119,261,0.4559386973180077,0.441,55,90,0.6111111111111112
Yi Jianlian,jianlyi01,PF,21,NJN,2009,61,1421.0,525,60,67,259,326,29,36,70,157,191,500,0.382,48,140,0.3428571428571428,143,360,0.3972222222222222,0.43,95,123,0.7723577235772358
Amir Johnson,johnsam01,PF,21,DET,2009,62,911.0,217,20,102,130,232,20,60,33,171,97,163,0.5950920245398773,0,0,0.0,97,163,0.5950920245398773,0.595,23,35,0.6571428571428571
Anthony Johnson,johnsan02,PG,34,ORL,2009,80,1481.0,421,200,29,118,147,46,5,82,111,154,381,0.4041994750656168,52,133,0.3909774436090225,102,248,0.4112903225806452,0.472,61,81,0.7530864197530864
Joe Johnson,johnsjo02,SG,27,ATL,2009,79,3124.0,1688,455,65,281,346,84,19,195,176,620,1420,0.4366197183098591,149,414,0.359903381642512,471,1006,0.4681908548707753,0.489,299,362,0.8259668508287292
Linton Johnson,johnsli01,PF,28,TOT,2009,10,55.0,9,2,3,5,8,1,0,2,7,4,11,0.3636363636363636,1,2,0.5,3,9,0.3333333333333333,0.409,0,0,0.0
Trey Johnson,johnstr01,SG,24,CLE,2009,4,14.0,4,0,0,1,1,0,0,1,4,0,5,0.0,0,0,0.0,0,5,0.0,0.0,4,4,1.0
Dahntay Jones,jonesda02,SG,28,DEN,2009,79,1426.0,429,78,58,110,168,49,19,68,199,154,336,0.4583333333333333,11,17,0.6470588235294118,143,319,0.4482758620689655,0.475,110,151,0.7284768211920529
Damon Jones,jonesda01,PG,32,MIL,2009,18,108.0,33,7,0,6,6,3,0,6,4,11,34,0.3235294117647059,11,28,0.3928571428571428,0,6,0.0,0.485,0,0,0.0
Dwayne Jones,jonesdw02,PF,25,CHA,2009,6,52.0,12,0,6,6,12,0,1,4,6,4,7,0.5714285714285714,0,0,0.0,4,7,0.5714285714285714,0.571,4,6,0.6666666666666666
Fred Jones,jonesfr01,SF,29,LAC,2009,52,1495.0,378,188,23,103,126,53,11,66,112,129,317,0.4069400630914827,54,147,0.3673469387755102,75,170,0.4411764705882353,0.492,66,81,0.8148148148148148
James Jones,jonesja02,SF,28,MIA,2009,40,630.0,169,20,12,50,62,12,14,12,58,55,149,0.3691275167785235,33,96,0.34375,22,53,0.4150943396226415,0.48,26,31,0.8387096774193549
Solomon Jones,jonesso01,C,24,ATL,2009,63,675.0,188,15,52,90,142,7,34,27,125,67,111,0.6036036036036037,1,2,0.5,66,109,0.6055045871559633,0.608,53,74,0.7162162162162162
DeAndre Jordan,jordade01,C,20,LAC,2009,53,771.0,228,11,72,165,237,11,59,41,96,93,147,0.6326530612244898,0,0,0.0,93,147,0.6326530612244898,0.633,42,109,0.3853211009174312
Chris Kaman,kamanch01,C,26,LAC,2009,31,921.0,373,46,75,172,247,17,45,84,93,161,305,0.5278688524590164,0,0,0.0,161,305,0.5278688524590164,0.528,51,75,0.68
Jason Kapono,kaponja01,SG,27,TOR,2009,80,1831.0,654,105,26,137,163,22,3,70,144,261,604,0.4321192052980132,98,229,0.4279475982532751,163,375,0.4346666666666666,0.513,34,42,0.8095238095238095
Jason Kidd,kiddja01,PG,35,DAL,2009,81,2886.0,731,702,85,415,500,160,39,185,168,257,618,0.4158576051779935,131,323,0.4055727554179567,126,295,0.4271186440677966,0.522,86,105,0.819047619047619
Tarence Kinsey,kinseta01,SG,24,CLE,2009,50,277.0,102,10,10,28,38,12,0,22,34,31,69,0.4492753623188406,7,18,0.3888888888888889,24,51,0.4705882352941176,0.5,33,38,0.868421052631579
Andrei Kirilenko,kirilan01,PF,27,UTA,2009,67,1831.0,776,175,84,235,319,83,77,121,127,256,570,0.4491228070175438,20,73,0.273972602739726,236,497,0.4748490945674044,0.467,244,311,0.7845659163987139
Linas Kleiza,kleizli01,SF,24,DEN,2009,82,1824.0,813,64,92,235,327,31,14,82,155,289,646,0.4473684210526316,87,267,0.3258426966292135,202,379,0.5329815303430079,0.515,148,204,0.7254901960784313
Brevin Knight,knighbr01,PG,33,UTA,2009,74,938.0,180,190,13,75,88,68,4,66,98,66,189,0.3492063492063492,0,6,0.0,66,183,0.360655737704918,0.349,48,64,0.75
Kyle Korver,korveky01,SF,27,UTA,2009,78,1874.0,705,137,35,223,258,47,30,90,170,245,560,0.4375,103,267,0.3857677902621723,142,293,0.4846416382252559,0.529,112,127,0.8818897637795275
Kosta Koufos,koufoko01,C,19,UTA,2009,48,565.0,224,20,50,88,138,12,31,26,70,94,185,0.5081081081081081,0,0,0.0,94,185,0.5081081081081081,0.508,36,51,0.7058823529411765
Nenad Krstić,krstine01,C,25,OKC,2009,46,1141.0,445,29,85,168,253,21,49,45,114,191,407,0.4692874692874693,0,0,0.0,191,407,0.4692874692874693,0.469,63,79,0.7974683544303798
Rob Kurz,kurzro01,PF,23,GSW,2009,40,442.0,157,20,33,48,81,14,19,16,78,51,131,0.3893129770992366,15,38,0.3947368421052631,36,93,0.3870967741935484,0.447,40,50,0.8
Carl Landry,landrca01,PF,25,HOU,2009,69,1467.0,638,39,124,219,343,26,31,68,166,240,418,0.5741626794258373,1,3,0.3333333333333333,239,415,0.5759036144578313,0.575,157,193,0.8134715025906736
Acie Law,lawac01,PG,24,ATL,2009,55,560.0,162,86,6,52,58,11,3,29,43,52,139,0.3741007194244604,9,29,0.3103448275862069,43,110,0.3909090909090909,0.406,49,60,0.8166666666666667
Courtney Lee,leeco01,SG,23,ORL,2009,77,1939.0,646,91,18,160,178,76,14,69,157,243,540,0.45,82,203,0.4039408866995074,161,337,0.4777448071216617,0.526,78,94,0.8297872340425532
David Lee,leeda02,C,25,NYK,2009,81,2824.0,1293,174,256,695,951,80,22,150,260,522,951,0.5488958990536278,0,3,0.0,522,948,0.5506329113924051,0.549,249,330,0.7545454545454545
Rashard Lewis,lewisra02,PF,29,ORL,2009,79,2859.0,1401,205,92,361,453,81,51,158,194,478,1089,0.4389348025711662,220,554,0.3971119133574007,258,535,0.4822429906542056,0.54,225,269,0.8364312267657993
Shaun Livingston,livinsh01,PG,23,TOT,2009,12,231.0,71,20,3,25,28,7,2,9,12,31,60,0.5166666666666667,0,0,0.0,31,60,0.5166666666666667,0.517,9,10,0.9
Brook Lopez,lopezbr01,C,20,NJN,2009,82,2501.0,1068,86,225,440,665,44,151,147,257,448,844,0.5308056872037915,0,2,0.0,448,842,0.5320665083135392,0.531,172,217,0.7926267281105991
Robin Lopez,lopezro01,C,20,PHO,2009,60,614.0,189,8,52,66,118,11,41,28,97,71,137,0.5182481751824818,0,1,0.0,71,136,0.5220588235294118,0.518,47,68,0.6911764705882353
Kevin Love,loveke01,C,20,MIN,2009,81,2048.0,899,84,274,460,734,35,50,118,205,316,688,0.4593023255813953,2,19,0.1052631578947368,314,669,0.4693572496263079,0.461,265,336,0.7886904761904762
Kyle Lowry,lowryky01,PG,22,TOT,2009,77,1679.0,584,275,26,163,189,69,17,117,146,189,434,0.4354838709677419,25,98,0.2551020408163265,164,336,0.4880952380952381,0.464,181,226,0.8008849557522124
Tyronn Lue,luety01,PG,31,TOT,2009,44,521.0,183,60,6,40,46,8,0,23,54,71,162,0.4382716049382716,27,62,0.4354838709677419,44,100,0.44,0.522,14,19,0.7368421052631579
Mark Madsen,madsema01,C,33,MIN,2009,19,116.0,6,4,10,8,18,1,1,3,18,3,14,0.2142857142857142,0,0,0.0,3,14,0.2142857142857142,0.214,0,4,0.0
Corey Maggette,maggeco01,PF,29,GSW,2009,51,1588.0,950,92,49,233,282,44,8,120,192,292,634,0.4605678233438486,24,95,0.2526315789473684,268,539,0.4972170686456401,0.479,342,415,0.8240963855421687
Jamaal Magloire,magloja01,C,30,MIA,2009,55,709.0,159,22,82,140,222,11,25,32,121,65,131,0.4961832061068702,0,0,0.0,65,131,0.4961832061068702,0.496,29,60,0.4833333333333333
Stephon Marbury,marbust01,PG,31,BOS,2009,23,414.0,88,75,2,26,28,10,3,37,34,38,111,0.3423423423423423,6,25,0.24,32,86,0.3720930232558139,0.369,6,13,0.4615384615384615
Shawn Marion,mariosh01,SF,30,TOT,2009,69,2470.0,891,139,180,409,589,88,66,105,132,382,788,0.4847715736040609,10,53,0.1886792452830188,372,735,0.5061224489795918,0.491,117,147,0.7959183673469388
Sean Marks,marksse01,C,33,NOH,2009,60,838.0,192,14,62,125,187,7,33,35,121,80,165,0.4848484848484848,2,10,0.2,78,155,0.5032258064516129,0.491,30,44,0.6818181818181818
Donyell Marshall,marshdo01,PF,35,PHI,2009,25,189.0,94,15,6,34,40,4,5,6,24,33,73,0.4520547945205479,25,55,0.4545454545454545,8,18,0.4444444444444444,0.623,3,6,0.5
Cartier Martin,martica01,SF,24,CHA,2009,33,266.0,86,13,7,26,33,8,4,9,33,28,77,0.3636363636363636,10,33,0.303030303030303,18,44,0.4090909090909091,0.429,20,25,0.8
Kenyon Martin,martike01,PF,31,DEN,2009,66,2111.0,769,132,81,314,395,96,74,104,201,318,648,0.4907407407407407,14,38,0.3684210526315789,304,610,0.4983606557377049,0.502,119,197,0.6040609137055838
Kevin Martin,martike02,SG,25,SAC,2009,51,1947.0,1254,138,29,154,183,61,8,146,116,341,811,0.4204685573366215,115,277,0.4151624548736462,226,534,0.4232209737827715,0.491,457,527,0.8671726755218216
Desmond Mason,masonde01,SG,31,OKC,2009,39,1064.0,294,46,41,116,157,15,30,56,96,124,285,0.4350877192982456,0,3,0.0,124,282,0.4397163120567376,0.435,46,85,0.5411764705882353
Roger Mason,masonro01,SG,28,SAS,2009,82,2496.0,969,173,16,235,251,40,12,100,160,349,822,0.4245742092457421,166,394,0.4213197969543147,183,428,0.4275700934579439,0.526,105,118,0.8898305084745762
Jason Maxiell,maxieja01,C,25,DET,2009,78,1408.0,452,24,169,155,324,25,63,45,157,184,320,0.575,0,1,0.0,184,319,0.5768025078369906,0.575,84,158,0.5316455696202531
Sean May,mayse01,PF,24,CHA,2009,24,301.0,93,10,20,49,69,5,4,26,32,39,98,0.3979591836734694,1,1,1.0,38,97,0.3917525773195876,0.403,14,20,0.7
O.J. Mayo,mayooj01,SG,21,MEM,2009,82,3120.0,1516,262,56,252,308,91,13,226,204,562,1283,0.4380358534684334,145,378,0.3835978835978836,417,905,0.4607734806629834,0.495,247,281,0.8790035587188612
Luc Mbah a Moute,mbahalu01,PF,22,MIL,2009,82,2114.0,594,87,189,298,487,87,45,100,204,227,491,0.4623217922606925,0,4,0.0,227,487,0.4661190965092402,0.462,140,192,0.7291666666666666
Rashad McCants,mccanra01,SG,24,TOT,2009,58,1101.0,554,68,21,89,110,47,14,64,103,192,488,0.3934426229508196,63,189,0.3333333333333333,129,299,0.431438127090301,0.458,107,141,0.7588652482269503
Antonio McDyess,mcdyean01,PF,34,DET,2009,62,1866.0,596,83,185,422,607,41,50,51,191,268,525,0.5104761904761905,0,0,0.0,268,525,0.5104761904761905,0.51,60,86,0.6976744186046512
JaVale McGee,mcgeeja01,C,21,WAS,2009,75,1143.0,489,23,120,174,294,33,75,61,155,191,387,0.4935400516795866,0,0,0.0,191,387,0.4935400516795866,0.494,107,162,0.6604938271604939
Tracy McGrady,mcgratr01,SG,29,HOU,2009,35,1181.0,545,175,20,134,154,42,15,69,38,188,485,0.3876288659793814,44,117,0.376068376068376,144,368,0.391304347826087,0.433,125,156,0.8012820512820513
Dominic McGuire,mcguido01,SF,23,WAS,2009,79,2072.0,356,198,113,315,428,62,74,92,153,140,324,0.4320987654320987,2,4,0.5,138,320,0.43125,0.435,74,102,0.7254901960784313
Josh McRoberts,mcrobjo01,PF,21,IND,2009,33,279.0,80,16,26,48,74,12,16,12,41,35,83,0.4216867469879518,0,10,0.0,35,73,0.4794520547945205,0.422,10,13,0.7692307692307693
Pops Mensah-Bonsu,mensapo01,PF,25,TOT,2009,22,283.0,111,6,55,58,113,9,5,19,43,39,103,0.3786407766990291,0,2,0.0,39,101,0.3861386138613861,0.379,33,48,0.6875
Chris Mihm,mihmch01,C,29,LAL,2009,18,105.0,36,10,15,19,34,1,6,10,23,15,40,0.375,0,0,0.0,15,40,0.375,0.375,6,7,0.8571428571428571
C.J. Miles,milescj01,SG,21,UTA,2009,72,1623.0,657,107,45,122,167,46,15,64,187,258,562,0.4590747330960854,63,179,0.3519553072625698,195,383,0.5091383812010444,0.515,78,89,0.8764044943820225
Darius Miles,milesda01,SF,27,MEM,2009,34,298.0,120,17,19,38,57,11,20,21,32,48,99,0.4848484848484848,1,6,0.1666666666666666,47,93,0.5053763440860215,0.49,23,31,0.7419354838709677
Darko Miličić,milicda01,C,23,MEM,2009,61,1034.0,333,34,83,181,264,22,51,48,134,137,266,0.5150375939849624,0,0,0.0,137,266,0.5150375939849624,0.515,59,105,0.5619047619047619
Andre Miller,millean02,PG,32,PHI,2009,82,2976.0,1337,534,123,245,368,109,14,199,196,492,1041,0.4726224783861671,15,53,0.2830188679245283,477,988,0.4827935222672064,0.48,338,409,0.8264058679706602
Brad Miller,millebr01,C,32,TOT,2009,70,2100.0,831,234,150,395,545,52,36,130,223,292,614,0.4755700325732899,23,56,0.4107142857142857,269,558,0.482078853046595,0.494,224,272,0.8235294117647058
Mike Miller,millemi01,SF,28,MIN,2009,73,2356.0,722,326,73,410,483,30,31,145,139,264,548,0.4817518248175182,85,225,0.3777777777777777,179,323,0.5541795665634675,0.559,109,149,0.7315436241610739
Paul Millsap,millspa01,PF,23,UTA,2009,76,2290.0,1028,138,251,403,654,78,73,129,288,400,749,0.5340453938584779,0,4,0.0,400,745,0.5369127516778524,0.534,228,326,0.6993865030674846
Yao Ming,mingya01,C,28,HOU,2009,77,2589.0,1514,137,204,557,761,30,150,234,257,566,1032,0.5484496124031008,1,1,1.0,565,1031,0.5480116391852571,0.549,381,440,0.865909090909091
Cuttino Mobley,moblecu01,SG,33,LAC,2009,11,365.0,151,12,9,20,29,15,2,18,21,63,146,0.4315068493150685,12,35,0.3428571428571428,51,111,0.4594594594594595,0.473,13,18,0.7222222222222222
Nazr Mohammed,mohamna01,C,31,CHA,2009,39,341.0,104,8,35,44,79,5,16,23,63,41,101,0.4059405940594059,0,0,0.0,41,101,0.4059405940594059,0.406,22,40,0.55
Jamario Moon,moonja01,SF,28,TOT,2009,80,2068.0,577,95,58,307,365,86,60,43,133,222,474,0.4683544303797468,65,183,0.3551912568306011,157,291,0.5395189003436426,0.537,68,80,0.85
Mikki Moore,mooremi01,PF-C,33,TOT,2009,70,1202.0,276,53,76,182,258,17,19,48,208,114,206,0.5533980582524272,0,0,0.0,114,206,0.5533980582524272,0.553,48,61,0.7868852459016393
Randolph Morris,morrira01,C,23,ATL,2009,23,89.0,18,2,4,16,20,2,1,7,25,7,17,0.4117647058823529,0,0,0.0,7,17,0.4117647058823529,0.412,4,4,1.0
Adam Morrison,morriad01,SF,24,TOT,2009,52,711.0,209,41,18,62,80,9,4,32,77,80,223,0.358744394618834,32,96,0.3333333333333333,48,127,0.3779527559055118,0.43,17,23,0.7391304347826086
Anthony Morrow,morroan01,SG,23,GSW,2009,67,1515.0,676,80,78,121,199,36,12,52,130,255,534,0.4775280898876404,86,184,0.4673913043478261,169,350,0.4828571428571429,0.558,80,92,0.8695652173913043
Troy Murphy,murphtr01,PF,28,IND,2009,73,2482.0,1041,172,146,715,861,58,34,114,226,364,767,0.4745762711864407,161,358,0.4497206703910614,203,409,0.4963325183374083,0.58,152,184,0.8260869565217391
Ronald Murray,murraro01,SG,29,ATL,2009,80,1975.0,974,158,22,146,168,88,17,128,173,355,795,0.4465408805031446,87,242,0.359504132231405,268,553,0.484629294755877,0.501,177,233,0.759656652360515
Dikembe Mutombo,mutomdi01,C,42,HOU,2009,9,96.0,16,0,12,21,33,0,11,6,11,5,13,0.3846153846153846,0,0,0.0,5,13,0.3846153846153846,0.385,6,9,0.6666666666666666
Eduardo Nájera,najered01,PF,32,NJN,2009,27,319.0,79,19,17,50,67,10,4,18,50,33,74,0.4459459459459459,5,25,0.2,28,49,0.5714285714285714,0.48,8,22,0.3636363636363636
Steve Nash,nashst01,PG,34,PHO,2009,74,2484.0,1160,717,19,204,223,55,10,248,108,428,851,0.5029377203290247,108,246,0.4390243902439024,320,605,0.5289256198347108,0.566,196,210,0.9333333333333332
DeMarcus Nelson,nelsode01,PG,23,GSW,2009,13,171.0,53,13,6,18,24,9,2,15,24,24,54,0.4444444444444444,0,3,0.0,24,51,0.4705882352941176,0.444,5,14,0.3571428571428571
Jameer Nelson,nelsoja01,PG,26,ORL,2009,42,1309.0,702,226,20,125,145,51,3,83,123,267,531,0.5028248587570622,82,181,0.4530386740331492,185,350,0.5285714285714286,0.58,86,97,0.8865979381443299
Rasho Nesterović,nestera01,C,32,IND,2009,70,1214.0,473,109,93,147,240,30,38,63,171,224,437,0.5125858123569794,0,1,0.0,224,436,0.5137614678899083,0.513,25,32,0.78125
Demetris Nichols,nichode01,SF,24,TOT,2009,4,14.0,7,1,0,2,2,0,1,0,1,3,9,0.3333333333333333,0,2,0.0,3,7,0.4285714285714285,0.333,1,2,0.5
Joakim Noah,noahjo01,C,23,CHI,2009,80,1938.0,537,106,244,362,606,49,110,82,238,207,372,0.5564516129032258,0,1,0.0,207,371,0.5579514824797843,0.556,123,182,0.6758241758241759
Andrés Nocioni,nocioan01,PF-SF,29,TOT,2009,76,1991.0,867,102,54,307,361,39,33,113,261,299,701,0.4265335235378031,124,311,0.3987138263665595,175,390,0.4487179487179487,0.515,145,183,0.7923497267759563
Steve Novak,novakst01,PF,25,LAC,2009,71,1161.0,492,40,19,106,125,20,5,23,71,176,396,0.4444444444444444,119,286,0.4160839160839161,57,110,0.5181818181818182,0.595,21,23,0.9130434782608696
Dirk Nowitzki,nowitdi01,PF,30,DAL,2009,81,3050.0,2094,197,88,593,681,61,63,157,176,774,1616,0.4789603960396039,61,170,0.3588235294117647,713,1446,0.4930843706777317,0.498,485,545,0.8899082568807339
Patrick O'Bryant,obryapa01,C,22,TOT,2009,39,255.0,101,11,13,53,66,6,19,22,61,45,84,0.5357142857142857,0,2,0.0,45,82,0.5487804878048781,0.536,11,20,0.55
Jermaine O'Neal,onealje01,C,30,TOT,2009,68,2027.0,905,122,126,307,433,29,136,144,211,365,770,0.474025974025974,0,1,0.0,365,769,0.4746423927178153,0.474,175,222,0.7882882882882883
Shaquille O'Neal,onealsh01,C,36,PHO,2009,75,2252.0,1333,126,187,446,633,49,108,168,253,512,841,0.6087990487514863,0,1,0.0,512,840,0.6095238095238096,0.609,309,519,0.5953757225433526
Fabricio Oberto,obertfa01,C,33,SAS,2009,54,677.0,142,59,65,77,142,7,11,38,95,61,104,0.5865384615384616,0,1,0.0,61,103,0.5922330097087378,0.587,20,35,0.5714285714285714
Greg Oden,odengr01,C,21,POR,2009,61,1314.0,540,31,169,255,424,25,69,87,238,198,351,0.5641025641025641,0,0,0.0,198,351,0.5641025641025641,0.564,144,226,0.6371681415929203
Lamar Odom,odomla01,PF,29,LAL,2009,78,2316.0,885,204,176,461,637,77,98,138,235,346,703,0.492176386913229,33,103,0.3203883495145631,313,600,0.5216666666666666,0.516,160,257,0.622568093385214
Emeka Okafor,okafoem01,C,26,CHA,2009,82,2691.0,1085,53,275,552,827,48,136,144,247,433,772,0.560880829015544,0,0,0.0,433,772,0.560880829015544,0.561,219,369,0.5934959349593496
Mehmet Okur,okurme01,C,29,UTA,2009,72,2409.0,1225,120,124,433,557,54,53,132,219,431,888,0.4853603603603603,90,202,0.4455445544554455,341,686,0.4970845481049563,0.536,273,334,0.8173652694610778
Kevin Ollie,ollieke01,PG,36,MIN,2009,50,850.0,202,117,13,62,75,19,4,34,79,61,150,0.4066666666666667,0,1,0.0,61,149,0.4093959731543624,0.407,80,96,0.8333333333333334
Travis Outlaw,outlatr01,SF,24,POR,2009,81,2246.0,1034,83,70,261,331,47,57,94,168,385,850,0.4529411764705882,89,236,0.3771186440677966,296,614,0.4820846905537459,0.505,175,242,0.7231404958677686
Zaza Pachulia,pachuza01,C,24,ATL,2009,77,1473.0,481,57,173,263,436,35,26,91,208,159,320,0.496875,0,3,0.0,159,317,0.501577287066246,0.497,163,230,0.7086956521739131
Anthony Parker,parkean01,SG,33,TOR,2009,80,2637.0,857,269,45,272,317,100,15,114,145,321,754,0.4257294429708222,94,241,0.3900414937759336,227,513,0.442495126705653,0.488,121,145,0.8344827586206897
Tony Parker,parketo01,PG,26,SAS,2009,72,2456.0,1581,496,27,196,223,67,4,186,110,639,1263,0.505938242280285,19,65,0.2923076923076923,620,1198,0.5175292153589316,0.513,284,363,0.7823691460055097
Chris Paul,paulch01,PG,23,NOH,2009,78,3002.0,1781,861,69,363,432,216,10,231,212,631,1255,0.502788844621514,64,176,0.3636363636363636,567,1079,0.5254865616311399,0.528,455,524,0.8683206106870229
Sasha Pavlović,pavloal01,SF,25,CLE,2009,66,1053.0,305,72,31,96,127,22,16,48,122,116,275,0.4218181818181818,48,117,0.4102564102564102,68,158,0.430379746835443,0.509,25,54,0.4629629629629629
Oleksiy Pecherov,pecheol01,C,23,WAS,2009,32,277.0,116,2,35,41,76,6,3,10,34,39,101,0.3861386138613861,14,43,0.3255813953488372,25,58,0.4310344827586206,0.455,24,29,0.8275862068965517
Kendrick Perkins,perkike01,C,24,BOS,2009,76,2253.0,648,96,204,415,619,22,150,165,253,276,478,0.5774058577405857,0,2,0.0,276,476,0.5798319327731093,0.577,96,160,0.6
Morris Peterson,petermo01,SG,31,NOH,2009,43,515.0,191,16,13,71,84,15,2,15,51,73,183,0.3989071038251366,33,85,0.388235294117647,40,98,0.4081632653061224,0.489,12,19,0.631578947368421
Johan Petro,petrojo01,C,23,TOT,2009,49,559.0,162,16,42,116,158,19,15,28,107,73,176,0.4147727272727273,0,2,0.0,73,174,0.4195402298850574,0.415,16,29,0.5517241379310345
Paul Pierce,piercpa01,SF,31,BOS,2009,81,3035.0,1658,294,56,401,457,80,27,228,215,540,1181,0.4572396274343776,119,304,0.3914473684210526,421,877,0.4800456100342075,0.508,459,553,0.8300180831826401
Mickaël Piétrus,pietrmi01,SG,26,ORL,2009,54,1329.0,510,65,44,132,176,31,24,56,126,176,426,0.4131455399061033,80,223,0.358744394618834,96,203,0.4729064039408867,0.507,78,110,0.7090909090909091
James Posey,poseyja01,SG,32,NOH,2009,75,2140.0,668,82,38,324,362,58,21,79,216,216,524,0.4122137404580153,116,314,0.3694267515923566,100,210,0.4761904761904761,0.523,120,146,0.821917808219178
Leon Powe,powele01,PF,25,BOS,2009,70,1227.0,538,46,145,200,345,24,38,76,192,177,338,0.5236686390532544,0,0,0.0,177,338,0.5236686390532544,0.524,184,267,0.6891385767790262
Josh Powell,poweljo01,PF,26,LAL,2009,60,703.0,250,27,71,105,176,9,17,51,98,106,239,0.4435146443514644,0,0,0.0,106,239,0.4435146443514644,0.444,38,50,0.76
Ronnie Price,pricero01,PG,25,UTA,2009,52,738.0,207,108,12,57,69,39,5,61,74,77,203,0.3793103448275862,19,61,0.3114754098360656,58,142,0.4084507042253521,0.426,34,45,0.7555555555555555
Tayshaun Prince,princta01,SF,28,DET,2009,82,3057.0,1163,253,128,348,476,44,51,101,104,459,1020,0.45,56,141,0.3971631205673759,403,879,0.4584755403868031,0.477,189,243,0.7777777777777778
Gabe Pruitt,pruitga01,SG,22,BOS,2009,47,366.0,93,39,9,34,43,15,3,19,34,31,101,0.3069306930693069,14,48,0.2916666666666667,17,53,0.320754716981132,0.376,17,21,0.8095238095238095
Joel Przybilla,przybjo01,C,29,POR,2009,82,1952.0,448,27,204,513,717,34,97,78,215,168,269,0.6245353159851301,0,1,0.0,168,268,0.6268656716417911,0.625,112,169,0.6627218934911243
Chris Quinn,quinnch01,PG,25,MIA,2009,66,962.0,339,132,8,67,75,24,2,33,79,118,289,0.4083044982698962,56,137,0.4087591240875912,62,152,0.4078947368421052,0.505,47,58,0.8103448275862069
Vladimir Radmanović,radmavl01,SF,28,TOT,2009,78,1445.0,540,81,45,177,222,46,15,98,111,196,466,0.4206008583690987,105,262,0.4007633587786259,91,204,0.446078431372549,0.533,43,58,0.7413793103448276
Anthony Randolph,randoan01,PF,19,GSW,2009,63,1129.0,499,49,128,235,363,42,74,80,141,199,431,0.4617169373549884,0,4,0.0,199,427,0.4660421545667447,0.462,101,141,0.7163120567375887
Shavlik Randolph,randosh01,PF,25,POR,2009,10,37.0,18,0,10,8,18,0,1,6,4,8,13,0.6153846153846154,1,1,1.0,7,12,0.5833333333333334,0.654,1,4,0.25
Zach Randolph,randoza01,PF-C,27,TOT,2009,50,1757.0,1041,103,157,347,504,43,16,114,133,415,873,0.4753722794959908,32,97,0.3298969072164948,383,776,0.4935567010309278,0.494,179,244,0.7336065573770492
Theo Ratliff,ratlith01,C,35,PHI,2009,46,579.0,89,9,46,82,128,17,47,14,77,34,64,0.53125,0,0,0.0,34,64,0.53125,0.531,21,35,0.6
Michael Redd,reddmi01,SG,29,MIL,2009,33,1203.0,699,88,24,83,107,35,2,53,45,249,547,0.4552102376599634,70,191,0.3664921465968586,179,356,0.5028089887640449,0.519,131,161,0.8136645962732919
J.J. Redick,redicjj01,SG,24,ORL,2009,64,1111.0,382,73,8,101,109,21,1,54,72,117,299,0.391304347826087,67,179,0.3743016759776536,50,120,0.4166666666666667,0.503,81,93,0.8709677419354839
Jason Richardson,richaja01,SG,28,TOT,2009,72,2410.0,1212,146,77,242,319,76,28,95,146,465,974,0.4774127310061601,129,325,0.3969230769230769,336,649,0.5177195685670262,0.544,153,199,0.7688442211055276
Jeremy Richardson,richaje01,SF,24,ORL,2009,12,93.0,37,3,1,13,14,0,0,3,6,14,49,0.2857142857142857,6,17,0.3529411764705882,8,32,0.25,0.347,3,6,0.5
Quentin Richardson,richaqu01,SG,28,NYK,2009,72,1894.0,733,117,71,248,319,47,7,74,132,262,667,0.3928035982008995,120,329,0.364741641337386,142,338,0.4201183431952662,0.483,89,117,0.7606837606837606
Luke Ridnour,ridnolu01,PG,27,MIL,2009,72,2033.0,688,365,33,185,218,92,16,128,200,250,621,0.4025764895330113,55,157,0.3503184713375796,195,464,0.4202586206896552,0.447,133,153,0.869281045751634
Anthony Roberson,roberan02,PG,25,TOT,2009,29,276.0,119,20,6,16,22,10,1,8,18,44,120,0.3666666666666666,26,81,0.3209876543209876,18,39,0.4615384615384615,0.475,5,5,1.0
Nate Robinson,robinna01,PG,24,NYK,2009,74,2209.0,1272,301,98,192,290,95,6,139,206,449,1028,0.4367704280155642,125,385,0.3246753246753247,324,643,0.5038880248833593,0.498,249,296,0.8412162162162162
Sergio Rodríguez,rodrise01,PG,22,POR,2009,80,1225.0,356,286,43,87,130,54,2,119,133,129,329,0.39209726443769,37,114,0.3245614035087719,92,215,0.427906976744186,0.448,61,77,0.7922077922077922
Rajon Rondo,rondora01,PG,22,BOS,2009,80,2642.0,953,659,100,316,416,149,11,209,193,383,759,0.5046113306982872,15,48,0.3125,368,711,0.5175808720112518,0.514,172,268,0.6417910447761194
Derrick Rose,rosede01,PG,20,CHI,2009,81,3000.0,1361,512,96,221,317,66,18,202,125,574,1208,0.4751655629139072,16,72,0.2222222222222222,558,1136,0.4911971830985915,0.482,197,250,0.788
Malik Rose,rosema01,PF,34,TOT,2009,38,470.0,130,36,17,79,96,10,3,36,72,45,131,0.3435114503816794,0,7,0.0,45,124,0.3629032258064516,0.344,40,51,0.7843137254901961
Quinton Ross,rossqu01,SF,27,MEM,2009,68,1164.0,265,47,29,97,126,32,14,36,114,99,259,0.3822393822393822,33,88,0.375,66,171,0.3859649122807017,0.446,34,42,0.8095238095238095
Brandon Roy,roybr01,SG,24,POR,2009,78,2903.0,1765,400,104,266,370,88,22,152,127,633,1318,0.4802731411229135,83,220,0.3772727272727272,550,1098,0.5009107468123861,0.512,416,505,0.8237623762376237
Michael Ruffin,ruffimi01,PF,32,POR,2009,11,35.0,6,0,6,5,11,3,1,2,7,2,7,0.2857142857142857,0,0,0.0,2,7,0.2857142857142857,0.286,2,2,1.0
Brandon Rush,rushbr01,SG,23,IND,2009,75,1803.0,610,66,34,199,233,38,37,75,128,243,575,0.4226086956521739,78,209,0.3732057416267942,165,366,0.4508196721311475,0.49,46,66,0.696969696969697
Kareem Rush,rushka01,SG,28,PHI,2009,25,199.0,54,15,0,15,15,5,1,10,10,20,58,0.3448275862068966,10,33,0.303030303030303,10,25,0.4,0.431,4,4,1.0
John Salmons,salmojo01,SF,29,TOT,2009,79,2959.0,1446,249,59,274,333,83,24,165,182,516,1093,0.4720951509606587,126,302,0.4172185430463576,390,791,0.4930467762326169,0.53,288,347,0.829971181556196
Cheikh Samb,sambch01,C,24,TOT,2009,18,83.0,15,1,10,14,24,3,10,3,7,6,32,0.1875,0,3,0.0,6,29,0.2068965517241379,0.188,3,7,0.4285714285714285
Brian Scalabrine,scalabr01,C,30,BOS,2009,39,504.0,136,18,7,43,50,7,10,12,73,48,114,0.4210526315789473,24,61,0.3934426229508196,24,53,0.4528301886792453,0.526,16,18,0.8888888888888888
Luis Scola,scolalu01,PF,28,HOU,2009,82,2488.0,1044,123,200,520,720,68,11,123,261,424,799,0.5306633291614519,0,3,0.0,424,796,0.5326633165829145,0.531,196,258,0.7596899224806202
Thabo Sefolosha,sefolth01,SF-SG,24,TOT,2009,66,1453.0,389,111,54,188,242,75,45,64,104,152,357,0.4257703081232493,24,87,0.2758620689655172,128,270,0.4740740740740741,0.459,61,73,0.8356164383561644
Mouhamed Sene,senesa01,C,22,TOT,2009,6,29.0,20,0,5,9,14,1,3,4,2,6,9,0.6666666666666666,0,0,0.0,6,9,0.6666666666666666,0.667,8,10,0.8
Ramon Sessions,sessira01,PG,22,MIL,2009,79,2173.0,977,452,64,205,269,83,7,152,158,345,775,0.4451612903225806,6,34,0.1764705882352941,339,741,0.4574898785425101,0.449,281,354,0.7937853107344632
Walter Sharpe,sharpwa01,PF,22,DET,2009,8,20.0,8,0,0,3,3,0,2,0,3,4,11,0.3636363636363636,0,2,0.0,4,9,0.4444444444444444,0.364,0,2,0.0
Bobby Simmons,simmobo01,SF,28,NJN,2009,71,1729.0,556,92,72,205,277,50,10,62,186,198,441,0.4489795918367347,117,262,0.4465648854961832,81,179,0.4525139664804469,0.582,43,58,0.7413793103448276
Cedric Simmons,simmoce01,PF,23,TOT,2009,18,84.0,29,2,5,11,16,1,4,2,8,11,25,0.44,0,0,0.0,11,25,0.44,0.44,7,16,0.4375
Courtney Sims,simsco01,C,25,TOT,2009,2,13.0,6,0,2,2,4,0,0,1,1,3,6,0.5,0,0,0.0,3,6,0.5,0.5,0,0,0.0
Sean Singletary,singlse01,PG,23,TOT,2009,37,303.0,90,29,10,25,35,11,0,23,45,31,85,0.3647058823529411,10,25,0.4,21,60,0.35,0.424,18,21,0.8571428571428571
James Singleton,singlja01,PF,27,DAL,2009,62,884.0,314,17,89,161,250,26,28,36,110,117,221,0.5294117647058824,13,40,0.325,104,181,0.574585635359116,0.559,67,78,0.8589743589743589
Brian Skinner,skinnbr01,PF,32,LAC,2009,51,843.0,214,27,72,131,203,17,52,43,94,92,205,0.448780487804878,0,2,0.0,92,203,0.4532019704433497,0.449,30,47,0.6382978723404256
Craig Smith,smithcr01,PF,25,MIN,2009,74,1460.0,746,79,98,186,284,31,19,105,184,289,514,0.5622568093385214,0,1,0.0,289,513,0.5633528265107213,0.562,168,248,0.6774193548387096
J.R. Smith,smithjr01,SG,23,DEN,2009,81,2245.0,1233,227,43,254,297,78,14,150,190,424,950,0.4463157894736842,180,453,0.3973509933774834,244,497,0.4909456740442656,0.541,205,272,0.7536764705882353
Joe Smith,smithjo02,C,33,TOT,2009,57,1102.0,374,41,89,174,263,17,40,25,122,156,333,0.4684684684684684,3,7,0.4285714285714285,153,326,0.4693251533742331,0.473,59,82,0.7195121951219512
Josh Smith,smithjo03,PF,23,ATL,2009,69,2421.0,1073,169,134,364,498,94,111,161,184,418,849,0.4923439340400471,26,87,0.2988505747126437,392,762,0.5144356955380578,0.508,211,359,0.5877437325905293
Will Solomon,solomwi01,PG,30,TOT,2009,53,712.0,263,133,12,52,64,27,4,54,71,105,245,0.4285714285714285,28,86,0.3255813953488372,77,159,0.4842767295597484,0.486,25,34,0.7352941176470589
Darius Songaila,songada01,C,30,WAS,2009,77,1521.0,566,94,75,152,227,64,20,74,200,243,457,0.5317286652078774,0,1,0.0,243,456,0.5328947368421053,0.532,80,90,0.8888888888888888
Marreese Speights,speigma01,C,21,PHI,2009,79,1263.0,608,30,123,170,293,27,56,46,181,252,502,0.50199203187251,2,8,0.25,250,494,0.5060728744939271,0.504,102,132,0.7727272727272727
Jerry Stackhouse,stackje01,SG,34,DAL,2009,10,162.0,42,12,5,12,17,4,1,9,6,16,60,0.2666666666666666,3,19,0.1578947368421052,13,41,0.3170731707317073,0.292,7,7,1.0
DeShawn Stevenson,stevede01,SG,27,WAS,2009,32,886.0,211,98,11,65,76,21,2,32,43,72,231,0.3116883116883117,35,129,0.2713178294573643,37,102,0.3627450980392157,0.387,32,60,0.5333333333333333
Peja Stojaković,stojape01,SF,31,NOH,2009,61,2089.0,812,75,44,220,264,52,3,51,101,287,719,0.3991655076495132,145,384,0.3776041666666667,142,335,0.4238805970149253,0.5,93,104,0.8942307692307693
Amar'e Stoudemire,stoudam01,PF,26,PHO,2009,53,1948.0,1134,104,116,314,430,49,57,150,163,404,749,0.5393858477970628,3,7,0.4285714285714285,401,742,0.5404312668463612,0.541,323,387,0.834625322997416
Rodney Stuckey,stuckro01,PG,22,DET,2009,79,2517.0,1058,387,69,206,275,78,11,173,217,401,913,0.4392113910186199,23,78,0.2948717948717949,378,835,0.4526946107784431,0.452,233,290,0.803448275862069
Robert Swift,swiftro01,C,23,OKC,2009,26,343.0,86,9,21,68,89,5,17,8,50,37,71,0.5211267605633803,0,0,0.0,37,71,0.5211267605633803,0.521,12,16,0.75
Stromile Swift,swiftst01,PF,29,TOT,2009,19,185.0,62,3,16,30,46,4,8,16,40,24,56,0.4285714285714285,1,1,1.0,23,55,0.4181818181818181,0.438,13,26,0.5
Wally Szczerbiak,szczewa02,SF,31,CLE,2009,74,1527.0,517,82,43,189,232,28,10,55,130,179,398,0.4497487437185929,69,168,0.4107142857142857,110,230,0.4782608695652174,0.536,90,106,0.8490566037735849
Mike Taylor,taylomi01,PG,23,LAC,2009,51,771.0,289,106,22,65,87,36,0,73,84,110,267,0.4119850187265917,13,40,0.325,97,227,0.4273127753303964,0.436,56,81,0.691358024691358
Sebastian Telfair,telfase01,PG,23,MIN,2009,75,2095.0,738,343,32,95,127,73,12,146,184,267,697,0.3830703012912482,73,211,0.3459715639810427,194,486,0.3991769547325103,0.435,131,160,0.81875
Jason Terry,terryja01,SG,31,DAL,2009,74,2491.0,1447,251,39,138,177,97,20,119,141,541,1168,0.4631849315068493,167,456,0.3662280701754385,374,712,0.5252808988764045,0.535,198,225,0.88
Etan Thomas,thomaet01,C,30,WAS,2009,26,306.0,80,6,25,41,66,3,18,18,35,32,66,0.4848484848484848,0,0,0.0,32,66,0.4848484848484848,0.485,16,23,0.6956521739130435
Kenny Thomas,thomake01,PF,31,SAC,2009,8,62.0,6,1,4,11,15,6,1,1,9,3,8,0.375,0,0,0.0,3,8,0.375,0.375,0,0,0.0
Kurt Thomas,thomaku01,PF,36,SAS,2009,79,1404.0,343,66,134,271,405,34,58,42,170,153,304,0.5032894736842105,0,2,0.0,153,302,0.5066225165562914,0.503,37,45,0.8222222222222222
Tim Thomas,thomati01,PF,31,TOT,2009,64,1247.0,545,68,42,159,201,31,11,70,144,189,438,0.4315068493150685,78,189,0.4126984126984127,111,249,0.4457831325301205,0.521,89,121,0.7355371900826446
Tyrus Thomas,thomaty01,PF,22,CHI,2009,79,2175.0,857,77,148,360,508,91,151,129,220,308,683,0.4509516837481698,3,9,0.3333333333333333,305,674,0.4525222551928783,0.453,238,304,0.7828947368421053
Jason Thompson,thompja02,PF,22,SAC,2009,82,2303.0,910,93,234,372,606,46,59,146,314,356,717,0.496513249651325,0,8,0.0,356,709,0.5021156558533145,0.497,198,286,0.6923076923076923
Al Thornton,thornal01,SF,25,LAC,2009,71,2654.0,1194,103,122,246,368,59,62,130,227,469,1051,0.4462416745956232,20,79,0.2531645569620253,449,972,0.4619341563786008,0.456,236,313,0.7539936102236422
Anthony Tolliver,tollian01,PF,23,SAS,2009,19,208.0,52,17,12,29,41,5,1,7,16,19,65,0.2923076923076923,9,41,0.2195121951219512,10,24,0.4166666666666667,0.362,5,10,0.5
Alando Tucker,tuckeal02,SG,24,PHO,2009,30,282.0,138,12,19,12,31,5,1,14,14,52,121,0.4297520661157025,8,23,0.3478260869565217,44,98,0.4489795918367347,0.463,26,33,0.7878787878787878
Ronny Turiaf,turiaro01,C,26,GSW,2009,79,1696.0,470,166,88,272,360,34,168,70,243,186,366,0.5081967213114754,0,3,0.0,186,363,0.512396694214876,0.508,98,124,0.7903225806451613
Hedo Türkoğlu,turkohe01,SF,29,ORL,2009,77,2815.0,1294,375,45,365,410,64,19,204,218,423,1025,0.4126829268292682,134,376,0.3563829787234042,289,649,0.4453004622496148,0.478,314,389,0.8071979434447301
Ime Udoka,udokaim01,SF,31,SAS,2009,67,1035.0,289,54,28,159,187,36,12,38,86,110,287,0.3832752613240418,41,125,0.328,69,162,0.4259259259259259,0.455,28,46,0.6086956521739131
Beno Udrih,udrihbe01,PG,26,SAC,2009,73,2270.0,800,342,46,174,220,81,12,158,192,321,696,0.4612068965517241,35,113,0.3097345132743362,286,583,0.490566037735849,0.486,123,150,0.82
Roko Ukić,ukicro01,PG,24,TOR,2009,72,890.0,301,153,27,48,75,30,2,60,77,123,324,0.3796296296296296,11,62,0.1774193548387097,112,262,0.4274809160305343,0.397,44,60,0.7333333333333333
Anderson Varejão,varejan01,PF,26,CLE,2009,81,2306.0,694,81,166,415,581,75,66,80,239,270,504,0.5357142857142857,0,2,0.0,270,502,0.5378486055776892,0.536,154,250,0.616
Jacque Vaughn,vaughja01,PG,33,SAS,2009,30,292.0,65,55,4,18,22,6,0,15,26,24,75,0.32,1,1,1.0,23,74,0.3108108108108108,0.327,16,18,0.8888888888888888
Charlie Villanueva,villach01,PF,24,MIL,2009,78,2095.0,1264,137,154,366,520,50,56,138,254,487,1089,0.4471992653810835,89,258,0.3449612403100775,398,831,0.4789410348977136,0.488,201,240,0.8375
Jake Voskuhl,voskuja01,C,31,TOR,2009,38,240.0,35,8,21,38,59,3,4,17,60,12,45,0.2666666666666666,0,0,0.0,12,45,0.2666666666666666,0.267,11,14,0.7857142857142857
Sasha Vujačić,vujacsa01,SG,24,LAL,2009,80,1293.0,461,113,19,116,135,77,7,35,154,155,401,0.3865336658354115,81,223,0.3632286995515695,74,178,0.4157303370786517,0.488,70,76,0.9210526315789472
Dwyane Wade,wadedw01,SG,27,MIA,2009,79,3048.0,2386,589,89,309,398,173,106,272,178,854,1739,0.4910868315123634,88,278,0.316546762589928,766,1461,0.5242984257357974,0.516,590,771,0.7652399481193255
Von Wafer,wafervo01,SG,23,HOU,2009,63,1225.0,610,71,19,94,113,40,8,59,71,229,512,0.447265625,64,164,0.3902439024390244,165,348,0.4741379310344827,0.51,88,117,0.7521367521367521
Henry Walker,walkebi01,SF,21,BOS,2009,29,216.0,88,13,8,21,29,6,2,18,51,36,58,0.6206896551724138,0,1,0.0,36,57,0.631578947368421,0.621,16,23,0.6956521739130435
Ben Wallace,wallabe01,PF,34,CLE,2009,56,1314.0,165,44,136,226,362,48,75,34,82,69,155,0.4451612903225806,0,0,0.0,69,155,0.4451612903225806,0.445,27,64,0.421875
Gerald Wallace,wallage01,SF,26,CHA,2009,71,2669.0,1182,189,112,441,553,121,67,148,210,389,811,0.4796547472256473,39,131,0.2977099236641221,350,680,0.5147058823529411,0.504,365,454,0.8039647577092511
Rasheed Wallace,wallara01,C,34,DET,2009,66,2123.0,795,91,56,434,490,62,86,59,197,302,720,0.4194444444444444,113,319,0.3542319749216301,189,401,0.4713216957605985,0.498,78,101,0.7722772277227723
Luke Walton,waltolu01,SF,28,LAL,2009,65,1166.0,326,177,55,125,180,32,10,69,105,134,307,0.4364820846905538,17,57,0.2982456140350877,117,250,0.468,0.464,41,57,0.7192982456140351
Hakim Warrick,warriha01,PF,26,MEM,2009,82,2029.0,951,66,129,277,406,48,39,98,170,340,693,0.4906204906204906,5,23,0.217391304347826,335,670,0.5,0.494,266,374,0.7112299465240641
C.J. Watson,watsocj01,PG,24,GSW,2009,77,1883.0,730,206,39,153,192,96,4,92,137,257,562,0.4572953736654804,48,120,0.4,209,442,0.4728506787330316,0.5,168,193,0.8704663212435233
Earl Watson,watsoea01,PG,29,OKC,2009,68,1776.0,448,391,36,147,183,50,11,156,137,174,453,0.3841059602649007,20,85,0.2352941176470588,154,368,0.4184782608695652,0.406,80,106,0.7547169811320755
Kyle Weaver,weaveky01,SG,22,OKC,2009,56,1166.0,299,101,31,99,130,47,25,69,81,113,246,0.4593495934959349,32,93,0.3440860215053763,81,153,0.5294117647058824,0.524,41,58,0.7068965517241379
Martell Webster,webstma02,SF,22,POR,2009,1,5.0,0,0,0,0,0,0,0,0,0,0,1,0.0,0,1,0.0,0,0,0.0,0.0,0,0,0.0
Sonny Weems,weemsso01,SG,22,DEN,2009,12,55.0,19,3,0,4,4,1,0,6,8,8,25,0.32,0,3,0.0,8,22,0.3636363636363636,0.32,3,8,0.375
David West,westda01,PF,28,NOH,2009,76,2982.0,1593,173,160,486,646,49,68,163,207,610,1292,0.4721362229102167,6,25,0.24,604,1267,0.4767166535122336,0.474,367,415,0.8843373493975903
Delonte West,westde01,SG,25,CLE,2009,64,2152.0,751,226,31,172,203,94,13,92,125,285,624,0.4567307692307692,91,228,0.3991228070175439,194,396,0.4898989898989899,0.53,90,108,0.8333333333333334
Mario West,westma02,SG,24,ATL,2009,53,269.0,43,19,24,32,56,18,4,13,35,14,34,0.4117647058823529,1,1,1.0,13,33,0.3939393939393939,0.426,14,30,0.4666666666666667
Russell Westbrook,westbru01,PG,20,OKC,2009,82,2668.0,1256,435,178,221,399,110,16,274,191,436,1095,0.3981735159817351,35,129,0.2713178294573643,401,966,0.4151138716356107,0.414,349,428,0.8154205607476636
D.J. White,whitedj01,PF,22,OKC,2009,7,130.0,62,6,10,22,32,3,5,3,10,26,50,0.52,0,0,0.0,26,50,0.52,0.52,10,13,0.7692307692307693
James White,whiteja02,SF,26,HOU,2009,4,11.0,7,1,0,0,0,1,1,3,2,3,5,0.6,1,2,0.5,2,3,0.6666666666666666,0.7,0,0,0.0
Chris Wilcox,wilcoch01,C,26,TOT,2009,62,1049.0,447,47,96,181,277,26,16,75,137,184,370,0.4972972972972973,0,4,0.0,184,366,0.5027322404371585,0.497,79,140,0.5642857142857143
Damien Wilkins,wilkida02,SG,29,OKC,2009,41,636.0,218,37,20,50,70,22,7,37,55,77,213,0.3615023474178404,27,72,0.375,50,141,0.3546099290780142,0.425,37,46,0.8043478260869565
Deron Williams,willide01,PG,24,UTA,2009,68,2505.0,1322,725,24,171,195,73,20,228,134,463,984,0.4705284552845528,70,226,0.3097345132743362,393,758,0.5184696569920845,0.506,326,384,0.8489583333333334
Jawad Williams,willija04,SF,25,CLE,2009,10,20.0,12,0,1,1,2,1,0,1,2,5,12,0.4166666666666667,2,6,0.3333333333333333,3,6,0.5,0.5,0,0,0.0
Lou Williams,willilo02,SG,22,PHI,2009,81,1919.0,1039,242,36,129,165,85,14,151,128,336,844,0.3981042654028436,63,220,0.2863636363636364,273,624,0.4375,0.435,304,385,0.7896103896103897
Marcus Williams,willima03,PG,23,GSW,2009,9,54.0,12,13,0,4,4,1,1,4,6,4,17,0.2352941176470588,2,6,0.3333333333333333,2,11,0.1818181818181818,0.294,2,6,0.3333333333333333
Marcus Williams,willima04,PF,22,SAS,2009,2,3.0,4,0,0,0,0,0,0,0,1,2,2,1.0,0,0,0.0,2,2,1.0,1.0,0,0,0.0
Marvin Williams,willima02,SF,22,ATL,2009,61,2093.0,845,81,110,272,382,57,39,70,127,285,622,0.4581993569131832,55,155,0.3548387096774194,230,467,0.4925053533190578,0.502,220,273,0.8058608058608059
Mo Williams,willima01,PG,26,CLE,2009,81,2834.0,1443,329,47,232,279,69,9,179,215,526,1126,0.4671403197158081,183,420,0.4357142857142857,343,706,0.4858356940509915,0.548,208,228,0.912280701754386
Sean Williams,willise01,PF,22,NJN,2009,33,366.0,80,13,34,45,79,7,29,20,72,30,72,0.4166666666666667,0,0,0.0,30,72,0.4166666666666667,0.417,20,32,0.625
Shawne Williams,willish03,SF,22,DAL,2009,15,170.0,42,2,19,27,46,2,9,5,19,16,56,0.2857142857142857,1,17,0.0588235294117647,15,39,0.3846153846153846,0.295,9,11,0.8181818181818182
Shelden Williams,willish02,PF,25,TOT,2009,45,512.0,186,12,49,104,153,22,18,34,64,70,157,0.445859872611465,0,2,0.0,70,155,0.4516129032258064,0.446,46,63,0.7301587301587301
Metta World Peace,artesro01,SF,29,HOU,2009,69,2452.0,1181,229,65,294,359,105,24,140,155,416,1037,0.4011571841851494,153,383,0.3994778067885117,263,654,0.4021406727828746,0.475,196,262,0.7480916030534351
Antoine Wright,wrighan01,SF,24,DAL,2009,65,1552.0,474,77,31,105,136,46,27,54,172,179,431,0.4153132250580046,45,149,0.3020134228187919,134,282,0.475177304964539,0.468,71,95,0.7473684210526316
Brandan Wright,wrighbr03,PF,21,GSW,2009,39,688.0,323,21,62,95,157,22,37,23,74,130,246,0.5284552845528455,0,4,0.0,130,242,0.5371900826446281,0.528,63,85,0.7411764705882353
Dorell Wright,wrighdo01,SF,23,MIA,2009,6,73.0,18,2,2,18,20,2,0,6,8,8,20,0.4,0,0,0.0,8,20,0.4,0.4,2,6,0.3333333333333333
Julian Wright,wrighju01,SF,21,NOH,2009,54,772.0,237,43,46,106,152,35,19,43,49,109,234,0.4658119658119658,2,21,0.0952380952380952,107,213,0.5023474178403756,0.47,17,30,0.5666666666666667
Lorenzen Wright,wrighlo02,C,33,CLE,2009,17,125.0,23,3,7,18,25,4,5,9,17,10,27,0.3703703703703703,0,0,0.0,10,27,0.3703703703703703,0.37,3,8,0.375
Nick Young,youngni01,SG,23,WAS,2009,82,1837.0,892,95,31,119,150,39,20,92,140,336,756,0.4444444444444444,56,164,0.3414634146341463,280,592,0.4729729729729729,0.481,164,193,0.8497409326424871
Thaddeus Young,youngth01,PF,20,PHI,2009,75,2580.0,1145,86,139,238,377,100,23,118,165,475,960,0.4947916666666667,56,164,0.3414634146341463,419,796,0.5263819095477387,0.524,139,189,0.7354497354497355
Sun Yue,yuesu01,SG,23,LAL,2009,10,28.0,6,2,0,0,0,1,1,3,10,3,11,0.2727272727272727,0,6,0.0,3,5,0.6,0.273,0,0,0.0
Arron Afflalo,afflaar01,SG,24,DEN,2010,82,2221.0,724,138,59,193,252,46,30,74,225,272,585,0.4649572649572649,108,249,0.4337349397590361,164,336,0.4880952380952381,0.557,72,98,0.7346938775510204
Alexis Ajinça,ajincal01,C,21,CHA,2010,6,30.0,10,0,1,3,4,1,1,2,5,5,10,0.5,0,0,0.0,5,10,0.5,0.5,0,1,0.0
LaMarcus Aldridge,aldrila01,PF,24,POR,2010,78,2922.0,1393,160,192,435,627,67,48,104,231,579,1169,0.495295124037639,5,16,0.3125,574,1153,0.4978317432784042,0.497,230,304,0.756578947368421
Joe Alexander,alexajo01,SF,23,CHI,2010,8,29.0,4,2,2,3,5,1,1,0,9,1,6,0.1666666666666666,0,1,0.0,1,5,0.2,0.167,2,3,0.6666666666666666
Malik Allen,allenma01,PF,31,DEN,2010,51,456.0,105,16,36,46,82,11,5,22,68,46,116,0.396551724137931,1,6,0.1666666666666666,45,110,0.4090909090909091,0.401,12,13,0.9230769230769232
Ray Allen,allenra02,SG,34,BOS,2010,80,2819.0,1304,210,45,208,253,64,25,129,182,464,973,0.4768756423432682,145,399,0.3634085213032581,319,574,0.5557491289198606,0.551,231,253,0.9130434782608696
Tony Allen,allento01,SG,28,BOS,2010,54,889.0,330,72,52,93,145,59,19,66,109,129,253,0.5098814229249012,0,5,0.0,129,248,0.5201612903225806,0.51,72,119,0.6050420168067226
Rafer Alston,alstora01,PG,33,TOT,2010,52,1421.0,427,176,13,116,129,50,10,95,103,155,446,0.3475336322869955,58,168,0.3452380952380952,97,278,0.3489208633093525,0.413,59,81,0.7283950617283951
Lou Amundson,amundlo01,PF,27,PHO,2010,79,1168.0,371,31,128,218,346,24,73,57,169,152,276,0.5507246376811594,0,1,0.0,152,275,0.5527272727272727,0.551,67,123,0.5447154471544715
Chris Andersen,anderch01,PF,31,DEN,2010,76,1695.0,448,33,147,336,483,42,143,59,171,142,251,0.5657370517928287,0,3,0.0,142,248,0.5725806451612904,0.566,164,236,0.6949152542372882
David Andersen,anderda03,C,29,HOU,2010,63,891.0,367,44,54,154,208,15,12,37,119,147,340,0.4323529411764706,27,78,0.3461538461538461,120,262,0.4580152671755725,0.472,46,67,0.6865671641791045
Antonio Anderson,anderan02,SF,24,OKC,2010,1,15.0,2,0,1,0,1,0,0,1,1,1,3,0.3333333333333333,0,0,0.0,1,3,0.3333333333333333,0.333,0,0,0.0
Ryan Anderson,anderry01,PF,21,ORL,2010,63,911.0,487,37,70,132,202,25,14,56,81,169,388,0.4355670103092783,78,211,0.3696682464454976,91,177,0.5141242937853108,0.536,71,82,0.8658536585365854
Carmelo Anthony,anthoca01,SF,25,DEN,2010,69,2634.0,1943,222,152,302,454,88,30,209,225,688,1502,0.4580559254327563,59,187,0.3155080213903743,629,1315,0.4783269961977186,0.478,508,612,0.8300653594771242
Joel Anthony,anthojo01,C,27,MIA,2010,80,1322.0,218,12,123,126,249,20,109,45,158,76,159,0.4779874213836478,0,0,0.0,76,159,0.4779874213836478,0.478,66,92,0.717391304347826
Gilbert Arenas,arenagi01,PG,28,WAS,2010,32,1169.0,722,230,17,116,133,41,9,117,95,253,616,0.4107142857142857,63,181,0.3480662983425414,190,435,0.4367816091954023,0.462,153,207,0.7391304347826086
Trevor Ariza,arizatr01,SF,24,HOU,2010,72,2629.0,1072,276,78,325,403,126,40,161,162,394,999,0.3943943943943944,136,407,0.3341523341523341,258,592,0.4358108108108108,0.462,148,228,0.6491228070175439
Hilton Armstrong,armsthi01,PF-C,25,TOT,2010,33,335.0,71,21,27,54,81,15,12,22,59,28,79,0.3544303797468354,0,1,0.0,28,78,0.358974358974359,0.354,15,32,0.46875
Carlos Arroyo,arroyca01,PG,30,MIA,2010,72,1585.0,439,225,26,104,130,36,6,54,102,178,375,0.4746666666666667,7,25,0.28,171,350,0.4885714285714285,0.484,76,90,0.8444444444444444
Darrell Arthur,arthuda01,PF,21,MEM,2010,32,457.0,143,15,37,73,110,14,14,22,60,63,146,0.4315068493150685,0,1,0.0,63,145,0.4344827586206896,0.432,17,30,0.5666666666666667
Chucky Atkins,atkinch01,PG,35,DET,2010,40,644.0,161,91,5,24,29,17,0,32,53,57,157,0.3630573248407643,22,73,0.3013698630136986,35,84,0.4166666666666667,0.433,25,27,0.925925925925926
D.J. Augustin,augusdj01,PG,22,CHA,2010,80,1472.0,508,193,11,86,97,45,5,74,127,168,435,0.3862068965517241,70,178,0.3932584269662921,98,257,0.3813229571984435,0.467,102,131,0.7786259541984732
Jeff Ayres,pendeje02,C,22,POR,2010,39,405.0,104,1,25,73,98,7,16,12,76,43,65,0.6615384615384615,0,0,0.0,43,65,0.6615384615384615,0.662,18,20,0.9
Kelenna Azubuike,azubuke01,SF,26,GSW,2010,9,231.0,125,10,12,29,41,5,9,7,16,48,88,0.5454545454545454,10,27,0.3703703703703703,38,61,0.6229508196721312,0.602,19,28,0.6785714285714286
Renaldo Balkman,balkmre01,SF,25,DEN,2010,13,91.0,14,7,4,19,23,8,2,6,16,6,18,0.3333333333333333,0,7,0.0,6,11,0.5454545454545454,0.333,2,6,0.3333333333333333
Marcus Banks,banksma01,PG,28,TOR,2010,22,244.0,109,26,3,20,23,12,2,20,30,39,73,0.5342465753424658,7,24,0.2916666666666667,32,49,0.6530612244897959,0.582,24,29,0.8275862068965517
Leandro Barbosa,barbole01,PG,27,PHO,2010,44,786.0,418,64,11,58,69,23,12,46,71,155,365,0.4246575342465753,44,136,0.3235294117647059,111,229,0.4847161572052402,0.485,64,73,0.8767123287671232
J.J. Barea,bareajo01,PG,25,DAL,2010,78,1546.0,596,258,17,129,146,35,6,102,119,232,527,0.4402277039848197,56,157,0.3566878980891719,176,370,0.4756756756756757,0.493,76,90,0.8444444444444444
Andrea Bargnani,bargnan01,PF,24,TOR,2010,80,2799.0,1376,93,105,388,493,25,111,120,215,537,1143,0.4698162729658792,121,325,0.3723076923076923,416,818,0.508557457212714,0.523,181,234,0.7735042735042735
Matt Barnes,barnema02,SF,29,ORL,2010,81,2097.0,716,134,106,339,445,59,30,112,185,271,557,0.4865350089766607,66,207,0.3188405797101449,205,350,0.5857142857142857,0.546,108,146,0.7397260273972602
Earl Barron,barroea01,C,28,NYK,2010,7,232.0,82,8,31,46,77,4,4,11,24,30,68,0.4411764705882353,0,0,0.0,30,68,0.4411764705882353,0.441,22,29,0.7586206896551724
Brandon Bass,bassbr01,PF,24,ORL,2010,50,648.0,290,19,54,73,127,12,27,31,69,119,233,0.5107296137339056,0,0,0.0,119,233,0.5107296137339056,0.511,52,63,0.8253968253968254
Tony Battie,battito01,C,33,NJN,2010,15,134.0,36,3,4,19,23,4,2,3,19,14,40,0.35,1,4,0.25,13,36,0.3611111111111111,0.363,7,10,0.7
Shane Battier,battish01,SG,31,HOU,2010,67,2168.0,534,164,74,238,312,53,76,64,139,178,447,0.3982102908277405,101,279,0.3620071684587813,77,168,0.4583333333333333,0.511,77,106,0.7264150943396226
Nicolas Batum,batumni01,SF,21,POR,2010,37,918.0,375,44,32,109,141,24,25,27,83,139,268,0.5186567164179104,54,132,0.4090909090909091,85,136,0.625,0.619,43,51,0.8431372549019608
Jerryd Bayless,bayleje01,SG,21,POR,2010,74,1304.0,630,172,18,102,120,26,5,94,152,200,483,0.4140786749482402,29,92,0.3152173913043478,171,391,0.4373401534526854,0.444,201,242,0.8305785123966942
Michael Beasley,beaslmi01,PF,21,MIA,2010,78,2328.0,1156,100,123,375,498,80,49,131,221,468,1040,0.45,28,102,0.2745098039215686,440,938,0.4690831556503198,0.463,192,240,0.8
Rodrigue Beaubois,beaubro01,PG,21,DAL,2010,56,700.0,397,74,12,66,78,29,12,54,84,155,299,0.5183946488294314,45,110,0.4090909090909091,110,189,0.582010582010582,0.594,42,52,0.8076923076923077
Marco Belinelli,belinma01,SG,23,TOR,2010,66,1121.0,469,89,14,81,95,42,5,60,80,154,379,0.4063324538258575,60,158,0.379746835443038,94,221,0.4253393665158371,0.485,101,121,0.8347107438016529
Charlie Bell,bellch01,SG,30,MIL,2010,71,1611.0,459,104,31,101,132,39,12,54,136,169,443,0.3814898419864559,73,200,0.365,96,243,0.3950617283950617,0.464,48,67,0.7164179104477612
Raja Bell,bellra01,SG,33,TOT,2010,6,180.0,71,13,5,18,23,4,2,5,15,28,61,0.4590163934426229,12,27,0.4444444444444444,16,34,0.4705882352941176,0.557,3,3,1.0
Jonathan Bender,bendejo01,SF,29,NYK,2010,25,292.0,118,16,15,37,52,2,17,28,33,40,100,0.4,14,39,0.358974358974359,26,61,0.4262295081967213,0.47,24,26,0.9230769230769232
Mike Bibby,bibbymi01,PG,31,ATL,2010,80,2195.0,730,310,20,164,184,67,3,90,157,268,644,0.4161490683229814,126,324,0.3888888888888889,142,320,0.44375,0.514,68,79,0.8607594936708861
Andris Biedriņš,biedran01,C,23,GSW,2010,33,763.0,166,57,63,196,259,20,44,32,117,81,137,0.5912408759124088,0,0,0.0,81,137,0.5912408759124088,0.591,4,25,0.16
Chauncey Billups,billuch01,PG,33,DEN,2010,73,2490.0,1427,409,25,203,228,82,9,177,153,402,962,0.4178794178794179,157,407,0.3857493857493858,245,555,0.4414414414414414,0.499,466,512,0.91015625
DeJuan Blair,blairde01,PF,20,SAS,2010,82,1494.0,638,65,200,326,526,50,39,112,224,275,495,0.5555555555555556,0,2,0.0,275,493,0.5578093306288032,0.556,88,161,0.546583850931677
Steve Blake,blakest01,PG,29,TOT,2010,80,2159.0,586,380,21,166,187,58,6,128,123,217,522,0.4157088122605364,116,294,0.3945578231292517,101,228,0.4429824561403508,0.527,36,48,0.75
Andray Blatche,blatcan01,PF,23,WAS,2010,81,2256.0,1143,170,158,351,509,85,71,182,218,478,999,0.4784784784784784,13,44,0.2954545454545454,465,955,0.4869109947643979,0.485,174,234,0.7435897435897436
Keith Bogans,boganke01,SF,29,SAS,2010,79,1559.0,347,95,25,151,176,45,12,53,156,120,298,0.4026845637583892,70,196,0.3571428571428571,50,102,0.4901960784313725,0.52,37,50,0.74
Andrew Bogut,bogutan01,C,25,MIL,2010,69,2229.0,1095,127,208,493,701,39,175,131,222,473,910,0.5197802197802198,0,2,0.0,473,908,0.5209251101321586,0.52,149,237,0.6286919831223629
Matt Bonner,bonnema01,PF,29,SAS,2010,65,1161.0,457,68,52,162,214,30,24,39,109,166,372,0.4462365591397849,90,231,0.3896103896103896,76,141,0.5390070921985816,0.567,35,48,0.7291666666666666
Josh Boone,boonejo01,PF,25,NJN,2010,63,1045.0,253,29,124,191,315,30,48,37,111,117,223,0.5246636771300448,0,0,0.0,117,223,0.5246636771300448,0.525,19,58,0.3275862068965517
Carlos Boozer,boozeca01,PF,28,UTA,2010,78,2673.0,1519,247,181,693,874,84,36,212,270,617,1098,0.5619307832422586,0,0,0.0,617,1098,0.5619307832422586,0.562,285,384,0.7421875
Chris Bosh,boshch01,C,25,TOR,2010,70,2526.0,1678,166,205,554,759,43,68,169,170,600,1158,0.5181347150259067,8,22,0.3636363636363636,592,1136,0.5211267605633803,0.522,470,590,0.7966101694915254
Ryan Bowen,bowenry01,SF,34,OKC,2010,1,8.0,4,0,1,1,2,1,0,0,2,1,1,1.0,0,0,0.0,1,1,1.0,1.0,2,2,1.0
Earl Boykins,boykiea01,PG,33,WAS,2010,67,1117.0,440,171,17,58,75,24,3,69,48,172,403,0.4267990074441687,19,60,0.3166666666666666,153,343,0.446064139941691,0.45,77,89,0.8651685393258427
Elton Brand,brandel01,PF,30,PHI,2010,76,2297.0,996,109,179,282,461,82,80,131,232,412,858,0.4801864801864802,0,1,0.0,412,857,0.4807467911318553,0.48,172,233,0.7381974248927039
Corey Brewer,breweco01,SG,23,MIN,2010,82,2482.0,1066,193,70,209,279,117,29,164,224,409,949,0.4309799789251844,82,237,0.3459915611814346,327,712,0.4592696629213483,0.474,166,256,0.6484375
Ronnie Brewer,brewero02,SG,24,TOT,2010,58,1742.0,511,154,45,142,187,91,15,53,80,209,429,0.4871794871794871,8,31,0.2580645161290322,201,398,0.5050251256281407,0.497,85,133,0.6390977443609023
Primož Brezec,brezepr01,C,30,TOT,2010,21,95.0,19,1,12,13,25,1,3,2,19,9,26,0.3461538461538461,0,0,0.0,9,26,0.3461538461538461,0.346,1,6,0.1666666666666666
Jon Brockman,brockjo01,PF,22,SAC,2010,52,654.0,147,22,105,108,213,15,5,23,115,55,103,0.5339805825242718,0,0,0.0,55,103,0.5339805825242718,0.534,37,62,0.5967741935483871
Aaron Brooks,brookaa01,PG,25,HOU,2010,82,2919.0,1604,434,54,161,215,69,14,232,199,575,1331,0.4320060105184072,209,525,0.3980952380952381,366,806,0.4540942928039702,0.511,245,298,0.8221476510067114
Bobby Brown,brownbo02,PG,25,TOT,2010,45,519.0,215,88,9,29,38,15,1,46,42,88,237,0.3713080168776371,26,98,0.2653061224489796,62,139,0.4460431654676259,0.426,13,15,0.8666666666666667
Derrick Brown,brownde04,SF,22,CHA,2010,57,535.0,186,19,31,47,78,21,10,19,53,68,147,0.4625850340136054,2,7,0.2857142857142857,66,140,0.4714285714285714,0.469,48,72,0.6666666666666666
Devin Brown,brownde02,SG,31,TOT,2010,50,1060.0,399,65,29,95,124,33,6,62,72,136,361,0.3767313019390582,58,164,0.3536585365853658,78,197,0.3959390862944162,0.457,69,86,0.8023255813953488
Kwame Brown,brownkw01,C,27,DET,2010,48,660.0,157,22,53,124,177,15,12,43,93,62,124,0.5,0,1,0.0,62,123,0.5040650406504065,0.5,33,98,0.336734693877551
Shannon Brown,brownsh01,SG,24,LAL,2010,82,1700.0,667,108,30,153,183,57,31,67,129,253,592,0.4273648648648648,62,189,0.328042328042328,191,403,0.4739454094292804,0.48,99,121,0.8181818181818182
Kobe Bryant,bryanko01,SG,31,LAL,2010,73,2835.0,1970,365,78,313,391,113,20,233,187,716,1569,0.4563416188655194,99,301,0.3289036544850498,617,1268,0.4865930599369085,0.488,439,541,0.8114602587800369
Chase Budinger,budinch01,SF,21,HOU,2010,74,1488.0,657,88,38,182,220,34,11,48,85,249,565,0.4407079646017699,92,249,0.3694779116465863,157,316,0.4968354430379746,0.522,67,87,0.7701149425287356
Caron Butler,butleca01,SF-SG,29,TOT,2010,74,2783.0,1206,156,104,357,461,116,24,160,193,450,1051,0.4281636536631779,42,145,0.2896551724137931,408,906,0.4503311258278146,0.448,264,315,0.8380952380952381
Rasual Butler,butlera01,SF,30,LAC,2010,82,2702.0,979,116,39,201,240,36,68,79,121,356,870,0.4091954022988506,145,432,0.3356481481481481,211,438,0.4817351598173516,0.493,122,145,0.8413793103448276
Andrew Bynum,bynuman01,C,22,LAL,2010,65,1977.0,977,68,177,364,541,35,94,115,193,392,688,0.5697674418604651,0,1,0.0,392,687,0.5705967976710334,0.57,193,261,0.7394636015325671
Will Bynum,bynumwi01,PG,27,DET,2010,63,1667.0,628,283,24,118,142,55,7,115,143,237,534,0.4438202247191011,12,55,0.2181818181818181,225,479,0.4697286012526096,0.455,142,178,0.797752808988764
José Calderón,caldejo01,PG,28,TOR,2010,68,1817.0,699,404,23,119,142,47,7,99,135,274,568,0.4823943661971831,68,171,0.3976608187134502,206,397,0.5188916876574308,0.542,83,104,0.7980769230769231
Marcus Camby,cambyma01,PF-C,35,TOT,2010,74,2314.0,556,186,249,622,871,95,146,91,161,238,501,0.4750499001996008,2,7,0.2857142857142857,236,494,0.4777327935222672,0.477,78,122,0.639344262295082
Brian Cardinal,cardibr01,PF,32,MIN,2010,29,267.0,48,24,7,22,29,9,3,7,56,14,36,0.3888888888888889,3,9,0.3333333333333333,11,27,0.4074074074074074,0.431,17,18,0.9444444444444444
Rodney Carney,carnero01,SG,25,PHI,2010,68,857.0,319,37,26,111,137,25,20,21,79,113,282,0.400709219858156,41,135,0.3037037037037037,72,147,0.4897959183673469,0.473,52,63,0.8253968253968254
DeMarre Carroll,carrode01,SF,23,MEM,2010,71,795.0,209,33,53,97,150,28,9,24,107,88,222,0.3963963963963964,0,6,0.0,88,216,0.4074074074074074,0.396,33,53,0.6226415094339622
Matt Carroll,carroma01,SG,29,DAL,2010,25,121.0,46,6,4,8,12,5,0,7,13,18,50,0.36,4,19,0.2105263157894736,14,31,0.4516129032258064,0.4,6,6,1.0
Anthony Carter,cartean01,PG,34,DEN,2010,54,859.0,180,160,17,72,89,39,13,58,72,76,181,0.4198895027624309,17,63,0.2698412698412698,59,118,0.5,0.467,11,13,0.8461538461538461
Vince Carter,cartevi01,SG,33,ORL,2010,75,2310.0,1244,236,33,260,293,53,18,106,189,434,1015,0.4275862068965517,119,324,0.3672839506172839,315,691,0.4558610709117221,0.486,257,306,0.8398692810457516
Omri Casspi,casspom01,SF,21,SAC,2010,77,1931.0,792,95,75,274,349,54,17,98,125,300,672,0.4464285714285714,75,203,0.3694581280788177,225,469,0.4797441364605543,0.502,117,174,0.6724137931034483
Mario Chalmers,chalmma01,PG,23,MIA,2010,73,1807.0,521,246,25,110,135,91,12,123,175,182,454,0.4008810572687225,75,236,0.3177966101694915,107,218,0.4908256880733945,0.483,82,110,0.7454545454545455
Tyson Chandler,chandty01,C,27,CHA,2010,51,1163.0,333,16,114,206,320,17,55,91,138,109,190,0.5736842105263158,0,0,0.0,109,190,0.5736842105263158,0.574,115,157,0.732484076433121
Wilson Chandler,chandwi01,SG,22,NYK,2010,65,2320.0,993,138,93,255,348,46,49,108,184,412,860,0.4790697674418605,40,150,0.2666666666666666,372,710,0.523943661971831,0.502,129,160,0.80625
Earl Clark,clarkea01,PF,22,PHO,2010,51,383.0,140,21,18,44,62,7,13,23,25,56,151,0.3708609271523179,2,5,0.4,54,146,0.3698630136986301,0.377,26,36,0.7222222222222222
Jarron Collins,collija03,C,31,PHO,2010,34,261.0,34,6,22,40,62,2,3,10,42,12,31,0.3870967741935484,0,0,0.0,12,31,0.3870967741935484,0.387,10,25,0.4
Jason Collins,collija04,C,31,ATL,2010,24,115.0,16,4,5,9,14,3,2,5,21,8,23,0.3478260869565217,0,1,0.0,8,22,0.3636363636363636,0.348,0,2,0.0
Mardy Collins,collima01,SG,25,LAC,2010,43,470.0,111,44,13,37,50,23,1,32,45,47,128,0.3671875,4,17,0.2352941176470588,43,111,0.3873873873873873,0.383,13,21,0.6190476190476191
Darren Collison,collida01,PG,22,NOH,2010,76,2109.0,946,432,41,151,192,78,4,202,92,376,789,0.476552598225602,46,115,0.4,330,674,0.4896142433234421,0.506,148,174,0.8505747126436781
Nick Collison,collini01,C,29,OKC,2010,75,1557.0,439,38,152,232,384,37,48,63,230,182,309,0.5889967637540453,1,4,0.25,181,305,0.5934426229508196,0.591,74,107,0.6915887850467289
Mike Conley,conlemi01,PG,22,MEM,2010,80,2569.0,959,425,30,161,191,109,12,170,178,369,830,0.444578313253012,82,212,0.3867924528301887,287,618,0.4644012944983818,0.494,139,187,0.7433155080213903
Will Conroy,conrowi01,PG,27,HOU,2010,5,36.0,6,7,0,3,3,0,0,4,5,3,10,0.3,0,3,0.0,3,7,0.4285714285714285,0.3,0,2,0.0
Brian Cook,cookbr01,PF,29,HOU,2010,15,44.0,21,1,1,8,9,0,2,6,5,7,23,0.3043478260869565,2,9,0.2222222222222222,5,14,0.3571428571428571,0.348,5,7,0.7142857142857143
Daequan Cook,cookda02,SG,22,MIA,2010,45,691.0,223,43,9,73,82,14,10,24,50,81,253,0.3201581027667984,40,126,0.3174603174603174,41,127,0.3228346456692913,0.399,21,25,0.84
Jamal Crawford,crawfja01,SG,29,ATL,2010,79,2460.0,1425,238,34,167,201,61,12,137,132,496,1105,0.448868778280543,163,427,0.3817330210772833,333,678,0.4911504424778761,0.523,270,315,0.8571428571428571
Dante Cunningham,cunnida01,PF,22,POR,2010,63,707.0,243,14,54,106,160,24,22,15,97,106,214,0.4953271028037383,0,2,0.0,106,212,0.5,0.495,31,48,0.6458333333333334
Eddy Curry,curryed01,C,27,NYK,2010,7,62.0,26,0,4,9,13,0,1,13,13,8,21,0.3809523809523809,0,0,0.0,8,21,0.3809523809523809,0.381,10,17,0.5882352941176471
JamesOn Curry,curryja01,PG,24,LAC,2010,1,0.0,0,0,0,0,0,0,0,0,0,0,0,0.0,0,0,0.0,0,0,0.0,0.0,0,0,0.0
Stephen Curry,curryst01,PG,21,GSW,2010,80,2896.0,1399,472,48,308,356,152,19,243,252,528,1143,0.4619422572178477,166,380,0.4368421052631579,362,763,0.4744429882044561,0.535,177,200,0.885
Samuel Dalembert,dalemsa01,C,28,PHI,2010,82,2124.0,667,64,239,545,784,42,151,123,252,285,523,0.5449330783938815,0,0,0.0,285,523,0.5449330783938815,0.545,97,133,0.7293233082706767
Erick Dampier,dampier01,C,34,DAL,2010,55,1280.0,328,31,128,272,400,15,77,61,153,133,213,0.6244131455399061,1,3,0.3333333333333333,132,210,0.6285714285714286,0.627,61,101,0.6039603960396039
Marquis Daniels,daniema01,SF,29,BOS,2010,51,937.0,288,66,27,68,95,27,6,42,91,124,249,0.4979919678714859,6,28,0.2142857142857142,118,221,0.5339366515837104,0.51,34,56,0.6071428571428571
Baron Davis,davisba01,PG,30,LAC,2010,75,2523.0,1145,598,52,214,266,126,43,211,210,412,1015,0.4059113300492611,82,296,0.277027027027027,330,719,0.4589707927677329,0.446,239,291,0.8213058419243986
Glen Davis,davisgl01,PF,24,BOS,2010,54,933.0,340,35,101,104,205,21,14,53,132,122,279,0.4372759856630824,0,4,0.0,122,275,0.4436363636363636,0.437,96,138,0.6956521739130435
Paul Davis,davispa01,PF,25,WAS,2010,2,8.0,5,3,0,0,0,0,1,0,0,2,4,0.5,0,0,0.0,2,4,0.5,0.5,1,2,0.5
Ricky Davis,davisri01,SF,30,LAC,2010,36,499.0,158,39,10,47,57,11,3,29,39,62,143,0.4335664335664335,16,42,0.3809523809523809,46,101,0.4554455445544554,0.49,18,31,0.5806451612903226
Austin Daye,dayeau01,SF,21,DET,2010,69,915.0,349,34,34,140,174,25,26,48,114,137,295,0.4644067796610169,29,95,0.3052631578947368,108,200,0.54,0.514,46,56,0.8214285714285714
Carlos Delfino,delfica01,SF,27,MIL,2010,75,2279.0,825,202,51,343,394,80,21,119,138,299,732,0.4084699453551912,134,365,0.3671232876712328,165,367,0.4495912806539509,0.5,93,119,0.7815126050420168
Luol Deng,denglu01,SF,24,CHI,2010,70,2651.0,1230,143,131,381,512,66,61,134,129,473,1014,0.4664694280078895,32,83,0.3855421686746988,441,931,0.4736842105263157,0.482,252,330,0.7636363636363637
DeMar DeRozan,derozde01,SG,20,TOR,2010,77,1664.0,662,53,66,157,223,43,18,62,176,255,512,0.498046875,4,16,0.25,251,496,0.5060483870967742,0.502,148,194,0.7628865979381443
Boris Diaw,diawbo01,PF,27,CHA,2010,82,2906.0,925,325,131,293,424,60,57,178,219,373,773,0.482535575679172,66,206,0.3203883495145631,307,567,0.5414462081128748,0.525,113,147,0.7687074829931972
Yakhouba Diawara,diawaya01,SG,27,MIA,2010,6,44.0,5,3,1,3,4,1,0,3,8,2,10,0.2,1,6,0.1666666666666666,1,4,0.25,0.25,0,0,0.0
Travis Diener,dienetr01,PG,27,TOT,2010,9,51.0,6,8,0,3,3,4,0,0,2,2,10,0.2,1,7,0.1428571428571428,1,3,0.3333333333333333,0.25,1,4,0.25
DeSagana Diop,diopde01,C,28,CHA,2010,27,262.0,32,5,24,41,65,5,14,12,31,15,29,0.5172413793103449,0,0,0.0,15,29,0.5172413793103449,0.517,2,9,0.2222222222222222
Keyon Dooling,doolike01,PG,29,NJN,2010,53,971.0,364,135,8,46,54,34,0,59,82,129,324,0.3981481481481481,59,157,0.375796178343949,70,167,0.4191616766467065,0.489,47,61,0.7704918032786885
Joey Dorsey,dorsejo01,PF,26,TOT,2010,15,106.0,23,2,16,27,43,3,2,6,21,9,20,0.45,0,0,0.0,9,20,0.45,0.45,5,12,0.4166666666666667
Toney Douglas,douglto01,PG,23,NYK,2010,56,1087.0,481,112,40,68,108,42,3,55,116,179,391,0.4578005115089514,68,175,0.3885714285714285,111,216,0.5138888888888888,0.545,55,68,0.8088235294117647
Chris Douglas-Roberts,douglch01,SF,23,NJN,2010,67,1730.0,657,93,45,153,198,55,19,97,101,255,573,0.4450261780104712,14,54,0.2592592592592592,241,519,0.464354527938343,0.457,133,157,0.8471337579617835
Goran Dragić,dragigo01,PG,23,PHO,2010,80,1442.0,635,241,38,133,171,48,8,126,131,222,491,0.4521384928716904,74,188,0.3936170212765957,148,303,0.4884488448844885,0.527,117,159,0.7358490566037735
Jared Dudley,dudleja01,SF,24,PHO,2010,82,1991.0,674,115,99,182,281,81,16,68,162,225,490,0.4591836734693877,120,262,0.4580152671755725,105,228,0.4605263157894737,0.582,104,138,0.7536231884057971
Chris Duhon,duhonch01,PG,27,NYK,2010,67,2072.0,494,378,28,150,178,59,3,110,83,168,451,0.3725055432372505,90,258,0.3488372093023256,78,193,0.4041450777202072,0.472,68,95,0.7157894736842105
Tim Duncan,duncati01,C,33,SAS,2010,78,2438.0,1395,246,221,567,788,45,117,140,152,561,1082,0.5184842883548983,2,11,0.1818181818181818,559,1071,0.5219421101774043,0.519,271,374,0.7245989304812834
Mike Dunleavy,dunlemi02,SF,29,IND,2010,67,1486.0,666,103,25,211,236,38,15,72,105,229,558,0.4103942652329749,75,236,0.3177966101694915,154,322,0.4782608695652174,0.478,133,158,0.8417721518987342
Kevin Durant,duranke01,SF,21,OKC,2010,82,3239.0,2472,231,105,518,623,112,84,271,171,794,1668,0.4760191846522781,128,351,0.3646723646723647,666,1317,0.5056947608200456,0.514,756,840,0.9
Wayne Ellington,ellinwa01,SG,22,MIN,2010,76,1384.0,505,74,33,126,159,20,5,74,72,190,448,0.4241071428571428,64,162,0.3950617283950617,126,286,0.4405594405594406,0.496,61,70,0.8714285714285714
Monta Ellis,ellismo01,SG,24,GSW,2010,64,2647.0,1631,340,47,210,257,143,25,244,189,631,1406,0.4487908961593172,77,228,0.337719298245614,554,1178,0.4702886247877759,0.476,292,388,0.7525773195876289
Francisco Elson,elsonfr01,C,33,TOT,2010,12,66.0,12,2,6,8,14,1,0,1,7,5,15,0.3333333333333333,0,0,0.0,5,15,0.3333333333333333,0.333,2,5,0.4
Maurice Evans,evansma01,SF,31,ATL,2010,79,1317.0,453,48,59,95,154,34,17,20,125,175,393,0.4452926208651399,57,169,0.3372781065088757,118,224,0.5267857142857143,0.518,46,61,0.7540983606557377
Reggie Evans,evansre01,PF,29,TOR,2010,28,311.0,95,8,30,75,105,14,4,22,44,34,69,0.4927536231884058,0,0,0.0,34,69,0.4927536231884058,0.493,27,60,0.45
Tyreke Evans,evansty01,SG,20,SAC,2010,72,2677.0,1450,414,66,314,380,109,26,216,204,533,1165,0.4575107296137339,36,141,0.2553191489361702,497,1024,0.4853515625,0.473,348,465,0.7483870967741936
Jordan Farmar,farmajo01,PG,23,LAL,2010,82,1474.0,591,127,14,117,131,52,11,72,109,224,515,0.4349514563106796,86,229,0.3755458515283842,138,286,0.4825174825174825,0.518,57,85,0.6705882352941176
Raymond Felton,feltora01,PG,25,CHA,2010,80,2643.0,968,446,53,235,288,123,22,168,172,388,846,0.458628841607565,60,156,0.3846153846153846,328,690,0.4753623188405797,0.494,132,173,0.7630057803468208
Rudy Fernández,fernaru01,SG,24,POR,2010,62,1441.0,503,127,35,129,164,62,11,72,87,160,423,0.3782505910165484,98,266,0.3684210526315789,62,157,0.3949044585987261,0.494,85,98,0.8673469387755102
Kyrylo Fesenko,fesenky01,C,23,UTA,2010,49,408.0,128,15,33,57,90,6,19,24,78,52,95,0.5473684210526316,0,1,0.0,52,94,0.5531914893617021,0.547,24,57,0.4210526315789473
Michael Finley,finlemi01,SF,36,TOT,2010,46,709.0,202,43,6,65,71,10,6,21,33,81,184,0.4402173913043478,32,82,0.3902439024390244,49,102,0.4803921568627451,0.527,8,15,0.5333333333333333
Derek Fisher,fishede01,PG,35,LAL,2010,82,2227.0,615,201,25,145,170,90,9,78,202,212,558,0.3799283154121863,78,224,0.3482142857142857,134,334,0.4011976047904191,0.45,113,132,0.8560606060606061
Jonny Flynn,flynnjo01,PG,20,MIN,2010,81,2339.0,1094,356,24,167,191,82,2,233,98,397,952,0.4170168067226891,77,215,0.3581395348837209,320,737,0.4341926729986431,0.457,223,270,0.825925925925926
T.J. Ford,fordtj01,PG,26,IND,2010,47,1189.0,484,180,41,108,149,44,11,90,102,186,418,0.4449760765550239,8,50,0.16,178,368,0.483695652173913,0.455,104,135,0.7703703703703704
Jeff Foster,fosteje01,C,33,IND,2010,16,255.0,49,21,34,47,81,3,4,14,45,22,46,0.4782608695652174,0,1,0.0,22,45,0.4888888888888889,0.478,5,9,0.5555555555555556
Randy Foye,foyera01,PG,26,WAS,2010,70,1667.0,704,228,16,114,130,33,10,94,123,256,619,0.4135702746365105,63,182,0.3461538461538461,193,437,0.4416475972540046,0.464,129,145,0.8896551724137931
Channing Frye,fryech01,C,26,PHO,2010,81,2190.0,904,113,66,361,427,64,74,73,263,317,703,0.4509246088193456,172,392,0.4387755102040816,145,311,0.4662379421221865,0.573,98,121,0.8099173553719008
Dan Gadzuric,gadzuda01,C,31,MIL,2010,32,314.0,88,12,38,54,92,9,13,15,63,39,89,0.4382022471910112,0,0,0.0,39,89,0.4382022471910112,0.438,10,25,0.4
Sundiata Gaines,gainesu01,PG,23,UTA,2010,32,217.0,106,39,6,23,29,12,0,14,17,38,82,0.4634146341463415,7,26,0.2692307692307692,31,56,0.5535714285714286,0.506,23,46,0.5
Danilo Gallinari,gallida01,SF,21,NYK,2010,81,2747.0,1221,135,65,333,398,75,58,110,191,392,927,0.4228694714131607,186,488,0.3811475409836065,206,439,0.4692482915717539,0.523,251,307,0.8175895765472313
Francisco García,garcifr01,SG,28,SAC,2010,25,575.0,202,45,11,55,66,10,19,21,49,82,176,0.4659090909090909,23,59,0.3898305084745763,59,117,0.5042735042735043,0.531,15,17,0.8823529411764706
Kevin Garnett,garneke01,PF,33,BOS,2010,69,2060.0,990,185,78,428,506,68,57,101,170,402,772,0.5207253886010362,1,5,0.2,401,767,0.5228161668839635,0.521,185,221,0.8371040723981901
Marc Gasol,gasolma01,C,25,MEM,2010,69,2469.0,1008,165,208,432,640,69,109,135,254,378,651,0.5806451612903226,0,1,0.0,378,650,0.5815384615384616,0.581,252,376,0.6702127659574468
Pau Gasol,gasolpa01,C,29,LAL,2010,65,2403.0,1190,218,243,491,734,37,113,143,152,452,844,0.5355450236966824,0,5,0.0,452,839,0.5387365911799762,0.536,286,362,0.7900552486187845
Rudy Gay,gayru01,SF,23,MEM,2010,80,3175.0,1567,153,115,357,472,118,64,169,201,600,1288,0.4658385093167702,66,202,0.3267326732673267,534,1086,0.4917127071823204,0.491,301,400,0.7525
Alonzo Gee,geeal01,SG,22,WAS,2010,11,182.0,81,7,15,18,33,7,1,10,13,28,59,0.4745762711864407,7,9,0.7777777777777778,21,50,0.42,0.534,18,29,0.6206896551724138
Devean George,georgde01,SF,32,GSW,2010,45,761.0,242,32,21,93,114,41,10,15,89,89,206,0.4320388349514563,48,123,0.3902439024390244,41,83,0.4939759036144578,0.549,16,23,0.6956521739130435
Daniel Gibson,gibsoda01,PG,23,CLE,2010,56,1068.0,355,70,13,60,73,25,7,36,79,125,268,0.4664179104477612,71,149,0.4765100671140939,54,119,0.453781512605042,0.599,34,49,0.6938775510204082
Taj Gibson,gibsota01,PF,24,CHI,2010,82,2204.0,735,70,226,385,611,50,104,114,282,311,629,0.4944356120826709,0,0,0.0,311,629,0.4944356120826709,0.494,113,175,0.6457142857142857
J.R. Giddens,giddejr01,SF,24,TOT,2010,32,239.0,69,13,16,35,51,9,2,17,29,28,60,0.4666666666666667,0,10,0.0,28,50,0.56,0.467,13,23,0.5652173913043478
Trey Gilder,gildetr01,SF,25,MEM,2010,2,5.0,2,0,0,1,1,1,0,0,0,1,1,1.0,0,0,0.0,1,1,1.0,1.0,0,0,0.0
Manu Ginóbili,ginobma01,SG,32,SAS,2010,75,2150.0,1237,370,68,216,284,103,24,154,154,398,903,0.4407530454042082,132,350,0.3771428571428571,266,553,0.4810126582278481,0.514,309,355,0.8704225352112676
Ryan Gomes,gomesry01,SF,27,MIN,2010,76,2210.0,832,124,76,272,348,62,16,95,155,327,732,0.4467213114754098,74,199,0.371859296482412,253,533,0.474671669793621,0.497,104,126,0.8253968253968254
Drew Gooden,goodedr01,C-PF,28,TOT,2010,70,1755.0,763,47,207,335,542,41,58,108,194,288,602,0.4784053156146179,1,8,0.125,287,594,0.4831649831649832,0.479,186,216,0.8611111111111112
Ben Gordon,gordobe01,SG,26,DET,2010,62,1730.0,855,166,26,93,119,49,6,118,147,291,699,0.4163090128755364,75,234,0.3205128205128205,216,465,0.4645161290322581,0.47,198,230,0.8608695652173913
Eric Gordon,gordoer01,SG,21,LAC,2010,62,2229.0,1045,186,25,135,160,69,14,144,96,352,784,0.4489795918367347,119,321,0.3707165109034268,233,463,0.5032397408207343,0.525,222,299,0.7424749163879598
Marcin Gortat,gortama01,C,25,ORL,2010,81,1088.0,293,17,104,237,341,17,70,46,138,121,227,0.5330396475770925,0,3,0.0,121,224,0.5401785714285714,0.533,51,75,0.68
Joey Graham,grahajo01,SF,27,DEN,2010,63,759.0,266,22,39,84,123,23,7,43,104,105,202,0.5198019801980198,2,13,0.1538461538461538,103,189,0.544973544973545,0.525,54,73,0.7397260273972602
Stephen Graham,grahast01,SG,27,CHA,2010,70,804.0,296,23,24,111,135,20,10,36,94,119,240,0.4958333333333333,16,50,0.32,103,190,0.5421052631578948,0.529,42,65,0.6461538461538462
Danny Granger,grangda01,SF,26,IND,2010,62,2278.0,1497,171,67,275,342,94,51,157,183,488,1139,0.4284460052677787,158,438,0.3607305936073059,330,701,0.470756062767475,0.498,363,428,0.8481308411214953
Aaron Gray,grayaa01,C,25,TOT,2010,32,311.0,104,22,45,61,106,9,11,18,54,42,82,0.5121951219512195,0,0,0.0,42,82,0.5121951219512195,0.512,20,28,0.7142857142857143
Danny Green,greenda02,SG,22,CLE,2010,20,115.0,40,5,8,9,17,6,3,5,9,15,39,0.3846153846153846,6,22,0.2727272727272727,9,17,0.5294117647058824,0.462,4,6,0.6666666666666666
Jeff Green,greenje02,PF,23,OKC,2010,82,3043.0,1239,134,112,378,490,104,72,135,221,485,1070,0.4532710280373832,104,312,0.3333333333333333,381,758,0.5026385224274407,0.502,165,223,0.7399103139013453
Willie Green,greenwi01,SG,28,PHI,2010,73,1553.0,638,152,20,109,129,32,11,67,135,248,543,0.4567219152854512,47,136,0.3455882352941176,201,407,0.4938574938574938,0.5,95,114,0.8333333333333334
Donté Greene,greendo01,SF,21,SAC,2010,76,1630.0,647,71,53,181,234,41,53,93,150,244,553,0.4412296564195298,69,183,0.3770491803278688,175,370,0.4729729729729729,0.504,90,140,0.6428571428571429
Taylor Griffin,griffta01,SF,23,PHO,2010,8,32.0,10,1,0,2,2,0,2,1,4,4,10,0.4,0,2,0.0,4,8,0.5,0.4,2,4,0.5
Hamed Haddadi,haddaha01,C,24,MEM,2010,36,240.0,62,10,26,49,75,1,14,20,57,24,62,0.3870967741935484,0,3,0.0,24,59,0.4067796610169492,0.387,14,19,0.7368421052631579
Malik Hairston,hairsma01,SG,22,SAS,2010,47,317.0,99,16,13,36,49,4,9,11,29,40,76,0.5263157894736842,2,11,0.1818181818181818,38,65,0.5846153846153846,0.539,17,30,0.5666666666666667
Marcus Haislip,haislma01,SF,29,SAS,2010,10,44.0,25,0,4,6,10,0,2,3,5,10,21,0.4761904761904761,3,5,0.6,7,16,0.4375,0.548,2,5,0.4
Richard Hamilton,hamilri01,SG,31,DET,2010,46,1552.0,831,202,30,92,122,30,3,115,115,293,717,0.4086471408647141,41,138,0.2971014492753623,252,579,0.4352331606217616,0.437,204,241,0.8464730290456431
Tyler Hansbrough,hansbty01,PF,24,IND,2010,29,511.0,246,28,60,78,138,17,8,21,70,81,225,0.36,0,4,0.0,81,221,0.3665158371040724,0.36,84,113,0.7433628318584071
James Harden,hardeja01,SG,20,OKC,2010,76,1738.0,753,137,47,197,244,80,20,106,200,233,578,0.4031141868512111,93,248,0.375,140,330,0.4242424242424242,0.484,194,240,0.8083333333333333
Al Harrington,harrial01,PF,29,NYK,2010,72,2195.0,1276,110,88,317,405,62,26,132,209,448,1030,0.4349514563106796,140,409,0.3422982885085575,308,621,0.4959742351046698,0.503,240,317,0.7570977917981072
Devin Harris,harride01,PG,26,NJN,2010,64,2221.0,1080,423,24,179,203,79,18,181,178,356,884,0.4027149321266968,60,217,0.2764976958525346,296,667,0.4437781109445277,0.437,308,386,0.7979274611398963
Mike Harris,harrimi01,PF,26,TOT,2010,13,96.0,29,3,10,14,24,5,1,9,14,11,30,0.3666666666666666,0,1,0.0,11,29,0.3793103448275862,0.367,7,11,0.6363636363636364
Jason Hart,hartja01,PG,31,TOT,2010,5,22.0,2,6,0,2,2,2,1,3,4,1,2,0.5,0,0,0.0,1,2,0.5,0.5,0,0,0.0
Udonis Haslem,hasleud01,PF,29,MIA,2010,78,2177.0,771,52,167,462,629,30,23,75,174,312,632,0.4936708860759494,0,0,0.0,312,632,0.4936708860759494,0.494,147,193,0.7616580310880829
Trenton Hassell,hassetr01,SF,30,NJN,2010,52,1106.0,232,50,56,96,152,17,9,47,91,90,219,0.410958904109589,0,5,0.0,90,214,0.4205607476635514,0.411,52,69,0.7536231884057971
Spencer Hawes,hawessp01,C,21,SAC,2010,72,1904.0,723,158,145,291,436,32,83,131,200,312,666,0.4684684684684684,26,87,0.2988505747126437,286,579,0.4939550949913644,0.488,73,106,0.6886792452830188
Chuck Hayes,hayesch01,C,26,HOU,2010,82,1773.0,358,139,151,314,465,73,43,74,219,161,329,0.4893617021276595,0,0,0.0,161,329,0.4893617021276595,0.489,36,66,0.5454545454545454
Jarvis Hayes,hayesja01,SF,28,NJN,2010,45,1033.0,350,40,9,99,108,29,9,28,91,138,328,0.4207317073170731,60,179,0.3351955307262569,78,149,0.5234899328859061,0.512,14,18,0.7777777777777778
Brendan Haywood,haywobr01,C,30,TOT,2010,77,2355.0,704,43,278,437,715,26,158,99,209,276,491,0.5621181262729125,0,1,0.0,276,490,0.563265306122449,0.562,152,245,0.6204081632653061
Luther Head,headlu01,SG,27,IND,2010,47,813.0,357,72,6,74,80,18,9,54,53,136,311,0.4372990353697749,37,105,0.3523809523809524,99,206,0.4805825242718446,0.497,48,58,0.8275862068965517
Gerald Henderson,hendege02,SG,22,CHA,2010,43,355.0,113,13,15,40,55,10,9,14,25,37,104,0.3557692307692308,4,19,0.2105263157894736,33,85,0.388235294117647,0.375,35,47,0.7446808510638298
Roy Hibbert,hibbero01,C,23,IND,2010,81,2035.0,946,158,177,287,464,30,131,145,285,387,782,0.4948849104859335,3,6,0.5,384,776,0.4948453608247423,0.497,169,224,0.7544642857142857
J.J. Hickson,hicksjj01,PF,21,CLE,2010,81,1691.0,689,40,110,290,400,36,39,92,132,289,522,0.553639846743295,0,1,0.0,289,521,0.5547024952015355,0.554,111,163,0.6809815950920245
Nenê,hilarne01,C,27,DEN,2010,82,2755.0,1135,203,166,461,627,115,82,125,281,421,717,0.5871687587168759,0,2,0.0,421,715,0.5888111888111888,0.587,293,416,0.7043269230769231
George Hill,hillge01,PG,23,SAS,2010,78,2276.0,964,226,42,163,205,69,26,101,222,353,738,0.4783197831978319,75,188,0.3989361702127659,278,550,0.5054545454545455,0.529,183,237,0.7721518987341772
Grant Hill,hillgr01,SF,37,PHO,2010,81,2430.0,912,193,74,371,445,60,36,108,165,336,703,0.4779516358463727,35,80,0.4375,301,623,0.4831460674157303,0.503,205,251,0.8167330677290837
Jordan Hill,hilljo01,PF,22,TOT,2010,47,624.0,244,20,76,99,175,14,21,30,92,99,201,0.4925373134328358,0,2,0.0,99,199,0.4974874371859296,0.493,46,68,0.6764705882352942
Kirk Hinrich,hinriki01,SG,29,CHI,2010,74,2481.0,805,330,24,236,260,85,24,113,204,308,753,0.4090305444887118,104,280,0.3714285714285714,204,473,0.4312896405919662,0.478,85,113,0.7522123893805309
Jrue Holiday,holidjr01,PG,19,PHI,2010,73,1767.0,587,280,56,135,191,79,18,156,153,230,520,0.4423076923076923,62,159,0.389937106918239,168,361,0.4653739612188365,0.502,65,86,0.7558139534883721
Ryan Hollins,holliry01,C,25,MIN,2010,73,1223.0,447,51,79,128,207,19,38,95,199,169,303,0.5577557755775577,0,1,0.0,169,302,0.5596026490066225,0.558,109,158,0.689873417721519
Al Horford,horfoal01,C,23,ATL,2010,81,2845.0,1148,189,236,563,799,59,91,122,225,467,847,0.551357733175915,1,1,1.0,466,846,0.5508274231678487,0.552,213,270,0.7888888888888889
Eddie House,houseed01,PG-SG,31,TOT,2010,68,1217.0,473,85,13,96,109,40,7,47,81,173,455,0.3802197802197802,79,227,0.3480176211453744,94,228,0.4122807017543859,0.467,48,52,0.9230769230769232
Dwight Howard,howardw01,C,24,ORL,2010,82,2843.0,1503,144,284,798,1082,75,228,274,287,510,834,0.6115107913669064,0,7,0.0,510,827,0.6166868198307134,0.612,483,816,0.5919117647058824
Josh Howard,howarjo01,SF,29,TOT,2010,35,918.0,446,48,30,95,125,26,11,46,91,157,388,0.4046391752577319,23,86,0.2674418604651162,134,302,0.4437086092715231,0.434,109,139,0.7841726618705036
Juwan Howard,howarju01,C,36,POR,2010,73,1632.0,437,61,108,227,335,27,10,72,191,191,375,0.5093333333333333,0,1,0.0,191,374,0.5106951871657754,0.509,55,70,0.7857142857142857
Lester Hudson,hudsole01,PG,25,TOT,2010,25,131.0,58,13,7,11,18,8,3,14,12,21,53,0.3962264150943396,5,16,0.3125,16,37,0.4324324324324324,0.443,11,13,0.8461538461538461
Larry Hughes,hughela01,SG,31,TOT,2010,45,1115.0,411,137,23,119,142,52,15,75,70,137,386,0.3549222797927461,43,139,0.3093525179856115,94,247,0.3805668016194332,0.411,94,113,0.831858407079646
Kris Humphries,humphkr01,PF,24,TOT,2010,69,1221.0,487,32,120,258,378,36,48,66,145,180,408,0.4411764705882353,0,1,0.0,180,407,0.4422604422604422,0.441,127,190,0.6684210526315789
Chris Hunter,huntech01,C,25,GSW,2010,60,783.0,270,37,56,111,167,13,35,30,132,109,217,0.5023041474654378,0,4,0.0,109,213,0.5117370892018779,0.502,52,69,0.7536231884057971
Lindsey Hunter,hunteli01,PG,39,CHI,2010,13,122.0,13,9,1,13,14,1,0,4,12,5,30,0.1666666666666666,1,13,0.0769230769230769,4,17,0.2352941176470588,0.183,2,2,1.0
Othello Hunter,hunteot01,SF,23,ATL,2010,7,33.0,11,0,6,6,12,0,1,3,5,4,12,0.3333333333333333,0,0,0.0,4,12,0.3333333333333333,0.333,3,4,0.75
Steven Hunter,huntest01,C,28,MEM,2010,21,158.0,53,0,18,24,42,1,10,9,10,17,43,0.3953488372093023,0,0,0.0,17,43,0.3953488372093023,0.395,19,36,0.5277777777777778
Serge Ibaka,ibakase01,PF,20,OKC,2010,73,1323.0,461,10,138,259,397,25,97,68,194,201,370,0.5432432432432432,1,2,0.5,200,368,0.5434782608695652,0.545,58,92,0.6304347826086957
Andre Iguodala,iguodan01,SF,26,PHI,2010,82,3193.0,1401,472,82,447,529,141,55,218,145,496,1120,0.4428571428571428,94,303,0.3102310231023102,402,817,0.4920440636474908,0.485,315,430,0.7325581395348837
Zydrunas Ilgauskas,ilgauzy01,C,34,CLE,2010,64,1339.0,474,48,114,231,345,14,50,63,183,194,438,0.4429223744292237,11,23,0.4782608695652174,183,415,0.4409638554216867,0.455,75,101,0.7425742574257426
D.J. Mbenga,mbengdj01,C,29,LAL,2010,49,355.0,105,8,32,55,87,5,29,15,54,48,103,0.4660194174757281,0,0,0.0,48,103,0.4660194174757281,0.466,9,19,0.4736842105263157
Ersan İlyasova,ilyaser01,PF,22,MIL,2010,81,1898.0,840,84,157,360,517,53,23,71,251,323,729,0.4430727023319616,81,241,0.3360995850622407,242,488,0.4959016393442623,0.499,113,158,0.7151898734177216
Allen Iverson,iversal01,SG-PG,34,TOT,2010,28,865.0,385,113,16,63,79,19,2,64,48,136,316,0.430379746835443,9,25,0.36,127,291,0.436426116838488,0.445,104,131,0.7938931297709924
Royal Ivey,iveyro01,SG,28,TOT,2010,44,326.0,93,27,6,28,34,19,2,11,39,35,83,0.4216867469879518,14,35,0.4,21,48,0.4375,0.506,9,12,0.75
Jarrett Jack,jackja01,PG,26,TOR,2010,82,2243.0,931,413,30,192,222,60,6,163,151,323,671,0.481371087928465,82,199,0.4120603015075377,241,472,0.510593220338983,0.542,203,241,0.8423236514522822
Cedric Jackson,jacksce01,PG,23,TOT,2010,12,74.0,20,14,2,6,8,3,2,11,7,6,20,0.3,1,6,0.1666666666666666,5,14,0.3571428571428571,0.325,7,12,0.5833333333333334
Darnell Jackson,jacksda01,PF,24,TOT,2010,28,123.0,23,4,9,13,22,2,4,13,21,9,30,0.3,1,4,0.25,8,26,0.3076923076923077,0.317,4,6,0.6666666666666666
Stephen Jackson,jacksst02,SG-PF,31,TOT,2010,81,3129.0,1667,300,78,323,401,132,43,259,197,600,1418,0.4231311706629055,129,393,0.3282442748091603,471,1025,0.4595121951219512,0.469,338,434,0.7788018433179723
LeBron James,jamesle01,SF,25,CLE,2010,76,2966.0,2258,651,71,483,554,125,77,261,119,768,1528,0.5026178010471204,129,387,0.3333333333333333,639,1141,0.5600350569675723,0.545,593,773,0.7671410090556274
Mike James,jamesmi01,PG,34,WAS,2010,4,46.0,18,5,1,2,3,3,0,5,3,6,20,0.3,2,6,0.3333333333333333,4,14,0.2857142857142857,0.35,4,8,0.5
Antawn Jamison,jamisan01,PF,33,TOT,2010,66,2406.0,1235,84,136,419,555,71,21,91,179,478,1036,0.4613899613899614,85,247,0.3441295546558704,393,789,0.4980988593155893,0.502,194,300,0.6466666666666666
Nathan Jawai,jawaina01,C,23,MIN,2010,39,412.0,124,24,49,55,104,10,9,27,58,49,111,0.4414414414414414,0,1,0.0,49,110,0.4454545454545454,0.441,26,38,0.6842105263157895
Othyus Jeffers,jeffeot01,SG,24,UTA,2010,14,73.0,37,1,8,11,19,4,0,6,10,12,29,0.4137931034482758,0,0,0.0,12,29,0.4137931034482758,0.414,13,19,0.6842105263157895
Al Jefferson,jeffeal01,C,25,MIN,2010,76,2463.0,1301,137,180,523,703,63,98,136,205,560,1125,0.4977777777777777,0,4,0.0,560,1121,0.4995539696699375,0.498,181,266,0.6804511278195489
Richard Jefferson,jefferi01,SF,29,SAS,2010,81,2520.0,994,158,58,298,356,45,40,105,178,362,775,0.4670967741935484,59,187,0.3155080213903743,303,588,0.5153061224489796,0.505,211,287,0.735191637630662
Jared Jeffries,jeffrja01,PF-SF,28,TOT,2010,70,1794.0,372,101,130,158,288,62,71,76,203,138,314,0.4394904458598726,21,71,0.2957746478873239,117,243,0.4814814814814814,0.473,75,120,0.625
Brandon Jennings,jennibr01,PG,20,MIL,2010,82,2671.0,1270,470,49,233,282,105,18,200,191,451,1216,0.3708881578947368,145,388,0.3737113402061855,306,828,0.3695652173913043,0.431,223,273,0.8168498168498168
Jonas Jerebko,jerebjo01,PF,22,DET,2010,80,2232.0,741,58,194,284,478,79,29,82,230,290,603,0.4809286898839137,36,115,0.3130434782608696,254,488,0.5204918032786885,0.511,125,176,0.7102272727272727
Yi Jianlian,jianlyi01,PF,22,NJN,2010,52,1655.0,623,47,115,257,372,37,52,77,170,227,563,0.4031971580817051,15,41,0.3658536585365853,212,522,0.4061302681992337,0.417,154,193,0.7979274611398963
Amir Johnson,johnsam01,PF,22,TOR,2010,82,1453.0,511,48,154,241,395,44,66,63,255,208,334,0.6227544910179641,0,4,0.0,208,330,0.6303030303030303,0.623,95,149,0.6375838926174496
Anthony Johnson,johnsan02,PG,35,ORL,2010,31,406.0,130,63,8,40,48,11,1,26,32,49,111,0.4414414414414414,13,39,0.3333333333333333,36,72,0.5,0.5,19,20,0.95
James Johnson,johnsja01,PF,22,CHI,2010,65,757.0,256,48,34,94,128,21,43,62,126,95,210,0.4523809523809524,15,46,0.3260869565217391,80,164,0.4878048780487805,0.488,51,70,0.7285714285714285
Joe Johnson,johnsjo02,SG,28,ATL,2010,76,2886.0,1619,369,74,279,353,82,5,145,145,635,1386,0.4581529581529581,129,350,0.3685714285714285,506,1036,0.4884169884169884,0.505,220,269,0.8178438661710037
Dahntay Jones,jonesda02,SF,29,IND,2010,76,1892.0,776,150,48,181,229,40,39,129,237,287,623,0.4606741573033708,4,32,0.125,283,591,0.4788494077834179,0.464,198,257,0.7704280155642024
Dwayne Jones,jonesdw02,PF,26,PHO,2010,2,7.0,0,0,0,2,2,0,0,0,1,0,0,0.0,0,0,0.0,0,0,0.0,0.0,0,0,0.0
James Jones,jonesja02,SF,29,MIA,2010,36,503.0,146,17,4,41,45,11,4,11,45,43,119,0.361344537815126,37,90,0.4111111111111111,6,29,0.2068965517241379,0.517,23,28,0.8214285714285714
Solomon Jones,jonesso01,C,25,IND,2010,52,675.0,207,32,51,93,144,14,37,40,125,78,176,0.4431818181818182,0,3,0.0,78,173,0.4508670520231214,0.443,51,71,0.7183098591549296
DeAndre Jordan,jordade01,C,21,LAC,2010,70,1137.0,336,21,122,230,352,16,62,75,152,144,238,0.6050420168067226,0,2,0.0,144,236,0.6101694915254238,0.605,48,128,0.375
Chris Kaman,kamanch01,C,27,LAC,2010,76,2608.0,1408,120,184,520,704,37,94,223,213,589,1202,0.4900166389351081,0,6,0.0,589,1196,0.4924749163879598,0.49,230,307,0.749185667752443
Jason Kapono,kaponja01,SF,28,PHI,2010,57,976.0,324,39,14,52,66,21,6,34,80,126,301,0.4186046511627907,63,171,0.3684210526315789,63,130,0.4846153846153846,0.523,9,15,0.6
Coby Karl,karlco01,SF-SG,26,TOT,2010,7,113.0,28,15,4,14,18,3,1,10,14,11,32,0.34375,2,11,0.1818181818181818,9,21,0.4285714285714285,0.375,4,6,0.6666666666666666
Jason Kidd,kiddja01,PG,36,DAL,2010,80,2881.0,824,724,48,397,445,145,35,195,142,284,671,0.4232488822652757,176,414,0.4251207729468599,108,257,0.4202334630350194,0.554,80,99,0.8080808080808081
Andrei Kirilenko,kirilan01,SF,28,UTA,2010,58,1681.0,688,158,76,188,264,83,71,79,102,244,482,0.5062240663900415,26,89,0.2921348314606741,218,393,0.55470737913486,0.533,174,234,0.7435897435897436
Kyle Korver,korveky01,SG,28,UTA,2010,52,952.0,374,89,10,101,111,26,12,42,76,138,280,0.4928571428571429,59,110,0.5363636363636364,79,170,0.4647058823529412,0.598,39,49,0.7959183673469388
Kosta Koufos,koufoko01,C,20,UTA,2010,36,172.0,53,6,16,29,45,2,4,15,26,22,47,0.4680851063829787,0,0,0.0,22,47,0.4680851063829787,0.468,9,15,0.6
Nenad Krstić,krstine01,C,26,OKC,2010,76,1741.0,639,52,134,249,383,32,45,58,177,281,560,0.5017857142857143,1,5,0.2,280,555,0.5045045045045045,0.503,76,106,0.7169811320754716
Oliver Lafayette,lafayol01,SG,25,BOS,2010,1,22.0,7,2,1,3,4,0,0,1,0,3,6,0.5,1,2,0.5,2,4,0.5,0.583,0,0,0.0
Carl Landry,landrca01,PF,26,TOT,2010,80,2469.0,1343,66,188,280,468,55,63,136,234,499,931,0.5359828141783028,1,3,0.3333333333333333,498,928,0.5366379310344828,0.537,344,427,0.8056206088992974
Marcus Landry,landrma01,SF,24,TOT,2010,18,111.0,44,0,5,14,19,1,2,6,14,16,43,0.3720930232558139,9,28,0.3214285714285714,7,15,0.4666666666666667,0.477,3,5,0.6
Acie Law,lawac01,PG,25,TOT,2010,26,234.0,113,26,3,14,17,11,1,17,16,35,75,0.4666666666666667,5,16,0.3125,30,59,0.5084745762711864,0.5,38,49,0.7755102040816326
Ty Lawson,lawsoty01,PG,22,DEN,2010,65,1318.0,542,203,42,82,124,48,2,82,89,201,390,0.5153846153846153,34,83,0.4096385542168674,167,307,0.5439739413680782,0.559,106,140,0.7571428571428571
Courtney Lee,leeco01,SG,24,NJN,2010,71,2375.0,885,121,60,192,252,93,20,76,130,338,775,0.4361290322580645,76,225,0.3377777777777778,262,550,0.4763636363636364,0.485,133,153,0.869281045751634
David Lee,leeda02,C,26,NYK,2010,81,3019.0,1640,295,228,721,949,85,40,189,257,686,1258,0.5453100158982512,0,8,0.0,686,1250,0.5488,0.545,268,330,0.8121212121212121
Rashard Lewis,lewisra02,PF,30,ORL,2010,72,2369.0,1013,107,62,256,318,78,28,108,180,350,805,0.4347826086956521,168,423,0.3971631205673759,182,382,0.4764397905759162,0.539,145,180,0.8055555555555556
Shaun Livingston,livinsh01,PG,24,TOT,2010,36,796.0,250,130,16,62,78,17,11,58,61,104,201,0.5174129353233831,0,6,0.0,104,195,0.5333333333333333,0.517,42,48,0.875
Brook Lopez,lopezbr01,C,21,NJN,2010,82,3027.0,1542,187,270,439,709,55,139,204,251,563,1129,0.4986713906111603,0,2,0.0,563,1127,0.4995563442768411,0.499,416,509,0.8172888015717092
Robin Lopez,lopezro01,C,21,PHO,2010,51,986.0,430,7,104,144,248,10,53,41,117,171,291,0.5876288659793815,0,0,0.0,171,291,0.5876288659793815,0.588,88,125,0.704
Kevin Love,loveke01,PF,21,MIN,2010,60,1714.0,842,136,227,431,658,43,23,117,136,291,646,0.4504643962848297,35,106,0.330188679245283,256,540,0.4740740740740741,0.478,225,276,0.8152173913043478
Kyle Lowry,lowryky01,PG,23,HOU,2010,68,1651.0,620,305,91,156,247,60,9,116,173,184,464,0.396551724137931,37,136,0.2720588235294117,147,328,0.4481707317073171,0.436,215,260,0.8269230769230769
Corey Maggette,maggeco01,PF,30,GSW,2010,70,2081.0,1387,172,92,281,373,51,4,168,231,457,886,0.5158013544018059,13,50,0.26,444,836,0.5311004784688995,0.523,460,551,0.8348457350272233
Jamaal Magloire,magloja01,C,31,MIA,2010,36,359.0,77,1,41,80,121,9,11,17,59,28,56,0.5,0,0,0.0,28,56,0.5,0.5,21,59,0.3559322033898305
Ian Mahinmi,mahinia01,C,23,SAS,2010,26,165.0,101,2,13,39,52,3,8,15,32,35,55,0.6363636363636364,0,0,0.0,35,55,0.6363636363636364,0.636,31,47,0.6595744680851063
Shawn Marion,mariosh01,SF,31,DAL,2010,75,2385.0,898,107,158,319,477,69,61,99,141,395,778,0.5077120822622108,3,19,0.1578947368421052,392,759,0.5164690382081687,0.51,105,139,0.7553956834532374
Sean Marks,marksse01,C,34,NOH,2010,14,75.0,10,2,14,9,23,0,3,2,17,4,8,0.5,0,0,0.0,4,8,0.5,0.5,2,5,0.4
Cartier Martin,martica01,SF,25,TOT,2010,18,390.0,141,16,25,43,68,11,1,19,48,50,136,0.3676470588235294,17,49,0.3469387755102041,33,87,0.3793103448275862,0.43,24,30,0.8
Kenyon Martin,martike01,PF,32,DEN,2010,58,1986.0,667,109,142,404,546,72,61,91,186,283,620,0.4564516129032258,8,29,0.2758620689655172,275,591,0.4653130287648054,0.463,93,167,0.5568862275449101
Kevin Martin,martike02,SG,26,TOT,2010,46,1633.0,946,111,29,135,164,46,6,92,96,289,693,0.417027417027417,70,210,0.3333333333333333,219,483,0.453416149068323,0.468,298,340,0.8764705882352941
Desmond Mason,masonde01,SF,32,SAC,2010,5,66.0,13,2,4,9,13,1,1,4,5,5,12,0.4166666666666667,0,0,0.0,5,12,0.4166666666666667,0.417,3,4,0.75
Roger Mason,masonro01,SG,29,SAS,2010,79,1515.0,501,137,11,151,162,30,14,59,99,193,496,0.3891129032258064,88,264,0.3333333333333333,105,232,0.4525862068965517,0.478,27,34,0.7941176470588235
Wesley Matthews,matthwe02,SG,23,UTA,2010,82,2025.0,769,124,50,141,191,64,15,93,152,273,565,0.4831858407079646,63,165,0.3818181818181818,210,400,0.525,0.539,160,193,0.8290155440414507
Jason Maxiell,maxieja01,C,26,DET,2010,76,1550.0,513,39,161,240,401,36,38,68,175,212,415,0.5108433734939759,0,1,0.0,212,414,0.5120772946859904,0.511,89,155,0.5741935483870968
Sean May,mayse01,C,25,SAC,2010,37,331.0,123,17,20,50,70,12,7,19,46,51,111,0.4594594594594595,0,4,0.0,51,107,0.4766355140186916,0.459,21,32,0.65625
Eric Maynor,maynoer01,PG,22,TOT,2010,81,1269.0,382,266,21,108,129,40,10,85,115,154,368,0.4184782608695652,22,71,0.3098591549295774,132,297,0.4444444444444444,0.448,52,72,0.7222222222222222
O.J. Mayo,mayooj01,SG,22,MEM,2010,82,3113.0,1432,242,61,250,311,98,17,176,174,542,1183,0.4581572273879966,136,355,0.3830985915492957,406,828,0.4903381642512077,0.516,212,262,0.8091603053435115
Luc Mbah a Moute,mbahalu01,PF,23,MIL,2010,73,1866.0,453,81,171,229,400,60,39,70,181,177,369,0.4796747967479675,6,17,0.3529411764705882,171,352,0.4857954545454545,0.488,93,133,0.6992481203007519
Antonio McDyess,mcdyean01,PF,35,SAS,2010,77,1617.0,446,83,149,306,455,43,32,79,147,205,428,0.4789719626168224,0,2,0.0,205,426,0.4812206572769953,0.479,36,57,0.631578947368421
JaVale McGee,mcgeeja01,C,22,WAS,2010,60,968.0,386,14,88,155,243,16,101,51,122,156,307,0.50814332247557,0,1,0.0,156,306,0.5098039215686274,0.508,74,116,0.6379310344827587
Tracy McGrady,mcgratr01,SG,30,TOT,2010,30,673.0,245,99,22,72,94,15,14,44,40,91,235,0.3872340425531915,16,64,0.25,75,171,0.4385964912280701,0.421,47,63,0.746031746031746
Dominic McGuire,mcguido01,SF,24,TOT,2010,51,307.0,38,11,23,56,79,5,4,17,35,19,52,0.3653846153846153,0,0,0.0,19,52,0.3653846153846153,0.365,0,7,0.0
Josh McRoberts,mcrobjo01,C,22,IND,2010,42,524.0,179,44,40,87,127,17,16,19,74,76,146,0.5205479452054794,8,23,0.3478260869565217,68,123,0.5528455284552846,0.548,19,38,0.5
Jodie Meeks,meeksjo01,SG,22,TOT,2010,60,719.0,281,39,9,90,99,18,5,25,52,104,268,0.3880597014925373,42,132,0.3181818181818182,62,136,0.4558823529411764,0.466,31,39,0.7948717948717948
Pops Mensah-Bonsu,mensapo01,PF,26,TOT,2010,20,120.0,39,3,16,19,35,4,9,10,20,13,33,0.3939393939393939,0,0,0.0,13,33,0.3939393939393939,0.394,13,24,0.5416666666666666
C.J. Miles,milescj01,SF,22,UTA,2010,63,1497.0,622,105,42,126,168,58,17,81,190,241,562,0.4288256227758007,74,217,0.3410138248847926,167,345,0.4840579710144927,0.495,66,95,0.6947368421052632
Darko Miličić,milicda01,C,24,TOT,2010,32,685.0,215,47,47,104,151,22,34,35,82,100,204,0.4901960784313725,0,1,0.0,100,203,0.4926108374384236,0.49,15,28,0.5357142857142857
Andre Miller,millean02,PG,33,POR,2010,82,2500.0,1146,445,81,185,266,93,9,173,169,404,908,0.4449339207048458,16,80,0.2,388,828,0.4685990338164251,0.454,322,392,0.8214285714285714
Brad Miller,millebr01,C,33,CHI,2010,82,1950.0,719,154,83,316,399,44,29,107,189,250,581,0.4302925989672977,37,132,0.2803030303030303,213,449,0.4743875278396436,0.462,182,220,0.8272727272727273
Mike Miller,millemi01,SG,29,WAS,2010,54,1805.0,586,212,55,281,336,39,12,115,131,217,433,0.5011547344110855,82,171,0.47953216374269,135,262,0.5152671755725191,0.596,70,85,0.8235294117647058
Patty Mills,millspa02,PG,21,POR,2010,10,38.0,26,5,1,1,2,0,0,4,6,10,24,0.4166666666666667,2,4,0.5,8,20,0.4,0.458,4,7,0.5714285714285714
Paul Millsap,millspa01,PF,24,UTA,2010,82,2277.0,954,131,186,373,559,64,99,116,285,385,716,0.5377094972067039,1,9,0.1111111111111111,384,707,0.5431400282885431,0.538,183,264,0.6931818181818182
Nazr Mohammed,mohamna01,C,32,CHA,2010,58,984.0,459,28,114,190,304,15,43,53,105,189,342,0.5526315789473685,0,0,0.0,189,342,0.5526315789473685,0.553,81,125,0.648
Jamario Moon,moonja01,SF,29,CLE,2010,61,1052.0,296,49,26,165,191,34,30,23,69,114,247,0.4615384615384615,32,100,0.32,82,147,0.5578231292517006,0.526,36,45,0.8
Mikki Moore,mooremi01,C,34,GSW,2010,23,406.0,115,36,26,43,69,5,13,21,60,54,90,0.6,0,0,0.0,54,90,0.6,0.6,7,11,0.6363636363636364
Randolph Morris,morrira01,PF,24,ATL,2010,28,124.0,62,2,10,28,38,5,3,12,34,23,41,0.5609756097560976,0,0,0.0,23,41,0.5609756097560976,0.561,16,27,0.5925925925925926
Adam Morrison,morriad01,SF,25,LAL,2010,31,241.0,74,18,10,22,32,3,2,10,17,32,85,0.3764705882352941,5,21,0.238095238095238,27,64,0.421875,0.406,5,8,0.625
Anthony Morrow,morroan01,SG,24,GSW,2010,69,2018.0,899,104,61,198,259,65,16,84,158,329,703,0.4679943100995732,140,307,0.4560260586319218,189,396,0.4772727272727273,0.568,101,114,0.8859649122807017
Byron Mullens,mulleby01,PF,20,OKC,2010,13,54.0,14,1,3,7,10,2,0,4,13,7,19,0.3684210526315789,0,0,0.0,7,19,0.3684210526315789,0.368,0,0,0.0
Troy Murphy,murphtr01,PF,29,IND,2010,72,2344.0,1050,150,129,608,737,72,34,100,175,384,813,0.4723247232472324,128,333,0.3843843843843844,256,480,0.5333333333333333,0.551,154,193,0.7979274611398963
Ronald Murray,murraro01,SG,30,TOT,2010,75,1673.0,746,135,28,155,183,46,16,91,126,268,683,0.3923865300146413,69,221,0.3122171945701357,199,462,0.4307359307359307,0.443,141,194,0.7268041237113402
Eduardo Nájera,najered01,PF,33,TOT,2010,46,685.0,157,29,34,81,115,26,14,25,94,62,146,0.4246575342465753,19,64,0.296875,43,82,0.524390243902439,0.49,14,24,0.5833333333333334
Steve Nash,nashst01,PG,35,PHO,2010,81,2660.0,1333,892,34,234,268,42,12,295,108,499,985,0.5065989847715736,124,291,0.4261168384879725,375,694,0.5403458213256485,0.57,211,225,0.9377777777777778
Jameer Nelson,nelsoja01,PG,27,ORL,2010,65,1860.0,818,353,26,168,194,48,2,139,147,317,706,0.4490084985835694,86,226,0.3805309734513274,231,480,0.48125,0.51,98,116,0.8448275862068966
Rasho Nesterović,nestera01,C,33,TOR,2010,42,413.0,163,25,37,52,89,10,17,16,54,81,149,0.5436241610738255,0,0,0.0,81,149,0.5436241610738255,0.544,1,5,0.2
Joakim Noah,noahjo01,C,24,CHI,2010,64,1925.0,687,132,220,484,704,32,100,117,198,262,520,0.5038461538461538,0,0,0.0,262,520,0.5038461538461538,0.504,163,219,0.7442922374429224
Andrés Nocioni,nocioan01,SF,30,SAC,2010,75,1477.0,635,75,32,190,222,32,26,67,160,234,587,0.3986371379897785,96,249,0.3855421686746988,138,338,0.408284023668639,0.48,71,99,0.7171717171717171
Steve Novak,novakst01,SF,26,LAC,2010,54,362.0,113,6,1,32,33,7,2,2,21,42,108,0.3888888888888889,22,71,0.3098591549295774,20,37,0.5405405405405406,0.491,7,9,0.7777777777777778
Dirk Nowitzki,nowitdi01,PF,31,DAL,2010,81,3039.0,2027,218,80,540,620,70,79,149,208,720,1496,0.481283422459893,51,121,0.4214876033057851,669,1375,0.4865454545454545,0.498,536,586,0.9146757679180888
Patrick O'Bryant,obryapa01,C,23,TOR,2010,11,51.0,19,1,2,9,11,2,4,5,12,8,15,0.5333333333333333,0,1,0.0,8,14,0.5714285714285714,0.533,3,6,0.5
Jermaine O'Neal,onealje01,C,31,MIA,2010,70,1991.0,950,92,124,362,486,25,95,125,212,394,745,0.5288590604026846,0,2,0.0,394,743,0.5302826379542396,0.529,162,225,0.72
Shaquille O'Neal,onealsh01,C,37,CLE,2010,53,1240.0,636,80,93,262,355,15,62,105,169,262,463,0.5658747300215983,0,1,0.0,262,462,0.5670995670995671,0.566,112,226,0.495575221238938
Fabricio Oberto,obertfa01,C,34,WAS,2010,57,650.0,83,51,34,71,105,11,9,36,121,35,56,0.625,0,0,0.0,35,56,0.625,0.625,13,17,0.7647058823529411
Greg Oden,odengr01,C,22,POR,2010,21,502.0,233,19,64,114,178,8,48,39,84,92,152,0.6052631578947368,0,0,0.0,92,152,0.6052631578947368,0.605,49,64,0.765625
Lamar Odom,odomla01,PF,30,LAL,2010,82,2585.0,882,267,184,618,802,75,59,150,227,342,739,0.462787550744249,58,182,0.3186813186813186,284,557,0.5098743267504489,0.502,140,202,0.693069306930693
Emeka Okafor,okafoem01,C,27,NOH,2010,82,2370.0,850,55,251,491,742,54,127,111,218,348,656,0.5304878048780488,0,0,0.0,348,656,0.5304878048780488,0.53,154,274,0.5620437956204379
Mehmet Okur,okurme01,C,30,UTA,2010,73,2149.0,988,119,132,383,515,38,81,127,223,355,775,0.4580645161290322,82,213,0.3849765258215962,273,562,0.4857651245551601,0.511,196,239,0.8200836820083682
Kevin Ollie,ollieke01,PG,37,OKC,2010,25,263.0,44,20,3,22,25,9,0,6,16,18,45,0.4,0,1,0.0,18,44,0.4090909090909091,0.4,8,8,1.0
Travis Outlaw,outlatr01,SF,25,TOT,2010,34,730.0,309,34,33,88,121,18,17,32,43,110,281,0.3914590747330961,40,105,0.3809523809523809,70,176,0.3977272727272727,0.463,49,59,0.8305084745762712
Zaza Pachulia,pachuza01,C,25,ATL,2010,78,1089.0,333,42,117,176,293,37,31,58,186,120,246,0.4878048780487805,0,4,0.0,120,242,0.4958677685950413,0.488,93,143,0.6503496503496503
Jannero Pargo,pargoja01,PG,30,CHI,2010,63,829.0,344,89,9,69,78,29,2,50,68,132,381,0.3464566929133858,38,138,0.2753623188405797,94,243,0.3868312757201646,0.396,42,45,0.9333333333333332
Anthony Parker,parkean01,SG,34,CLE,2010,81,2289.0,595,157,30,201,231,63,18,71,151,206,475,0.4336842105263158,108,261,0.4137931034482758,98,214,0.4579439252336448,0.547,75,95,0.7894736842105263
Tony Parker,parketo01,PG,27,SAS,2010,56,1728.0,894,317,7,128,135,29,8,149,96,349,716,0.4874301675977653,10,34,0.2941176470588235,339,682,0.4970674486803519,0.494,186,246,0.7560975609756098
Chris Paul,paulch01,PG,24,NOH,2010,45,1712.0,841,480,20,171,191,96,8,112,118,314,637,0.4929356357927786,52,127,0.4094488188976378,262,510,0.5137254901960784,0.534,161,190,0.8473684210526315
Sasha Pavlović,pavloal01,SF,26,MIN,2010,71,877.0,263,58,12,105,117,23,6,53,84,109,300,0.3633333333333333,35,118,0.2966101694915254,74,182,0.4065934065934066,0.422,10,26,0.3846153846153846
Oleksiy Pecherov,pecheol01,C,24,MIN,2010,44,447.0,197,11,32,92,124,9,14,32,55,77,188,0.4095744680851064,14,52,0.2692307692307692,63,136,0.4632352941176471,0.447,29,32,0.90625
Kendrick Perkins,perkike01,C,25,BOS,2010,78,2154.0,791,80,155,440,595,26,132,165,219,314,522,0.6015325670498084,0,3,0.0,314,519,0.605009633911368,0.602,163,280,0.5821428571428572
Morris Peterson,petermo01,SG,32,NOH,2010,46,973.0,327,41,17,109,126,25,5,27,81,116,301,0.3853820598006645,62,171,0.3625730994152046,54,130,0.4153846153846154,0.488,33,54,0.6111111111111112
Johan Petro,petrojo01,C,24,DEN,2010,36,436.0,122,14,32,97,129,10,13,23,80,54,101,0.5346534653465347,0,1,0.0,54,100,0.54,0.535,14,21,0.6666666666666666
Paul Pierce,piercpa01,SF,32,BOS,2010,71,2411.0,1296,218,39,271,310,84,31,166,196,409,867,0.4717416378316032,109,263,0.4144486692015209,300,604,0.4966887417218543,0.535,369,433,0.8521939953810623
Mickaël Piétrus,pietrmi01,SF,27,ORL,2010,75,1687.0,651,49,39,176,215,53,31,69,138,233,539,0.4322820037105751,116,306,0.3790849673202614,117,233,0.5021459227467812,0.54,69,109,0.6330275229357798
James Posey,poseyja01,SF,33,NOH,2010,77,1731.0,399,117,32,297,329,42,19,51,204,126,345,0.3652173913043478,81,242,0.3347107438016529,45,103,0.4368932038834951,0.483,66,80,0.825
Leon Powe,powele01,SF,26,CLE,2010,20,236.0,79,0,19,42,61,6,2,11,36,21,49,0.4285714285714285,0,0,0.0,21,49,0.4285714285714285,0.429,37,63,0.5873015873015873
Josh Powell,poweljo01,PF,27,LAL,2010,63,581.0,169,35,44,72,116,9,6,33,71,71,194,0.3659793814432989,7,16,0.4375,64,178,0.3595505617977528,0.384,20,31,0.6451612903225806
A.J. Price,priceaj01,PG,23,IND,2010,56,865.0,410,106,12,76,88,35,3,59,53,145,354,0.4096045197740113,60,174,0.3448275862068966,85,180,0.4722222222222222,0.494,60,75,0.8
Ronnie Price,pricero01,PG,26,UTA,2010,60,806.0,255,123,28,46,74,40,13,56,109,98,242,0.4049586776859504,18,63,0.2857142857142857,80,179,0.4469273743016759,0.442,41,59,0.6949152542372882
Tayshaun Prince,princta01,SF,29,DET,2010,49,1664.0,661,161,71,177,248,34,22,60,77,282,580,0.4862068965517241,27,73,0.3698630136986301,255,507,0.5029585798816568,0.509,70,98,0.7142857142857143
Joel Przybilla,przybjo01,C,30,POR,2010,30,681.0,123,8,72,166,238,8,43,39,95,45,86,0.5232558139534884,0,0,0.0,45,86,0.5232558139534884,0.523,33,51,0.6470588235294118
Chris Quinn,quinnch01,PG,26,NJN,2010,25,223.0,56,29,1,15,16,9,1,10,15,20,56,0.3571428571428571,10,32,0.3125,10,24,0.4166666666666667,0.446,6,6,1.0
Vladimir Radmanović,radmavl01,PF,29,TOT,2010,41,891.0,256,45,51,127,178,29,7,44,97,103,273,0.3772893772893773,30,108,0.2777777777777778,73,165,0.4424242424242424,0.432,20,27,0.7407407407407407
Anthony Randolph,randoan01,C,20,GSW,2010,33,749.0,384,42,73,142,215,28,51,49,92,137,309,0.4433656957928802,1,5,0.2,136,304,0.4473684210526316,0.445,109,136,0.8014705882352942
Shavlik Randolph,randosh01,PF,26,TOT,2010,6,53.0,14,1,7,7,14,1,1,3,9,6,18,0.3333333333333333,0,0,0.0,6,18,0.3333333333333333,0.333,2,2,1.0
Zach Randolph,randoza01,PF,28,MEM,2010,81,3051.0,1681,149,330,620,950,80,34,174,226,652,1336,0.4880239520958084,15,52,0.2884615384615384,637,1284,0.4961059190031153,0.494,362,465,0.7784946236559139
Theo Ratliff,ratlith01,C,36,TOT,2010,49,807.0,178,25,59,98,157,12,61,41,87,70,152,0.4605263157894737,0,0,0.0,70,152,0.4605263157894737,0.461,38,50,0.76
Michael Redd,reddmi01,SG,30,MIL,2010,18,492.0,215,39,11,43,54,19,2,15,24,75,213,0.352112676056338,18,60,0.3,57,153,0.3725490196078431,0.394,47,66,0.7121212121212122
J.J. Redick,redicjj01,SG,25,ORL,2010,82,1808.0,788,158,17,138,155,28,4,63,118,243,553,0.4394213381555154,111,274,0.4051094890510949,132,279,0.4731182795698925,0.54,191,222,0.8603603603603603
Chris Richard,richach01,PF,25,CHI,2010,18,224.0,37,7,19,40,59,8,4,14,50,15,29,0.5172413793103449,0,0,0.0,15,29,0.5172413793103449,0.517,7,11,0.6363636363636364
Jason Richardson,richaja01,SG,29,PHO,2010,79,2485.0,1239,143,81,323,404,66,33,92,169,473,998,0.4739478957915831,157,400,0.3925,316,598,0.5284280936454849,0.553,136,184,0.7391304347826086
Quentin Richardson,richaqu01,SF,29,MIA,2010,76,2082.0,678,93,64,310,374,70,18,62,169,242,561,0.4313725490196078,142,358,0.3966480446927374,100,203,0.4926108374384236,0.558,52,71,0.7323943661971831
Luke Ridnour,ridnolu01,PG,28,MIL,2010,82,1759.0,852,324,24,119,143,54,7,106,182,328,686,0.478134110787172,69,181,0.3812154696132597,259,505,0.5128712871287129,0.528,127,140,0.9071428571428573
Nate Robinson,robinna01,PG,25,TOT,2010,56,1115.0,567,163,28,82,110,49,5,73,116,215,493,0.4361054766734279,87,223,0.3901345291479821,128,270,0.4740740740740741,0.524,50,67,0.746268656716418
Sergio Rodríguez,rodrise01,PG,23,TOT,2010,66,1048.0,434,212,24,65,89,50,5,114,84,167,351,0.4757834757834758,32,91,0.3516483516483517,135,260,0.5192307692307693,0.521,68,93,0.7311827956989247
Rajon Rondo,rondora01,PG,23,BOS,2010,81,2963.0,1110,794,100,260,360,189,11,246,198,459,904,0.5077433628318584,17,80,0.2125,442,824,0.5364077669902912,0.517,175,282,0.6205673758865248
Derrick Rose,rosede01,PG,21,CHI,2010,78,2871.0,1619,469,65,228,293,57,27,217,96,672,1373,0.4894391842680262,16,60,0.2666666666666666,656,1313,0.4996191926884996,0.495,259,338,0.7662721893491125
Quinton Ross,rossqu01,SF-SG,28,TOT,2010,52,562.0,92,12,17,32,49,13,6,11,69,40,111,0.3603603603603603,4,21,0.1904761904761904,36,90,0.4,0.378,8,14,0.5714285714285714
Brandon Roy,roybr01,SG,25,POR,2010,65,2419.0,1398,305,73,212,285,61,16,129,136,491,1038,0.4730250481695568,73,221,0.3303167420814479,418,817,0.5116279069767442,0.508,343,440,0.7795454545454545
Brandon Rush,rushbr01,SG,24,IND,2010,82,2491.0,774,112,41,305,346,56,65,93,159,297,702,0.4230769230769231,124,302,0.4105960264900662,173,400,0.4325,0.511,56,89,0.6292134831460674
Kareem Rush,rushka01,SG,29,LAC,2010,7,58.0,9,4,1,5,6,2,3,3,8,4,11,0.3636363636363636,1,3,0.3333333333333333,3,8,0.375,0.409,0,0,0.0
John Salmons,salmojo01,SG,30,TOT,2010,81,2824.0,1245,223,35,235,270,99,26,123,166,437,991,0.4409687184661958,118,309,0.3818770226537217,319,682,0.4677419354838709,0.501,253,305,0.8295081967213115
Brian Scalabrine,scalabr01,PF,31,BOS,2010,52,472.0,78,27,9,39,48,9,4,17,59,29,85,0.3411764705882353,16,49,0.3265306122448979,13,36,0.3611111111111111,0.435,4,6,0.6666666666666666
Luis Scola,scolalu01,PF,29,HOU,2010,82,2671.0,1329,169,175,530,705,63,26,163,246,560,1090,0.5137614678899083,1,5,0.2,559,1085,0.5152073732718894,0.514,208,267,0.7790262172284644
Thabo Sefolosha,sefolth01,SG,25,OKC,2010,82,2348.0,489,145,76,311,387,97,46,90,154,194,441,0.4399092970521542,41,131,0.3129770992366412,153,310,0.4935483870967742,0.486,60,89,0.6741573033707865
Ramon Sessions,sessira01,PG,23,MIN,2010,82,1732.0,674,258,58,156,214,55,5,137,137,253,555,0.4558558558558558,1,15,0.0666666666666666,252,540,0.4666666666666667,0.457,167,233,0.7167381974248928
Bobby Simmons,simmobo01,PF,29,NJN,2010,23,395.0,122,15,11,52,63,15,3,19,52,42,117,0.358974358974359,20,63,0.3174603174603174,22,54,0.4074074074074074,0.444,18,20,0.9
James Singleton,singlja01,PF-SF,28,TOT,2010,57,977.0,254,31,108,168,276,28,43,49,113,97,254,0.3818897637795275,7,37,0.1891891891891892,90,217,0.4147465437788018,0.396,53,62,0.8548387096774194
Brian Skinner,skinnbr01,PF,33,LAC,2010,16,123.0,26,0,9,18,27,3,4,7,20,10,25,0.4,0,0,0.0,10,25,0.4,0.4,6,8,0.75
Craig Smith,smithcr01,PF,26,LAC,2010,75,1232.0,585,84,97,190,287,33,25,88,194,226,397,0.5692695214105793,1,5,0.2,225,392,0.5739795918367347,0.571,132,208,0.6346153846153846
J.R. Smith,smithjr01,SG,24,DEN,2010,75,2082.0,1156,183,28,206,234,99,20,139,174,428,1033,0.4143272023233301,158,467,0.3383297644539614,270,566,0.4770318021201413,0.491,142,201,0.7064676616915423
Jason Smith,smithja02,PF,23,PHI,2010,56,658.0,189,33,54,81,135,21,28,35,110,75,174,0.4310344827586206,10,29,0.3448275862068966,65,145,0.4482758620689655,0.46,29,42,0.6904761904761905
Joe Smith,smithjo02,PF,34,ATL,2010,64,592.0,194,21,66,91,157,6,19,22,95,77,193,0.3989637305699481,1,7,0.1428571428571428,76,186,0.4086021505376344,0.402,39,48,0.8125
Josh Smith,smithjo03,PF,24,ATL,2010,81,2871.0,1269,342,223,482,705,130,172,198,240,504,999,0.5045045045045045,0,7,0.0,504,992,0.5080645161290323,0.505,261,422,0.6184834123222749
Darius Songaila,songada01,C,31,NOH,2010,75,1410.0,543,70,59,173,232,62,14,81,206,241,488,0.4938524590163934,1,6,0.1666666666666666,240,482,0.4979253112033195,0.495,60,74,0.8108108108108109
Marreese Speights,speigma01,C,22,PHI,2010,62,1016.0,532,36,85,167,252,29,34,51,152,212,444,0.4774774774774775,0,5,0.0,212,439,0.4829157175398633,0.477,108,145,0.7448275862068966
Jerry Stackhouse,stackje01,SG,35,MIL,2010,42,855.0,358,70,19,81,100,21,9,66,56,129,316,0.4082278481012658,45,130,0.3461538461538461,84,186,0.4516129032258064,0.479,55,69,0.7971014492753623
DeShawn Stevenson,stevede01,SG,28,TOT,2010,64,883.0,136,56,11,80,91,16,6,30,74,46,163,0.2822085889570552,19,87,0.2183908045977011,27,76,0.3552631578947368,0.34,25,35,0.7142857142857143
Peja Stojaković,stojape01,SF,32,NOH,2010,62,1947.0,784,92,39,188,227,48,5,56,83,278,688,0.4040697674418604,132,352,0.375,146,336,0.4345238095238095,0.5,96,107,0.897196261682243
Amar'e Stoudemire,stoudam01,PF,27,PHO,2010,82,2838.0,1896,82,230,502,732,52,83,213,281,704,1264,0.5569620253164557,1,6,0.1666666666666666,703,1258,0.5588235294117647,0.557,487,632,0.7705696202531646
Rodney Stuckey,stuckro01,PG,23,DET,2010,73,2499.0,1215,348,67,214,281,101,12,163,205,449,1109,0.4048692515779982,18,79,0.2278481012658227,431,1030,0.4184466019417476,0.413,299,359,0.8328690807799443
DaJuan Summers,summeda01,SF,22,DET,2010,44,405.0,134,16,14,31,45,8,7,16,52,46,130,0.3538461538461538,15,42,0.3571428571428571,31,88,0.3522727272727273,0.412,27,38,0.7105263157894737
Jermaine Taylor,tayloje02,SG,23,HOU,2010,31,303.0,128,16,21,25,46,10,3,19,15,45,119,0.3781512605042016,5,22,0.2272727272727272,40,97,0.4123711340206185,0.399,33,46,0.717391304347826
Jeff Teague,teaguje01,PG,21,ATL,2010,71,719.0,228,122,5,62,67,34,11,50,82,90,227,0.3964757709251101,7,32,0.21875,83,195,0.4256410256410256,0.412,41,49,0.8367346938775511
Sebastian Telfair,telfase01,PG,24,TOT,2010,43,659.0,208,126,5,40,45,24,5,50,71,83,201,0.4129353233830846,13,56,0.2321428571428571,70,145,0.4827586206896552,0.445,29,37,0.7837837837837838
Garrett Temple,templga01,SG,23,TOT,2010,27,334.0,136,21,6,25,31,13,6,27,42,44,101,0.4356435643564356,13,37,0.3513513513513513,31,64,0.484375,0.5,35,50,0.7
Jason Terry,terryja01,SG,32,DAL,2010,77,2540.0,1280,292,19,121,140,94,17,109,142,456,1041,0.4380403458213256,136,373,0.3646112600536193,320,668,0.4790419161676646,0.503,232,268,0.8656716417910447
Hasheem Thabeet,thabeha01,C,22,MEM,2010,68,883.0,208,11,85,158,243,15,89,43,162,77,131,0.5877862595419847,0,0,0.0,77,131,0.5877862595419847,0.588,54,93,0.5806451612903226
Etan Thomas,thomaet01,C,31,OKC,2010,23,321.0,75,1,18,46,64,4,16,18,39,31,68,0.4558823529411764,0,0,0.0,31,68,0.4558823529411764,0.456,13,22,0.5909090909090909
Kenny Thomas,thomake01,PF,32,SAC,2010,26,313.0,41,15,35,51,86,10,10,17,42,17,35,0.4857142857142857,0,0,0.0,17,35,0.4857142857142857,0.486,7,12,0.5833333333333334
Kurt Thomas,thomaku01,C,37,MIL,2010,70,1049.0,210,47,84,207,291,26,46,48,159,99,208,0.4759615384615384,0,0,0.0,99,208,0.4759615384615384,0.476,12,15,0.8
Tim Thomas,thomati01,SF,32,DAL,2010,18,285.0,135,14,13,28,41,10,2,14,31,49,106,0.4622641509433962,16,43,0.3720930232558139,33,63,0.5238095238095238,0.538,21,24,0.875
Tyrus Thomas,thomaty01,PF-C,23,TOT,2010,54,1220.0,508,56,81,254,335,63,85,92,129,194,420,0.4619047619047619,0,3,0.0,194,417,0.4652278177458033,0.462,120,175,0.6857142857142857
Jason Thompson,thompja02,C,23,SAC,2010,75,2357.0,939,124,224,413,637,41,73,139,279,370,784,0.4719387755102041,1,10,0.1,369,774,0.4767441860465116,0.473,198,277,0.7148014440433214
Al Thornton,thornal01,SF,26,TOT,2010,75,2079.0,804,90,116,178,294,45,35,102,206,320,676,0.4733727810650887,11,31,0.3548387096774194,309,645,0.4790697674418605,0.482,153,211,0.7251184834123223
Marcus Thornton,thornma01,SG,22,NOH,2010,73,1872.0,1057,114,72,139,211,58,11,76,127,398,883,0.4507361268403171,117,313,0.3738019169329074,281,570,0.4929824561403508,0.517,144,177,0.8135593220338984
Jamaal Tinsley,tinslja01,PG,31,MEM,2010,38,589.0,133,108,11,55,66,33,5,63,67,52,140,0.3714285714285714,7,39,0.1794871794871795,45,101,0.4455445544554455,0.396,22,27,0.8148148148148148
Anthony Tolliver,tollian01,PF,24,TOT,2010,46,1427.0,539,87,84,236,320,32,33,46,128,193,449,0.4298440979955457,50,152,0.3289473684210526,143,297,0.4814814814814814,0.486,103,134,0.7686567164179104
Alando Tucker,tuckeal02,SF,25,TOT,2010,15,96.0,51,4,6,4,10,0,0,5,6,17,39,0.4358974358974359,1,7,0.1428571428571428,16,32,0.5,0.449,16,21,0.7619047619047619
Ronny Turiaf,turiaro01,C,27,GSW,2010,42,872.0,207,90,54,137,191,23,54,49,98,85,146,0.5821917808219178,0,1,0.0,85,145,0.5862068965517241,0.582,37,78,0.4743589743589743
Hedo Türkoğlu,turkohe01,SF,30,TOR,2010,74,2272.0,835,304,42,301,343,55,32,125,220,276,674,0.4094955489614243,108,289,0.3737024221453287,168,385,0.4363636363636363,0.49,175,226,0.7743362831858407
Ime Udoka,udokaim01,SG,32,SAC,2010,69,944.0,250,58,51,140,191,34,6,42,83,91,241,0.3775933609958506,26,91,0.2857142857142857,65,150,0.4333333333333333,0.432,42,57,0.7368421052631579
Beno Udrih,udrihbe01,PG,27,SAC,2010,79,2477.0,1023,372,38,181,219,89,10,136,166,415,841,0.4934601664684899,75,199,0.3768844221105528,340,642,0.5295950155763239,0.538,118,141,0.8368794326241135
Roko Ukić,ukicro01,PG,25,MIL,2010,13,97.0,40,12,0,3,3,1,0,6,6,14,30,0.4666666666666667,3,12,0.25,11,18,0.6111111111111112,0.517,9,11,0.8181818181818182
Anderson Varejão,varejan01,PF,27,CLE,2010,76,2166.0,651,87,189,389,578,71,67,67,223,267,467,0.5717344753747323,1,5,0.2,266,462,0.5757575757575758,0.573,116,175,0.6628571428571428
Charlie Villanueva,villach01,PF,25,DET,2010,78,1848.0,931,53,85,280,365,48,55,74,223,363,827,0.4389359129383313,99,282,0.351063829787234,264,545,0.4844036697247706,0.499,106,130,0.8153846153846154
Sasha Vujačić,vujacsa01,SG,25,LAL,2010,67,575.0,185,41,25,54,79,20,4,17,67,66,164,0.4024390243902439,25,81,0.3086419753086419,41,83,0.4939759036144578,0.479,28,33,0.8484848484848485
Dwyane Wade,wadedw01,SG,28,MIA,2010,77,2792.0,2045,501,107,266,373,142,82,252,181,719,1511,0.4758438120450033,73,243,0.3004115226337449,646,1268,0.5094637223974764,0.5,534,702,0.7606837606837606
Henry Walker,walkebi01,SG-SF,22,TOT,2010,35,768.0,329,40,15,73,88,23,3,28,83,120,232,0.5172413793103449,50,116,0.4310344827586206,70,116,0.603448275862069,0.625,39,49,0.7959183673469388
Ben Wallace,wallabe01,C,35,DET,2010,69,1975.0,381,105,245,352,597,86,84,64,131,158,292,0.541095890410959,0,2,0.0,158,290,0.5448275862068965,0.541,65,160,0.40625
Gerald Wallace,wallage01,SF,27,CHA,2010,76,3119.0,1386,161,150,612,762,117,83,178,194,456,943,0.4835630965005302,52,140,0.3714285714285714,404,803,0.5031133250311333,0.511,422,544,0.7757352941176471
Rasheed Wallace,wallara01,C,35,BOS,2010,79,1780.0,710,80,42,283,325,80,70,63,222,266,650,0.4092307692307692,82,290,0.2827586206896552,184,360,0.5111111111111111,0.472,96,125,0.768
Luke Walton,waltolu01,SF,29,LAL,2010,29,272.0,69,40,12,26,38,10,1,12,19,30,84,0.3571428571428571,7,17,0.4117647058823529,23,67,0.3432835820895522,0.399,2,4,0.5
Hakim Warrick,warriha01,PF,27,TOT,2010,76,1557.0,733,52,127,187,314,24,18,80,126,265,550,0.4818181818181818,1,7,0.1428571428571428,264,543,0.4861878453038674,0.483,202,274,0.7372262773722628
C.J. Watson,watsocj01,PG,25,GSW,2010,65,1788.0,667,180,28,141,169,103,8,69,124,247,528,0.4678030303030303,45,145,0.3103448275862069,202,383,0.5274151436031331,0.51,128,166,0.7710843373493976
Earl Watson,watsoea01,PG,30,IND,2010,79,2322.0,619,399,54,186,240,104,16,175,181,223,524,0.4255725190839695,53,184,0.2880434782608695,170,340,0.5,0.476,120,169,0.7100591715976331
Kyle Weaver,weaveky01,SG,23,OKC,2010,12,144.0,36,11,1,17,18,6,6,4,13,12,33,0.3636363636363636,7,19,0.3684210526315789,5,14,0.3571428571428571,0.47,5,6,0.8333333333333334
Martell Webster,webstma02,SF,23,POR,2010,82,2005.0,768,62,47,221,268,45,40,60,153,259,639,0.405320813771518,124,332,0.3734939759036144,135,307,0.4397394136807817,0.502,126,155,0.8129032258064516
Sonny Weems,weemsso01,SG,23,TOR,2010,69,1368.0,518,101,42,150,192,39,25,65,126,236,458,0.5152838427947598,2,15,0.1333333333333333,234,443,0.5282167042889391,0.517,44,64,0.6875
David West,westda01,PF,29,NOH,2010,81,2949.0,1541,239,164,441,605,76,60,173,233,619,1226,0.5048939641109299,7,27,0.2592592592592592,612,1199,0.5104253544620517,0.508,296,342,0.8654970760233918
Delonte West,westde01,SG,26,CLE,2010,60,1500.0,528,196,29,140,169,55,28,90,86,194,436,0.4449541284403669,25,77,0.3246753246753247,169,359,0.4707520891364902,0.474,115,142,0.8098591549295775
Mario West,westma02,SG,25,ATL,2010,39,142.0,30,9,8,19,27,8,0,7,25,12,21,0.5714285714285714,0,1,0.0,12,20,0.6,0.571,6,10,0.6
Russell Westbrook,westbru01,PG,21,OKC,2010,82,2813.0,1322,652,143,258,401,108,34,268,204,485,1160,0.418103448275862,23,104,0.2211538461538461,462,1056,0.4375,0.428,329,422,0.7796208530805687
D.J. White,whitedj01,PF,23,OKC,2010,12,102.0,59,4,10,13,23,5,3,3,12,25,41,0.6097560975609756,0,0,0.0,25,41,0.6097560975609756,0.61,9,10,0.9
Chris Wilcox,wilcoch01,PF,27,DET,2010,34,441.0,152,13,44,73,117,13,12,38,64,63,120,0.525,0,0,0.0,63,120,0.525,0.525,26,52,0.5
Damien Wilkins,wilkida02,SF,30,MIN,2010,80,1585.0,451,135,72,177,249,66,25,76,144,165,381,0.4330708661417323,18,61,0.2950819672131147,147,320,0.459375,0.457,103,129,0.7984496124031008
Mike Wilks,wilksmi01,PG,30,OKC,2010,4,59.0,16,4,1,3,4,0,0,4,5,6,12,0.5,2,3,0.6666666666666666,4,9,0.4444444444444444,0.583,2,4,0.5
Deron Williams,willide01,PG,25,UTA,2010,76,2802.0,1419,798,50,253,303,96,16,252,208,494,1053,0.4691358024691358,96,259,0.3706563706563706,398,794,0.5012594458438288,0.515,335,418,0.8014354066985646
Jason Williams,willija02,PG,34,ORL,2010,82,1703.0,493,298,7,119,126,53,3,87,65,189,426,0.4436619718309859,84,221,0.3800904977375565,105,205,0.5121951219512195,0.542,31,41,0.7560975609756098
Jawad Williams,willija04,PG,26,CLE,2010,54,742.0,224,34,16,67,83,12,5,18,73,81,206,0.3932038834951456,30,93,0.3225806451612903,51,113,0.4513274336283185,0.466,32,45,0.7111111111111111
Lou Williams,willilo02,PG,23,PHI,2010,64,1912.0,898,268,25,162,187,80,15,106,110,318,677,0.4697193500738552,70,206,0.3398058252427184,248,471,0.5265392781316348,0.521,192,233,0.8240343347639485
Marcus Williams,willima03,PG,24,MEM,2010,62,872.0,269,161,13,80,93,32,1,74,43,104,271,0.3837638376383764,24,81,0.2962962962962963,80,190,0.4210526315789473,0.428,37,55,0.6727272727272727
Marvin Williams,willima02,SF,23,ATL,2010,81,2468.0,820,93,106,310,416,66,46,72,160,302,664,0.4548192771084337,40,132,0.303030303030303,262,532,0.4924812030075188,0.485,176,215,0.8186046511627907
Mo Williams,willima01,PG,27,CLE,2010,69,2359.0,1092,368,28,178,206,70,21,173,170,378,855,0.4421052631578947,159,371,0.4285714285714285,219,484,0.4524793388429752,0.535,177,198,0.8939393939393939
Reggie Williams,willire02,SF,23,GSW,2010,24,782.0,365,66,18,92,110,23,6,29,49,140,283,0.4946996466431095,33,92,0.358695652173913,107,191,0.5602094240837696,0.553,52,62,0.8387096774193549
Sean Williams,willise01,PF,23,NJN,2010,20,227.0,52,1,21,25,46,8,19,20,41,21,49,0.4285714285714285,0,1,0.0,21,48,0.4375,0.429,10,19,0.5263157894736842
Shelden Williams,willish02,PF,26,BOS,2010,54,597.0,201,21,47,99,146,13,21,30,85,63,121,0.5206611570247934,0,1,0.0,63,120,0.525,0.521,75,98,0.7653061224489796
Terrence Williams,willite01,SF,22,NJN,2010,78,1764.0,656,223,46,302,348,43,10,124,126,261,651,0.4009216589861751,31,100,0.31,230,551,0.4174228675136116,0.425,103,144,0.7152777777777778
Metta World Peace,artesro01,SF,30,LAL,2010,77,2605.0,845,234,99,232,331,106,21,121,165,306,740,0.4135135135135135,105,296,0.3547297297297297,201,444,0.4527027027027027,0.484,128,186,0.6881720430107527
Antoine Wright,wrighan01,SF,25,TOR,2010,67,1392.0,435,71,38,152,190,30,11,58,134,162,399,0.4060150375939849,58,173,0.3352601156069364,104,226,0.4601769911504424,0.479,53,77,0.6883116883116883
Dorell Wright,wrighdo01,SF,24,MIA,2010,72,1496.0,510,91,50,185,235,52,32,53,94,194,419,0.4630071599045346,61,157,0.3885350318471338,133,262,0.5076335877862596,0.536,61,69,0.8840579710144928
Julian Wright,wrighju01,SF,22,NOH,2010,68,871.0,259,41,58,86,144,29,18,44,45,116,232,0.5,2,6,0.3333333333333333,114,226,0.504424778761062,0.504,25,41,0.6097560975609756
Nick Young,youngni01,SG,24,WAS,2010,74,1421.0,639,48,20,82,102,28,8,56,147,233,558,0.4175627240143369,69,170,0.4058823529411764,164,388,0.422680412371134,0.479,104,130,0.8
Sam Young,youngsa01,SF,24,MEM,2010,80,1321.0,595,52,77,124,201,34,20,94,106,224,497,0.4507042253521127,11,56,0.1964285714285714,213,441,0.4829931972789115,0.462,136,175,0.7771428571428571
Thaddeus Young,youngth01,PF,21,PHI,2010,67,2145.0,926,97,130,220,350,81,15,126,133,382,813,0.4698646986469865,48,138,0.3478260869565217,334,675,0.4948148148148148,0.499,114,165,0.6909090909090909
Jeff Adrien,adrieje01,PF,24,GSW,2011,23,196.0,57,10,23,35,58,4,5,9,28,23,54,0.4259259259259259,0,0,0.0,23,54,0.4259259259259259,0.426,11,19,0.5789473684210527
Arron Afflalo,afflaar01,SG,25,DEN,2011,69,2324.0,867,168,45,206,251,34,31,71,153,312,627,0.4976076555023923,105,248,0.4233870967741935,207,379,0.5461741424802111,0.581,138,163,0.8466257668711656
Maurice Ager,agerma01,SG,26,MIN,2011,4,29.0,15,1,0,2,2,1,0,4,4,6,11,0.5454545454545454,3,4,0.75,3,7,0.4285714285714285,0.682,0,0,0.0
Alexis Ajinça,ajincal01,C,22,TOT,2011,34,340.0,143,10,17,61,78,11,19,18,73,59,133,0.4436090225563909,12,34,0.3529411764705882,47,99,0.4747474747474747,0.489,13,18,0.7222222222222222
Solomon Alabi,alabiso01,C,22,TOR,2011,12,59.0,6,2,7,7,14,2,2,3,5,3,15,0.2,0,0,0.0,3,15,0.2,0.2,0,2,0.0
Cole Aldrich,aldrico01,C,22,OKC,2011,18,142.0,18,4,13,22,35,5,7,8,30,8,15,0.5333333333333333,0,0,0.0,8,15,0.5333333333333333,0.533,2,4,0.5
LaMarcus Aldridge,aldrila01,PF,25,POR,2011,81,3211.0,1769,170,278,431,709,82,94,153,220,707,1415,0.4996466431095406,4,23,0.1739130434782608,703,1392,0.5050287356321839,0.501,351,444,0.7905405405405406
Malik Allen,allenma01,PF,32,ORL,2011,18,178.0,23,4,12,20,32,1,4,3,30,11,31,0.3548387096774194,0,0,0.0,11,31,0.3548387096774194,0.355,1,2,0.5
Ray Allen,allenra02,SG,35,BOS,2011,80,2890.0,1321,219,51,223,274,77,16,117,147,480,978,0.4907975460122699,168,378,0.4444444444444444,312,600,0.52,0.577,193,219,0.8812785388127854
Tony Allen,allento01,SG,29,MEM,2011,72,1494.0,643,104,70,123,193,129,44,86,161,251,492,0.5101626016260162,4,23,0.1739130434782608,247,469,0.5266524520255863,0.514,137,182,0.7527472527472527
Al-Farouq Aminu,aminual01,SF,20,LAC,2011,81,1452.0,457,60,75,192,267,59,25,103,121,160,406,0.3940886699507389,45,143,0.3146853146853147,115,263,0.4372623574144487,0.45,92,119,0.773109243697479
Lou Amundson,amundlo01,PF,28,GSW,2011,46,691.0,200,17,81,104,185,14,33,24,87,83,183,0.453551912568306,0,0,0.0,83,183,0.453551912568306,0.454,34,87,0.3908045977011494
Chris Andersen,anderch01,C,32,DEN,2011,45,732.0,250,20,75,144,219,23,58,25,79,82,137,0.5985401459854015,0,1,0.0,82,136,0.6029411764705882,0.599,86,135,0.6370370370370371
David Andersen,anderda03,PF,30,TOT,2011,40,373.0,134,13,20,64,84,5,9,22,40,56,121,0.4628099173553719,8,23,0.3478260869565217,48,98,0.4897959183673469,0.496,14,22,0.6363636363636364
James Anderson,anderja01,SF,21,SAS,2011,26,286.0,94,18,2,21,23,3,6,13,24,31,81,0.382716049382716,18,46,0.391304347826087,13,35,0.3714285714285714,0.494,14,18,0.7777777777777778
Ryan Anderson,anderry01,PF,22,ORL,2011,64,1424.0,681,52,129,226,355,30,38,49,137,226,525,0.4304761904761904,134,341,0.3929618768328445,92,184,0.5,0.558,95,117,0.811965811965812
Carmelo Anthony,anthoca01,SF,26,TOT,2011,77,2751.0,1970,221,118,445,563,68,46,206,224,684,1503,0.4550898203592814,95,251,0.3784860557768924,589,1252,0.4704472843450479,0.487,507,605,0.8380165289256198
Joel Anthony,anthojo01,C,28,MIA,2011,75,1463.0,153,24,104,162,266,10,93,36,194,53,99,0.5353535353535354,0,0,0.0,53,99,0.5353535353535354,0.535,47,73,0.6438356164383562
Gilbert Arenas,arenagi01,PG,29,TOT,2011,70,1796.0,755,274,22,167,189,74,21,177,188,269,734,0.3664850136239782,97,327,0.2966360856269113,172,407,0.4226044226044226,0.433,120,153,0.7843137254901961
Trevor Ariza,arizatr01,SF,25,NOH,2011,75,2600.0,826,162,61,347,408,120,31,118,180,303,762,0.3976377952755905,82,271,0.3025830258302583,221,491,0.45010183299389,0.451,138,197,0.700507614213198
Hilton Armstrong,armsthi01,C,26,TOT,2011,53,488.0,92,14,42,89,131,18,21,28,84,37,76,0.4868421052631579,2,4,0.5,35,72,0.4861111111111111,0.5,16,33,0.4848484848484848
Carlos Arroyo,arroyca01,PG,31,TOT,2011,64,1185.0,310,125,20,83,103,21,1,60,71,120,273,0.4395604395604395,31,69,0.4492753623188406,89,204,0.4362745098039216,0.496,39,47,0.8297872340425532
Darrell Arthur,arthuda01,PF,22,MEM,2011,80,1609.0,729,53,115,227,342,52,63,88,228,310,624,0.4967948717948718,0,6,0.0,310,618,0.5016181229773463,0.497,109,134,0.8134328358208955
Ömer Aşık,asikom01,C,24,CHI,2011,82,989.0,229,32,112,194,306,20,56,64,153,78,141,0.5531914893617021,0,0,0.0,78,141,0.5531914893617021,0.553,73,145,0.503448275862069
D.J. Augustin,augusdj01,PG,23,CHA,2011,82,2757.0,1178,498,38,187,225,54,3,155,152,399,958,0.4164926931106472,111,333,0.3333333333333333,288,625,0.4608,0.474,269,297,0.9057239057239056
Luke Babbitt,babbilu01,SF,21,POR,2011,24,137.0,36,6,6,24,30,2,2,8,15,15,55,0.2727272727272727,3,16,0.1875,12,39,0.3076923076923077,0.3,3,9,0.3333333333333333
Renaldo Balkman,balkmre01,SF,26,TOT,2011,8,62.0,16,2,2,5,7,4,2,1,15,6,13,0.4615384615384615,1,2,0.5,5,11,0.4545454545454545,0.5,3,4,0.75
Marcus Banks,banksma01,PG,29,TOR,2011,3,22.0,6,3,0,1,1,1,0,2,4,0,2,0.0,0,0,0.0,0,2,0.0,0.0,6,8,0.75
Leandro Barbosa,barbole01,SG,28,TOR,2011,58,1395.0,769,119,14,85,99,50,6,84,112,294,653,0.450229709035222,72,213,0.3380281690140845,222,440,0.5045454545454545,0.505,109,137,0.7956204379562044
J.J. Barea,bareajo01,PG,26,DAL,2011,81,1669.0,769,317,29,130,159,30,1,136,136,285,649,0.4391371340523883,66,189,0.3492063492063492,219,460,0.4760869565217391,0.49,133,157,0.8471337579617835
Andrea Bargnani,bargnan01,C,25,TOR,2011,66,2353.0,1414,119,74,269,343,34,46,152,160,525,1173,0.4475703324808184,77,223,0.3452914798206278,448,950,0.471578947368421,0.48,287,350,0.82
Matt Barnes,barnema02,SF,30,LAL,2011,53,1020.0,356,71,73,155,228,39,22,58,127,131,279,0.4695340501792114,34,107,0.3177570093457944,97,172,0.563953488372093,0.53,60,77,0.7792207792207793
Earl Barron,barroea01,C,29,TOT,2011,21,305.0,79,11,32,44,76,8,6,16,46,32,99,0.3232323232323232,0,0,0.0,32,99,0.3232323232323232,0.323,15,24,0.625
Brandon Bass,bassbr01,PF,25,ORL,2011,76,1980.0,854,57,134,290,424,27,52,97,159,332,645,0.5147286821705427,0,2,0.0,332,643,0.5163297045101088,0.515,190,233,0.8154506437768241
Tony Battie,battito01,C,34,PHI,2011,38,377.0,100,12,17,82,99,5,15,12,59,45,96,0.46875,2,3,0.6666666666666666,43,93,0.4623655913978494,0.479,8,14,0.5714285714285714
Shane Battier,battish01,SF,32,TOT,2011,82,2375.0,624,185,90,283,373,69,81,79,158,229,509,0.449901768172888,102,267,0.3820224719101123,127,242,0.5247933884297521,0.55,64,93,0.6881720430107527
Nicolas Batum,batumni01,SF,22,POR,2011,80,2522.0,990,123,109,252,361,68,49,83,194,367,807,0.4547707558859975,118,342,0.3450292397660818,249,465,0.535483870967742,0.528,138,164,0.8414634146341463
Jerryd Bayless,bayleje01,PG,22,TOT,2011,71,1496.0,651,266,26,139,165,38,5,127,149,218,517,0.4216634429400386,49,146,0.3356164383561644,169,371,0.4555256064690027,0.469,166,206,0.8058252427184466
Michael Beasley,beaslmi01,SF,22,MIN,2011,73,2361.0,1401,158,118,291,409,54,52,195,222,561,1246,0.4502407704654895,60,164,0.3658536585365853,501,1082,0.4630314232902033,0.474,219,291,0.7525773195876289
Rodrigue Beaubois,beaubro01,PG,22,DAL,2011,28,496.0,236,64,7,45,52,20,8,47,76,94,223,0.42152466367713,25,83,0.3012048192771084,69,140,0.4928571428571429,0.478,23,30,0.7666666666666667
Marco Belinelli,belinma01,SG,24,NOH,2011,80,1957.0,836,92,17,134,151,38,6,77,146,302,691,0.4370477568740955,134,324,0.4135802469135802,168,367,0.4577656675749318,0.534,98,125,0.784
Charlie Bell,bellch01,SG,31,GSW,2011,19,171.0,32,13,6,12,18,6,1,6,13,12,43,0.2790697674418604,6,21,0.2857142857142857,6,22,0.2727272727272727,0.349,2,4,0.5
Raja Bell,bellra01,SG,34,UTA,2011,68,2097.0,541,118,31,145,176,56,14,63,169,191,467,0.4089935760171306,68,193,0.3523316062176165,123,274,0.4489051094890511,0.482,91,102,0.8921568627450981
Mike Bibby,bibbymi01,PG,32,TOT,2011,80,2285.0,688,265,17,178,195,50,9,101,175,248,576,0.4305555555555556,153,348,0.4396551724137931,95,228,0.4166666666666667,0.563,39,62,0.6290322580645161
Andris Biedriņš,biedran01,C,24,GSW,2011,59,1397.0,294,60,145,281,426,52,52,57,198,142,266,0.5338345864661654,0,0,0.0,142,266,0.5338345864661654,0.534,10,31,0.3225806451612903
Chauncey Billups,billuch01,PG,34,TOT,2011,72,2310.0,1208,387,25,165,190,71,14,177,146,339,794,0.4269521410579345,146,363,0.4022038567493113,193,431,0.4477958236658932,0.519,384,419,0.9164677804295944
DeJuan Blair,blairde01,PF,21,SAS,2011,81,1734.0,674,77,215,350,565,95,42,113,213,292,583,0.5008576329331046,0,2,0.0,292,581,0.5025817555938038,0.501,90,137,0.656934306569343
Steve Blake,blakest01,PG,30,LAL,2011,79,1581.0,319,170,19,137,156,40,3,73,99,110,306,0.3594771241830065,73,193,0.3782383419689119,37,113,0.3274336283185841,0.479,26,30,0.8666666666666667
Andray Blatche,blatcan01,PF,24,WAS,2011,64,2172.0,1076,144,183,343,526,98,51,172,182,426,957,0.445141065830721,4,18,0.2222222222222222,422,939,0.4494142705005325,0.447,220,283,0.7773851590106007
Eric Bledsoe,bledser01,PG,21,LAC,2011,81,1841.0,543,289,68,155,223,92,26,194,130,206,486,0.4238683127572016,32,116,0.2758620689655172,174,370,0.4702702702702703,0.457,99,133,0.7443609022556391
Keith Bogans,boganke01,SG,30,CHI,2011,82,1461.0,359,101,19,129,148,38,9,41,113,124,307,0.4039087947882736,90,237,0.379746835443038,34,70,0.4857142857142857,0.55,21,32,0.65625
Andrew Bogut,bogutan01,C,26,MIL,2011,65,2297.0,830,131,199,521,720,47,168,125,217,367,742,0.4946091644204852,0,4,0.0,367,738,0.497289972899729,0.495,96,217,0.4423963133640553
Matt Bonner,bonnema01,PF,30,SAS,2011,66,1432.0,481,60,60,179,239,26,21,27,110,172,371,0.4636118598382749,105,230,0.4565217391304347,67,141,0.475177304964539,0.605,32,43,0.7441860465116279
Trevor Booker,booketr01,PF,23,WAS,2011,65,1063.0,346,35,98,153,251,29,42,38,115,139,253,0.549407114624506,0,1,0.0,139,252,0.5515873015873016,0.549,68,101,0.6732673267326733
Carlos Boozer,boozeca01,C,29,CHI,2011,59,1882.0,1033,145,130,435,565,45,18,149,186,431,845,0.5100591715976331,0,0,0.0,431,845,0.5100591715976331,0.51,171,244,0.7008196721311475
Chris Bosh,boshch01,PF,26,MIA,2011,77,2795.0,1438,144,141,500,641,59,49,138,172,524,1056,0.4962121212121212,6,25,0.24,518,1031,0.5024248302618817,0.499,384,471,0.8152866242038217
Earl Boykins,boykiea01,PG,34,MIL,2011,57,862.0,408,141,15,40,55,38,3,52,43,156,352,0.4431818181818182,27,71,0.380281690140845,129,281,0.4590747330960854,0.482,69,82,0.8414634146341463
Craig Brackins,brackcr01,PF,23,PHI,2011,3,33.0,8,1,2,2,4,1,0,0,3,4,16,0.25,0,5,0.0,4,11,0.3636363636363636,0.25,0,0,0.0
Avery Bradley,bradlav01,PG,20,BOS,2011,31,162.0,52,12,4,13,17,9,0,16,20,23,67,0.3432835820895522,0,5,0.0,23,62,0.3709677419354839,0.343,6,12,0.5
Elton Brand,brandel01,PF,31,PHI,2011,81,2809.0,1217,120,237,439,676,92,106,101,244,502,981,0.5117227319062182,0,1,0.0,502,980,0.5122448979591837,0.512,213,273,0.7802197802197802
Corey Brewer,breweco01,SF-SG,24,TOT,2011,69,1510.0,552,89,57,118,175,100,16,87,159,193,488,0.3954918032786885,30,112,0.2678571428571428,163,376,0.4335106382978723,0.426,136,192,0.7083333333333334
Ronnie Brewer,brewero02,SG,25,CHI,2011,81,1781.0,503,140,55,207,262,106,22,55,82,205,427,0.4800936768149882,6,27,0.2222222222222222,199,400,0.4975,0.487,87,133,0.6541353383458647
Jon Brockman,brockjo01,C,23,MIL,2011,63,677.0,136,18,74,110,184,14,3,24,119,48,94,0.5106382978723404,0,0,0.0,48,94,0.5106382978723404,0.511,40,59,0.6779661016949152
Aaron Brooks,brookaa01,PG,26,TOT,2011,59,1284.0,634,233,20,58,78,34,3,99,115,220,587,0.3747870528109029,70,236,0.2966101694915254,150,351,0.4273504273504273,0.434,124,140,0.8857142857142857
Derrick Brown,brownde04,SF,23,TOT,2011,49,576.0,185,33,41,58,99,20,10,35,59,74,131,0.5648854961832062,5,10,0.5,69,121,0.5702479338842975,0.584,32,60,0.5333333333333333
Kwame Brown,brownkw01,C,28,CHA,2011,66,1714.0,524,43,147,303,450,26,39,69,174,194,375,0.5173333333333333,0,0,0.0,194,375,0.5173333333333333,0.517,136,231,0.5887445887445888
Shannon Brown,brownsh01,SG,25,LAL,2011,82,1568.0,712,96,35,122,157,67,16,75,124,273,643,0.4245723172628304,74,212,0.3490566037735849,199,431,0.4617169373549884,0.482,92,101,0.9108910891089108
Kobe Bryant,bryanko01,SG,32,LAL,2011,82,2779.0,2078,388,83,336,419,99,12,243,172,740,1639,0.4514948139109213,115,356,0.3230337078651685,625,1283,0.4871395167575993,0.487,483,583,0.8284734133790738
Chase Budinger,budinch01,SF,22,HOU,2011,78,1738.0,765,127,52,229,281,41,18,67,114,279,656,0.4253048780487805,89,274,0.3248175182481752,190,382,0.4973821989528796,0.493,118,138,0.855072463768116
Caron Butler,butleca01,SF,30,DAL,2011,29,867.0,436,46,22,96,118,28,8,49,59,170,378,0.4497354497354497,28,65,0.4307692307692308,142,313,0.4536741214057508,0.487,68,88,0.7727272727272727
Rasual Butler,butlera01,SG,31,TOT,2011,47,770.0,222,27,10,67,77,8,15,24,37,79,237,0.3333333333333333,46,136,0.3382352941176471,33,101,0.3267326732673267,0.43,18,27,0.6666666666666666
Andrew Bynum,bynuman01,C,23,LAL,2011,54,1500.0,612,73,170,338,508,19,106,74,140,237,413,0.5738498789346247,0,0,0.0,237,413,0.5738498789346247,0.574,138,209,0.6602870813397129
Will Bynum,bynumwi01,PG,28,DET,2011,61,1125.0,482,195,15,59,74,52,4,83,113,182,406,0.4482758620689655,16,50,0.32,166,356,0.4662921348314606,0.468,102,122,0.8360655737704918
José Calderón,caldejo01,PG,29,TOR,2011,68,2102.0,669,605,30,172,202,81,7,148,143,262,596,0.4395973154362416,57,156,0.3653846153846153,205,440,0.4659090909090909,0.487,88,103,0.8543689320388349
Marcus Camby,cambyma01,C,36,POR,2011,59,1540.0,277,121,182,424,606,40,92,62,140,117,294,0.3979591836734694,0,1,0.0,117,293,0.3993174061433447,0.398,43,70,0.6142857142857143
Derrick Caracter,caracde01,C,22,LAL,2011,41,215.0,81,7,19,24,43,4,10,19,47,32,66,0.4848484848484848,0,0,0.0,32,66,0.4848484848484848,0.485,17,23,0.7391304347826086
Brian Cardinal,cardibr01,SF,33,DAL,2011,56,618.0,145,40,10,49,59,24,7,17,82,43,100,0.43,42,87,0.4827586206896552,1,13,0.0769230769230769,0.64,17,18,0.9444444444444444
Rodney Carney,carnero01,SF,26,TOT,2011,27,336.0,127,11,13,35,48,12,5,16,33,46,110,0.4181818181818181,17,38,0.4473684210526316,29,72,0.4027777777777778,0.495,18,27,0.6666666666666666
DeMarre Carroll,carrode01,PF,24,TOT,2011,12,50.0,10,4,2,6,8,1,1,0,5,4,12,0.3333333333333333,0,0,0.0,4,12,0.3333333333333333,0.333,2,2,1.0
Matt Carroll,carroma01,SG,30,CHA,2011,54,582.0,235,23,12,56,68,17,6,23,43,89,199,0.4472361809045226,17,46,0.3695652173913043,72,153,0.4705882352941176,0.49,40,52,0.7692307692307693
Anthony Carter,cartean01,PG,35,TOT,2011,33,463.0,110,69,7,44,51,27,6,39,49,45,106,0.4245283018867924,12,40,0.3,33,66,0.5,0.481,8,8,1.0
Vince Carter,cartevi01,SG,34,TOT,2011,73,2051.0,1022,146,54,221,275,67,20,90,193,389,891,0.4365881032547699,116,321,0.3613707165109034,273,570,0.4789473684210526,0.502,128,173,0.7398843930635838
Omri Casspi,casspom01,SF,22,SAC,2011,71,1702.0,610,74,74,233,307,54,13,68,115,225,546,0.412087912087912,92,247,0.3724696356275304,133,299,0.4448160535117056,0.496,68,101,0.6732673267326733
Mario Chalmers,chalmma01,PG,24,MIA,2011,70,1579.0,447,177,12,134,146,76,7,91,158,155,388,0.3994845360824742,83,231,0.3593073593073593,72,157,0.4585987261146497,0.506,54,62,0.8709677419354839
Tyson Chandler,chandty01,C,28,DAL,2011,74,2059.0,748,32,206,486,692,36,80,88,240,266,407,0.6535626535626535,0,0,0.0,266,407,0.6535626535626535,0.654,216,295,0.7322033898305085
Wilson Chandler,chandwi01,SF,23,TOT,2011,72,2401.0,1100,120,75,333,408,48,94,104,199,429,953,0.4501573976915005,112,320,0.35,317,633,0.5007898894154819,0.509,130,161,0.8074534161490683
Josh Childress,childjo01,SG,27,PHO,2011,54,894.0,272,42,69,86,155,33,23,44,68,121,214,0.5654205607476636,1,16,0.0625,120,198,0.6060606060606061,0.568,29,59,0.4915254237288136
Earl Clark,clarkea01,SF,23,TOT,2011,42,464.0,163,9,37,64,101,8,18,28,45,68,158,0.430379746835443,0,5,0.0,68,153,0.4444444444444444,0.43,27,47,0.574468085106383
Jarron Collins,collija03,C,32,TOT,2011,28,181.0,19,2,14,10,24,4,1,7,29,6,21,0.2857142857142857,0,0,0.0,6,21,0.2857142857142857,0.286,7,10,0.7
Jason Collins,collija04,C,32,ATL,2011,49,593.0,96,22,30,72,102,9,9,26,97,34,71,0.4788732394366197,1,1,1.0,33,70,0.4714285714285714,0.486,27,41,0.6585365853658537
Sherron Collins,collish01,PG,23,CHA,2011,20,66.0,17,8,0,5,5,2,0,4,2,7,25,0.28,2,10,0.2,5,15,0.3333333333333333,0.32,1,1,1.0
Darren Collison,collida01,PG,23,IND,2011,79,2360.0,1039,403,40,185,225,87,14,194,109,398,870,0.4574712643678161,41,124,0.3306451612903225,357,746,0.4785522788203753,0.481,202,232,0.8706896551724138
Nick Collison,collini01,C,30,OKC,2011,71,1524.0,329,69,119,197,316,42,31,55,210,137,242,0.5661157024793388,0,0,0.0,137,242,0.5661157024793388,0.566,55,73,0.7534246575342466
Mike Conley,conlemi01,PG,23,MEM,2011,81,2872.0,1107,528,32,215,247,144,18,176,182,423,953,0.4438614900314795,80,217,0.3686635944700461,343,736,0.4660326086956521,0.486,181,247,0.7327935222672065
Brian Cook,cookbr01,PF,30,LAC,2011,40,447.0,193,15,19,77,96,12,11,25,75,72,170,0.4235294117647059,34,79,0.430379746835443,38,91,0.4175824175824176,0.524,15,24,0.625
Daequan Cook,cookda02,SG,23,OKC,2011,43,598.0,239,20,8,64,72,14,1,17,51,79,181,0.43646408839779,65,154,0.422077922077922,14,27,0.5185185185185185,0.616,16,20,0.8
Marcus Cousin,cousima01,C,24,UTA,2011,4,18.0,4,0,0,3,3,0,1,1,1,2,3,0.6666666666666666,0,0,0.0,2,3,0.6666666666666666,0.667,0,0,0.0
DeMarcus Cousins,couside01,C,20,SAC,2011,81,2309.0,1143,204,217,482,699,85,68,268,332,432,1004,0.4302788844621514,3,18,0.1666666666666666,429,986,0.4350912778904665,0.432,276,402,0.6865671641791045
Jamal Crawford,crawfja01,SG,30,ATL,2011,76,2297.0,1077,241,22,108,130,57,14,145,97,368,874,0.4210526315789473,119,349,0.3409742120343839,249,525,0.4742857142857143,0.489,222,260,0.8538461538461538
Jordan Crawford,crawfjo02,SG,22,TOT,2011,42,1027.0,490,117,31,74,105,39,3,83,63,192,500,0.384,33,128,0.2578125,159,372,0.4274193548387097,0.417,73,84,0.8690476190476191
Dante Cunningham,cunnida01,PF,23,TOT,2011,78,1637.0,482,43,96,181,277,54,43,51,177,218,472,0.461864406779661,1,13,0.0769230769230769,217,459,0.4727668845315904,0.463,45,62,0.7258064516129032
Stephen Curry,curryst01,PG,22,GSW,2011,74,2489.0,1373,432,52,234,286,109,20,226,233,505,1053,0.4795821462488129,151,342,0.4415204678362573,354,711,0.4978902953586498,0.551,212,227,0.933920704845815
Samuel Dalembert,dalemsa01,C,29,SAC,2011,80,1938.0,644,67,212,445,657,36,116,132,225,268,567,0.4726631393298059,0,2,0.0,268,565,0.4743362831858407,0.473,108,148,0.7297297297297297
Erick Dampier,dampier01,C,35,MIA,2011,51,815.0,128,22,53,124,177,14,47,32,82,52,89,0.5842696629213483,0,1,0.0,52,88,0.5909090909090909,0.584,24,44,0.5454545454545454
Antonio Daniels,daniean01,PG,35,PHI,2011,4,35.0,6,2,0,5,5,0,0,1,0,2,5,0.4,0,2,0.0,2,3,0.6666666666666666,0.4,2,2,1.0
Marquis Daniels,daniema01,SF,30,BOS,2011,49,938.0,271,64,24,89,113,39,22,38,63,114,232,0.4913793103448275,4,21,0.1904761904761904,110,211,0.5213270142180095,0.5,39,57,0.6842105263157895
Baron Davis,davisba01,PG,31,TOT,2011,58,1649.0,760,391,35,121,156,78,28,146,143,289,693,0.417027417027417,81,239,0.3389121338912134,208,454,0.4581497797356828,0.475,101,131,0.7709923664122137
Ed Davis,davised01,PF,21,TOR,2011,65,1602.0,501,40,168,294,462,39,67,48,183,215,373,0.5764075067024129,0,0,0.0,215,373,0.5764075067024129,0.576,71,128,0.5546875
Glen Davis,davisgl01,C,25,BOS,2011,78,2298.0,915,92,101,324,425,78,30,85,231,359,801,0.4481897627965043,2,15,0.1333333333333333,357,786,0.4541984732824427,0.449,195,265,0.7358490566037735
Austin Daye,dayeau01,SF,22,DET,2011,72,1446.0,537,78,64,210,274,39,39,59,165,193,471,0.4097664543524416,69,172,0.4011627906976744,124,299,0.4147157190635451,0.483,82,108,0.7592592592592593
Carlos Delfino,delfica01,SF,28,MIL,2011,49,1590.0,565,112,24,176,200,76,8,57,72,200,513,0.3898635477582846,105,284,0.3697183098591549,95,229,0.4148471615720524,0.492,60,75,0.8
Luol Deng,denglu01,SF,25,CHI,2011,82,3208.0,1430,230,116,360,476,78,48,156,162,531,1155,0.4597402597402597,115,333,0.3453453453453453,416,822,0.5060827250608273,0.51,253,336,0.7529761904761905
DeMar DeRozan,derozde01,SG,21,TOR,2011,82,2851.0,1410,148,75,240,315,85,31,144,217,539,1154,0.4670710571923743,5,52,0.0961538461538461,534,1102,0.484573502722323,0.469,327,402,0.8134328358208955
Boris Diaw,diawbo01,PF,28,CHA,2011,82,2778.0,924,337,105,309,414,74,46,166,190,381,774,0.4922480620155038,78,226,0.3451327433628318,303,548,0.5529197080291971,0.543,84,123,0.6829268292682927
Ike Diogu,dioguik01,PF,27,LAC,2011,36,470.0,207,2,41,74,115,3,3,22,72,83,148,0.5608108108108109,0,0,0.0,83,148,0.5608108108108109,0.561,41,62,0.6612903225806451
DeSagana Diop,diopde01,C,29,CHA,2011,16,181.0,20,7,12,28,40,4,15,11,26,8,24,0.3333333333333333,0,0,0.0,8,24,0.3333333333333333,0.333,4,11,0.3636363636363636
Keyon Dooling,doolike01,PG,30,MIL,2011,80,1757.0,571,243,12,105,117,54,4,91,119,206,519,0.3969171483622351,81,234,0.3461538461538461,125,285,0.4385964912280701,0.475,78,94,0.8297872340425532
Joey Dorsey,dorsejo01,C,27,TOR,2011,43,522.0,135,27,79,111,190,24,17,39,78,52,99,0.5252525252525253,0,0,0.0,52,99,0.5252525252525253,0.525,31,65,0.4769230769230769
Toney Douglas,douglto01,SG,24,NYK,2011,81,1971.0,856,244,65,179,244,89,4,89,177,314,755,0.4158940397350993,143,383,0.3733681462140992,171,372,0.4596774193548387,0.511,85,107,0.794392523364486
Chris Douglas-Roberts,douglch01,SF,24,MIL,2011,44,884.0,323,50,7,81,88,29,13,35,73,117,273,0.4285714285714285,15,46,0.3260869565217391,102,227,0.4493392070484581,0.456,74,89,0.8314606741573034
Zabian Dowdell,dowdeza01,PG,26,PHO,2011,24,292.0,121,51,5,15,20,20,2,29,30,51,125,0.408,3,10,0.3,48,115,0.417391304347826,0.42,16,17,0.9411764705882352
Goran Dragić,dragigo01,PG,24,TOT,2011,70,1234.0,523,204,36,106,142,50,10,117,125,192,441,0.4353741496598639,56,155,0.3612903225806451,136,286,0.4755244755244755,0.499,83,133,0.6240601503759399
Jared Dudley,dudleja01,SF,25,PHO,2011,82,2140.0,867,108,111,207,318,87,20,77,139,300,629,0.4769475357710652,105,253,0.4150197628458498,195,376,0.5186170212765957,0.56,162,218,0.7431192660550459
Chris Duhon,duhonch01,PG,28,ORL,2011,51,774.0,125,118,9,43,52,16,2,61,30,49,129,0.3798449612403101,13,52,0.25,36,77,0.4675324675324675,0.43,14,25,0.56
Tim Duncan,duncati01,C,34,SAS,2011,76,2156.0,1022,203,169,509,678,50,146,122,119,419,838,0.5,0,4,0.0,419,834,0.5023980815347722,0.5,184,257,0.7159533073929961
Mike Dunleavy,dunlemi02,SG,30,IND,2011,61,1683.0,682,105,28,248,276,40,30,69,107,240,520,0.4615384615384615,102,254,0.4015748031496063,138,266,0.518796992481203,0.56,100,125,0.8
Ronald Dupree,duprero01,SF,30,TOR,2011,3,13.0,2,1,0,3,3,0,0,0,2,1,4,0.25,0,1,0.0,1,3,0.3333333333333333,0.25,0,0,0.0
Kevin Durant,duranke01,SF,22,OKC,2011,78,3038.0,2161,214,57,476,533,88,76,218,159,711,1538,0.4622886866059817,145,414,0.3502415458937198,566,1124,0.50355871886121,0.509,594,675,0.88
Devin Ebanks,ebankde01,SG,21,LAL,2011,20,118.0,62,2,15,12,27,4,5,6,7,21,51,0.4117647058823529,2,5,0.4,19,46,0.4130434782608695,0.431,18,23,0.782608695652174
Wayne Ellington,ellinwa01,SG,23,MIN,2011,62,1181.0,410,72,26,82,108,28,3,53,85,160,397,0.4030226700251889,48,121,0.396694214876033,112,276,0.4057971014492754,0.463,42,53,0.7924528301886793
Monta Ellis,ellismo01,SG,25,GSW,2011,80,3227.0,1929,450,44,237,281,168,23,252,203,726,1611,0.4506517690875233,137,379,0.3614775725593667,589,1232,0.4780844155844156,0.493,340,431,0.7888631090487239
Francisco Elson,elsonfr01,C,34,UTA,2011,62,610.0,134,33,35,80,115,21,14,32,84,54,113,0.4778761061946903,0,0,0.0,54,113,0.4778761061946903,0.478,26,31,0.8387096774193549
Melvin Ely,elyme01,C,32,DEN,2011,30,366.0,69,14,27,47,74,4,11,14,50,28,51,0.5490196078431373,0,0,0.0,28,51,0.5490196078431373,0.549,13,21,0.6190476190476191
Semih Erden,erdense01,C,24,TOT,2011,41,595.0,163,20,37,81,118,15,24,34,104,62,111,0.5585585585585585,0,0,0.0,62,111,0.5585585585585585,0.559,39,60,0.65
Jeremy Evans,evansje01,SF,23,UTA,2011,49,463.0,178,24,36,61,97,17,17,19,50,76,115,0.6608695652173913,0,1,0.0,76,114,0.6666666666666666,0.661,26,37,0.7027027027027027
Maurice Evans,evansma01,SF,32,TOT,2011,73,1549.0,461,45,52,104,156,34,14,33,129,177,424,0.4174528301886792,55,167,0.3293413173652694,122,257,0.4747081712062256,0.482,52,58,0.896551724137931
Reggie Evans,evansre01,PF,30,TOR,2011,30,798.0,132,38,119,226,345,29,6,39,89,42,103,0.4077669902912621,0,1,0.0,42,102,0.4117647058823529,0.408,48,88,0.5454545454545454
Tyreke Evans,evansty01,SG,21,SAC,2011,57,2107.0,1012,319,46,229,275,85,30,184,143,382,933,0.4094319399785637,43,148,0.2905405405405405,339,785,0.4318471337579618,0.432,205,266,0.7706766917293233
Patrick Ewing,ewingpa02,SF,26,NOH,2011,7,19.0,3,2,1,1,2,0,1,1,1,0,5,0.0,0,2,0.0,0,3,0.0,0.0,3,4,0.75
Christian Eyenga,eyengch01,SF,21,CLE,2011,44,947.0,303,35,27,96,123,34,28,47,78,130,306,0.4248366013071895,25,91,0.2747252747252747,105,215,0.4883720930232558,0.466,18,28,0.6428571428571429
Jordan Farmar,farmajo01,PG,24,NJN,2011,73,1796.0,701,368,24,149,173,62,6,139,128,255,651,0.391705069124424,109,304,0.3585526315789473,146,347,0.4207492795389049,0.475,82,100,0.82
Derrick Favors,favorde01,PF,19,TOT,2011,78,1535.0,533,39,171,241,412,29,68,77,246,215,416,0.5168269230769231,0,0,0.0,215,416,0.5168269230769231,0.517,103,173,0.5953757225433526
Raymond Felton,feltora01,PG-SG,26,TOT,2011,75,2737.0,1164,625,48,221,269,125,11,221,150,427,1005,0.4248756218905473,116,329,0.3525835866261398,311,676,0.4600591715976331,0.483,194,241,0.8049792531120332
Rudy Fernández,fernaru01,SG,25,POR,2011,78,1821.0,668,193,37,135,172,87,14,88,134,213,575,0.3704347826086956,116,361,0.3213296398891966,97,214,0.4532710280373832,0.471,126,146,0.863013698630137
Kyrylo Fesenko,fesenky01,C,24,UTA,2011,53,456.0,106,18,34,74,108,4,16,25,90,44,100,0.44,0,1,0.0,44,99,0.4444444444444444,0.44,18,46,0.391304347826087
Landry Fields,fieldla01,SG,22,NYK,2011,82,2541.0,797,155,105,416,521,80,17,107,114,299,602,0.4966777408637873,86,219,0.3926940639269406,213,383,0.556135770234987,0.568,113,147,0.7687074829931972
Derek Fisher,fishede01,PG,36,LAL,2011,82,2297.0,558,224,14,138,152,99,8,70,192,206,529,0.389413988657845,63,159,0.3962264150943396,143,370,0.3864864864864865,0.449,83,103,0.8058252427184466
Jonny Flynn,flynnjo01,PG,21,MIN,2011,53,983.0,279,182,12,65,77,34,3,113,58,108,296,0.3648648648648648,31,100,0.31,77,196,0.3928571428571428,0.417,32,42,0.7619047619047619
Gary Forbes,forbega01,SF,25,DEN,2011,63,791.0,326,49,28,88,116,23,6,46,77,124,273,0.4542124542124542,19,58,0.3275862068965517,105,215,0.4883720930232558,0.489,59,87,0.6781609195402298
T.J. Ford,fordtj01,PG,27,IND,2011,41,773.0,223,141,17,64,81,35,8,63,69,91,236,0.3855932203389831,6,32,0.1875,85,204,0.4166666666666667,0.398,35,48,0.7291666666666666
Jeff Foster,fosteje01,C,34,IND,2011,56,940.0,187,46,160,190,350,24,31,26,127,80,167,0.4790419161676646,0,3,0.0,80,164,0.4878048780487805,0.479,27,48,0.5625
Randy Foye,foyera01,SG,27,LAC,2011,63,1551.0,616,170,13,90,103,47,21,95,122,206,531,0.3879472693032015,71,217,0.3271889400921659,135,314,0.4299363057324841,0.455,133,149,0.8926174496644296
Channing Frye,fryech01,PF,27,PHO,2011,77,2541.0,976,96,65,448,513,46,79,73,272,358,829,0.4318455971049457,171,439,0.3895216400911162,187,390,0.4794871794871795,0.535,89,107,0.8317757009345794
Dan Gadzuric,gadzuda01,C-PF,32,TOT,2011,42,463.0,118,14,71,64,135,13,29,29,91,54,129,0.4186046511627907,0,1,0.0,54,128,0.421875,0.419,10,27,0.3703703703703703
Sundiata Gaines,gainesu01,PG,24,TOT,2011,24,301.0,111,42,13,25,38,16,1,27,25,42,105,0.4,9,38,0.2368421052631578,33,67,0.4925373134328358,0.443,18,36,0.5
Danilo Gallinari,gallida01,PF-SF,22,TOT,2011,62,2104.0,970,104,59,246,305,51,27,83,144,265,640,0.4140625,103,293,0.3515358361774744,162,347,0.4668587896253602,0.495,337,391,0.8618925831202046
Francisco García,garcifr01,SF,29,SAC,2011,58,1386.0,560,71,24,109,133,51,49,45,126,207,475,0.4357894736842105,81,224,0.3616071428571428,126,251,0.50199203187251,0.521,65,76,0.8552631578947368
Kevin Garnett,garneke01,PF,34,BOS,2011,71,2220.0,1056,171,83,548,631,95,57,115,148,434,822,0.5279805352798054,1,5,0.2,433,817,0.5299877600979193,0.529,187,217,0.8617511520737328
Marc Gasol,gasolma01,C,26,MEM,2011,81,2586.0,951,200,154,415,569,74,136,146,265,364,691,0.5267727930535456,3,7,0.4285714285714285,361,684,0.5277777777777778,0.529,220,294,0.7482993197278912
Pau Gasol,gasolpa01,C,30,LAL,2011,82,3037.0,1541,273,268,568,836,48,130,142,203,593,1120,0.5294642857142857,1,3,0.3333333333333333,592,1117,0.5299910474485229,0.53,354,430,0.8232558139534883
Rudy Gay,gayru01,SF,24,MEM,2011,54,2152.0,1069,153,82,254,336,91,58,135,131,409,869,0.4706559263521289,57,144,0.3958333333333333,352,725,0.4855172413793103,0.503,194,241,0.8049792531120332
Alonzo Gee,geeal01,SG,23,TOT,2011,56,1118.0,331,38,62,120,182,40,18,55,94,121,264,0.4583333333333333,17,51,0.3333333333333333,104,213,0.488262910798122,0.491,72,92,0.782608695652174
Paul George,georgpa01,SG,20,IND,2011,61,1265.0,476,65,37,187,224,62,26,70,127,179,395,0.4531645569620253,41,138,0.2971014492753623,138,257,0.5369649805447471,0.505,77,101,0.7623762376237624
Daniel Gibson,gibsoda01,SG,24,CLE,2011,67,1865.0,780,201,24,153,177,48,21,80,154,264,660,0.4,118,293,0.4027303754266211,146,367,0.3978201634877384,0.489,134,163,0.8220858895705522
Taj Gibson,gibsota01,PF,25,CHI,2011,80,1742.0,569,58,162,296,458,39,106,71,203,234,502,0.4661354581673306,1,8,0.125,233,494,0.4716599190283401,0.467,100,148,0.6756756756756757
Manu Ginóbili,ginobma01,SG,33,SAS,2011,80,2426.0,1393,393,42,253,295,123,28,174,163,441,1018,0.4332023575638506,154,441,0.3492063492063492,287,577,0.4974003466204506,0.509,357,410,0.8707317073170732
Ryan Gomes,gomesry01,SF,28,LAC,2011,76,2095.0,547,118,61,193,254,62,12,55,159,207,505,0.4099009900990099,72,211,0.3412322274881517,135,294,0.4591836734693877,0.481,61,85,0.7176470588235294
Drew Gooden,goodedr01,PF,29,MIL,2011,35,860.0,396,47,73,165,238,21,18,46,98,156,362,0.430939226519337,3,20,0.15,153,342,0.4473684210526316,0.435,81,102,0.7941176470588235
Ben Gordon,gordobe01,SG,27,DET,2011,82,2131.0,921,171,41,154,195,48,16,141,178,339,770,0.4402597402597402,107,266,0.4022556390977443,232,504,0.4603174603174603,0.51,136,160,0.85
Eric Gordon,gordoer01,SG,22,LAC,2011,56,2112.0,1247,244,45,119,164,71,18,151,115,427,949,0.4499473129610116,106,291,0.3642611683848797,321,658,0.4878419452887538,0.506,287,348,0.8247126436781609
Marcin Gortat,gortama01,C,26,TOT,2011,80,2032.0,817,70,148,483,631,36,91,81,188,338,603,0.560530679933665,1,4,0.25,337,599,0.5626043405676127,0.561,140,193,0.7253886010362695
Joey Graham,grahajo01,SF,28,CLE,2011,39,586.0,202,18,8,76,84,6,7,28,73,82,179,0.4581005586592179,9,30,0.3,73,149,0.4899328859060403,0.483,29,36,0.8055555555555556
Stephen Graham,grahast01,SG,28,NJN,2011,59,959.0,198,40,17,106,123,14,1,38,106,81,200,0.405,5,21,0.238095238095238,76,179,0.4245810055865922,0.418,31,38,0.8157894736842105
Danny Granger,grangda01,SF,27,IND,2011,79,2763.0,1622,203,87,338,425,89,62,206,213,535,1260,0.4246031746031746,157,407,0.3857493857493858,378,853,0.4431418522860492,0.487,395,466,0.8476394849785408
Aaron Gray,grayaa01,C,26,NOH,2011,41,531.0,129,16,59,112,171,11,12,32,96,56,99,0.5656565656565656,0,0,0.0,56,99,0.5656565656565656,0.566,17,34,0.5
Danny Green,greenda02,SG,23,SAS,2011,8,92.0,41,2,3,12,15,2,1,5,7,17,35,0.4857142857142857,7,19,0.3684210526315789,10,16,0.625,0.586,0,0,0.0
Jeff Green,greenje02,PF-SF,24,TOT,2011,75,2427.0,998,108,73,287,360,53,37,99,210,368,820,0.448780487804878,64,211,0.3033175355450237,304,609,0.4991789819376026,0.488,198,244,0.8114754098360656
Willie Green,greenwi01,SG,29,NOH,2011,77,1674.0,672,74,22,139,161,36,13,67,143,270,609,0.4433497536945813,54,155,0.3483870967741935,216,454,0.4757709251101321,0.488,78,100,0.78
Donté Greene,greendo01,SF,22,SAC,2011,69,1127.0,400,48,49,98,147,36,20,60,88,156,386,0.4041450777202072,45,154,0.2922077922077922,111,232,0.4784482758620689,0.462,43,65,0.6615384615384615
Orien Greene,greenor01,SG,28,NJN,2011,3,5.0,3,1,0,0,0,1,0,0,0,1,2,0.5,0,0,0.0,1,2,0.5,0.5,1,2,0.5
Blake Griffin,griffbl01,PF,21,LAC,2011,82,3112.0,1845,312,270,719,989,63,45,223,252,696,1376,0.5058139534883721,7,24,0.2916666666666667,689,1352,0.5096153846153846,0.508,446,695,0.641726618705036
Hamed Haddadi,haddaha01,C,25,MEM,2011,31,168.0,75,5,24,44,68,2,13,11,29,30,58,0.5172413793103449,0,1,0.0,30,57,0.5263157894736842,0.517,15,23,0.6521739130434783
Richard Hamilton,hamilri01,SG,32,DET,2011,55,1498.0,777,171,24,102,126,39,4,88,95,288,671,0.4292101341281669,55,144,0.3819444444444444,233,527,0.4421252371916508,0.47,146,172,0.8488372093023255
Tyler Hansbrough,hansbty01,PF,25,IND,2011,70,1535.0,767,41,145,221,366,37,15,76,160,285,613,0.464926590538336,0,2,0.0,285,611,0.4664484451718494,0.465,197,253,0.7786561264822134
Luke Harangody,haranlu01,PF,23,TOT,2011,49,640.0,193,30,40,103,143,15,17,16,80,79,206,0.3834951456310679,16,66,0.2424242424242424,63,140,0.45,0.422,19,26,0.7307692307692307
James Harden,hardeja01,SG,21,OKC,2011,82,2189.0,998,176,42,213,255,92,24,106,207,298,684,0.435672514619883,113,324,0.3487654320987654,185,360,0.5138888888888888,0.518,289,343,0.8425655976676385
Al Harrington,harrial01,PF,30,DEN,2011,73,1665.0,765,101,76,256,332,39,10,106,202,281,675,0.4162962962962963,117,328,0.3567073170731707,164,347,0.4726224783861671,0.503,86,117,0.7350427350427351
Devin Harris,harride01,PG,27,TOT,2011,71,2254.0,1079,503,17,152,169,70,7,207,163,343,813,0.4218942189421894,58,180,0.3222222222222222,285,633,0.4502369668246445,0.458,335,402,0.8333333333333334
Manny Harris,harrima01,SG,21,CLE,2011,54,933.0,321,85,36,104,140,31,7,63,65,108,289,0.3737024221453287,34,92,0.3695652173913043,74,197,0.3756345177664975,0.433,71,93,0.7634408602150538
Mike Harris,harrimi01,PF,27,HOU,2011,4,16.0,8,1,2,3,5,0,1,1,2,3,6,0.5,0,0,0.0,3,6,0.5,0.5,2,4,0.5
Udonis Haslem,hasleud01,PF,30,MIA,2011,13,345.0,104,6,29,77,106,7,3,14,39,44,86,0.5116279069767442,0,0,0.0,44,86,0.5116279069767442,0.512,16,20,0.8
Spencer Hawes,hawessp01,C,22,PHI,2011,81,1718.0,584,121,129,336,465,29,71,97,201,264,568,0.4647887323943662,9,37,0.2432432432432432,255,531,0.480225988700565,0.473,47,88,0.5340909090909091
Chuck Hayes,hayesch01,C,27,HOU,2011,74,2079.0,582,202,219,380,599,79,49,86,200,244,463,0.5269978401727862,0,2,0.0,244,461,0.5292841648590022,0.527,94,142,0.6619718309859155
Gordon Hayward,haywago01,SF,20,UTA,2011,72,1218.0,388,81,41,98,139,30,19,70,106,142,293,0.4846416382252559,35,74,0.4729729729729729,107,219,0.4885844748858447,0.544,69,97,0.711340206185567
Lazar Hayward,haywala01,SF,24,MIN,2011,42,419.0,160,28,23,47,70,12,7,19,44,55,154,0.3571428571428571,17,60,0.2833333333333333,38,94,0.4042553191489361,0.412,33,42,0.7857142857142857
Brendan Haywood,haywobr01,C,31,DAL,2011,72,1331.0,320,19,129,247,376,16,74,51,146,128,223,0.5739910313901345,0,1,0.0,128,222,0.5765765765765766,0.574,64,177,0.3615819209039548
Luther Head,headlu01,PG,28,SAC,2011,36,586.0,200,70,16,44,60,10,9,32,43,68,164,0.4146341463414634,25,64,0.390625,43,100,0.43,0.491,39,50,0.78
Gerald Henderson,hendege02,SG,23,CHA,2011,68,1661.0,653,101,49,158,207,50,32,64,118,259,570,0.4543859649122807,7,36,0.1944444444444444,252,534,0.4719101123595505,0.461,128,163,0.7852760736196319
Xavier Henry,henryxa01,SG,19,MEM,2011,38,527.0,165,18,9,28,37,11,3,13,48,65,160,0.40625,2,17,0.1176470588235294,63,143,0.4405594405594406,0.413,33,52,0.6346153846153846
Roy Hibbert,hibbero01,C,24,IND,2011,81,2244.0,1025,166,182,428,610,33,142,185,256,410,890,0.4606741573033708,0,4,0.0,410,886,0.4627539503386004,0.461,205,275,0.7454545454545455
J.J. Hickson,hicksjj01,C,22,CLE,2011,80,2256.0,1105,91,217,478,695,48,54,173,215,429,936,0.4583333333333333,0,5,0.0,429,931,0.4607948442534909,0.458,247,367,0.6730245231607629
Nenê,hilarne01,C,28,DEN,2011,75,2291.0,1091,149,145,426,571,84,73,134,238,402,654,0.6146788990825688,1,5,0.2,401,649,0.6178736517719569,0.615,286,402,0.7114427860696517
George Hill,hillge01,PG,24,SAS,2011,76,2148.0,884,193,24,175,199,66,21,99,153,287,633,0.4533965244865718,77,204,0.3774509803921568,210,429,0.4895104895104895,0.514,233,270,0.8629629629629629
Grant Hill,hillgr01,SF,38,PHO,2011,80,2409.0,1056,200,77,261,338,64,35,134,184,399,825,0.4836363636363636,45,114,0.3947368421052631,354,711,0.4978902953586498,0.511,213,257,0.8287937743190662
Jordan Hill,hilljo01,C,23,HOU,2011,72,1125.0,406,29,128,178,306,14,52,62,157,173,352,0.4914772727272727,0,2,0.0,173,350,0.4942857142857143,0.491,60,85,0.7058823529411765
Kirk Hinrich,hinriki01,SG-PG,30,TOT,2011,72,2157.0,737,288,21,161,182,75,17,121,185,278,623,0.4462279293739968,75,188,0.3989361702127659,203,435,0.4666666666666667,0.506,106,126,0.8412698412698413
Jrue Holiday,holidjr01,PG,20,PHI,2011,82,2901.0,1145,531,68,264,332,120,29,218,203,446,999,0.4464464464464464,81,222,0.3648648648648648,365,777,0.4697554697554698,0.487,172,209,0.8229665071770335
Ryan Hollins,holliry01,C,26,CLE,2011,70,1182.0,373,26,70,116,186,22,42,67,199,131,219,0.5981735159817352,0,0,0.0,131,219,0.5981735159817352,0.598,111,163,0.6809815950920245
Al Horford,horfoal01,C,24,ATL,2011,77,2704.0,1178,266,182,536,718,59,80,119,193,513,921,0.5570032573289903,2,4,0.5,511,917,0.5572519083969466,0.558,150,188,0.7978723404255319
Eddie House,houseed01,SG,32,MIA,2011,56,978.0,362,62,9,83,92,32,3,29,68,128,321,0.3987538940809969,68,175,0.3885714285714285,60,146,0.410958904109589,0.505,38,40,0.95
Dwight Howard,howardw01,C,25,ORL,2011,78,2935.0,1784,107,309,789,1098,107,186,279,258,619,1044,0.592911877394636,0,7,0.0,619,1037,0.5969141755062681,0.593,546,916,0.5960698689956332
Josh Howard,howarjo01,SF,30,WAS,2011,18,409.0,152,24,18,56,74,13,5,20,34,58,162,0.3580246913580246,7,29,0.2413793103448276,51,133,0.3834586466165413,0.38,29,47,0.6170212765957447
Juwan Howard,howarju01,PF,37,MIA,2011,57,592.0,139,23,36,86,122,10,4,25,61,55,125,0.44,0,0,0.0,55,125,0.44,0.44,29,35,0.8285714285714286
Lester Hudson,hudsole01,PG,26,WAS,2011,11,73.0,18,17,1,4,5,4,1,7,10,6,24,0.25,4,15,0.2666666666666666,2,9,0.2222222222222222,0.333,2,4,0.5
Kris Humphries,humphkr01,PF,25,NJN,2011,74,2061.0,741,84,225,546,771,33,80,103,168,307,583,0.5265866209262435,0,1,0.0,307,582,0.5274914089347079,0.527,127,191,0.6649214659685864
Serge Ibaka,ibakase01,PF,21,OKC,2011,82,2216.0,808,22,214,408,622,31,198,71,267,335,617,0.5429497568881686,0,1,0.0,335,616,0.5438311688311688,0.543,138,184,0.75
Andre Iguodala,iguodan01,SF,27,PHI,2011,67,2469.0,945,422,61,326,387,101,38,138,109,338,759,0.4453227931488801,61,181,0.3370165745856354,277,578,0.4792387543252595,0.486,208,300,0.6933333333333334
Zydrunas Ilgauskas,ilgauzy01,C,35,MIA,2011,72,1145.0,360,26,108,179,287,23,58,52,185,162,319,0.5078369905956113,0,1,0.0,162,318,0.5094339622641509,0.508,36,46,0.782608695652174
D.J. Mbenga,mbengdj01,C,30,NOH,2011,41,330.0,59,6,35,51,86,6,27,21,52,23,49,0.4693877551020408,0,0,0.0,23,49,0.4693877551020408,0.469,13,18,0.7222222222222222
Ersan İlyasova,ilyaser01,PF,23,MIL,2011,60,1505.0,571,56,105,260,365,51,24,63,159,221,507,0.4358974358974359,36,121,0.2975206611570248,185,386,0.4792746113989637,0.471,93,104,0.8942307692307693
Royal Ivey,iveyro01,SG,29,OKC,2011,25,155.0,41,7,2,14,16,6,1,5,17,16,38,0.4210526315789473,7,16,0.4375,9,22,0.4090909090909091,0.513,2,2,1.0
Jarrett Jack,jackja01,SG-PG,27,TOT,2011,83,1722.0,735,242,20,153,173,54,6,110,102,260,637,0.4081632653061224,33,108,0.3055555555555556,227,529,0.4291115311909262,0.434,182,214,0.8504672897196262
Darnell Jackson,jacksda01,PF,25,SAC,2011,59,486.0,187,14,49,45,94,12,3,23,61,77,158,0.4873417721518987,3,11,0.2727272727272727,74,147,0.5034013605442177,0.497,30,49,0.6122448979591837
Stephen Jackson,jacksst02,SG,32,CHA,2011,67,2405.0,1240,241,53,251,304,80,28,209,161,435,1059,0.4107648725212464,121,359,0.3370473537604457,314,700,0.4485714285714285,0.468,249,305,0.8163934426229508
Damion James,jamesda01,SF,23,NJN,2011,25,403.0,110,20,17,68,85,16,12,25,36,46,103,0.4466019417475728,0,3,0.0,46,100,0.46,0.447,18,28,0.6428571428571429
LeBron James,jamesle01,SF,26,MIA,2011,79,3063.0,2111,554,80,510,590,124,50,284,163,758,1485,0.5104377104377105,92,279,0.3297491039426523,666,1206,0.5522388059701493,0.541,503,663,0.7586726998491704
Antawn Jamison,jamisan01,PF,34,CLE,2011,56,1842.0,1010,93,86,289,375,50,30,77,137,374,876,0.4269406392694064,91,263,0.3460076045627376,283,613,0.4616639477977161,0.479,171,234,0.7307692307692307
Othyus Jeffers,jeffeot01,SG,25,TOT,2011,17,322.0,93,20,25,42,67,17,0,14,32,31,65,0.4769230769230769,1,4,0.25,30,61,0.4918032786885246,0.485,30,46,0.6521739130434783
Al Jefferson,jeffeal01,C,26,UTA,2011,82,2940.0,1528,149,235,559,794,46,153,105,238,654,1319,0.4958301743745261,0,0,0.0,654,1319,0.4958301743745261,0.496,220,289,0.7612456747404844
Richard Jefferson,jefferi01,SF,30,SAS,2011,81,2459.0,891,107,54,256,310,38,34,93,164,304,642,0.4735202492211838,135,307,0.4397394136807817,169,335,0.5044776119402985,0.579,148,195,0.7589743589743589
Jared Jeffries,jeffrja01,PF,29,TOT,2011,42,601.0,74,36,62,54,116,31,17,21,75,30,86,0.3488372093023256,2,9,0.2222222222222222,28,77,0.3636363636363636,0.36,12,29,0.4137931034482758
Brandon Jennings,jennibr01,PG,21,MIL,2011,63,2169.0,1019,305,42,192,234,95,21,146,131,361,926,0.3898488120950324,98,303,0.3234323432343234,263,623,0.4221508828250401,0.443,199,246,0.8089430894308943
Eugene Jeter,jetereu01,PG,27,SAC,2011,62,858.0,255,162,9,61,70,29,2,51,54,106,259,0.4092664092664093,6,30,0.2,100,229,0.4366812227074236,0.421,37,41,0.902439024390244
Yi Jianlian,jianlyi01,PF,23,WAS,2011,63,1112.0,355,25,79,169,248,27,32,51,115,145,347,0.4178674351585014,3,13,0.2307692307692307,142,334,0.4251497005988024,0.422,62,91,0.6813186813186813
Amir Johnson,johnsam01,PF,23,TOR,2011,72,1853.0,688,81,189,272,461,53,88,69,263,281,495,0.5676767676767677,0,1,0.0,281,494,0.5688259109311741,0.568,126,160,0.7875
Armon Johnson,johnsar02,PG,21,POR,2011,38,277.0,110,45,11,25,36,5,1,38,31,46,101,0.4554455445544554,5,12,0.4166666666666667,41,89,0.4606741573033708,0.48,13,22,0.5909090909090909
Chris Johnson,johnsch03,C,25,TOT,2011,14,138.0,33,3,12,20,32,3,9,10,21,9,21,0.4285714285714285,0,0,0.0,9,21,0.4285714285714285,0.429,15,20,0.75
James Johnson,johnsja01,SF,23,TOT,2011,38,822.0,271,89,37,105,142,33,37,64,95,108,237,0.4556962025316455,8,34,0.2352941176470588,100,203,0.4926108374384236,0.473,47,71,0.6619718309859155
Joe Johnson,johnsjo02,SG,29,ATL,2011,72,2554.0,1312,338,59,232,291,47,7,146,131,514,1161,0.4427217915590009,89,300,0.2966666666666667,425,861,0.4936120789779326,0.481,195,243,0.8024691358024691
Trey Johnson,johnstr01,SG,26,TOT,2011,8,94.0,34,11,2,5,7,1,1,5,12,12,33,0.3636363636363636,1,3,0.3333333333333333,11,30,0.3666666666666666,0.379,9,10,0.9
Wesley Johnson,johnswe01,SG,23,MIN,2011,79,2069.0,709,148,51,189,240,58,54,95,163,271,682,0.3973607038123167,103,289,0.356401384083045,168,393,0.4274809160305343,0.473,64,92,0.6956521739130435
Dahntay Jones,jonesda02,SG,30,IND,2011,45,589.0,283,33,4,61,65,20,7,31,70,100,214,0.4672897196261682,14,39,0.358974358974359,86,175,0.4914285714285714,0.5,69,90,0.7666666666666667
Dominique Jones,jonesdo02,SG,22,DAL,2011,18,135.0,42,19,6,19,25,5,3,10,7,14,45,0.3111111111111111,0,4,0.0,14,41,0.3414634146341463,0.311,14,17,0.8235294117647058
James Jones,jonesja02,SF,30,MIA,2011,81,1549.0,475,43,23,137,160,29,19,21,129,146,346,0.4219653179190751,123,287,0.4285714285714285,23,59,0.3898305084745763,0.6,60,72,0.8333333333333334
Solomon Jones,jonesso01,C,26,IND,2011,39,528.0,139,30,45,68,113,12,22,35,94,49,121,0.4049586776859504,0,1,0.0,49,120,0.4083333333333333,0.405,41,62,0.6612903225806451
DeAndre Jordan,jordade01,C,22,LAC,2011,80,2047.0,566,42,207,368,575,41,142,101,255,234,341,0.6862170087976539,0,1,0.0,234,340,0.6882352941176471,0.686,98,217,0.4516129032258064
Chris Kaman,kamanch01,C,28,LAC,2011,32,838.0,397,46,51,174,225,16,48,58,75,177,376,0.4707446808510638,0,0,0.0,177,376,0.4707446808510638,0.471,43,57,0.7543859649122807
Jason Kapono,kaponja01,SF,29,PHI,2011,24,112.0,16,4,3,8,11,2,1,2,4,7,28,0.25,1,8,0.125,6,20,0.3,0.268,1,2,0.5
Jason Kidd,kiddja01,PG,37,DAL,2011,80,2653.0,630,655,35,316,351,134,29,179,119,215,596,0.360738255033557,133,391,0.340153452685422,82,205,0.4,0.472,67,77,0.8701298701298701
Andrei Kirilenko,kirilan01,SF,29,UTA,2011,64,1999.0,750,192,100,227,327,81,74,117,113,253,542,0.466789667896679,36,98,0.3673469387755102,217,444,0.4887387387387387,0.5,208,270,0.7703703703703704
Linas Kleiza,kleizli01,SF,26,TOR,2011,39,1032.0,436,40,37,140,177,19,7,65,99,178,406,0.438423645320197,39,131,0.2977099236641221,139,275,0.5054545454545455,0.486,41,65,0.6307692307692307
Kyle Korver,korveky01,SG,29,CHI,2011,82,1649.0,681,124,12,138,150,35,20,60,156,242,557,0.4344703770197486,120,289,0.4152249134948096,122,268,0.4552238805970149,0.542,77,87,0.8850574712643678
Kosta Koufos,koufoko01,C,21,TOT,2011,50,434.0,160,7,57,73,130,10,25,31,59,68,150,0.4533333333333333,0,2,0.0,68,148,0.4594594594594595,0.453,24,43,0.5581395348837209
Nenad Krstić,krstine01,C,27,TOT,2011,71,1571.0,575,27,124,211,335,26,25,56,184,231,452,0.5110619469026548,0,0,0.0,231,452,0.5110619469026548,0.511,113,146,0.773972602739726
Carl Landry,landrca01,PF,27,TOT,2011,76,2008.0,903,63,165,182,347,40,32,109,196,345,687,0.5021834061135371,0,4,0.0,345,683,0.5051244509516838,0.502,213,288,0.7395833333333334
Acie Law,lawac01,PG,26,TOT,2011,51,726.0,215,84,12,51,63,32,0,43,61,81,186,0.4354838709677419,6,36,0.1666666666666666,75,150,0.5,0.452,47,64,0.734375
Gani Lawal,lawalga01,PF,22,PHO,2011,1,2.0,0,0,0,0,0,0,0,0,1,0,0,0.0,0,0,0.0,0,0,0.0,0.0,0,0,0.0
Ty Lawson,lawsoty01,PG,23,DEN,2011,80,2103.0,933,377,67,142,209,80,4,137,133,346,688,0.502906976744186,69,171,0.4035087719298245,277,517,0.5357833655705996,0.553,172,225,0.7644444444444445
Courtney Lee,leeco01,SG,25,HOU,2011,81,1723.0,672,100,51,158,209,58,18,68,102,253,576,0.4392361111111111,71,174,0.4080459770114942,182,402,0.4527363184079602,0.501,95,120,0.7916666666666666
David Lee,leeda02,PF,27,GSW,2011,73,2634.0,1203,233,217,497,714,74,31,170,211,496,978,0.5071574642126789,1,3,0.3333333333333333,495,975,0.5076923076923077,0.508,210,267,0.7865168539325843
Rashard Lewis,lewisra02,SF-PF,31,TOT,2011,57,1824.0,668,92,71,219,290,52,30,87,159,252,582,0.4329896907216495,87,244,0.3565573770491803,165,338,0.4881656804733728,0.508,77,96,0.8020833333333334
Jeremy Lin,linje01,PG,22,GSW,2011,29,285.0,76,42,12,22,34,33,9,18,31,28,72,0.3888888888888889,1,5,0.2,27,67,0.4029850746268656,0.396,19,25,0.76
Shaun Livingston,livinsh01,PG,25,CHA,2011,73,1261.0,479,164,29,120,149,47,29,88,109,185,397,0.4659949622166247,1,4,0.25,184,393,0.4681933842239186,0.467,108,125,0.864
Brook Lopez,lopezbr01,C,22,NJN,2011,82,2889.0,1673,129,197,291,488,47,120,176,240,644,1309,0.4919786096256685,0,1,0.0,644,1308,0.4923547400611621,0.492,385,489,0.787321063394683
Robin Lopez,lopezro01,C,22,PHO,2011,67,991.0,432,8,82,134,216,18,45,48,143,179,357,0.5014005602240896,0,0,0.0,179,357,0.5014005602240896,0.501,74,100,0.74
Kevin Love,loveke01,PF,22,MIN,2011,73,2611.0,1476,184,330,782,1112,45,28,155,148,482,1026,0.4697855750487329,88,211,0.4170616113744075,394,815,0.4834355828220859,0.513,424,499,0.8496993987975952
Kyle Lowry,lowryky01,PG,24,HOU,2011,75,2563.0,1011,500,89,220,309,102,23,158,207,345,809,0.4264524103831891,129,343,0.3760932944606414,216,466,0.463519313304721,0.506,192,251,0.7649402390438247
John Lucas III,lucasjo02,PG,28,CHI,2011,2,10.0,2,1,0,0,0,0,0,0,0,1,3,0.3333333333333333,0,1,0.0,1,2,0.5,0.333,0,2,0.0
Corey Maggette,maggeco01,SF,31,MIL,2011,67,1401.0,805,84,44,197,241,21,5,127,175,253,559,0.4525939177101968,28,78,0.358974358974359,225,481,0.4677754677754678,0.478,271,325,0.8338461538461538
Jamaal Magloire,magloja01,C,32,MIA,2011,18,158.0,35,3,17,44,61,4,2,5,26,13,22,0.5909090909090909,0,0,0.0,13,22,0.5909090909090909,0.591,9,18,0.5
Ian Mahinmi,mahinia01,C,24,DAL,2011,56,488.0,173,8,43,77,120,14,15,25,105,55,98,0.5612244897959183,0,2,0.0,55,96,0.5729166666666666,0.561,63,82,0.7682926829268293
Shawn Marion,mariosh01,SF,32,DAL,2011,80,2253.0,999,110,168,383,551,68,50,130,144,434,834,0.5203836930455635,5,33,0.1515151515151515,429,801,0.5355805243445693,0.523,126,164,0.7682926829268293
Sean Marks,marksse01,C,35,POR,2011,29,208.0,45,4,16,24,40,3,5,11,44,19,44,0.4318181818181818,2,2,1.0,17,42,0.4047619047619047,0.455,5,8,0.625
Cartier Martin,martica01,SF,26,WAS,2011,52,542.0,209,18,20,54,74,18,6,16,52,71,182,0.3901098901098901,39,99,0.3939393939393939,32,83,0.3855421686746988,0.497,28,40,0.7
Kenyon Martin,martike01,PF,33,DEN,2011,48,1233.0,414,109,67,230,297,43,35,59,136,185,362,0.511049723756906,2,9,0.2222222222222222,183,353,0.5184135977337111,0.514,42,72,0.5833333333333334
Kevin Martin,martike02,SG,27,HOU,2011,80,2603.0,1876,198,28,230,258,80,15,184,155,553,1267,0.43646408839779,176,459,0.3834422657952069,377,808,0.4665841584158416,0.506,594,669,0.8878923766816144
Roger Mason,masonro01,SG,30,NYK,2011,26,319.0,75,20,5,38,43,6,2,6,25,26,77,0.3376623376623376,16,44,0.3636363636363636,10,33,0.303030303030303,0.442,7,10,0.7
Wesley Matthews,matthwe02,SG,24,POR,2011,82,2758.0,1300,164,48,210,258,102,9,138,195,440,979,0.449438202247191,154,378,0.4074074074074074,286,601,0.475873544093178,0.528,266,315,0.8444444444444444
Jason Maxiell,maxieja01,PF,27,DET,2011,57,930.0,237,17,66,107,173,24,21,44,92,93,189,0.492063492063492,0,0,0.0,93,189,0.492063492063492,0.492,51,99,0.5151515151515151
Eric Maynor,maynoer01,PG,23,OKC,2011,82,1200.0,348,238,25,96,121,35,6,77,96,134,333,0.4024024024024024,37,96,0.3854166666666667,97,237,0.4092827004219409,0.458,43,59,0.7288135593220338
O.J. Mayo,mayooj01,SG,23,MEM,2011,71,1869.0,803,145,35,135,170,73,26,99,127,304,747,0.4069611780455154,96,264,0.3636363636363636,208,483,0.4306418219461698,0.471,99,131,0.7557251908396947
Luc Mbah a Moute,mbahalu01,PF,24,MIL,2011,79,2093.0,529,68,169,251,420,72,28,77,180,198,428,0.4626168224299065,0,7,0.0,198,421,0.4703087885985748,0.463,133,188,0.7074468085106383
Antonio McDyess,mcdyean01,PF,36,SAS,2011,73,1387.0,390,84,122,273,395,36,39,72,163,169,344,0.4912790697674418,0,1,0.0,169,343,0.4927113702623906,0.491,52,77,0.6753246753246753
JaVale McGee,mcgeeja01,C,23,WAS,2011,79,2193.0,798,38,223,411,634,41,193,102,232,332,604,0.5496688741721855,0,3,0.0,332,601,0.5524126455906821,0.55,134,230,0.5826086956521739
Tracy McGrady,mcgratr01,SG,31,DET,2011,72,1686.0,574,252,49,202,251,66,34,102,101,227,514,0.4416342412451361,30,88,0.3409090909090909,197,426,0.4624413145539906,0.471,90,129,0.6976744186046512
Dominic McGuire,mcguido01,SF,25,CHA,2011,52,760.0,174,43,63,136,199,10,33,25,94,72,182,0.3956043956043956,0,2,0.0,72,180,0.4,0.396,30,39,0.7692307692307693
Josh McRoberts,mcrobjo01,PF,23,IND,2011,72,1597.0,533,150,109,273,382,47,57,93,165,211,386,0.5466321243523317,23,60,0.3833333333333333,188,326,0.5766871165644172,0.576,88,119,0.7394957983193278
Jodie Meeks,meeksjo01,SG,23,PHI,2011,74,2062.0,774,78,21,150,171,63,4,60,97,242,570,0.4245614035087719,138,348,0.396551724137931,104,222,0.4684684684684684,0.546,152,170,0.8941176470588236
Pops Mensah-Bonsu,mensapo01,PF,27,NOH,2011,7,35.0,2,2,3,8,11,0,0,2,11,1,3,0.3333333333333333,0,0,0.0,1,3,0.3333333333333333,0.333,0,0,0.0
C.J. Miles,milescj01,SF,23,UTA,2011,78,1969.0,1000,135,54,201,255,74,38,93,221,366,899,0.407119021134594,109,339,0.3215339233038348,257,560,0.4589285714285714,0.468,159,196,0.8112244897959183
Darko Miličić,milicda01,C,25,MIN,2011,69,1686.0,606,104,133,227,360,54,140,151,229,271,578,0.4688581314878893,0,0,0.0,271,578,0.4688581314878893,0.469,64,115,0.5565217391304348
Andre Miller,millean02,PG,34,POR,2011,81,2650.0,1029,566,97,205,302,114,12,197,171,388,844,0.4597156398104265,4,37,0.1081081081081081,384,807,0.4758364312267658,0.462,249,292,0.8527397260273972
Brad Miller,millebr01,C,34,HOU,2011,60,1015.0,382,145,44,178,222,28,21,54,98,132,296,0.4459459459459459,40,107,0.3738317757009345,92,189,0.4867724867724867,0.514,78,94,0.8297872340425532
Mike Miller,millemi01,SG,30,MIA,2011,41,838.0,228,51,38,146,184,20,2,41,88,81,202,0.400990099009901,43,118,0.3644067796610169,38,84,0.4523809523809524,0.507,23,34,0.6764705882352942
Patty Mills,millspa02,PG,22,POR,2011,64,783.0,353,109,19,32,51,27,1,62,63,135,328,0.4115853658536585,47,133,0.3533834586466165,88,195,0.4512820512820513,0.483,36,47,0.7659574468085106
Paul Millsap,millspa01,PF,25,UTA,2011,76,2605.0,1315,187,164,415,579,103,69,145,272,525,988,0.5313765182186235,9,23,0.391304347826087,516,965,0.5347150259067357,0.536,256,338,0.757396449704142
Yao Ming,mingya01,C,30,HOU,2011,5,91.0,51,4,7,20,27,0,8,7,13,18,37,0.4864864864864865,0,0,0.0,18,37,0.4864864864864865,0.486,15,16,0.9375
Nazr Mohammed,mohamna01,C,33,TOT,2011,75,1280.0,535,23,140,228,368,30,56,70,184,234,448,0.5223214285714286,0,1,0.0,234,447,0.5234899328859061,0.522,67,112,0.5982142857142857
Greg Monroe,monrogr01,C,20,DET,2011,80,2222.0,751,105,248,353,601,93,45,81,196,303,550,0.5509090909090909,0,1,0.0,303,549,0.5519125683060109,0.551,145,233,0.6223175965665236
Jamario Moon,moonja01,SF,30,TOT,2011,59,1042.0,255,52,23,142,165,28,33,22,65,101,248,0.407258064516129,38,123,0.3089430894308943,63,125,0.504,0.484,15,17,0.8823529411764706
Anthony Morrow,morroan01,SG,25,NJN,2011,58,1856.0,764,68,37,135,172,19,7,54,135,279,620,0.45,110,260,0.4230769230769231,169,360,0.4694444444444444,0.539,96,107,0.897196261682243
Timofey Mozgov,mozgoti01,C,24,TOT,2011,45,524.0,163,15,46,75,121,15,25,35,84,63,133,0.4736842105263157,0,0,0.0,63,133,0.4736842105263157,0.474,37,52,0.7115384615384616
Byron Mullens,mulleby01,PF,21,OKC,2011,13,85.0,25,0,6,18,24,2,3,8,11,9,28,0.3214285714285714,0,0,0.0,9,28,0.3214285714285714,0.321,7,14,0.5
Troy Murphy,murphtr01,PF,30,TOT,2011,35,466.0,109,23,22,91,113,15,3,20,47,42,114,0.3684210526315789,5,33,0.1515151515151515,37,81,0.4567901234567901,0.39,20,30,0.6666666666666666
Hamady N'Diaye,ndiayha01,C,24,WAS,2011,16,80.0,14,0,2,5,7,2,5,3,18,4,5,0.8,0,0,0.0,4,5,0.8,0.8,6,12,0.5
Eduardo Nájera,najered01,PF,34,CHA,2011,31,372.0,69,20,14,30,44,11,6,13,52,26,72,0.3611111111111111,11,34,0.3235294117647059,15,38,0.3947368421052631,0.438,6,11,0.5454545454545454
Steve Nash,nashst01,PG,36,PHO,2011,75,2497.0,1106,855,40,220,260,48,4,265,87,399,811,0.4919852034525277,81,205,0.3951219512195122,318,606,0.5247524752475248,0.542,227,249,0.9116465863453816
Gary Neal,nealga01,SG,26,SAS,2011,80,1685.0,783,96,21,175,196,27,4,78,148,285,632,0.4509493670886076,129,308,0.4188311688311688,156,324,0.4814814814814814,0.553,84,104,0.8076923076923077
Jameer Nelson,nelsoja01,PG,28,ORL,2011,76,2319.0,997,456,37,189,226,75,3,194,209,374,838,0.4463007159904534,119,297,0.4006734006734007,255,541,0.4713493530499076,0.517,130,162,0.8024691358024691
Joakim Noah,noahjo01,C,25,CHI,2011,48,1576.0,561,107,182,316,498,48,72,90,156,211,402,0.5248756218905473,0,1,0.0,211,401,0.5261845386533666,0.525,139,188,0.7393617021276596
Andrés Nocioni,nocioan01,SF,31,PHI,2011,54,931.0,327,45,19,150,169,14,15,47,100,118,277,0.4259927797833935,42,118,0.3559322033898305,76,159,0.4779874213836478,0.502,49,61,0.8032786885245902
Steve Novak,novakst01,SF,27,TOT,2011,30,215.0,104,3,4,24,28,1,5,4,14,35,67,0.5223880597014925,26,46,0.5652173913043478,9,21,0.4285714285714285,0.716,8,8,1.0
Dirk Nowitzki,nowitdi01,PF,32,DAL,2011,73,2504.0,1681,190,50,463,513,38,47,137,172,610,1179,0.5173876166242578,66,168,0.3928571428571428,544,1011,0.5380811078140455,0.545,395,443,0.891647855530474
Jermaine O'Neal,onealje01,C,32,BOS,2011,24,431.0,129,12,25,63,88,2,30,27,65,50,109,0.4587155963302752,0,1,0.0,50,108,0.4629629629629629,0.459,29,43,0.6744186046511628
Shaquille O'Neal,onealsh01,C,38,BOS,2011,37,752.0,341,26,48,130,178,16,42,56,120,134,201,0.6666666666666666,0,0,0.0,134,201,0.6666666666666666,0.667,73,131,0.5572519083969466
Fabricio Oberto,obertfa01,C,35,POR,2011,5,45.0,7,0,3,4,7,0,0,3,10,3,5,0.6,0,0,0.0,3,5,0.6,0.6,1,2,0.5
Lamar Odom,odomla01,PF,31,LAL,2011,82,2639.0,1180,249,175,535,710,47,61,139,200,473,893,0.5296752519596865,68,178,0.3820224719101123,405,715,0.5664335664335665,0.568,166,246,0.6747967479674797
Emeka Okafor,okafoem01,C,28,NOH,2011,72,2287.0,745,42,230,454,684,40,127,119,230,300,524,0.5725190839694656,0,1,0.0,300,523,0.5736137667304015,0.573,145,258,0.562015503875969
Mehmet Okur,okurme01,C,31,UTA,2011,13,168.0,64,19,9,21,30,4,4,7,18,22,62,0.3548387096774194,5,16,0.3125,17,46,0.3695652173913043,0.395,15,20,0.75
Travis Outlaw,outlatr01,SF,26,NJN,2011,82,2358.0,756,84,54,271,325,34,36,71,148,274,731,0.3748290013679891,76,252,0.3015873015873015,198,479,0.4133611691022965,0.427,132,171,0.7719298245614035
Larry Owens,owensla01,SF,28,TOT,2011,12,143.0,40,8,1,14,15,9,5,5,18,15,32,0.46875,6,13,0.4615384615384615,9,19,0.4736842105263157,0.563,4,9,0.4444444444444444
Zaza Pachulia,pachuza01,C,26,ATL,2011,79,1244.0,349,58,119,214,333,34,22,69,184,107,232,0.4612068965517241,0,0,0.0,107,232,0.4612068965517241,0.461,135,179,0.7541899441340782
Anthony Parker,parkean01,SF,35,CLE,2011,72,2091.0,600,218,33,185,218,67,10,80,109,220,552,0.3985507246376811,86,227,0.3788546255506608,134,325,0.4123076923076923,0.476,74,95,0.7789473684210526
Tony Parker,parketo01,PG,28,SAS,2011,78,2528.0,1368,513,30,208,238,90,3,200,135,555,1069,0.5191768007483629,25,70,0.3571428571428571,530,999,0.5305305305305306,0.531,233,303,0.768976897689769
Patrick Patterson,pattepa01,PF,21,HOU,2011,52,868.0,328,41,86,114,200,17,37,31,77,149,267,0.5580524344569289,0,2,0.0,149,265,0.5622641509433962,0.558,30,42,0.7142857142857143
Chris Paul,paulch01,PG,25,NOH,2011,80,2880.0,1268,782,38,289,327,188,5,177,196,430,928,0.4633620689655172,71,183,0.3879781420765027,359,745,0.4818791946308725,0.502,337,384,0.8776041666666666
Sasha Pavlović,pavloal01,SF-SG,27,TOT,2011,31,362.0,76,16,1,31,32,10,7,12,34,29,72,0.4027777777777778,12,31,0.3870967741935484,17,41,0.4146341463414634,0.486,6,10,0.6
Nikola Peković,pekovni01,C,25,MIN,2011,65,887.0,359,27,90,103,193,18,35,91,181,136,263,0.5171102661596958,0,0,0.0,136,263,0.5171102661596958,0.517,87,114,0.7631578947368421
Kendrick Perkins,perkike01,C,26,TOT,2011,29,742.0,174,26,62,170,232,9,26,56,91,67,130,0.5153846153846153,0,0,0.0,67,130,0.5153846153846153,0.515,40,72,0.5555555555555556
Morris Peterson,petermo01,SG,33,OKC,2011,4,23.0,4,1,0,3,3,0,0,0,5,2,5,0.4,0,1,0.0,2,4,0.5,0.4,0,0,0.0
Johan Petro,petrojo01,C,25,NJN,2011,77,893.0,273,44,62,150,212,34,34,46,178,129,290,0.4448275862068965,0,4,0.0,129,286,0.451048951048951,0.445,15,28,0.5357142857142857
Paul Pierce,piercpa01,SF,33,BOS,2011,80,2774.0,1511,260,34,396,430,80,51,171,231,507,1021,0.4965719882468168,111,297,0.3737373737373737,396,724,0.5469613259668509,0.551,386,449,0.8596881959910914
Mickaël Piétrus,pietrmi01,SG-SF,28,TOT,2011,57,1107.0,410,33,15,111,126,29,21,39,101,143,365,0.3917808219178082,85,236,0.3601694915254237,58,129,0.4496124031007752,0.508,39,57,0.6842105263157895
Dexter Pittman,pittmde01,C,22,MIA,2011,2,11.0,2,0,1,2,3,0,0,2,2,1,3,0.3333333333333333,0,0,0.0,1,3,0.3333333333333333,0.333,0,0,0.0
Quincy Pondexter,pondequ01,SF,22,NOH,2011,66,734.0,188,28,23,65,88,17,10,16,63,73,180,0.4055555555555555,18,50,0.36,55,130,0.4230769230769231,0.456,24,34,0.7058823529411765
James Posey,poseyja01,SF,34,IND,2011,49,839.0,240,34,10,137,147,24,6,24,103,81,241,0.3360995850622407,67,212,0.3160377358490566,14,29,0.4827586206896552,0.475,11,15,0.7333333333333333
Leon Powe,powele01,C-PF,27,TOT,2011,30,328.0,158,7,24,39,63,10,4,12,44,59,119,0.4957983193277311,0,2,0.0,59,117,0.5042735042735043,0.496,40,72,0.5555555555555556
Josh Powell,poweljo01,PF,28,ATL,2011,54,653.0,224,22,49,86,135,5,5,53,78,94,208,0.4519230769230769,0,1,0.0,94,207,0.4541062801932367,0.452,36,45,0.8
A.J. Price,priceaj01,PG,24,IND,2011,50,795.0,323,111,16,56,72,29,1,53,61,114,320,0.35625,41,149,0.2751677852348993,73,171,0.4269005847953216,0.42,54,81,0.6666666666666666
Ronnie Price,pricero01,SG,27,UTA,2011,59,717.0,197,56,22,39,61,42,5,55,106,74,210,0.3523809523809524,20,69,0.2898550724637681,54,141,0.3829787234042553,0.4,29,39,0.7435897435897436
Tayshaun Prince,princta01,SF,30,DET,2011,78,2562.0,1098,215,78,251,329,30,41,82,90,473,1001,0.4725274725274725,34,98,0.3469387755102041,439,903,0.486157253599114,0.49,118,168,0.7023809523809523
Joel Przybilla,przybjo01,C,31,TOT,2011,36,519.0,64,13,37,108,145,5,15,29,79,25,44,0.5681818181818182,0,0,0.0,25,44,0.5681818181818182,0.568,14,27,0.5185185185185185
Chris Quinn,quinnch01,PG,27,SAS,2011,41,292.0,81,42,3,22,25,5,1,12,29,33,91,0.3626373626373626,11,37,0.2972972972972973,22,54,0.4074074074074074,0.423,4,8,0.5
Vladimir Radmanović,radmavl01,PF,30,GSW,2011,74,1169.0,374,79,64,148,212,44,44,57,157,137,318,0.4308176100628931,70,173,0.4046242774566474,67,145,0.4620689655172413,0.541,30,34,0.8823529411764706
Anthony Randolph,randoan01,C-PF,21,TOT,2011,40,590.0,305,33,43,117,160,22,24,53,62,123,264,0.4659090909090909,1,4,0.25,122,260,0.4692307692307692,0.468,58,86,0.6744186046511628
Zach Randolph,randoza01,PF,29,MEM,2011,75,2724.0,1504,163,326,588,914,63,25,151,175,598,1188,0.5033670033670034,8,43,0.1860465116279069,590,1145,0.5152838427947598,0.507,300,396,0.7575757575757576
Theo Ratliff,ratlith01,C,37,LAL,2011,10,71.0,2,3,6,7,13,2,5,3,7,1,6,0.1666666666666666,0,0,0.0,1,6,0.1666666666666666,0.167,0,2,0.0
Andy Rautins,rautian01,SG,24,NYK,2011,5,24.0,8,3,0,1,1,1,0,7,0,3,7,0.4285714285714285,1,4,0.25,2,3,0.6666666666666666,0.5,1,2,0.5
Michael Redd,reddmi01,SG,31,MIL,2011,10,134.0,44,12,0,8,8,2,1,4,4,18,45,0.4,4,17,0.2352941176470588,14,28,0.5,0.444,4,4,1.0
J.J. Redick,redicjj01,SG,26,ORL,2011,59,1513.0,593,102,6,107,113,29,3,53,80,197,447,0.4407158836689038,87,219,0.3972602739726027,110,228,0.4824561403508772,0.538,112,128,0.875
Jason Richardson,richaja01,SG,30,TOT,2011,80,2715.0,1249,147,67,264,331,93,13,95,162,472,1056,0.4469696969696969,189,479,0.3945720250521921,283,577,0.4904679376083189,0.536,116,159,0.7295597484276729
Quentin Richardson,richaqu01,SF,30,ORL,2011,57,955.0,249,38,39,139,178,25,5,33,74,87,255,0.3411764705882353,42,146,0.2876712328767123,45,109,0.4128440366972477,0.424,33,44,0.75
Luke Ridnour,ridnolu01,PG,29,MIN,2011,71,2159.0,840,384,37,162,199,89,10,158,146,319,681,0.4684287812041116,81,184,0.4402173913043478,238,497,0.4788732394366197,0.528,121,137,0.8832116788321168
Nate Robinson,robinna01,PG,26,TOT,2011,59,1013.0,401,111,15,75,90,29,4,68,115,150,376,0.3989361702127659,65,200,0.325,85,176,0.4829545454545454,0.485,36,44,0.8181818181818182
Rajon Rondo,rondora01,PG,24,BOS,2011,68,2527.0,721,760,87,210,297,153,11,234,120,318,670,0.4746268656716418,10,43,0.2325581395348837,308,627,0.4912280701754385,0.482,75,132,0.5681818181818182
Derrick Rose,rosede01,PG,22,CHI,2011,81,3026.0,2026,623,81,249,330,85,51,278,136,711,1597,0.4452097683155917,128,385,0.3324675324675324,583,1212,0.481023102310231,0.485,476,555,0.8576576576576577
Quinton Ross,rossqu01,SF,29,NJN,2011,36,353.0,57,10,10,20,30,3,6,7,40,26,59,0.4406779661016949,0,3,0.0,26,56,0.4642857142857143,0.441,5,14,0.3571428571428571
Brandon Roy,roybr01,SG,26,POR,2011,47,1310.0,573,129,28,93,121,37,12,55,76,209,523,0.3996175908221797,38,114,0.3333333333333333,171,409,0.4180929095354523,0.436,117,138,0.8478260869565217
Brandon Rush,rushbr01,SG,25,IND,2011,67,1754.0,607,62,33,184,217,41,35,69,107,217,515,0.4213592233009708,93,223,0.4170403587443946,124,292,0.4246575342465753,0.512,80,106,0.7547169811320755
John Salmons,salmojo01,SG,31,MIL,2011,73,2554.0,1024,252,27,239,266,72,28,137,157,373,898,0.4153674832962138,83,219,0.3789954337899543,290,679,0.4270986745213549,0.462,195,240,0.8125
Samardo Samuels,samuesa01,PF,22,CLE,2011,37,701.0,288,17,75,83,158,15,18,53,88,110,241,0.4564315352697095,0,3,0.0,110,238,0.4621848739495798,0.456,68,110,0.6181818181818182
Larry Sanders,sandela01,C,22,MIL,2011,60,872.0,260,16,59,119,178,22,72,38,117,116,268,0.4328358208955223,0,0,0.0,116,268,0.4328358208955223,0.433,28,50,0.56
Brian Scalabrine,scalabr01,PF,32,CHI,2011,18,88.0,20,6,1,7,8,3,4,5,18,10,19,0.5263157894736842,0,5,0.0,10,14,0.7142857142857143,0.526,0,0,0.0
Luis Scola,scolalu01,PF,30,HOU,2011,74,2412.0,1352,185,147,459,606,48,44,147,227,569,1129,0.503985828166519,0,3,0.0,569,1126,0.5053285968028419,0.504,214,290,0.7379310344827587
Thabo Sefolosha,sefolth01,SG,26,OKC,2011,79,2049.0,401,111,65,281,346,97,38,55,171,157,333,0.4714714714714714,28,102,0.2745098039215686,129,231,0.5584415584415584,0.514,59,79,0.7468354430379747
Kevin Séraphin,serapke01,PF,21,WAS,2011,58,635.0,154,10,80,72,152,17,28,42,126,66,147,0.4489795918367347,0,0,0.0,66,147,0.4489795918367347,0.449,22,31,0.7096774193548387
Ramon Sessions,sessira01,PG,24,CLE,2011,81,2133.0,1075,419,46,209,255,60,8,178,93,362,776,0.4664948453608247,3,15,0.2,359,761,0.4717477003942181,0.468,348,423,0.8226950354609929
Mustafa Shakur,shakumu01,PG,26,WAS,2011,22,159.0,51,25,7,15,22,5,3,18,15,21,59,0.3559322033898305,1,10,0.1,20,49,0.4081632653061224,0.364,8,15,0.5333333333333333
Garret Siler,silerga01,C,24,PHO,2011,21,101.0,45,3,16,12,28,1,4,10,20,17,31,0.5483870967741935,0,0,0.0,17,31,0.5483870967741935,0.548,11,22,0.5
Bobby Simmons,simmobo01,SF,30,SAS,2011,2,16.0,0,2,0,0,0,0,0,0,2,0,3,0.0,0,3,0.0,0,0,0.0,0.0,0,0,0.0
Brian Skinner,skinnbr01,C,34,MIL,2011,2,6.0,0,0,0,0,0,0,0,0,0,0,0,0.0,0,0,0.0,0,0,0.0,0.0,0,0,0.0
Craig Smith,smithcr01,PF,27,LAC,2011,48,586.0,258,31,43,74,117,16,7,33,84,104,188,0.5531914893617021,0,5,0.0,104,183,0.5683060109289617,0.553,50,68,0.7352941176470589
Ish Smith,smithis01,PG,22,TOT,2011,43,442.0,101,79,7,40,47,18,2,34,37,43,115,0.3739130434782609,3,10,0.3,40,105,0.3809523809523809,0.387,12,21,0.5714285714285714
J.R. Smith,smithjr01,SF,25,DEN,2011,79,1968.0,969,175,45,277,322,92,16,100,173,341,784,0.4349489795918367,124,318,0.389937106918239,217,466,0.4656652360515021,0.514,163,221,0.7375565610859729
Jason Smith,smithja02,C,24,NOH,2011,77,1102.0,331,36,89,152,241,26,32,53,150,136,307,0.4429967426710097,0,2,0.0,136,305,0.4459016393442623,0.443,59,70,0.8428571428571429
Joe Smith,smithjo02,PF,35,TOT,2011,16,69.0,8,4,3,18,21,0,4,5,13,3,16,0.1875,0,0,0.0,3,16,0.1875,0.188,2,2,1.0
Josh Smith,smithjo03,PF,25,ATL,2011,77,2645.0,1274,255,134,523,657,99,120,197,217,497,1041,0.4774255523535062,51,154,0.3311688311688311,446,887,0.5028184892897407,0.502,229,316,0.7246835443037974
Darius Songaila,songada01,C,32,PHI,2011,10,71.0,16,2,2,8,10,0,0,4,16,7,15,0.4666666666666667,0,0,0.0,7,15,0.4666666666666667,0.467,2,4,0.5
Marreese Speights,speigma01,C,23,PHI,2011,64,734.0,344,30,64,146,210,8,19,40,120,144,291,0.4948453608247423,1,4,0.25,143,287,0.4982578397212543,0.497,55,73,0.7534246575342466
Tiago Splitter,splitti01,C,26,SAS,2011,60,738.0,278,26,72,129,201,29,17,32,91,101,191,0.5287958115183246,0,1,0.0,101,190,0.531578947368421,0.529,76,140,0.5428571428571428
Jerry Stackhouse,stackje01,SG,36,MIA,2011,7,50.0,12,3,1,6,7,0,2,2,3,3,12,0.25,1,4,0.25,2,8,0.25,0.292,5,7,0.7142857142857143
Lance Stephenson,stephla01,SG,20,IND,2011,12,115.0,37,21,1,17,18,4,0,16,14,13,39,0.3333333333333333,0,5,0.0,13,34,0.3823529411764705,0.333,11,14,0.7857142857142857
DeShawn Stevenson,stevede01,SG,29,DAL,2011,72,1158.0,383,77,20,86,106,21,5,44,71,128,330,0.3878787878787879,94,249,0.3775100401606425,34,81,0.419753086419753,0.53,33,43,0.7674418604651163
Peja Stojaković,stojape01,SF,33,TOT,2011,33,617.0,280,29,14,61,75,13,2,17,24,100,227,0.4405286343612334,57,136,0.4191176470588235,43,91,0.4725274725274725,0.566,23,25,0.92
Amar'e Stoudemire,stoudam01,C,28,NYK,2011,78,2870.0,1971,202,198,438,636,71,150,250,274,744,1482,0.5020242914979757,10,23,0.4347826086956521,734,1459,0.5030843043180261,0.505,473,597,0.7922948073701842
Rodney Stuckey,stuckro01,PG,24,DET,2011,70,2183.0,1082,361,70,146,216,76,10,155,177,363,827,0.4389359129383313,26,90,0.2888888888888888,337,737,0.457259158751696,0.455,330,381,0.8661417322834646
DaJuan Summers,summeda01,SF,23,DET,2011,22,199.0,74,2,2,10,12,3,1,13,21,28,69,0.4057971014492754,9,21,0.4285714285714285,19,48,0.3958333333333333,0.471,9,20,0.45
Pape Sy,sypa01,SF,22,ATL,2011,3,21.0,7,2,2,1,3,1,0,3,1,2,6,0.3333333333333333,0,1,0.0,2,5,0.4,0.333,3,3,1.0
Jermaine Taylor,tayloje02,SG,24,TOT,2011,34,483.0,223,32,26,36,62,14,5,46,39,94,196,0.4795918367346938,14,45,0.3111111111111111,80,151,0.5298013245033113,0.515,21,28,0.75
Jeff Teague,teaguje01,PG,22,ATL,2011,70,963.0,361,138,11,91,102,45,25,64,82,133,304,0.4375,18,48,0.375,115,256,0.44921875,0.467,77,97,0.7938144329896907
Sebastian Telfair,telfase01,PG,25,MIN,2011,37,711.0,266,111,17,37,54,25,3,64,64,97,241,0.4024896265560166,28,78,0.358974358974359,69,163,0.4233128834355828,0.461,44,60,0.7333333333333333
Garrett Temple,templga01,PG-SG,24,TOT,2011,24,230.0,57,32,1,22,23,11,6,23,24,20,68,0.2941176470588235,10,37,0.2702702702702703,10,31,0.3225806451612903,0.368,7,17,0.4117647058823529
Jason Terry,terryja01,SG,33,DAL,2011,82,2564.0,1293,334,24,129,153,93,13,167,140,492,1091,0.4509624197983501,127,351,0.3618233618233618,365,740,0.4932432432432432,0.509,182,214,0.8504672897196262
Hasheem Thabeet,thabeha01,C,23,TOT,2011,47,373.0,53,4,24,51,75,9,16,17,76,17,40,0.425,0,0,0.0,17,40,0.425,0.425,19,35,0.5428571428571428
Etan Thomas,thomaet01,C,32,ATL,2011,13,82.0,32,2,6,17,23,1,4,5,11,10,21,0.4761904761904761,0,0,0.0,10,21,0.4761904761904761,0.476,12,15,0.8
Kurt Thomas,thomaku01,PF,38,CHI,2011,52,1178.0,211,60,75,226,301,32,42,42,164,95,186,0.510752688172043,1,1,1.0,94,185,0.5081081081081081,0.513,20,32,0.625
Tyrus Thomas,thomaty01,C,24,CHA,2011,41,861.0,419,29,65,159,224,30,66,65,113,156,331,0.4712990936555891,0,3,0.0,156,328,0.4756097560975609,0.471,107,136,0.7867647058823529
Jason Thompson,thompja02,PF,24,SAC,2011,75,1748.0,663,88,144,310,454,28,44,99,212,271,534,0.5074906367041199,0,3,0.0,271,531,0.5103578154425612,0.507,121,200,0.605
Al Thornton,thornal01,SF-PF,27,TOT,2011,71,1383.0,524,62,56,157,213,35,12,64,143,205,431,0.4756380510440835,4,26,0.1538461538461538,201,405,0.4962962962962963,0.48,110,142,0.7746478873239436
Marcus Thornton,thornma01,SG,23,TOT,2011,73,1775.0,933,135,61,197,258,64,9,93,110,350,807,0.4337050805452292,88,240,0.3666666666666666,262,567,0.4620811287477954,0.488,145,184,0.7880434782608695
Anthony Tolliver,tollian01,SF,25,MIN,2011,65,1362.0,434,82,92,203,295,28,28,49,145,141,313,0.4504792332268371,47,115,0.408695652173913,94,198,0.4747474747474747,0.526,105,131,0.8015267175572519
Ronny Turiaf,turiaro01,C,28,NYK,2011,64,1141.0,267,92,64,143,207,35,73,41,160,103,163,0.6319018404907976,0,0,0.0,103,163,0.6319018404907976,0.632,61,98,0.6224489795918368
Hedo Türkoğlu,turkohe01,SF-PF,31,TOT,2011,81,2540.0,877,343,45,311,356,72,34,132,247,322,722,0.445983379501385,127,310,0.4096774193548387,195,412,0.4733009708737864,0.534,106,156,0.6794871794871795
Evan Turner,turneev01,SG,22,PHI,2011,78,1797.0,565,159,42,264,306,49,14,80,138,225,529,0.4253308128544423,14,44,0.3181818181818182,211,485,0.4350515463917526,0.439,101,125,0.808
Ekpe Udoh,udohek01,C,23,GSW,2011,58,1030.0,236,40,80,101,181,22,86,48,144,97,222,0.4369369369369369,0,0,0.0,97,222,0.4369369369369369,0.437,42,64,0.65625
Ime Udoka,udokaim01,SF,33,SAS,2011,20,130.0,14,13,5,14,19,8,1,5,14,5,21,0.238095238095238,0,8,0.0,5,13,0.3846153846153846,0.238,4,8,0.5
Beno Udrih,udrihbe01,PG,28,SAC,2011,79,2734.0,1086,386,41,224,265,94,9,141,181,412,824,0.5,65,182,0.3571428571428571,347,642,0.5404984423676013,0.539,197,228,0.8640350877192983
Ben Uzoh,uzohbe01,PG,22,NJN,2011,42,438.0,158,69,30,31,61,13,8,25,29,61,144,0.4236111111111111,3,8,0.375,58,136,0.4264705882352941,0.434,33,56,0.5892857142857143
Anderson Varejão,varejan01,C,28,CLE,2011,31,994.0,282,45,98,203,301,27,38,40,87,114,216,0.5277777777777778,0,2,0.0,114,214,0.5327102803738317,0.528,54,81,0.6666666666666666
Greivis Vásquez,vasqugr01,PG,24,MEM,2011,70,860.0,249,151,12,61,73,22,4,70,83,95,233,0.407725321888412,25,86,0.2906976744186046,70,147,0.4761904761904761,0.461,34,44,0.7727272727272727
Charlie Villanueva,villach01,PF,26,DET,2011,76,1666.0,840,48,50,245,295,42,42,66,175,313,708,0.442090395480226,125,323,0.3869969040247678,188,385,0.4883116883116883,0.53,89,116,0.7672413793103449
Sasha Vujačić,vujacsa01,SG,26,TOT,2011,67,1648.0,656,132,30,156,186,54,5,66,136,239,595,0.4016806722689076,97,262,0.3702290076335878,142,333,0.4264264264264264,0.483,81,96,0.84375
Dwyane Wade,wadedw01,SG,29,MIA,2011,76,2823.0,1941,346,123,362,485,111,87,237,197,692,1384,0.5,63,206,0.3058252427184466,629,1178,0.533955857385399,0.523,494,652,0.7576687116564417
Von Wafer,wafervo01,SG,25,BOS,2011,58,553.0,184,35,7,42,49,18,5,20,39,67,159,0.4213836477987421,18,67,0.2686567164179104,49,92,0.532608695652174,0.478,32,38,0.8421052631578947
Henry Walker,walkebi01,SG,23,NYK,2011,61,784.0,298,34,16,106,122,21,6,37,81,104,236,0.4406779661016949,59,153,0.3856209150326797,45,83,0.5421686746987951,0.566,31,44,0.7045454545454546
John Wall,walljo01,PG,20,WAS,2011,69,2606.0,1131,574,35,282,317,121,35,261,175,398,972,0.4094650205761317,34,115,0.2956521739130435,364,857,0.4247374562427071,0.427,301,393,0.7659033078880407
Ben Wallace,wallabe01,C,36,DET,2011,54,1238.0,154,72,129,221,350,54,54,44,81,67,149,0.4496644295302013,1,2,0.5,66,147,0.4489795918367347,0.453,19,57,0.3333333333333333
Gerald Wallace,wallage01,SF-PF,28,TOT,2011,71,2693.0,1113,173,111,458,569,105,63,152,183,386,851,0.4535840188014101,62,186,0.3333333333333333,324,665,0.4872180451127819,0.49,279,374,0.7459893048128342
Luke Walton,waltolu01,SF,30,LAL,2011,54,484.0,91,62,9,58,67,9,4,31,38,38,116,0.3275862068965517,8,34,0.2352941176470588,30,82,0.3658536585365853,0.362,7,10,0.7
Willie Warren,warrewi01,PG,21,LAC,2011,19,134.0,37,27,1,11,12,6,0,8,16,13,35,0.3714285714285714,5,15,0.3333333333333333,8,20,0.4,0.443,6,8,0.75
Hakim Warrick,warriha01,PF,28,PHO,2011,80,1416.0,669,69,88,208,296,32,9,79,100,228,446,0.5112107623318386,1,11,0.0909090909090909,227,435,0.5218390804597701,0.512,212,294,0.7210884353741497
C.J. Watson,watsocj01,PG,26,CHI,2011,82,1091.0,405,186,16,78,94,55,11,73,82,146,394,0.3705583756345177,44,112,0.3928571428571428,102,282,0.3617021276595745,0.426,69,93,0.7419354838709677
Earl Watson,watsoea01,PG,31,UTA,2011,80,1567.0,343,278,52,130,182,61,17,116,146,126,307,0.4104234527687296,36,107,0.3364485981308411,90,200,0.45,0.469,55,82,0.6707317073170732
Kyle Weaver,weaveky01,SG,24,UTA,2011,5,69.0,28,7,2,8,10,2,2,7,3,9,25,0.36,3,7,0.4285714285714285,6,18,0.3333333333333333,0.42,7,8,0.875
Martell Webster,webstma02,SF,24,MIN,2011,46,1094.0,453,53,36,111,147,28,9,58,101,152,340,0.4470588235294118,55,132,0.4166666666666667,97,208,0.4663461538461538,0.528,94,122,0.7704918032786885
Sonny Weems,weemsso01,SF,24,TOR,2011,59,1413.0,545,104,39,114,153,34,2,86,87,228,513,0.4444444444444444,17,61,0.2786885245901639,211,452,0.4668141592920354,0.461,72,94,0.7659574468085106
David West,westda01,PF,30,NOH,2011,70,2451.0,1322,164,155,374,529,67,62,142,202,528,1040,0.5076923076923077,2,9,0.2222222222222222,526,1031,0.510184287099903,0.509,264,327,0.8073394495412844
Delonte West,westde01,PG,27,BOS,2011,24,453.0,135,64,6,31,37,20,10,30,29,55,120,0.4583333333333333,12,33,0.3636363636363636,43,87,0.4942528735632184,0.508,13,15,0.8666666666666667
Mario West,westma02,SG,26,NJN,2011,6,116.0,22,10,2,9,11,7,0,2,13,9,21,0.4285714285714285,1,4,0.25,8,17,0.4705882352941176,0.452,3,5,0.6
Russell Westbrook,westbru01,PG,22,OKC,2011,82,2847.0,1793,670,121,258,379,155,30,316,207,614,1390,0.441726618705036,34,103,0.3300970873786408,580,1287,0.4506604506604507,0.454,531,631,0.8415213946117274
D.J. White,whitedj01,C-PF,24,TOT,2011,47,685.0,268,19,43,115,158,12,20,14,77,111,219,0.5068493150684932,0,2,0.0,111,217,0.511520737327189,0.507,46,64,0.71875
Hassan Whiteside,whiteha01,C,21,SAC,2011,1,2.0,0,0,0,0,0,0,0,0,2,0,0,0.0,0,0,0.0,0,0,0.0,0.0,0,0,0.0
Chris Wilcox,wilcoch01,PF,28,DET,2011,57,995.0,424,43,95,176,271,29,17,43,145,187,322,0.5807453416149069,0,1,0.0,187,321,0.5825545171339563,0.581,50,89,0.5617977528089888
Damien Wilkins,wilkida02,SF,31,ATL,2011,52,676.0,180,41,23,67,90,27,9,21,72,69,137,0.5036496350364964,2,10,0.2,67,127,0.5275590551181102,0.511,40,56,0.7142857142857143
Deron Williams,willide01,PG,26,TOT,2011,65,2465.0,1309,667,40,220,260,79,15,230,190,428,975,0.438974358974359,105,317,0.3312302839116719,323,658,0.4908814589665654,0.493,348,412,0.8446601941747572
Jason Williams,willija02,PG,35,TOT,2011,27,295.0,54,52,3,27,30,11,1,18,8,22,67,0.3283582089552239,10,38,0.2631578947368421,12,29,0.4137931034482758,0.403,0,0,0.0
Jawad Williams,willija04,SF,27,CLE,2011,26,391.0,104,22,7,41,48,9,3,16,34,41,126,0.3253968253968254,13,45,0.2888888888888888,28,81,0.345679012345679,0.377,9,12,0.75
Lou Williams,willilo02,SG,24,PHI,2011,75,1747.0,1027,252,32,117,149,47,17,102,128,323,795,0.4062893081761006,88,253,0.3478260869565217,235,542,0.4335793357933579,0.462,293,356,0.8230337078651685
Marvin Williams,willima02,SF,24,ATL,2011,65,1865.0,676,88,68,245,313,34,23,62,104,246,537,0.4581005586592179,37,110,0.3363636363636363,209,427,0.4894613583138173,0.493,147,174,0.8448275862068966
Mo Williams,willima01,PG,28,TOT,2011,58,1788.0,812,380,21,132,153,53,10,171,150,291,730,0.3986301369863013,79,244,0.3237704918032787,212,486,0.4362139917695473,0.453,151,177,0.8531073446327684
Reggie Williams,willire02,SF,24,GSW,2011,80,1626.0,738,121,45,171,216,28,3,57,124,268,572,0.4685314685314685,102,241,0.4232365145228215,166,331,0.5015105740181269,0.558,100,134,0.746268656716418
Shawne Williams,willish03,PF,24,NYK,2011,64,1323.0,454,47,60,179,239,39,51,46,164,164,385,0.4259740259740259,85,212,0.4009433962264151,79,173,0.4566473988439306,0.536,41,49,0.8367346938775511
Shelden Williams,willish02,PF,27,TOT,2011,59,911.0,264,32,93,180,273,23,26,43,126,103,220,0.4681818181818182,0,0,0.0,103,220,0.4681818181818182,0.468,58,75,0.7733333333333333
Terrence Williams,willite01,SG,23,TOT,2011,21,290.0,106,38,4,47,51,9,0,33,25,43,115,0.3739130434782609,6,22,0.2727272727272727,37,93,0.3978494623655914,0.4,14,21,0.6666666666666666
Metta World Peace,artesro01,SF,31,LAL,2011,82,2410.0,697,175,100,167,267,124,36,90,181,261,658,0.3966565349544073,83,233,0.3562231759656652,178,425,0.4188235294117647,0.46,92,136,0.6764705882352942
Antoine Wright,wrighan01,SG,26,SAC,2011,7,31.0,2,0,2,1,3,1,0,1,3,1,8,0.125,0,4,0.0,1,4,0.25,0.125,0,0,0.0
Brandan Wright,wrighbr03,PF,23,TOT,2011,37,379.0,141,12,31,58,89,11,17,14,34,60,117,0.5128205128205128,0,0,0.0,60,117,0.5128205128205128,0.513,21,31,0.6774193548387096
Dorell Wright,wrighdo01,SF,25,GSW,2011,82,3147.0,1344,242,88,343,431,124,63,133,171,485,1146,0.4232111692844677,194,516,0.375968992248062,291,630,0.4619047619047619,0.508,180,228,0.7894736842105263
Julian Wright,wrighju01,SF,23,TOR,2011,52,766.0,188,58,47,71,118,39,20,43,45,82,160,0.5125,2,10,0.2,80,150,0.5333333333333333,0.519,22,43,0.5116279069767442
Nick Young,youngni01,SG,25,WAS,2011,64,2034.0,1115,75,26,148,174,45,17,90,144,412,935,0.4406417112299465,105,271,0.3874538745387454,307,664,0.4623493975903614,0.497,186,228,0.8157894736842105
Sam Young,youngsa01,SF,25,MEM,2011,78,1577.0,572,71,40,147,187,68,23,61,120,233,494,0.4716599190283401,17,50,0.34,216,444,0.4864864864864865,0.489,89,116,0.7672413793103449
Thaddeus Young,youngth01,PF,22,PHI,2011,82,2135.0,1045,82,153,281,434,90,26,99,170,458,847,0.5407319952774499,6,22,0.2727272727272727,452,825,0.5478787878787879,0.544,123,174,0.7068965517241379
Jeff Adrien,adrieje01,PF,25,HOU,2012,8,63.0,21,1,5,17,22,0,2,2,13,7,16,0.4375,0,0,0.0,7,16,0.4375,0.438,7,12,0.5833333333333334
Arron Afflalo,afflaar01,SG,26,DEN,2012,62,2086.0,943,149,40,157,197,36,13,85,134,329,699,0.4706723891273247,88,221,0.3981900452488687,241,478,0.50418410041841,0.534,197,247,0.7975708502024291
Blake Ahearn,ahearbl01,PG,27,UTA,2012,4,30.0,10,1,0,2,2,0,0,5,4,4,14,0.2857142857142857,2,9,0.2222222222222222,2,5,0.4,0.357,0,0,0.0
Solomon Alabi,alabiso01,C,23,TOR,2012,14,122.0,33,3,15,32,47,2,9,5,11,13,36,0.3611111111111111,0,0,0.0,13,36,0.3611111111111111,0.361,7,8,0.875
Cole Aldrich,aldrico01,C,23,OKC,2012,26,173.0,57,3,13,35,48,8,16,9,22,22,42,0.5238095238095238,0,0,0.0,22,42,0.5238095238095238,0.524,13,14,0.9285714285714286
LaMarcus Aldridge,aldrila01,PF,26,POR,2012,55,1994.0,1191,134,150,292,442,51,45,111,153,483,943,0.5121951219512195,2,11,0.1818181818181818,481,932,0.5160944206008584,0.513,223,274,0.8138686131386861
Lavoy Allen,allenla01,PF,22,PHI,2012,41,624.0,169,34,47,124,171,13,18,20,73,79,167,0.4730538922155688,0,0,0.0,79,167,0.4730538922155688,0.473,11,14,0.7857142857142857
Ray Allen,allenra02,SG,36,BOS,2012,46,1565.0,655,109,14,128,142,49,8,68,83,226,493,0.4584178498985801,106,234,0.452991452991453,120,259,0.4633204633204633,0.566,97,106,0.9150943396226416
Tony Allen,allento01,SG,30,MEM,2012,58,1525.0,568,79,98,135,233,104,33,94,142,210,448,0.46875,8,26,0.3076923076923077,202,422,0.4786729857819905,0.478,140,175,0.8
Morris Almond,almonmo01,SG,26,WAS,2012,4,67.0,14,2,1,7,8,7,0,1,6,6,17,0.3529411764705882,1,3,0.3333333333333333,5,14,0.3571428571428571,0.382,1,3,0.3333333333333333
Al-Farouq Aminu,aminual01,SF,21,NOH,2012,66,1477.0,399,66,95,213,308,59,34,91,136,150,365,0.410958904109589,13,47,0.2765957446808511,137,318,0.4308176100628931,0.429,86,114,0.7543859649122807
Lou Amundson,amundlo01,PF,29,IND,2012,60,753.0,213,14,94,128,222,27,44,45,125,89,207,0.429951690821256,0,0,0.0,89,207,0.429951690821256,0.43,35,82,0.4268292682926829
Chris Andersen,anderch01,C,33,DEN,2012,32,486.0,168,6,48,100,148,19,46,17,52,59,108,0.5462962962962963,0,0,0.0,59,108,0.5462962962962963,0.546,50,82,0.6097560975609756
Alan Anderson,anderal01,SF,29,TOR,2012,17,461.0,163,26,8,26,34,5,3,25,35,55,142,0.3873239436619718,24,61,0.3934426229508196,31,81,0.382716049382716,0.472,29,34,0.8529411764705882
James Anderson,anderja01,SG,22,SAS,2012,51,603.0,190,41,16,63,79,8,2,30,35,66,174,0.3793103448275862,19,68,0.2794117647058823,47,106,0.4433962264150943,0.434,39,52,0.75
Ryan Anderson,anderry01,PF,23,ORL,2012,61,1964.0,980,54,224,247,471,50,26,57,146,332,757,0.4385733157199472,166,422,0.3933649289099526,166,335,0.4955223880597015,0.548,150,171,0.8771929824561403
Carmelo Anthony,anthoca01,SF,27,NYK,2012,55,1876.0,1245,200,88,256,344,62,24,144,156,441,1025,0.4302439024390244,68,203,0.334975369458128,373,822,0.4537712895377129,0.463,295,367,0.8038147138964578
Joel Anthony,anthojo01,C,29,MIA,2012,64,1349.0,219,9,100,150,250,36,84,45,126,85,152,0.5592105263157895,0,0,0.0,85,152,0.5592105263157895,0.559,49,71,0.6901408450704225
Gilbert Arenas,arenagi01,PG,30,MEM,2012,17,211.0,72,18,2,16,18,11,1,12,35,26,64,0.40625,13,39,0.3333333333333333,13,25,0.52,0.508,7,10,0.7
Trevor Ariza,arizatr01,SF,26,NOH,2012,41,1350.0,444,135,41,174,215,69,25,76,73,168,403,0.4168734491315136,29,87,0.3333333333333333,139,316,0.439873417721519,0.453,79,102,0.7745098039215687
Ömer Aşık,asikom01,C,25,CHI,2012,66,971.0,205,32,127,223,350,30,68,68,121,79,156,0.5064102564102564,0,0,0.0,79,156,0.5064102564102564,0.506,47,103,0.4563106796116505
D.J. Augustin,augusdj01,PG,24,CHA,2012,48,1408.0,532,307,24,85,109,36,1,110,65,183,487,0.3757700205338809,61,179,0.3407821229050279,122,308,0.3961038961038961,0.438,105,120,0.875
Gustavo Ayón,ayongu01,PF,26,NOH,2012,54,1088.0,319,74,86,179,265,53,46,46,118,140,261,0.5363984674329502,0,1,0.0,140,260,0.5384615384615384,0.536,39,63,0.6190476190476191
Jeff Ayres,pendeje02,C,24,IND,2012,20,106.0,34,4,12,21,33,3,2,2,16,15,36,0.4166666666666667,0,0,0.0,15,36,0.4166666666666667,0.417,4,7,0.5714285714285714
Kelenna Azubuike,azubuke01,SG,28,DAL,2012,3,18.0,7,0,0,0,0,1,0,4,1,3,8,0.375,1,3,0.3333333333333333,2,5,0.4,0.438,0,0,0.0
Luke Babbitt,babbilu01,SF,22,POR,2012,40,537.0,202,16,16,79,95,10,4,27,46,71,173,0.4104046242774566,43,100,0.43,28,73,0.3835616438356164,0.535,17,20,0.85
Renaldo Balkman,balkmre01,SF,27,NYK,2012,14,115.0,42,5,6,20,26,4,3,6,14,16,32,0.5,2,9,0.2222222222222222,14,23,0.6086956521739131,0.531,8,11,0.7272727272727273
Leandro Barbosa,barbole01,SG,29,TOT,2012,64,1382.0,708,96,33,95,128,56,7,94,135,271,637,0.4254317111459968,65,170,0.3823529411764705,206,467,0.4411134903640257,0.476,101,124,0.8145161290322581
J.J. Barea,bareajo01,PG,27,MIN,2012,41,1032.0,463,232,14,100,114,21,0,103,61,167,418,0.3995215311004784,53,143,0.3706293706293706,114,275,0.4145454545454545,0.463,76,98,0.7755102040816326
Andrea Bargnani,bargnan01,C,26,TOR,2012,31,1032.0,603,61,24,148,172,18,15,69,52,209,484,0.4318181818181818,34,115,0.2956521739130435,175,369,0.4742547425474255,0.467,151,173,0.8728323699421965
Matt Barnes,barnema02,SF,31,LAL,2012,63,1440.0,491,126,97,247,344,35,48,73,152,175,387,0.4521963824289405,46,138,0.3333333333333333,129,249,0.5180722891566265,0.512,95,128,0.7421875
Earl Barron,barroea01,C,30,GSW,2012,2,9.0,4,0,1,0,1,0,0,0,5,2,4,0.5,0,0,0.0,2,4,0.5,0.5,0,0,0.0
Brandon Bass,bassbr01,PF,26,BOS,2012,59,1868.0,738,55,95,270,365,34,54,65,135,303,632,0.4794303797468354,0,0,0.0,303,632,0.4794303797468354,0.479,132,163,0.8098159509202454
Tony Battie,battito01,C,35,PHI,2012,27,295.0,42,16,8,59,67,4,6,4,26,19,51,0.3725490196078431,0,1,0.0,19,50,0.38,0.373,4,4,1.0
Shane Battier,battish01,SF,33,MIA,2012,65,1499.0,311,82,56,100,156,64,33,37,105,113,292,0.386986301369863,62,183,0.3387978142076502,51,109,0.4678899082568807,0.493,23,37,0.6216216216216216
Nicolas Batum,batumni01,SF,23,POR,2012,59,1791.0,818,84,81,190,271,57,60,90,105,289,641,0.4508580343213728,107,274,0.3905109489051095,182,367,0.4959128065395095,0.534,133,159,0.8364779874213837
Jerryd Bayless,bayleje01,PG,23,TOR,2012,31,705.0,353,118,8,58,66,24,4,53,70,117,276,0.4239130434782608,44,104,0.4230769230769231,73,172,0.4244186046511627,0.504,75,88,0.8522727272727273
Michael Beasley,beaslmi01,SF,23,MIN,2012,47,1087.0,541,45,39,168,207,18,19,80,83,221,497,0.4446680080482897,38,101,0.3762376237623762,183,396,0.4621212121212121,0.483,61,95,0.6421052631578947
Rodrigue Beaubois,beaubro01,PG,23,DAL,2012,53,1151.0,472,152,19,132,151,56,28,70,98,188,445,0.4224719101123595,38,132,0.2878787878787879,150,313,0.4792332268370607,0.465,58,69,0.8405797101449275
Marco Belinelli,belinma01,SG,25,NOH,2012,66,1966.0,780,101,19,153,172,48,5,69,115,286,686,0.4169096209912536,107,284,0.3767605633802817,179,402,0.445273631840796,0.495,101,129,0.7829457364341085
Raja Bell,bellra01,SG,35,UTA,2012,34,796.0,217,38,6,43,49,13,2,21,78,81,174,0.4655172413793103,34,87,0.3908045977011494,47,87,0.5402298850574713,0.563,21,25,0.84
Keith Benson,bensoke02,C,23,GSW,2012,3,9.0,0,0,2,1,3,0,0,0,0,0,1,0.0,0,0,0.0,0,1,0.0,0.0,0,0,0.0
Mike Bibby,bibbymi01,PG,33,NYK,2012,39,557.0,103,80,5,54,59,21,3,20,45,35,124,0.282258064516129,27,85,0.3176470588235294,8,39,0.2051282051282051,0.391,6,8,0.75
Andris Biedriņš,biedran01,C,25,GSW,2012,47,739.0,79,16,45,131,176,23,45,14,125,39,64,0.609375,0,0,0.0,39,64,0.609375,0.609,1,9,0.1111111111111111
Chauncey Billups,billuch01,SG,35,LAC,2012,20,607.0,299,80,4,46,50,9,3,38,40,83,228,0.3640350877192982,48,125,0.384,35,103,0.3398058252427184,0.469,85,95,0.8947368421052632
Bismack Biyombo,biyombi01,C,19,CHA,2012,63,1455.0,327,27,113,255,368,20,115,71,145,129,278,0.4640287769784172,0,0,0.0,129,278,0.4640287769784172,0.464,69,143,0.4825174825174825
DeJuan Blair,blairde01,PF,22,SAS,2012,64,1363.0,611,78,154,197,351,59,12,92,168,269,504,0.5337301587301587,0,1,0.0,269,503,0.5347912524850894,0.534,73,119,0.6134453781512605
Steve Blake,blakest01,PG,31,LAL,2012,53,1237.0,276,175,9,76,85,39,2,72,75,101,268,0.376865671641791,53,158,0.3354430379746835,48,110,0.4363636363636363,0.476,21,27,0.7777777777777778
Andray Blatche,blatcan01,PF,25,WAS,2012,26,626.0,221,28,42,108,150,20,17,37,54,93,245,0.3795918367346939,2,7,0.2857142857142857,91,238,0.3823529411764705,0.384,33,49,0.673469387755102
Eric Bledsoe,bledser01,PG,22,LAC,2012,40,464.0,132,66,22,43,65,31,14,47,58,49,126,0.3888888888888889,6,30,0.2,43,96,0.4479166666666667,0.413,28,44,0.6363636363636364
Keith Bogans,boganke01,SF,31,NJN,2012,5,94.0,21,3,5,6,11,2,0,3,15,8,21,0.3809523809523809,3,12,0.25,5,9,0.5555555555555556,0.452,2,5,0.4
Andrew Bogut,bogutan01,C,27,MIL,2012,12,364.0,136,31,22,78,100,12,24,24,36,61,136,0.4485294117647059,0,1,0.0,61,135,0.4518518518518518,0.449,14,23,0.6086956521739131
Matt Bonner,bonnema01,PF,31,SAS,2012,65,1326.0,429,61,29,185,214,15,21,14,68,154,350,0.44,105,250,0.42,49,100,0.49,0.59,16,21,0.7619047619047619
Trevor Booker,booketr01,PF,24,WAS,2012,50,1261.0,419,40,119,206,325,48,43,58,138,181,341,0.530791788856305,1,2,0.5,180,339,0.5309734513274337,0.532,56,93,0.6021505376344086
Carlos Boozer,boozeca01,PF,30,CHI,2012,66,1948.0,991,125,114,450,564,63,24,115,168,448,842,0.5320665083135392,0,1,0.0,448,841,0.5326991676575505,0.532,95,137,0.6934306569343066
Chris Bosh,boshch01,PF,27,MIA,2012,57,2007.0,1025,103,94,358,452,51,45,117,128,393,807,0.4869888475836431,10,35,0.2857142857142857,383,772,0.4961139896373057,0.493,229,279,0.8207885304659498
Earl Boykins,boykiea01,PG,35,HOU,2012,8,111.0,39,17,0,11,11,1,0,7,5,12,36,0.3333333333333333,2,9,0.2222222222222222,10,27,0.3703703703703703,0.361,13,15,0.8666666666666667
Craig Brackins,brackcr01,PF,24,PHI,2012,14,88.0,22,8,5,10,15,0,1,4,6,9,33,0.2727272727272727,3,9,0.3333333333333333,6,24,0.25,0.318,1,2,0.5
Avery Bradley,bradlav01,PG,21,BOS,2012,64,1368.0,484,87,34,81,115,43,12,75,109,200,402,0.4975124378109453,22,54,0.4074074074074074,178,348,0.5114942528735632,0.525,62,78,0.7948717948717948
Elton Brand,brandel01,C,32,PHI,2012,60,1732.0,659,97,145,284,429,58,97,65,176,287,581,0.4939759036144578,0,1,0.0,287,580,0.4948275862068965,0.494,85,116,0.7327586206896551
Corey Brewer,breweco01,SF,25,DEN,2012,59,1287.0,525,88,43,107,150,72,17,56,113,201,463,0.4341252699784017,33,127,0.2598425196850393,168,336,0.5,0.47,90,130,0.6923076923076923
Ronnie Brewer,brewero02,SG,26,CHI,2012,66,1635.0,455,137,72,159,231,72,21,59,64,190,445,0.4269662921348314,19,69,0.2753623188405797,171,376,0.4547872340425531,0.448,56,100,0.56
Jon Brockman,brockjo01,PF,24,MIL,2012,35,239.0,37,9,33,42,75,4,1,10,33,15,45,0.3333333333333333,0,1,0.0,15,44,0.3409090909090909,0.333,7,15,0.4666666666666667
MarShon Brooks,brookma01,SG,23,NJN,2012,56,1648.0,708,131,70,130,200,52,15,118,116,274,640,0.428125,47,150,0.3133333333333333,227,490,0.463265306122449,0.465,113,148,0.7635135135135135
Derrick Brown,brownde04,SF,24,CHA,2012,65,1443.0,524,67,95,141,236,48,12,55,96,212,409,0.5183374083129584,6,24,0.25,206,385,0.535064935064935,0.526,94,141,0.6666666666666666
Kwame Brown,brownkw01,C,29,GSW,2012,9,187.0,57,4,16,41,57,8,0,14,21,21,40,0.525,0,0,0.0,21,40,0.525,0.525,15,34,0.4411764705882353
Shannon Brown,brownsh01,SG,26,PHO,2012,59,1400.0,650,69,38,119,157,44,15,64,66,251,598,0.4197324414715719,68,188,0.3617021276595745,183,410,0.4463414634146341,0.477,80,99,0.8080808080808081
Kobe Bryant,bryanko01,SG,33,LAL,2012,58,2232.0,1616,264,66,247,313,69,18,204,105,574,1336,0.4296407185628742,87,287,0.3031358885017421,487,1049,0.4642516682554814,0.462,381,451,0.844789356984479
Chase Budinger,budinch01,SF,23,HOU,2012,58,1298.0,558,74,38,179,217,29,7,55,65,208,471,0.4416135881104034,88,219,0.4018264840182648,120,252,0.4761904761904761,0.535,54,70,0.7714285714285715
Alec Burks,burksal01,SG,20,UTA,2012,59,939.0,425,55,57,75,132,27,5,51,84,153,357,0.4285714285714285,15,45,0.3333333333333333,138,312,0.4423076923076923,0.45,104,143,0.7272727272727273
Caron Butler,butleca01,SF,31,LAC,2012,63,1871.0,753,78,44,186,230,52,9,77,123,287,705,0.4070921985815602,92,257,0.357976653696498,195,448,0.4352678571428571,0.472,87,107,0.8130841121495327
Jimmy Butler,butleji01,SG,22,CHI,2012,42,359.0,109,14,23,33,56,11,5,14,20,32,79,0.4050632911392405,2,11,0.1818181818181818,30,68,0.4411764705882353,0.418,43,56,0.7678571428571429
Rasual Butler,butlera01,SF,32,TOR,2012,34,453.0,110,19,6,60,66,7,5,15,39,41,133,0.3082706766917293,21,77,0.2727272727272727,20,56,0.3571428571428571,0.387,7,12,0.5833333333333334
Derrick Byars,byarsde01,PF,27,SAS,2012,2,37.0,10,1,6,5,11,2,0,0,2,3,11,0.2727272727272727,0,6,0.0,3,5,0.6,0.273,4,4,1.0
Andrew Bynum,bynuman01,C,24,LAL,2012,60,2112.0,1123,85,192,517,709,27,116,152,104,444,796,0.5577889447236181,1,5,0.2,443,791,0.5600505689001264,0.558,234,338,0.6923076923076923
Will Bynum,bynumwi01,PG,29,DET,2012,36,514.0,204,66,10,46,56,23,3,54,61,74,194,0.3814432989690721,7,29,0.2413793103448276,67,165,0.406060606060606,0.399,49,64,0.765625
José Calderón,caldejo01,PG,30,TOR,2012,53,1799.0,555,468,19,141,160,47,3,104,94,218,477,0.4570230607966457,59,159,0.3710691823899371,159,318,0.5,0.519,60,68,0.8823529411764706
Marcus Camby,cambyma01,C,37,TOT,2012,59,1352.0,287,107,157,373,530,50,85,57,126,128,287,0.445993031358885,2,5,0.4,126,282,0.4468085106382978,0.449,29,64,0.453125
Brian Cardinal,cardibr01,SF,34,DAL,2012,44,277.0,43,16,4,30,34,8,2,8,38,14,55,0.2545454545454545,10,49,0.2040816326530612,4,6,0.6666666666666666,0.345,5,6,0.8333333333333334
DeMarre Carroll,carrode01,SF-PF,25,TOT,2012,24,348.0,107,18,28,25,53,12,1,11,37,43,105,0.4095238095238095,7,19,0.3684210526315789,36,86,0.4186046511627907,0.443,14,16,0.875
Matt Carroll,carroma01,SG,31,CHA,2012,53,596.0,142,38,8,50,58,16,7,24,52,52,157,0.3312101910828025,8,43,0.1860465116279069,44,114,0.3859649122807017,0.357,30,38,0.7894736842105263
Anthony Carter,cartean01,PG,36,TOR,2012,24,209.0,47,34,5,28,33,8,4,17,20,17,53,0.320754716981132,5,17,0.2941176470588235,12,36,0.3333333333333333,0.368,8,10,0.8
Vince Carter,cartevi01,SG,35,DAL,2012,61,1542.0,615,139,32,173,205,56,25,84,134,223,542,0.4114391143911439,74,205,0.3609756097560975,149,337,0.4421364985163205,0.48,95,115,0.8260869565217391
Omri Casspi,casspom01,SF,23,CLE,2012,65,1341.0,459,66,63,165,228,37,21,64,115,166,412,0.4029126213592233,53,168,0.3154761904761904,113,244,0.4631147540983606,0.467,74,108,0.6851851851851852
Mario Chalmers,chalmma01,PG,25,MIA,2012,64,1825.0,627,222,16,155,171,97,11,142,166,223,498,0.4477911646586345,101,260,0.3884615384615384,122,238,0.5126050420168067,0.549,80,101,0.7920792079207921
Tyson Chandler,chandty01,C,29,NYK,2012,62,2061.0,699,56,212,400,612,56,89,102,186,241,355,0.6788732394366197,0,2,0.0,241,353,0.6827195467422096,0.679,217,315,0.6888888888888889
Wilson Chandler,chandwi01,SF,24,DEN,2012,8,215.0,75,17,6,35,41,6,6,18,18,31,79,0.3924050632911392,3,12,0.25,28,67,0.417910447761194,0.411,10,12,0.8333333333333334
Josh Childress,childjo01,SF,28,PHO,2012,34,491.0,100,34,31,64,95,14,6,9,38,48,99,0.4848484848484848,4,24,0.1666666666666666,44,75,0.5866666666666667,0.505,0,2,0.0
Earl Clark,clarkea01,PF,24,ORL,2012,45,559.0,123,18,35,89,124,12,32,25,72,51,139,0.3669064748201439,0,0,0.0,51,139,0.3669064748201439,0.367,21,29,0.7241379310344828
Norris Cole,coleno01,PG,23,MIA,2012,65,1260.0,441,133,21,70,91,44,2,105,124,177,450,0.3933333333333333,21,76,0.2763157894736842,156,374,0.4171122994652406,0.417,66,85,0.7764705882352941
Jason Collins,collija04,C,33,ATL,2012,30,308.0,39,10,12,36,48,4,3,10,34,16,40,0.4,0,0,0.0,16,40,0.4,0.4,7,15,0.4666666666666667
Darren Collison,collida01,PG,24,IND,2012,60,1878.0,621,287,30,157,187,49,14,114,101,230,523,0.4397705544933078,34,94,0.3617021276595745,196,429,0.4568764568764569,0.472,127,153,0.8300653594771242
Nick Collison,collini01,PF,31,OKC,2012,63,1307.0,284,82,119,155,274,33,28,61,153,120,201,0.5970149253731343,0,1,0.0,120,200,0.6,0.597,44,62,0.7096774193548387
Mike Conley,conlemi01,PG,24,MEM,2012,62,2174.0,788,404,22,134,156,136,11,125,133,296,684,0.4327485380116959,60,159,0.3773584905660377,236,525,0.4495238095238095,0.477,136,158,0.8607594936708861
Brian Cook,cookbr01,PF,31,TOT,2012,32,276.0,81,10,10,53,63,6,5,11,48,31,98,0.3163265306122449,10,50,0.2,21,48,0.4375,0.367,9,10,0.9
Daequan Cook,cookda02,SG,24,OKC,2012,57,989.0,311,15,12,110,122,22,11,16,69,109,296,0.3682432432432432,79,228,0.3464912280701754,30,68,0.4411764705882353,0.502,14,22,0.6363636363636364
DeMarcus Cousins,couside01,C,21,SAC,2012,64,1950.0,1160,102,265,438,703,93,75,170,257,448,999,0.4484484484484484,2,14,0.1428571428571428,446,985,0.4527918781725888,0.449,262,373,0.7024128686327078
Jamal Crawford,crawfja01,PG,31,POR,2012,60,1613.0,837,191,16,102,118,55,14,111,74,283,737,0.383989145183175,80,260,0.3076923076923077,203,477,0.4255765199161425,0.438,191,206,0.9271844660194176
Jordan Crawford,crawfjo02,SG,23,WAS,2012,64,1753.0,938,190,44,124,168,59,5,141,111,349,872,0.4002293577981651,79,273,0.2893772893772894,270,599,0.4507512520868113,0.446,161,203,0.7931034482758621
Dante Cunningham,cunnida01,PF,24,MEM,2012,64,1124.0,333,37,91,155,246,42,34,29,98,144,279,0.5161290322580645,0,2,0.0,144,277,0.51985559566787,0.516,45,69,0.6521739130434783
Eddy Curry,curryed01,C,29,MIA,2012,14,83.0,30,1,4,8,12,0,2,10,17,12,26,0.4615384615384615,0,0,0.0,12,26,0.4615384615384615,0.462,6,8,0.75
Stephen Curry,curryst01,PG,23,GSW,2012,26,732.0,383,138,15,73,88,39,8,65,62,145,296,0.4898648648648648,55,121,0.4545454545454545,90,175,0.5142857142857142,0.583,38,47,0.8085106382978723
Samuel Dalembert,dalemsa01,C,30,HOU,2012,65,1446.0,490,33,158,298,456,37,111,82,162,200,395,0.5063291139240507,0,1,0.0,200,394,0.5076142131979695,0.506,90,113,0.7964601769911505
Erick Dampier,dampier01,C,36,ATL,2012,15,83.0,2,4,10,15,25,1,4,3,9,1,8,0.125,0,0,0.0,1,8,0.125,0.125,0,0,0.0
Marquis Daniels,daniema01,SG,31,BOS,2012,38,484.0,121,47,16,50,66,21,9,28,36,52,143,0.3636363636363636,0,10,0.0,52,133,0.3909774436090225,0.364,17,23,0.7391304347826086
Baron Davis,davisba01,PG,32,NYK,2012,29,595.0,178,135,13,43,56,34,3,76,61,68,184,0.3695652173913043,26,85,0.3058823529411765,42,99,0.4242424242424242,0.44,16,24,0.6666666666666666
Ed Davis,davised01,PF,22,TOR,2012,66,1534.0,415,60,134,304,438,40,63,67,156,172,335,0.5134328358208955,0,1,0.0,172,334,0.5149700598802395,0.513,71,106,0.6698113207547169
Glen Davis,davisgl01,PF,26,ORL,2012,61,1427.0,566,47,107,224,331,43,19,75,106,225,534,0.4213483146067415,2,14,0.1428571428571428,223,520,0.4288461538461538,0.423,114,167,0.6826347305389222
Josh Davis,davisjo02,PF,31,MEM,2012,15,130.0,28,6,16,11,27,7,1,3,19,10,27,0.3703703703703703,4,13,0.3076923076923077,6,14,0.4285714285714285,0.444,4,8,0.5
Eric Dawson,dawsoer01,C,27,SAS,2012,4,39.0,15,0,5,5,10,1,2,3,6,7,12,0.5833333333333334,0,0,0.0,7,12,0.5833333333333334,0.583,1,2,0.5
Austin Daye,dayeau01,SF,23,DET,2012,41,603.0,194,33,14,77,91,22,21,40,62,73,227,0.3215859030837004,13,62,0.2096774193548387,60,165,0.3636363636363636,0.35,35,43,0.813953488372093
Carlos Delfino,delfica01,SF,29,MIL,2012,54,1537.0,488,123,20,188,208,79,10,66,99,182,453,0.401766004415011,86,239,0.3598326359832636,96,214,0.4485981308411215,0.497,38,48,0.7916666666666666
Luol Deng,denglu01,SF,26,CHI,2012,54,2129.0,828,157,77,273,350,56,36,96,81,311,755,0.4119205298013245,79,215,0.3674418604651163,232,540,0.4296296296296296,0.464,127,165,0.7696969696969697
Justin Dentmon,dentmju01,PG,26,TOT,2012,6,91.0,26,10,0,8,8,2,0,7,10,10,28,0.3571428571428571,2,14,0.1428571428571428,8,14,0.5714285714285714,0.393,4,6,0.6666666666666666
DeMar DeRozan,derozde01,SG,22,TOR,2012,63,2206.0,1054,128,40,171,211,48,17,123,162,381,903,0.4219269102990033,24,92,0.2608695652173913,357,811,0.4401972872996301,0.435,268,331,0.8096676737160121
Boris Diaw,diawbo01,PF,29,TOT,2012,57,1424.0,365,205,70,210,280,34,25,112,125,156,351,0.4444444444444444,31,99,0.3131313131313131,125,252,0.496031746031746,0.489,22,35,0.6285714285714286
Ike Diogu,dioguik01,PF,28,SAS,2012,2,14.0,2,0,0,1,1,0,0,1,1,0,2,0.0,0,0,0.0,0,2,0.0,0.0,2,2,1.0
DeSagana Diop,diopde01,C,30,CHA,2012,27,325.0,31,23,33,52,85,6,13,19,36,15,42,0.3571428571428571,0,0,0.0,15,42,0.3571428571428571,0.357,1,6,0.1666666666666666
Keyon Dooling,doolike01,SG,31,BOS,2012,46,662.0,182,51,3,36,39,13,2,34,57,66,163,0.4049079754601227,27,81,0.3333333333333333,39,82,0.4756097560975609,0.488,23,31,0.7419354838709677
Toney Douglas,douglto01,PG,25,NYK,2012,38,656.0,237,77,16,56,72,29,1,56,55,94,290,0.3241379310344827,27,117,0.2307692307692307,67,173,0.3872832369942196,0.371,22,26,0.8461538461538461
Goran Dragić,dragigo01,PG,25,HOU,2012,66,1752.0,775,351,53,115,168,85,10,157,166,277,600,0.4616666666666666,68,202,0.3366336633663366,209,398,0.5251256281407035,0.518,153,190,0.8052631578947368
Jared Dudley,dudleja01,SG,26,PHO,2012,65,2020.0,823,112,95,206,301,49,19,72,107,312,643,0.4852255054432348,80,209,0.3827751196172249,232,434,0.5345622119815668,0.547,119,164,0.725609756097561
Chris Duhon,duhonch01,PG,29,ORL,2012,63,1226.0,237,151,14,88,102,35,9,81,71,85,203,0.4187192118226601,50,119,0.4201680672268907,35,84,0.4166666666666667,0.542,17,21,0.8095238095238095
Tim Duncan,duncati01,C,35,SAS,2012,58,1634.0,895,132,110,410,520,38,88,97,98,361,733,0.4924965893587995,0,4,0.0,361,729,0.49519890260631,0.492,173,249,0.6947791164658634
Mike Dunleavy,dunlemi02,SF,31,MIL,2012,55,1445.0,677,117,29,175,204,28,8,58,87,239,504,0.4742063492063492,83,208,0.3990384615384615,156,296,0.527027027027027,0.557,116,143,0.8111888111888111
Kevin Durant,duranke01,SF,23,OKC,2012,66,2546.0,1850,231,40,487,527,88,77,248,133,643,1297,0.4957594448727833,133,344,0.3866279069767442,510,953,0.5351521511017838,0.547,431,501,0.8602794411177644
Jerome Dyson,dysonje01,PG,24,NOH,2012,9,180.0,67,18,2,17,19,11,2,20,19,19,48,0.3958333333333333,1,8,0.125,18,40,0.45,0.406,28,36,0.7777777777777778
Devin Ebanks,ebankde01,SG,22,LAL,2012,24,396.0,97,12,26,28,54,11,6,18,26,37,89,0.4157303370786517,0,9,0.0,37,80,0.4625,0.416,23,35,0.6571428571428571
Wayne Ellington,ellinwa01,SG,24,MIN,2012,51,973.0,311,33,14,85,99,26,10,26,56,122,302,0.4039735099337748,35,108,0.324074074074074,87,194,0.4484536082474227,0.462,32,40,0.8
Monta Ellis,ellismo01,SG,26,TOT,2012,58,2120.0,1181,346,20,180,200,85,18,177,136,450,1040,0.4326923076923077,62,201,0.308457711442786,388,839,0.4624553039332538,0.463,219,275,0.7963636363636364
Francisco Elson,elsonfr01,C,35,PHI,2012,5,16.0,2,1,0,1,1,1,1,1,0,1,3,0.3333333333333333,0,0,0.0,1,3,0.3333333333333333,0.333,0,0,0.0
Andre Emmett,emmetan01,SF,29,NJN,2012,6,45.0,13,1,2,4,6,2,1,2,2,4,7,0.5714285714285714,0,1,0.0,4,6,0.6666666666666666,0.571,5,8,0.625
Semih Erden,erdense01,C,25,CLE,2012,28,333.0,99,9,20,52,72,10,5,16,60,39,74,0.527027027027027,0,0,0.0,39,74,0.527027027027027,0.527,21,41,0.5121951219512195
Jeremy Evans,evansje01,SF,24,UTA,2012,29,217.0,62,13,19,31,50,6,24,5,23,27,42,0.6428571428571429,0,1,0.0,27,41,0.6585365853658537,0.643,8,16,0.5
Maurice Evans,evansma01,SF,33,WAS,2012,24,343.0,117,9,8,16,24,14,0,10,36,45,112,0.4017857142857143,17,45,0.3777777777777777,28,67,0.417910447761194,0.478,10,13,0.7692307692307693
Reggie Evans,evansre01,PF,31,LAC,2012,56,771.0,104,17,100,171,271,31,6,44,118,34,72,0.4722222222222222,0,0,0.0,34,72,0.4722222222222222,0.472,36,71,0.5070422535211268
Tyreke Evans,evansty01,SG,22,SAC,2012,63,2162.0,1037,283,64,225,289,84,29,171,136,408,900,0.4533333333333333,20,99,0.202020202020202,388,801,0.484394506866417,0.464,201,258,0.7790697674418605
Christian Eyenga,eyengch01,SF,22,TOT,2012,7,102.0,17,5,4,10,14,3,5,3,7,6,25,0.24,1,3,0.3333333333333333,5,22,0.2272727272727272,0.26,4,8,0.5
Kenneth Faried,farieke01,PF,22,DEN,2012,46,1037.0,471,36,142,210,352,34,47,54,116,181,309,0.5857605177993528,0,0,0.0,181,309,0.5857605177993528,0.586,109,164,0.6646341463414634
Jordan Farmar,farmajo01,PG,25,NJN,2012,39,831.0,406,129,7,54,61,24,2,68,49,147,315,0.4666666666666667,55,125,0.44,92,190,0.4842105263157895,0.554,57,63,0.9047619047619048
Derrick Favors,favorde01,PF,20,UTA,2012,65,1376.0,570,43,158,267,425,38,65,103,145,222,445,0.498876404494382,0,0,0.0,222,445,0.498876404494382,0.499,126,194,0.6494845360824743
Raymond Felton,feltora01,PG,27,POR,2012,60,1906.0,684,390,27,122,149,78,10,170,122,261,642,0.4065420560747663,62,203,0.3054187192118227,199,439,0.4533029612756264,0.455,100,124,0.8064516129032258
Rudy Fernández,fernaru01,SG,26,DEN,2012,31,710.0,268,75,9,56,65,31,3,40,37,99,225,0.44,40,122,0.3278688524590163,59,103,0.5728155339805825,0.529,30,43,0.6976744186046512
Kyrylo Fesenko,fesenky01,C,25,IND,2012,3,17.0,8,1,2,7,9,2,0,0,2,2,5,0.4,0,0,0.0,2,5,0.4,0.4,4,6,0.6666666666666666
Landry Fields,fieldla01,SG,23,NYK,2012,66,1894.0,580,169,59,219,278,79,17,102,99,236,513,0.4600389863547758,31,121,0.256198347107438,205,392,0.5229591836734694,0.49,77,137,0.5620437956204379
Derek Fisher,fishede01,PG,37,TOT,2012,63,1508.0,350,170,12,109,121,51,4,73,117,129,348,0.3706896551724138,35,109,0.3211009174311927,94,239,0.3933054393305439,0.421,57,67,0.8507462686567164
Jonny Flynn,flynnjo01,PG,22,TOT,2012,29,416.0,131,96,8,31,39,6,2,36,23,46,131,0.3511450381679389,10,34,0.2941176470588235,36,97,0.3711340206185567,0.389,29,39,0.7435897435897436
Jeff Foote,footeje01,C,24,NOH,2012,4,39.0,4,0,1,5,6,0,1,2,5,2,6,0.3333333333333333,0,0,0.0,2,6,0.3333333333333333,0.333,0,0,0.0
Gary Forbes,forbega01,SG,26,TOR,2012,48,713.0,319,54,27,75,102,24,4,54,56,112,271,0.4132841328413284,29,83,0.3493975903614458,83,188,0.4414893617021276,0.467,66,91,0.7252747252747253
T.J. Ford,fordtj01,PG,28,SAS,2012,14,191.0,51,45,3,15,18,9,2,23,23,19,43,0.4418604651162791,2,8,0.25,17,35,0.4857142857142857,0.465,11,14,0.7857142857142857
Courtney Fortson,fortsco01,PG,23,TOT,2012,10,95.0,35,10,6,9,15,3,0,10,5,11,32,0.34375,3,13,0.2307692307692307,8,19,0.4210526315789473,0.391,10,15,0.6666666666666666
Jeff Foster,fosteje01,C,35,IND,2012,11,141.0,25,4,18,24,42,8,1,7,26,9,18,0.5,1,1,1.0,8,17,0.4705882352941176,0.528,6,9,0.6666666666666666
Randy Foye,foyera01,SG,28,LAC,2012,65,1682.0,712,146,25,113,138,46,24,73,130,256,644,0.3975155279503105,127,329,0.3860182370820669,129,315,0.4095238095238095,0.496,73,85,0.8588235294117647
Jimmer Fredette,fredeji01,PG,22,SAC,2012,61,1135.0,462,108,17,56,73,30,3,67,73,172,446,0.3856502242152466,78,216,0.3611111111111111,94,230,0.408695652173913,0.473,40,48,0.8333333333333334
Enes Freedom,kanteen01,C,19,UTA,2012,66,874.0,304,8,107,171,278,18,23,54,87,117,236,0.4957627118644068,0,1,0.0,117,235,0.4978723404255319,0.496,70,105,0.6666666666666666
Channing Frye,fryech01,PF,28,PHO,2012,64,1669.0,674,88,71,308,379,42,70,63,176,255,613,0.4159869494290375,91,263,0.3460076045627376,164,350,0.4685714285714286,0.49,73,82,0.8902439024390244
Dan Gadzuric,gadzuda01,C,33,NYK,2012,2,13.0,0,0,1,4,5,1,1,1,4,0,2,0.0,0,0,0.0,0,2,0.0,0.0,0,2,0.0
Sundiata Gaines,gainesu01,SG,25,NJN,2012,57,793.0,291,126,27,81,108,55,2,52,58,102,271,0.3763837638376384,28,82,0.3414634146341463,74,189,0.3915343915343915,0.428,59,96,0.6145833333333334
Danilo Gallinari,gallida01,SF,23,DEN,2012,43,1351.0,628,116,28,174,202,42,23,68,86,193,466,0.4141630901287553,60,183,0.3278688524590163,133,283,0.469964664310954,0.479,182,209,0.8708133971291866
Francisco García,garcifr01,SF,30,SAC,2012,49,798.0,234,31,11,88,99,36,37,22,73,86,229,0.3755458515283842,38,131,0.2900763358778626,48,98,0.4897959183673469,0.459,24,30,0.8
Kevin Garnett,garneke01,C,35,BOS,2012,60,1864.0,947,175,66,428,494,56,61,107,141,391,777,0.5032175032175032,3,9,0.3333333333333333,388,768,0.5052083333333334,0.505,162,189,0.8571428571428571
Marc Gasol,gasolma01,C,27,MEM,2012,65,2370.0,952,204,120,459,579,62,121,121,201,357,740,0.4824324324324324,1,12,0.0833333333333333,356,728,0.489010989010989,0.483,237,317,0.7476340694006309
Pau Gasol,gasolpa01,PF,31,LAL,2012,65,2430.0,1129,237,183,495,678,37,88,142,127,459,917,0.5005452562704471,7,27,0.2592592592592592,452,890,0.5078651685393258,0.504,204,261,0.7816091954022989
Rudy Gay,gayru01,SF,25,MEM,2012,65,2422.0,1232,147,130,287,417,95,55,161,138,485,1067,0.4545454545454545,54,173,0.3121387283236994,431,894,0.4821029082774049,0.48,208,263,0.7908745247148289
Alonzo Gee,geeal01,SG,24,CLE,2012,63,1827.0,665,113,101,221,322,83,17,114,149,227,551,0.4119782214156079,44,137,0.3211678832116788,183,414,0.4420289855072464,0.452,167,212,0.7877358490566038
Paul George,georgpa01,SG,21,IND,2012,66,1958.0,798,158,56,314,370,108,38,117,191,281,639,0.4397496087636933,90,234,0.3846153846153846,191,405,0.4716049382716049,0.51,146,182,0.8021978021978022
Daniel Gibson,gibsoda01,SG,25,CLE,2012,35,916.0,263,76,11,90,101,26,16,45,69,87,248,0.3508064516129032,55,139,0.39568345323741,32,109,0.2935779816513761,0.462,34,43,0.7906976744186046
Taj Gibson,gibsota01,PF,26,CHI,2012,63,1284.0,484,47,135,197,332,27,81,60,131,200,404,0.495049504950495,0,0,0.0,200,404,0.495049504950495,0.495,84,135,0.6222222222222222
Manu Ginóbili,ginobma01,SG,34,SAS,2012,34,792.0,440,151,18,98,116,24,12,64,56,150,285,0.5263157894736842,52,126,0.4126984126984127,98,159,0.6163522012578616,0.618,88,101,0.8712871287128713
Mickell Gladness,gladnmi01,PF,25,TOT,2012,26,252.0,56,5,14,44,58,4,20,7,32,25,59,0.423728813559322,0,0,0.0,25,59,0.423728813559322,0.424,6,12,0.5
Ryan Gomes,gomesry01,SF,29,LAC,2012,32,425.0,74,12,14,47,61,16,0,15,34,31,95,0.3263157894736842,4,29,0.1379310344827586,27,66,0.4090909090909091,0.347,8,11,0.7272727272727273
Drew Gooden,goodedr01,C,30,MIL,2012,56,1469.0,766,144,130,233,363,46,34,109,112,287,657,0.4368340943683409,16,55,0.2909090909090909,271,602,0.4501661129568106,0.449,176,208,0.8461538461538461
Ben Gordon,gordobe01,SG,28,DET,2012,52,1398.0,648,127,14,107,121,34,11,115,114,234,530,0.4415094339622641,63,147,0.4285714285714285,171,383,0.4464751958224543,0.501,117,136,0.8602941176470589
Eric Gordon,gordoer01,SG,23,NOH,2012,9,310.0,185,31,2,23,25,13,4,24,20,63,140,0.45,10,40,0.25,53,100,0.53,0.486,49,65,0.7538461538461538
Marcin Gortat,gortama01,C,27,PHO,2012,66,2114.0,1017,59,185,474,659,48,99,90,142,427,769,0.5552665799739922,0,2,0.0,427,767,0.5567144719687093,0.555,163,251,0.649402390438247
Andrew Goudelock,goudean01,SG,23,LAL,2012,40,419.0,175,20,5,26,31,4,0,21,32,68,174,0.3908045977011494,28,75,0.3733333333333333,40,99,0.404040404040404,0.471,11,12,0.9166666666666666
Danny Granger,grangda01,SF,28,IND,2012,62,2062.0,1159,109,79,228,307,62,40,110,144,391,941,0.4155154091392136,123,323,0.3808049535603715,268,618,0.4336569579288026,0.481,254,291,0.872852233676976
Aaron Gray,grayaa01,C,27,TOR,2012,49,813.0,191,27,83,198,281,22,17,51,127,83,161,0.515527950310559,0,0,0.0,83,161,0.515527950310559,0.516,25,47,0.5319148936170213
Danny Green,greenda02,SG,24,SAS,2012,66,1522.0,603,86,54,174,228,58,46,67,107,211,477,0.4423480083857442,102,234,0.4358974358974359,109,243,0.448559670781893,0.549,79,100,0.79
Gerald Green,greenge01,SF,26,NJN,2012,31,781.0,400,34,15,93,108,28,17,55,80,154,320,0.48125,43,110,0.3909090909090909,111,210,0.5285714285714286,0.548,49,65,0.7538461538461538
Willie Green,greenwi01,SG,30,ATL,2012,53,922.0,404,40,15,65,80,23,6,33,74,153,325,0.4707692307692308,50,113,0.4424778761061947,103,212,0.4858490566037736,0.548,48,56,0.8571428571428571
Donté Greene,greendo01,PF,23,SAC,2012,53,777.0,285,34,19,114,133,18,29,32,67,108,266,0.4060150375939849,25,105,0.238095238095238,83,161,0.515527950310559,0.453,44,55,0.8
Blake Griffin,griffbl01,PF,22,LAC,2012,66,2392.0,1368,210,218,499,717,54,48,150,216,561,1022,0.5489236790606654,2,16,0.125,559,1006,0.5556660039761432,0.55,244,468,0.5213675213675214
Hamed Haddadi,haddaha01,C,26,MEM,2012,35,206.0,70,8,28,43,71,1,26,21,43,26,48,0.5416666666666666,0,1,0.0,26,47,0.5531914893617021,0.542,18,26,0.6923076923076923
Jordan Hamilton,hamiljo02,SF,21,DEN,2012,26,258.0,115,20,11,51,62,4,3,16,15,48,111,0.4324324324324324,17,47,0.3617021276595745,31,64,0.484375,0.509,2,5,0.4
Richard Hamilton,hamilri01,SG,33,CHI,2012,28,697.0,326,84,20,46,66,12,1,49,56,140,310,0.4516129032258064,17,46,0.3695652173913043,123,264,0.4659090909090909,0.479,29,37,0.7837837837837838
Tyler Hansbrough,hansbty01,PF,26,IND,2012,66,1442.0,614,30,113,177,290,54,9,65,159,194,479,0.4050104384133611,0,1,0.0,194,478,0.405857740585774,0.405,226,278,0.8129496402877698
Luke Harangody,haranlu01,PF,24,CLE,2012,21,231.0,60,6,20,33,53,6,3,4,17,23,65,0.3538461538461538,5,21,0.238095238095238,18,44,0.4090909090909091,0.392,9,12,0.75
James Harden,hardeja01,SG,22,OKC,2012,62,1946.0,1044,229,30,222,252,62,15,137,150,309,629,0.4912559618441971,114,292,0.3904109589041096,195,337,0.5786350148367952,0.582,312,369,0.8455284552845529
Justin Harper,harpeju01,PF,22,ORL,2012,14,84.0,20,2,3,9,12,2,3,6,5,9,31,0.2903225806451613,2,13,0.1538461538461538,7,18,0.3888888888888889,0.323,0,1,0.0
Josh Harrellson,harrejo01,PF,22,NYK,2012,37,540.0,162,11,47,97,144,23,20,20,48,63,149,0.4228187919463087,20,59,0.3389830508474576,43,90,0.4777777777777778,0.49,16,26,0.6153846153846154
Al Harrington,harrial01,PF,31,DEN,2012,64,1761.0,910,88,72,318,390,58,12,112,181,345,773,0.4463130659767141,101,303,0.3333333333333333,244,470,0.5191489361702127,0.512,119,176,0.6761363636363636
Devin Harris,harride01,PG,28,UTA,2012,63,1741.0,715,316,12,100,112,64,13,122,136,241,542,0.4446494464944649,77,213,0.3615023474178404,164,329,0.4984802431610942,0.516,156,209,0.7464114832535885
Manny Harris,harrima01,SG,22,CLE,2012,26,456.0,173,31,11,59,70,13,6,27,28,60,150,0.4,12,36,0.3333333333333333,48,114,0.4210526315789473,0.44,41,59,0.6949152542372882
Terrel Harris,harrite01,SG,24,MIA,2012,22,318.0,80,26,18,33,51,9,2,25,34,29,83,0.3493975903614458,8,39,0.2051282051282051,21,44,0.4772727272727273,0.398,14,21,0.6666666666666666
Tobias Harris,harrito02,SF,19,MIL,2012,42,479.0,208,22,30,71,101,13,7,31,45,79,169,0.4674556213017751,6,23,0.2608695652173913,73,146,0.5,0.485,44,54,0.8148148148148148
Udonis Haslem,hasleud01,PF,31,MIA,2012,64,1589.0,385,42,117,353,470,35,24,60,142,151,357,0.42296918767507,0,0,0.0,151,357,0.42296918767507,0.423,83,102,0.8137254901960784
Spencer Hawes,hawessp01,C,23,PHI,2012,37,920.0,355,98,78,192,270,16,48,55,100,156,319,0.4890282131661442,3,12,0.25,153,307,0.498371335504886,0.494,40,55,0.7272727272727273
Chuck Hayes,hayesch01,C,28,SAC,2012,54,1039.0,172,77,72,162,234,36,17,50,111,73,170,0.4294117647058823,0,2,0.0,73,168,0.4345238095238095,0.429,26,39,0.6666666666666666
Gordon Hayward,haywago01,SF,21,UTA,2012,66,2015.0,782,207,59,171,230,53,41,109,106,267,586,0.4556313993174061,55,159,0.3459119496855345,212,427,0.4964871194379391,0.503,193,232,0.8318965517241379
Lazar Hayward,haywala01,SF,25,OKC,2012,26,141.0,37,4,2,14,16,3,1,9,18,13,38,0.3421052631578947,4,14,0.2857142857142857,9,24,0.375,0.395,7,12,0.5833333333333334
Brendan Haywood,haywobr01,C,32,DAL,2012,54,1146.0,281,19,139,185,324,24,54,46,121,118,228,0.5175438596491229,0,0,0.0,118,228,0.5175438596491229,0.518,45,96,0.46875
Gerald Henderson,hendege02,SG,24,CHA,2012,55,1831.0,830,126,64,161,225,49,20,100,128,332,723,0.4591977869986168,11,47,0.2340425531914893,321,676,0.4748520710059171,0.467,155,204,0.7598039215686274
Xavier Henry,henryxa01,SG,20,NOH,2012,45,759.0,239,35,24,82,106,26,8,35,59,90,228,0.3947368421052631,7,17,0.4117647058823529,83,211,0.3933649289099526,0.41,52,85,0.611764705882353
Roy Hibbert,hibbero01,C,25,IND,2012,65,1937.0,834,108,213,359,572,32,128,128,195,332,668,0.497005988023952,0,1,0.0,332,667,0.4977511244377811,0.497,170,239,0.7112970711297071
J.J. Hickson,hicksjj01,PF,23,TOT,2012,54,1244.0,452,45,133,202,335,30,35,70,85,183,392,0.4668367346938775,0,2,0.0,183,390,0.4692307692307692,0.467,86,134,0.6417910447761194
Cory Higgins,higgico01,PG,22,CHA,2012,38,423.0,150,36,7,28,35,5,6,39,40,52,160,0.325,4,20,0.2,48,140,0.3428571428571428,0.338,42,60,0.7
Nenê,hilarne01,C,29,TOT,2012,39,1110.0,535,80,63,228,291,42,38,96,95,211,393,0.5368956743002544,0,4,0.0,211,389,0.5424164524421594,0.537,113,168,0.6726190476190477
George Hill,hillge01,PG,25,IND,2012,50,1274.0,481,145,31,120,151,42,17,52,98,168,380,0.4421052631578947,54,147,0.3673469387755102,114,233,0.4892703862660944,0.513,91,117,0.7777777777777778
Grant Hill,hillgr01,SF,39,PHO,2012,49,1378.0,499,107,29,142,171,41,29,65,88,201,451,0.4456762749445676,14,53,0.2641509433962264,187,398,0.4698492462311557,0.461,83,109,0.7614678899082569
Jordan Hill,hilljo01,C,24,TOT,2012,39,551.0,194,16,61,125,186,14,27,31,71,82,165,0.4969696969696969,0,3,0.0,82,162,0.5061728395061729,0.497,30,47,0.6382978723404256
Kirk Hinrich,hinriki01,SG,31,ATL,2012,48,1237.0,316,132,11,90,101,38,11,58,100,122,295,0.4135593220338983,47,136,0.3455882352941176,75,159,0.4716981132075472,0.493,25,32,0.78125
Darington Hobson,hobsoda01,SG,24,MIL,2012,5,39.0,4,6,0,3,3,0,0,2,1,2,13,0.1538461538461538,0,6,0.0,2,7,0.2857142857142857,0.154,0,0,0.0
Jrue Holiday,holidjr01,PG,21,PHI,2012,65,2196.0,879,290,57,155,212,103,18,135,137,360,834,0.4316546762589928,65,171,0.3801169590643274,295,663,0.444947209653092,0.471,94,120,0.7833333333333333
Ryan Hollins,holliry01,C,27,TOT,2012,39,522.0,131,9,34,48,82,5,17,35,78,46,84,0.5476190476190477,0,0,0.0,46,84,0.5476190476190477,0.548,39,75,0.52
Tyler Honeycutt,honeyty01,SF,21,SAC,2012,15,88.0,20,7,3,11,14,4,3,2,3,8,24,0.3333333333333333,1,3,0.3333333333333333,7,21,0.3333333333333333,0.354,3,5,0.6
Al Horford,horfoal01,C,25,ATL,2012,11,348.0,136,24,26,51,77,10,14,16,21,57,103,0.5533980582524272,0,1,0.0,57,102,0.5588235294117647,0.553,22,30,0.7333333333333333
Dennis Horner,hornede01,PF,23,NJN,2012,8,22.0,5,0,2,3,5,0,0,1,1,1,4,0.25,0,1,0.0,1,3,0.3333333333333333,0.25,3,4,0.75
Dwight Howard,howardw01,C,26,ORL,2012,54,2070.0,1113,104,200,585,785,81,116,175,159,416,726,0.5730027548209367,0,7,0.0,416,719,0.5785813630041725,0.573,281,572,0.4912587412587412
Josh Howard,howarjo01,SF,31,UTA,2012,43,991.0,372,50,39,119,158,32,10,53,91,144,361,0.3988919667590028,9,37,0.2432432432432432,135,324,0.4166666666666667,0.411,75,97,0.7731958762886598
Juwan Howard,howarju01,PF,38,MIA,2012,28,190.0,42,10,18,29,47,4,1,20,18,17,55,0.3090909090909091,0,0,0.0,17,55,0.3090909090909091,0.309,8,10,0.8
Lester Hudson,hudsole01,PG,27,TOT,2012,16,334.0,174,36,7,39,46,14,3,32,26,62,162,0.382716049382716,16,64,0.25,46,98,0.4693877551020408,0.432,34,41,0.8292682926829268
Larry Hughes,hughela01,PG,33,ORL,2012,9,114.0,12,7,1,4,5,2,0,12,10,5,22,0.2272727272727272,1,7,0.1428571428571428,4,15,0.2666666666666666,0.25,1,2,0.5
Kris Humphries,humphkr01,PF,26,NJN,2012,62,2162.0,855,90,233,448,681,50,74,119,173,323,671,0.481371087928465,0,0,0.0,323,671,0.481371087928465,0.481,209,278,0.7517985611510791
Serge Ibaka,ibakase01,PF,22,OKC,2012,66,1792.0,603,28,193,305,498,33,241,79,179,262,490,0.5346938775510204,1,3,0.3333333333333333,261,487,0.5359342915811088,0.536,78,118,0.6610169491525424
Andre Iguodala,iguodan01,SF,28,PHI,2012,62,2209.0,771,339,56,325,381,107,30,115,92,287,632,0.4541139240506329,76,193,0.3937823834196891,211,439,0.4806378132118451,0.514,121,196,0.6173469387755102
Ersan İlyasova,ilyaser01,PF,24,MIL,2012,60,1655.0,782,71,196,333,529,42,44,76,133,294,597,0.4924623115577889,51,112,0.4553571428571428,243,485,0.5010309278350515,0.535,143,183,0.7814207650273224
Kyrie Irving,irvinky01,PG,19,CLE,2012,51,1558.0,944,275,44,147,191,54,20,160,110,350,747,0.4685408299866131,73,183,0.3989071038251366,277,564,0.4911347517730496,0.517,171,196,0.8724489795918368
Royal Ivey,iveyro01,SG,30,OKC,2012,34,354.0,71,10,1,23,24,14,0,9,36,26,73,0.3561643835616438,18,53,0.3396226415094339,8,20,0.4,0.479,1,8,0.125
Jarrett Jack,jackja01,PG,28,NOH,2012,45,1530.0,700,285,23,153,176,31,9,106,93,266,583,0.4562607204116638,39,112,0.3482142857142857,227,471,0.4819532908704883,0.49,129,148,0.8716216216216216
Reggie Jackson,jacksre01,PG,21,OKC,2012,45,501.0,140,71,14,39,53,25,1,36,31,51,159,0.320754716981132,13,62,0.2096774193548387,38,97,0.3917525773195876,0.362,25,29,0.8620689655172413
Stephen Jackson,jacksst02,SF,33,TOT,2012,47,1212.0,461,118,22,141,163,54,13,103,99,159,425,0.3741176470588235,49,170,0.288235294117647,110,255,0.4313725490196078,0.432,94,114,0.8245614035087719
Damion James,jamesda01,SF,24,NJN,2012,7,170.0,34,3,7,26,33,7,7,12,17,13,35,0.3714285714285714,0,1,0.0,13,34,0.3823529411764705,0.371,8,12,0.6666666666666666
LeBron James,jamesle01,SF,27,MIA,2012,62,2326.0,1683,387,94,398,492,115,50,213,96,621,1169,0.5312232677502139,54,149,0.3624161073825503,567,1020,0.5558823529411765,0.554,387,502,0.7709163346613546
Mike James,jamesmi01,PG,36,CHI,2012,11,120.0,53,29,2,8,10,4,2,14,20,20,49,0.4081632653061224,6,10,0.6,14,39,0.358974358974359,0.469,7,8,0.875
Antawn Jamison,jamisan01,PF,35,CLE,2012,65,2151.0,1118,131,123,285,408,51,43,90,164,421,1044,0.4032567049808429,91,267,0.3408239700374532,330,777,0.4247104247104247,0.447,185,271,0.6826568265682657
Al Jefferson,jeffeal01,C,27,UTA,2012,61,2075.0,1170,134,133,452,585,47,101,62,155,516,1048,0.4923664122137404,1,4,0.25,515,1044,0.4932950191570881,0.493,137,177,0.7740112994350282
Richard Jefferson,jefferi01,SF,31,TOT,2012,63,1748.0,578,88,26,193,219,37,19,50,121,203,488,0.415983606557377,113,269,0.4200743494423792,90,219,0.410958904109589,0.532,59,85,0.6941176470588235
Jared Jeffries,jeffrja01,PF,30,NYK,2012,39,729.0,170,26,69,83,152,29,25,29,89,59,144,0.4097222222222222,3,16,0.1875,56,128,0.4375,0.42,49,72,0.6805555555555556
Charles Jenkins,jenkich01,PG,22,GSW,2012,51,893.0,297,170,8,60,68,33,6,60,85,130,291,0.4467353951890034,3,20,0.15,127,271,0.4686346863468634,0.452,34,39,0.8717948717948718
Brandon Jennings,jennibr01,PG,22,MIL,2012,66,2331.0,1260,365,49,177,226,104,22,146,114,469,1121,0.4183764495985727,129,388,0.3324742268041237,340,733,0.4638472032742155,0.476,193,239,0.8075313807531381
Jonas Jerebko,jerebjo01,PF,24,DET,2012,64,1468.0,556,43,96,212,308,41,21,66,162,212,453,0.4679911699779249,32,106,0.3018867924528302,180,347,0.5187319884726225,0.503,100,124,0.8064516129032258
Yi Jianlian,jianlyi01,PF,24,DAL,2012,30,203.0,79,5,12,37,49,7,8,14,23,31,82,0.3780487804878049,3,10,0.3,28,72,0.3888888888888889,0.396,14,21,0.6666666666666666
Amir Johnson,johnsam01,PF,24,TOR,2012,64,1553.0,452,79,149,259,408,33,69,94,209,196,340,0.5764705882352941,2,5,0.4,194,335,0.5791044776119403,0.579,58,84,0.6904761904761905
Armon Johnson,johnsar02,PG,22,TOT,2012,9,124.0,47,11,1,12,13,5,0,6,9,20,43,0.4651162790697674,1,3,0.3333333333333333,19,40,0.475,0.477,6,6,1.0
Carldell Johnson,johnsca01,PG,29,NOH,2012,15,119.0,27,22,1,8,9,8,0,7,11,11,35,0.3142857142857143,4,15,0.2666666666666666,7,20,0.35,0.371,1,3,0.3333333333333333
Chris Johnson,johnsch03,C,26,TOT,2012,27,175.0,55,2,15,25,40,6,9,15,33,20,41,0.4878048780487805,0,0,0.0,20,41,0.4878048780487805,0.488,15,19,0.7894736842105263
Ivan Johnson,johnsiv01,PF,27,ATL,2012,56,934.0,356,32,65,161,226,43,18,69,116,141,275,0.5127272727272727,2,6,0.3333333333333333,139,269,0.516728624535316,0.516,72,100,0.72
JaJuan Johnson,johnsja02,PF,22,BOS,2012,36,298.0,114,6,20,38,58,5,14,14,25,54,121,0.4462809917355372,0,0,0.0,54,121,0.4462809917355372,0.446,6,9,0.6666666666666666
James Johnson,johnsja01,SF,24,TOR,2012,62,1561.0,566,122,74,218,292,71,84,101,177,233,518,0.4498069498069498,19,60,0.3166666666666666,214,458,0.4672489082969432,0.468,81,115,0.7043478260869566
Joe Johnson,johnsjo02,SG,30,ATL,2012,60,2127.0,1129,232,53,168,221,48,13,116,75,423,931,0.4543501611170784,125,322,0.3881987577639751,298,609,0.4893267651888341,0.521,158,186,0.8494623655913979
Trey Johnson,johnstr01,SG,27,NOH,2012,11,61.0,21,4,3,9,12,1,0,5,10,8,14,0.5714285714285714,0,0,0.0,8,14,0.5714285714285714,0.571,5,5,1.0
Wesley Johnson,johnswe01,SF,24,MIN,2012,65,1469.0,393,59,24,153,177,35,48,60,115,158,397,0.3979848866498741,53,169,0.3136094674556213,105,228,0.4605263157894737,0.465,24,34,0.7058823529411765
Dahntay Jones,jonesda02,SF,31,IND,2012,65,1052.0,346,63,23,94,117,23,11,46,119,115,281,0.4092526690391459,33,77,0.4285714285714285,82,204,0.4019607843137255,0.468,83,99,0.8383838383838383
Dominique Jones,jonesdo02,SG,23,DAL,2012,33,268.0,88,42,9,35,44,10,5,28,28,29,73,0.3972602739726027,1,8,0.125,28,65,0.4307692307692308,0.404,29,37,0.7837837837837838
James Jones,jonesja02,SG,31,MIA,2012,51,666.0,185,19,6,43,49,17,9,10,45,57,150,0.38,46,114,0.4035087719298245,11,36,0.3055555555555556,0.533,25,30,0.8333333333333334
Solomon Jones,jonesso01,C-PF,27,TOT,2012,21,292.0,67,9,32,26,58,9,11,18,43,24,61,0.3934426229508196,0,0,0.0,24,61,0.3934426229508196,0.393,19,23,0.8260869565217391
DeAndre Jordan,jordade01,C,23,LAC,2012,66,1798.0,486,17,202,344,546,30,134,74,189,206,326,0.6319018404907976,0,1,0.0,206,325,0.6338461538461538,0.632,74,141,0.524822695035461
Jerome Jordan,jordaje01,C,25,NYK,2012,21,108.0,42,4,14,13,27,1,6,2,15,17,33,0.5151515151515151,0,0,0.0,17,33,0.5151515151515151,0.515,8,10,0.8
Cory Joseph,josepco01,PG,20,SAS,2012,29,266.0,58,34,5,20,25,7,3,12,16,22,70,0.3142857142857143,3,15,0.2,19,55,0.3454545454545454,0.336,11,17,0.6470588235294118
Chris Kaman,kamanch01,C,29,NOH,2012,47,1372.0,616,101,89,275,364,25,77,129,106,266,597,0.4455611390284757,0,0,0.0,266,597,0.4455611390284757,0.446,84,107,0.7850467289719626
Jason Kapono,kaponja01,SG,30,LAL,2012,27,269.0,54,11,2,12,14,3,0,6,21,21,55,0.3818181818181818,8,27,0.2962962962962963,13,28,0.4642857142857143,0.455,4,4,1.0
D.J. Kennedy,kennedj01,SF,22,CLE,2012,2,59.0,12,3,1,6,7,2,0,3,7,5,12,0.4166666666666667,2,4,0.5,3,8,0.375,0.5,0,2,0.0
Jason Kidd,kiddja01,PG,38,DAL,2012,48,1379.0,299,264,15,183,198,82,10,91,83,99,273,0.3626373626373626,79,223,0.3542600896860987,20,50,0.4,0.507,22,28,0.7857142857142857
Linas Kleiza,kleizli01,SF,27,TOR,2012,49,1057.0,473,46,42,157,199,23,4,64,119,165,410,0.4024390243902439,62,179,0.3463687150837989,103,231,0.4458874458874459,0.478,81,100,0.81
Brandon Knight,knighbr03,PG,20,DET,2012,66,2129.0,847,251,33,178,211,49,10,171,154,319,769,0.4148244473342002,105,276,0.3804347826086957,214,493,0.4340770791075051,0.483,104,137,0.7591240875912408
Kyle Korver,korveky01,SG,30,CHI,2012,65,1469.0,529,112,26,133,159,36,15,53,110,178,412,0.4320388349514563,118,271,0.4354243542435424,60,141,0.425531914893617,0.575,55,66,0.8333333333333334
Kosta Koufos,koufoko01,C,22,DEN,2012,48,792.0,263,15,95,163,258,24,41,33,96,115,192,0.5989583333333334,0,0,0.0,115,192,0.5989583333333334,0.599,33,55,0.6
Carl Landry,landrca01,PF,28,NOH,2012,41,999.0,511,38,78,136,214,13,12,64,89,182,362,0.5027624309392266,0,3,0.0,182,359,0.5069637883008357,0.503,147,184,0.7989130434782609
Ty Lawson,lawsoty01,PG,24,DEN,2012,61,2124.0,999,401,54,173,227,82,6,149,94,374,767,0.4876140808344198,73,200,0.365,301,567,0.5308641975308642,0.535,178,216,0.8240740740740741
Courtney Lee,leeco01,SG,26,HOU,2012,58,1757.0,660,88,26,133,159,68,22,64,106,251,580,0.4327586206896551,87,217,0.4009216589861751,164,363,0.4517906336088154,0.508,71,86,0.8255813953488372
David Lee,leeda02,PF,28,GSW,2012,57,2121.0,1147,162,171,374,545,54,22,149,179,464,922,0.5032537960954447,0,5,0.0,464,917,0.5059978189749182,0.503,219,280,0.7821428571428571
Malcolm Lee,leema01,SG,21,MIN,2012,19,243.0,62,31,9,17,26,8,4,17,22,23,59,0.3898305084745763,2,10,0.2,21,49,0.4285714285714285,0.407,14,17,0.8235294117647058
Kawhi Leonard,leonaka01,SF,20,SAS,2012,64,1534.0,507,70,104,223,327,85,24,44,88,199,404,0.4925742574257425,41,109,0.3761467889908257,158,295,0.535593220338983,0.543,68,88,0.7727272727272727
Travis Leslie,leslitr01,SG,21,LAC,2012,10,45.0,14,5,6,3,9,2,2,2,4,5,14,0.3571428571428571,0,0,0.0,5,14,0.3571428571428571,0.357,4,9,0.4444444444444444
Jon Leuer,leuerjo01,PF,22,MIL,2012,46,555.0,218,25,45,75,120,14,17,18,67,97,191,0.5078534031413613,3,9,0.3333333333333333,94,182,0.5164835164835165,0.516,21,28,0.75
Rashard Lewis,lewisra02,SF,32,WAS,2012,28,729.0,217,27,34,75,109,23,10,32,49,85,221,0.3846153846153846,16,67,0.2388059701492537,69,154,0.448051948051948,0.421,31,37,0.8378378378378378
DeAndre Liggins,liggide01,SF,23,ORL,2012,17,115.0,33,5,6,9,15,6,0,10,6,12,25,0.48,0,4,0.0,12,21,0.5714285714285714,0.48,9,19,0.4736842105263157
Jeremy Lin,linje01,PG,23,NYK,2012,35,940.0,512,216,18,89,107,55,9,126,78,171,383,0.4464751958224543,24,75,0.32,147,308,0.4772727272727273,0.478,146,183,0.7978142076502732
Shaun Livingston,livinsh01,SG,26,MIL,2012,58,1092.0,318,122,39,84,123,27,20,66,79,127,271,0.4686346863468634,2,3,0.6666666666666666,125,268,0.4664179104477612,0.472,62,79,0.7848101265822784
Brook Lopez,lopezbr01,C,23,NJN,2012,5,136.0,96,6,8,10,18,1,4,6,8,38,77,0.4935064935064935,0,0,0.0,38,77,0.4935064935064935,0.494,20,32,0.625
Robin Lopez,lopezro01,C,23,PHO,2012,64,895.0,348,20,90,119,209,18,60,43,128,124,269,0.4609665427509293,0,0,0.0,124,269,0.4609665427509293,0.461,100,140,0.7142857142857143
Kevin Love,loveke01,PF,23,MIN,2012,55,2145.0,1432,111,226,508,734,47,28,128,152,474,1059,0.4475920679886686,105,282,0.3723404255319149,369,777,0.4749034749034749,0.497,379,460,0.8239130434782609
Kyle Lowry,lowryky01,PG,25,HOU,2012,47,1510.0,670,310,37,176,213,73,14,130,133,210,513,0.4093567251461988,79,211,0.3744075829383886,131,302,0.4337748344370861,0.486,171,198,0.8636363636363636
John Lucas III,lucasjo02,PG,29,CHI,2012,49,726.0,369,108,22,54,76,19,1,42,42,143,358,0.3994413407821229,55,140,0.3928571428571428,88,218,0.4036697247706422,0.476,28,32,0.875
Shelvin Mack,macksh01,PG,21,WAS,2012,64,779.0,230,131,12,80,92,28,2,48,50,88,220,0.4,12,42,0.2857142857142857,76,178,0.4269662921348314,0.427,42,59,0.711864406779661
Vernon Macklin,macklve01,C,25,DET,2012,23,135.0,46,5,14,20,34,4,4,3,9,19,35,0.5428571428571428,0,0,0.0,19,35,0.5428571428571428,0.543,8,14,0.5714285714285714
Corey Maggette,maggeco01,SF,32,CHA,2012,32,881.0,480,39,21,104,125,23,1,59,83,139,373,0.3726541554959786,24,66,0.3636363636363636,115,307,0.3745928338762215,0.405,178,208,0.8557692307692307
Jamaal Magloire,magloja01,C,33,TOR,2012,34,374.0,41,6,25,88,113,4,10,22,66,17,45,0.3777777777777777,0,0,0.0,17,45,0.3777777777777777,0.378,7,27,0.2592592592592592
Ian Mahinmi,mahinia01,C,25,DAL,2012,61,1139.0,354,12,108,181,289,38,31,50,176,130,238,0.5462184873949579,0,1,0.0,130,237,0.5485232067510548,0.546,94,147,0.6394557823129252
Shawn Marion,mariosh01,SF,33,DAL,2012,63,1919.0,670,132,145,320,465,67,36,98,87,288,646,0.4458204334365325,20,68,0.2941176470588235,268,578,0.4636678200692041,0.461,74,93,0.7956989247311828
Cartier Martin,martica01,SF,27,WAS,2012,17,391.0,158,10,12,46,58,11,2,13,35,59,134,0.4402985074626865,29,75,0.3866666666666666,30,59,0.5084745762711864,0.549,11,19,0.5789473684210527
Kenyon Martin,martike01,PF,34,LAC,2012,42,940.0,217,18,49,132,181,44,43,32,103,97,220,0.4409090909090909,3,13,0.2307692307692307,94,207,0.4541062801932367,0.448,20,54,0.3703703703703703
Kevin Martin,martike02,SG,28,HOU,2012,40,1264.0,682,110,13,93,106,28,3,70,70,222,537,0.4134078212290503,78,225,0.3466666666666667,144,312,0.4615384615384615,0.486,160,179,0.8938547486033519
Roger Mason,masonro01,SG,31,WAS,2012,52,697.0,286,47,7,62,69,13,5,32,33,103,258,0.3992248062015504,59,154,0.3831168831168831,44,104,0.4230769230769231,0.514,21,27,0.7777777777777778
Wesley Matthews,matthwe02,SG,25,POR,2012,66,2228.0,904,113,56,168,224,96,15,73,148,314,763,0.4115334207077326,129,337,0.3827893175074184,185,426,0.4342723004694835,0.496,147,171,0.8596491228070176
Jason Maxiell,maxieja01,PF,28,DET,2012,65,1466.0,424,41,126,207,333,32,50,71,151,183,383,0.4778067885117493,0,2,0.0,183,381,0.4803149606299212,0.478,58,106,0.5471698113207547
Eric Maynor,maynoer01,PG,24,OKC,2012,9,137.0,38,22,3,10,13,5,0,11,13,14,39,0.358974358974359,6,17,0.3529411764705882,8,22,0.3636363636363636,0.436,4,4,1.0
O.J. Mayo,mayooj01,SG,24,MEM,2012,66,1771.0,833,169,30,180,210,71,23,124,137,300,736,0.4076086956521739,100,275,0.3636363636363636,200,461,0.4338394793926247,0.476,133,172,0.7732558139534884
Luc Mbah a Moute,mbahalu01,PF,25,MIL,2012,43,1009.0,333,29,77,150,227,40,22,39,93,133,261,0.5095785440613027,1,4,0.25,132,257,0.5136186770428015,0.511,66,103,0.6407766990291263
JaVale McGee,mcgeeja01,C,24,TOT,2012,61,1535.0,691,31,163,314,477,35,132,87,166,307,552,0.5561594202898551,0,0,0.0,307,552,0.5561594202898551,0.556,77,167,0.4610778443113772
Tracy McGrady,mcgratr01,SF,32,ATL,2012,52,837.0,273,110,23,131,154,16,15,53,35,101,231,0.4372294372294372,15,33,0.4545454545454545,86,198,0.4343434343434343,0.47,56,83,0.6746987951807228
Dominic McGuire,mcguido01,PF,26,GSW,2012,64,1127.0,227,110,73,173,246,44,36,56,104,94,210,0.4476190476190476,0,4,0.0,94,206,0.4563106796116505,0.448,39,53,0.7358490566037735
Josh McRoberts,mcrobjo01,PF,24,LAL,2012,50,718.0,138,51,61,110,171,15,18,31,74,56,118,0.4745762711864407,3,7,0.4285714285714285,53,111,0.4774774774774775,0.487,23,36,0.6388888888888888
Jodie Meeks,meeksjo01,SG,24,PHI,2012,66,1644.0,556,54,17,144,161,40,3,29,82,191,467,0.4089935760171306,97,266,0.3646616541353383,94,201,0.4676616915422885,0.513,77,85,0.9058823529411764
C.J. Miles,milescj01,SG,24,UTA,2012,56,1145.0,508,69,27,89,116,46,18,53,122,177,465,0.3806451612903225,46,150,0.3066666666666666,131,315,0.4158730158730159,0.43,108,136,0.7941176470588235
Darko Miličić,milicda01,C,26,MIN,2012,29,472.0,134,17,35,62,97,9,25,32,59,59,130,0.4538461538461538,0,0,0.0,59,130,0.4538461538461538,0.454,16,37,0.4324324324324324
Andre Miller,millean02,SG,35,DEN,2012,66,1809.0,639,441,53,168,221,63,9,177,133,242,552,0.4384057971014493,18,83,0.216867469879518,224,469,0.4776119402985074,0.455,137,169,0.8106508875739645
Brad Miller,millebr01,C,35,MIN,2012,15,146.0,35,24,4,15,19,4,2,12,10,9,27,0.3333333333333333,7,15,0.4666666666666667,2,12,0.1666666666666666,0.463,10,12,0.8333333333333334
Mike Miller,millemi01,SG,31,MIA,2012,39,752.0,237,42,22,106,128,14,6,30,58,91,209,0.4354066985645933,53,117,0.452991452991453,38,92,0.4130434782608695,0.562,2,5,0.4
Patty Mills,millspa02,PG,23,SAS,2012,16,261.0,165,39,4,24,28,10,1,26,14,63,130,0.4846153846153846,24,56,0.4285714285714285,39,74,0.527027027027027,0.577,15,15,1.0
Paul Millsap,millspa01,PF,26,UTA,2012,64,2100.0,1061,150,180,383,563,118,52,112,222,426,861,0.494773519163763,7,31,0.2258064516129032,419,830,0.5048192771084338,0.499,202,255,0.792156862745098
Nazr Mohammed,mohamna01,C,34,OKC,2012,63,692.0,171,14,59,111,170,20,37,26,101,79,169,0.4674556213017751,0,1,0.0,79,168,0.4702380952380952,0.467,13,23,0.5652173913043478
Greg Monroe,monrogr01,C,21,DET,2012,66,2082.0,1015,152,239,398,637,83,46,161,180,407,781,0.5211267605633803,0,1,0.0,407,780,0.5217948717948718,0.521,201,272,0.7389705882352942
Jamario Moon,moonja01,SF,31,CHA,2012,8,123.0,18,5,2,20,22,1,5,8,5,7,24,0.2916666666666667,2,10,0.2,5,14,0.3571428571428571,0.333,2,2,1.0
E'Twaun Moore,mooreet01,PG,22,BOS,2012,38,331.0,110,34,4,29,33,11,3,21,33,43,113,0.3805309734513274,17,45,0.3777777777777777,26,68,0.3823529411764705,0.456,7,7,1.0
Mikki Moore,mooremi01,C,36,GSW,2012,7,118.0,24,5,7,15,22,3,3,7,24,9,20,0.45,0,0,0.0,9,20,0.45,0.45,6,7,0.8571428571428571
Darius Morris,morrida01,PG,21,LAL,2012,19,169.0,46,21,2,14,16,2,0,19,16,18,42,0.4285714285714285,4,9,0.4444444444444444,14,33,0.4242424242424242,0.476,6,9,0.6666666666666666
Marcus Morris,morrima03,PF,22,HOU,2012,17,126.0,40,3,5,11,16,2,2,4,12,16,54,0.2962962962962963,2,17,0.1176470588235294,14,37,0.3783783783783784,0.315,6,8,0.75
Markieff Morris,morrima02,PF,22,PHO,2012,63,1227.0,467,65,69,210,279,41,42,70,179,174,436,0.3990825688073394,43,124,0.3467741935483871,131,312,0.4198717948717949,0.448,76,106,0.7169811320754716
Anthony Morrow,morroan01,SG,26,NJN,2012,62,1636.0,747,61,31,96,127,46,9,70,86,272,658,0.4133738601823708,106,286,0.3706293706293706,166,372,0.4462365591397849,0.494,97,104,0.9326923076923076
Timofey Mozgov,mozgoti01,C,25,DEN,2012,44,687.0,239,22,53,126,179,15,42,53,86,100,190,0.5263157894736842,0,0,0.0,100,190,0.5263157894736842,0.526,39,57,0.6842105263157895
Byron Mullens,mulleby01,C,22,CHA,2012,65,1465.0,606,57,96,231,327,21,52,74,137,251,591,0.4247038917089678,12,51,0.2352941176470588,239,540,0.4425925925925926,0.435,92,112,0.8214285714285714
Troy Murphy,murphtr01,PF,31,LAL,2012,59,956.0,188,51,40,151,191,15,16,26,98,77,171,0.4502923976608187,28,67,0.417910447761194,49,104,0.4711538461538461,0.532,6,9,0.6666666666666666
Hamady N'Diaye,ndiayha01,C,25,WAS,2012,3,3.0,0,0,0,0,0,0,0,0,0,0,1,0.0,0,0,0.0,0,1,0.0,0.0,0,0,0.0
Eduardo Nájera,najered01,PF,35,CHA,2012,22,270.0,58,12,11,39,50,19,4,7,40,24,64,0.375,8,29,0.2758620689655172,16,35,0.4571428571428571,0.438,2,4,0.5
Steve Nash,nashst01,PG,37,PHO,2012,62,1961.0,772,664,26,160,186,38,8,229,53,295,555,0.5315315315315315,55,141,0.3900709219858156,240,414,0.5797101449275363,0.581,127,142,0.8943661971830986
Gary Neal,nealga01,SG,27,SAS,2012,56,1206.0,557,117,12,106,118,27,2,60,75,212,486,0.4362139917695473,83,198,0.4191919191919191,129,288,0.4479166666666667,0.522,50,64,0.78125
Jameer Nelson,nelsoja01,PG,29,ORL,2012,57,1706.0,676,325,29,152,181,38,5,135,130,259,606,0.4273927392739274,87,231,0.3766233766233766,172,375,0.4586666666666666,0.499,71,88,0.8068181818181818
Joakim Noah,noahjo01,C,26,CHI,2012,64,1945.0,652,160,242,387,629,41,92,92,162,249,490,0.5081632653061224,0,1,0.0,249,489,0.50920245398773,0.508,154,206,0.7475728155339806
Andrés Nocioni,nocioan01,SF,32,PHI,2012,11,56.0,17,1,1,13,14,1,1,5,4,5,20,0.25,1,6,0.1666666666666666,4,14,0.2857142857142857,0.275,6,11,0.5454545454545454
Steve Novak,novakst01,PF,28,NYK,2012,54,1020.0,477,12,9,95,104,16,9,21,59,161,337,0.4777448071216617,133,282,0.4716312056737589,28,55,0.509090909090909,0.675,22,26,0.8461538461538461
Dirk Nowitzki,nowitdi01,PF,33,DAL,2012,62,2079.0,1342,136,46,372,418,42,30,117,129,473,1034,0.4574468085106383,78,212,0.3679245283018867,395,822,0.4805352798053528,0.495,318,355,0.895774647887324
Jermaine O'Neal,onealje01,C,33,BOS,2012,25,570.0,125,10,37,98,135,8,43,21,80,52,120,0.4333333333333333,0,0,0.0,52,120,0.4333333333333333,0.433,21,31,0.6774193548387096
Lamar Odom,odomla01,SF,32,DAL,2012,50,1027.0,332,83,36,172,208,20,18,52,97,123,349,0.3524355300859599,28,111,0.2522522522522522,95,238,0.3991596638655462,0.393,58,98,0.5918367346938775
Emeka Okafor,okafoem01,C,29,NOH,2012,27,781.0,266,24,70,143,213,16,26,37,73,114,214,0.5327102803738317,0,0,0.0,114,214,0.5327102803738317,0.533,38,74,0.5135135135135135
Mehmet Okur,okurme01,C,32,NJN,2012,17,454.0,130,30,22,59,81,9,5,25,45,52,139,0.3741007194244604,23,72,0.3194444444444444,29,67,0.4328358208955223,0.457,3,5,0.6
Daniel Orton,ortonda01,PF,21,ORL,2012,16,187.0,45,5,19,20,39,8,9,7,30,17,30,0.5666666666666667,0,1,0.0,17,29,0.5862068965517241,0.567,11,25,0.44
Travis Outlaw,outlatr01,SF,27,SAC,2012,39,500.0,167,16,19,42,61,19,21,20,34,60,175,0.3428571428571428,16,60,0.2666666666666666,44,115,0.3826086956521739,0.389,31,46,0.6739130434782609
Larry Owens,owensla01,SF,29,NJN,2012,7,75.0,13,4,2,11,13,0,1,2,10,4,11,0.3636363636363636,2,5,0.4,2,6,0.3333333333333333,0.455,3,4,0.75
Zaza Pachulia,pachuza01,C,27,ATL,2012,58,1640.0,455,79,154,303,457,55,29,81,172,169,339,0.4985250737463126,0,0,0.0,169,339,0.4985250737463126,0.499,117,158,0.740506329113924
Jannero Pargo,pargoja01,PG,32,ATL,2012,50,671.0,282,96,9,64,73,20,2,49,64,105,253,0.4150197628458498,53,138,0.3840579710144927,52,115,0.4521739130434782,0.52,19,20,0.95
Jeremy Pargo,pargoje01,PG,25,MEM,2012,44,424.0,126,55,12,25,37,15,0,46,46,50,150,0.3333333333333333,10,38,0.2631578947368421,40,112,0.3571428571428571,0.367,16,27,0.5925925925925926
Anthony Parker,parkean01,SF,36,CLE,2012,51,1280.0,367,120,10,128,138,38,7,50,65,141,326,0.4325153374233129,50,138,0.3623188405797101,91,188,0.4840425531914893,0.509,35,56,0.625
Tony Parker,parketo01,PG,29,SAS,2012,60,1923.0,1095,463,22,149,171,57,5,153,75,427,890,0.4797752808988764,14,61,0.2295081967213114,413,829,0.4981905910735826,0.488,227,284,0.7992957746478874
Chandler Parsons,parsoch01,SF,23,HOU,2012,63,1804.0,599,134,90,210,300,73,29,81,142,248,549,0.4517304189435337,60,178,0.3370786516853932,188,371,0.5067385444743935,0.506,43,78,0.5512820512820513
Patrick Patterson,pattepa01,PF,22,HOU,2012,64,1483.0,490,53,112,174,286,27,36,49,113,225,511,0.4403131115459882,0,3,0.0,225,508,0.4429133858267716,0.44,40,57,0.7017543859649122
Chris Paul,paulch01,PG,26,LAC,2012,60,2181.0,1189,543,42,171,213,152,4,124,138,425,890,0.4775280898876404,79,213,0.3708920187793427,346,677,0.5110782865583456,0.522,260,302,0.8609271523178808
Sasha Pavlović,pavloal01,SF,28,BOS,2012,45,527.0,120,18,4,68,72,20,15,20,54,50,128,0.390625,17,58,0.293103448275862,33,70,0.4714285714285714,0.457,3,8,0.375
Nikola Peković,pekovni01,C,26,MIN,2012,47,1264.0,651,31,181,165,346,29,31,87,98,256,454,0.5638766519823789,0,0,0.0,256,454,0.5638766519823789,0.564,139,187,0.7433155080213903
Kendrick Perkins,perkike01,C,27,OKC,2012,65,1744.0,329,78,120,306,426,25,73,118,189,128,262,0.4885496183206106,0,0,0.0,128,262,0.4885496183206106,0.489,73,112,0.6517857142857143
Johan Petro,petrojo01,C,26,NJN,2012,59,920.0,250,45,68,156,224,21,23,38,122,109,260,0.4192307692307692,1,1,1.0,108,259,0.416988416988417,0.421,31,37,0.8378378378378378
Paul Pierce,piercpa01,SF,34,BOS,2012,61,2075.0,1181,274,37,280,317,70,26,173,147,394,890,0.4426966292134831,100,273,0.3663003663003663,294,617,0.4764991896272285,0.499,293,344,0.8517441860465116
Mickaël Piétrus,pietrmi01,SG,29,BOS,2012,42,921.0,289,25,18,112,130,21,10,33,81,104,270,0.3851851851851852,61,182,0.3351648351648351,43,88,0.4886363636363636,0.498,20,31,0.6451612903225806
Dexter Pittman,pittmde01,C,23,MIA,2012,35,301.0,106,9,27,44,71,8,8,17,73,44,94,0.4680851063829787,0,0,0.0,44,94,0.4680851063829787,0.468,18,28,0.6428571428571429
Quincy Pondexter,pondequ01,SF,23,MEM,2012,64,1002.0,271,27,55,71,126,27,5,30,90,108,239,0.4518828451882845,22,73,0.3013698630136986,86,166,0.5180722891566265,0.498,33,53,0.6226415094339622
A.J. Price,priceaj01,PG,25,IND,2012,44,568.0,172,86,13,48,61,20,2,32,30,59,174,0.3390804597701149,26,88,0.2954545454545454,33,86,0.3837209302325581,0.414,28,35,0.8
Ronnie Price,pricero01,PG,28,PHO,2012,36,517.0,131,67,18,38,56,34,3,46,72,49,130,0.3769230769230769,13,44,0.2954545454545454,36,86,0.4186046511627907,0.427,20,25,0.8
Tayshaun Prince,princta01,SF,31,DET,2012,63,2087.0,798,153,72,209,281,27,32,74,77,336,798,0.4210526315789473,37,104,0.3557692307692308,299,694,0.430835734870317,0.444,89,115,0.7739130434782608
Joel Przybilla,przybjo01,C,32,POR,2012,27,449.0,55,6,29,109,138,4,16,22,66,22,48,0.4583333333333333,0,0,0.0,22,48,0.4583333333333333,0.458,11,18,0.6111111111111112
Vladimir Radmanović,radmavl01,SF,31,ATL,2012,49,755.0,220,54,34,109,143,21,15,35,62,74,197,0.3756345177664975,50,135,0.3703703703703703,24,62,0.3870967741935484,0.503,22,29,0.7586206896551724
Anthony Randolph,randoan01,PF,22,MIN,2012,34,517.0,252,19,42,81,123,13,35,40,56,94,200,0.47,0,1,0.0,94,199,0.4723618090452261,0.47,64,84,0.7619047619047619
Zach Randolph,randoza01,PF,30,MEM,2012,28,735.0,324,48,78,147,225,21,4,40,57,132,285,0.4631578947368421,2,8,0.25,130,277,0.4693140794223827,0.467,58,88,0.6590909090909091
Michael Redd,reddmi01,SG,32,PHO,2012,51,770.0,418,33,14,63,77,13,0,37,29,144,360,0.4,42,132,0.3181818181818182,102,228,0.4473684210526316,0.458,88,111,0.7927927927927928
J.J. Redick,redicjj01,SG,27,ORL,2012,65,1765.0,751,164,18,132,150,27,6,68,92,248,584,0.4246575342465753,112,268,0.417910447761194,136,316,0.430379746835443,0.521,143,157,0.910828025477707
Ryan Reid,reidry01,PF,25,OKC,2012,5,17.0,8,0,1,1,2,0,0,1,1,4,5,0.8,0,0,0.0,4,5,0.8,0.8,0,0,0.0
Jason Richardson,richaja01,SG,31,ORL,2012,54,1591.0,629,107,36,158,194,53,22,60,91,243,596,0.4077181208053691,102,277,0.3682310469314079,141,319,0.4420062695924764,0.493,41,69,0.5942028985507246
Quentin Richardson,richaqu01,SF,31,ORL,2012,48,866.0,215,38,15,108,123,28,6,29,74,74,197,0.3756345177664975,42,121,0.3471074380165289,32,76,0.4210526315789473,0.482,25,30,0.8333333333333334
Luke Ridnour,ridnolu01,SG,30,MIN,2012,53,1750.0,639,252,19,122,141,56,16,96,136,242,550,0.44,49,152,0.3223684210526316,193,398,0.4849246231155779,0.485,106,119,0.8907563025210085
Nate Robinson,robinna01,PG,27,GSW,2012,51,1192.0,570,231,15,85,100,59,2,75,118,205,484,0.4235537190082644,66,181,0.3646408839779005,139,303,0.4587458745874587,0.492,94,113,0.831858407079646
Rajon Rondo,rondora01,PG,25,BOS,2012,53,1957.0,630,620,62,195,257,95,3,193,99,256,572,0.4475524475524475,10,42,0.238095238095238,246,530,0.4641509433962264,0.456,108,181,0.5966850828729282
Derrick Rose,rosede01,PG,23,CHI,2012,39,1375.0,852,307,26,105,131,35,28,119,52,302,695,0.4345323741007194,54,173,0.3121387283236994,248,522,0.475095785440613,0.473,194,239,0.8117154811715481
Ricky Rubio,rubiori01,PG,21,MIN,2012,41,1404.0,436,336,21,150,171,91,8,131,97,139,389,0.3573264781491002,32,94,0.3404255319148936,107,295,0.3627118644067796,0.398,126,157,0.802547770700637
Brandon Rush,rushbr01,SF,26,GSW,2012,65,1717.0,634,88,33,218,251,35,58,68,64,235,469,0.5010660980810234,99,219,0.4520547945205479,136,250,0.544,0.607,65,82,0.7926829268292683
Walker Russell,russewa02,PG,29,DET,2012,28,357.0,84,58,7,19,26,18,1,33,29,33,95,0.3473684210526316,4,13,0.3076923076923077,29,82,0.3536585365853658,0.368,14,22,0.6363636363636364
John Salmons,salmojo01,SF,32,SAC,2012,46,1250.0,344,93,20,114,134,37,7,45,77,141,345,0.408695652173913,33,112,0.2946428571428571,108,233,0.463519313304721,0.457,29,45,0.6444444444444445
Samardo Samuels,samuesa01,C,23,CLE,2012,54,825.0,292,20,63,117,180,20,20,56,113,105,231,0.4545454545454545,0,0,0.0,105,231,0.4545454545454545,0.455,82,117,0.7008547008547008
Larry Sanders,sandela01,PF,23,MIL,2012,52,643.0,186,33,62,98,160,32,76,43,133,84,184,0.4565217391304347,0,2,0.0,84,182,0.4615384615384615,0.457,18,38,0.4736842105263157
Brian Scalabrine,scalabr01,PF,33,CHI,2012,28,122.0,32,15,8,13,21,5,6,9,9,14,30,0.4666666666666667,1,7,0.1428571428571428,13,23,0.5652173913043478,0.483,3,6,0.5
Luis Scola,scolalu01,PF,31,HOU,2012,66,2067.0,1025,140,122,306,428,35,24,153,214,436,888,0.4909909909909909,0,3,0.0,436,885,0.4926553672316384,0.491,153,198,0.7727272727272727
Thabo Sefolosha,sefolth01,SG,27,OKC,2012,42,914.0,203,47,21,107,128,37,17,40,78,67,155,0.432258064516129,31,71,0.4366197183098591,36,84,0.4285714285714285,0.532,38,43,0.8837209302325582
Josh Selby,selbyjo01,PG,20,MEM,2012,28,237.0,63,30,2,13,15,7,0,29,17,25,72,0.3472222222222222,2,15,0.1333333333333333,23,57,0.4035087719298245,0.361,11,14,0.7857142857142857
Kevin Séraphin,serapke01,C,22,WAS,2012,57,1176.0,453,33,103,177,280,19,76,66,133,203,382,0.5314136125654451,0,1,0.0,203,381,0.5328083989501312,0.531,47,70,0.6714285714285714
Ramon Sessions,sessira01,PG,25,TOT,2012,64,1707.0,721,354,33,181,214,44,3,141,100,242,565,0.4283185840707965,43,97,0.4432989690721649,199,468,0.4252136752136752,0.466,194,248,0.782258064516129
Iman Shumpert,shumpim01,PG,21,NYK,2012,59,1705.0,563,164,42,144,186,101,8,111,173,214,534,0.4007490636704119,48,157,0.3057324840764331,166,377,0.4403183023872679,0.446,87,109,0.7981651376146789
Xavier Silas,silasxa01,SG,24,PHI,2012,2,39.0,11,3,2,2,4,0,0,3,5,4,15,0.2666666666666666,1,6,0.1666666666666666,3,9,0.3333333333333333,0.3,2,3,0.6666666666666666
Bobby Simmons,simmobo01,SF,31,LAC,2012,28,418.0,80,11,17,38,55,15,3,10,41,28,90,0.3111111111111111,20,60,0.3333333333333333,8,30,0.2666666666666666,0.422,4,7,0.5714285714285714
Chris Singleton,singlch01,SF,22,WAS,2012,66,1431.0,306,49,43,190,233,70,30,38,176,116,312,0.3717948717948718,44,127,0.3464566929133858,72,185,0.3891891891891892,0.442,30,44,0.6818181818181818
James Singleton,singlja01,PF,30,WAS,2012,12,262.0,98,15,25,56,81,9,8,10,27,41,75,0.5466666666666666,2,9,0.2222222222222222,39,66,0.5909090909090909,0.56,14,15,0.9333333333333332
Brian Skinner,skinnbr01,C,35,MEM,2012,1,4.0,0,0,0,0,0,0,0,0,1,0,1,0.0,0,0,0.0,0,1,0.0,0.0,0,0,0.0
Donald Sloan,sloando01,PG,24,TOT,2012,33,669.0,183,105,18,49,67,13,3,49,37,79,198,0.398989898989899,2,25,0.08,77,173,0.4450867052023121,0.404,23,30,0.7666666666666667
Craig Smith,smithcr01,PF,28,POR,2012,47,464.0,156,19,33,77,110,16,5,24,55,59,117,0.5042735042735043,0,1,0.0,59,116,0.5086206896551724,0.504,38,53,0.7169811320754716
Greg Smith,smithgr02,C,21,HOU,2012,8,69.0,14,1,5,15,20,2,5,1,17,7,11,0.6363636363636364,0,0,0.0,7,11,0.6363636363636364,0.636,0,0,0.0
Ish Smith,smithis01,PG,23,TOT,2012,26,234.0,72,41,7,28,35,15,2,13,15,31,81,0.382716049382716,3,9,0.3333333333333333,28,72,0.3888888888888889,0.401,7,10,0.7
J.R. Smith,smithjr01,SG,26,NYK,2012,35,967.0,436,84,29,107,136,54,6,46,87,165,405,0.4074074074074074,67,193,0.3471502590673575,98,212,0.4622641509433962,0.49,39,55,0.7090909090909091
Jason Smith,smithja02,PF,25,NOH,2012,40,947.0,396,34,72,124,196,21,41,40,102,181,348,0.5201149425287356,1,9,0.1111111111111111,180,339,0.5309734513274337,0.522,33,47,0.7021276595744681
Jerry Smith,smithje01,PG,24,NJN,2012,5,46.0,7,4,2,5,7,5,0,0,5,3,14,0.2142857142857142,1,6,0.1666666666666666,2,8,0.25,0.25,0,0,0.0
Josh Smith,smithjo03,PF,26,ATL,2012,66,2329.0,1239,257,136,496,632,93,115,164,172,504,1101,0.4577656675749318,28,109,0.2568807339449541,476,992,0.4798387096774194,0.47,203,322,0.6304347826086957
Nolan Smith,smithno01,PG,23,POR,2012,44,541.0,167,62,17,39,56,18,3,42,55,67,180,0.3722222222222222,13,45,0.2888888888888888,54,135,0.4,0.408,20,28,0.7142857142857143
Marreese Speights,speigma01,PF,24,MEM,2012,60,1345.0,526,48,133,241,374,21,29,74,147,221,488,0.4528688524590163,0,3,0.0,221,485,0.4556701030927835,0.453,84,109,0.7706422018348624
Tiago Splitter,splitti01,C,27,SAS,2012,59,1121.0,549,65,93,213,306,21,47,87,134,212,343,0.6180758017492711,0,0,0.0,212,343,0.6180758017492711,0.618,125,181,0.6906077348066298
Jerry Stackhouse,stackje01,SF,37,ATL,2012,30,273.0,108,14,6,17,23,10,3,13,12,37,100,0.37,13,38,0.3421052631578947,24,62,0.3870967741935484,0.435,21,23,0.9130434782608696
Lance Stephenson,stephla01,SG,21,IND,2012,42,442.0,106,46,12,41,53,21,5,36,30,47,125,0.376,4,30,0.1333333333333333,43,95,0.4526315789473684,0.392,8,17,0.4705882352941176
DeShawn Stevenson,stevede01,SF,30,NJN,2012,51,960.0,148,41,7,94,101,19,4,19,59,49,172,0.2848837209302325,41,145,0.2827586206896552,8,27,0.2962962962962963,0.404,9,16,0.5625
Greg Stiemsma,stiemgr01,C,26,BOS,2012,55,766.0,161,28,48,129,177,37,85,33,144,66,121,0.5454545454545454,0,0,0.0,66,121,0.5454545454545454,0.545,29,41,0.7073170731707317
Julyan Stone,stoneju01,SG,23,DEN,2012,22,179.0,36,37,5,20,25,8,6,11,18,13,31,0.4193548387096774,2,11,0.1818181818181818,11,20,0.55,0.452,8,11,0.7272727272727273
Amar'e Stoudemire,stoudam01,PF,29,NYK,2012,47,1543.0,823,52,106,261,367,38,45,112,138,316,654,0.4831804281345566,5,21,0.238095238095238,311,633,0.4913112164296998,0.487,186,243,0.7654320987654321
Rodney Stuckey,stuckro01,SG,25,DET,2012,55,1644.0,812,210,38,104,142,44,10,106,124,256,597,0.4288107202680067,33,104,0.3173076923076923,223,493,0.4523326572008113,0.456,267,320,0.834375
DaJuan Summers,summeda01,SF,24,NOH,2012,15,209.0,68,10,8,15,23,7,0,8,31,28,65,0.4307692307692308,5,16,0.3125,23,49,0.4693877551020408,0.469,7,9,0.7777777777777778
Jeff Teague,teaguje01,PG,23,ATL,2012,66,2183.0,831,321,21,138,159,106,37,134,145,320,672,0.4761904761904761,51,149,0.3422818791946309,269,523,0.51434034416826,0.514,140,185,0.7567567567567568
Sebastian Telfair,telfase01,PG,26,PHO,2012,60,895.0,368,138,20,71,91,41,12,68,120,141,342,0.4122807017543859,33,105,0.3142857142857143,108,237,0.4556962025316455,0.461,53,67,0.7910447761194029
Jason Terry,terryja01,SG,34,DAL,2012,63,2000.0,950,226,16,133,149,73,11,127,69,357,830,0.4301204819277108,138,365,0.3780821917808219,219,465,0.4709677419354838,0.513,98,111,0.8828828828828829
Hasheem Thabeet,thabeha01,C,24,TOT,2012,20,139.0,35,0,16,26,42,1,10,8,20,11,21,0.5238095238095238,0,0,0.0,11,21,0.5238095238095238,0.524,13,20,0.65
Isaiah Thomas,thomais02,PG,22,SAC,2012,65,1656.0,749,266,48,120,168,53,8,105,121,256,571,0.4483362521891418,83,219,0.3789954337899543,173,352,0.4914772727272727,0.521,154,185,0.8324324324324325
Kurt Thomas,thomaku01,C,39,POR,2012,53,803.0,160,46,39,149,188,24,31,31,123,73,157,0.464968152866242,0,0,0.0,73,157,0.464968152866242,0.465,14,20,0.7
Lance Thomas,thomala01,PF,23,NOH,2012,42,630.0,166,12,49,77,126,10,7,24,78,57,126,0.4523809523809524,0,1,0.0,57,125,0.456,0.452,52,62,0.8387096774193549
Malcolm Thomas,thomama01,PF,23,SAS,2012,3,15.0,1,1,1,2,3,1,1,0,0,0,3,0.0,0,0,0.0,0,3,0.0,0.0,1,2,0.5
Tyrus Thomas,thomaty01,PF,25,CHA,2012,54,1013.0,304,35,49,151,200,36,60,53,144,120,327,0.3669724770642202,1,3,0.3333333333333333,119,324,0.3672839506172839,0.369,63,83,0.7590361445783133
Trey Thompkins,thomptr02,C,21,LAC,2012,24,119.0,57,3,4,20,24,3,3,6,10,24,61,0.3934426229508196,4,13,0.3076923076923077,20,48,0.4166666666666667,0.426,5,7,0.7142857142857143
Jason Thompson,thompja02,PF,25,SAC,2012,64,1657.0,583,79,166,277,443,43,44,68,149,237,443,0.5349887133182845,0,2,0.0,237,441,0.5374149659863946,0.535,109,181,0.6022099447513812
Klay Thompson,thompkl01,SG,21,GSW,2012,66,1608.0,826,133,24,137,161,49,20,103,155,318,718,0.4428969359331476,111,268,0.4141791044776119,207,450,0.46,0.52,79,91,0.8681318681318682
Mychel Thompson,thompmy02,SG,23,CLE,2012,5,95.0,18,7,0,5,5,2,1,5,8,7,24,0.2916666666666667,4,11,0.3636363636363636,3,13,0.2307692307692307,0.375,0,0,0.0
Tristan Thompson,thomptr01,PF,20,CLE,2012,60,1424.0,494,27,187,202,389,27,62,81,134,194,442,0.4389140271493212,0,2,0.0,194,440,0.4409090909090909,0.439,106,192,0.5520833333333334
Marcus Thornton,thornma01,SG,24,SAC,2012,51,1780.0,952,98,84,104,188,71,12,84,111,352,803,0.4383561643835616,107,310,0.3451612903225806,245,493,0.4969574036511156,0.505,141,163,0.8650306748466258
Jamaal Tinsley,tinslja01,PG,33,UTA,2012,37,507.0,137,123,6,39,45,17,8,52,47,57,141,0.4042553191489361,10,37,0.2702702702702703,47,104,0.4519230769230769,0.44,13,17,0.7647058823529411
Anthony Tolliver,tollian01,SF,26,MIN,2012,51,882.0,208,22,50,103,153,18,19,35,86,71,182,0.3901098901098901,25,101,0.2475247524752475,46,81,0.5679012345679012,0.459,41,55,0.7454545454545455
Ronny Turiaf,turiaro01,C,29,TOT,2012,17,279.0,51,10,20,50,70,14,17,14,39,19,33,0.5757575757575758,0,1,0.0,19,32,0.59375,0.576,13,22,0.5909090909090909
Hedo Türkoğlu,turkohe01,SF,32,ORL,2012,53,1653.0,576,233,24,175,199,45,17,142,139,209,504,0.4146825396825397,91,258,0.3527131782945736,118,246,0.4796747967479675,0.505,67,95,0.7052631578947368
Evan Turner,turneev01,SF,23,PHI,2012,65,1713.0,610,180,27,349,376,40,20,105,117,263,590,0.4457627118644068,11,49,0.2244897959183673,252,541,0.4658040665434381,0.455,73,108,0.6759259259259259
Jeremy Tyler,tylerje01,C,20,GSW,2012,42,568.0,205,16,54,86,140,16,20,36,84,88,209,0.4210526315789473,0,1,0.0,88,208,0.4230769230769231,0.421,29,52,0.5576923076923077
Edwin Ubiles,ubileed01,SF,25,WAS,2012,4,52.0,14,1,2,8,10,1,1,1,1,5,18,0.2777777777777778,1,5,0.2,4,13,0.3076923076923077,0.306,3,3,1.0
Ekpe Udoh,udohek01,C,24,TOT,2012,61,1290.0,340,57,100,154,254,40,102,53,174,127,295,0.4305084745762711,0,2,0.0,127,293,0.4334470989761092,0.431,86,114,0.7543859649122807
Beno Udrih,udrihbe01,SG,29,MIL,2012,59,1080.0,348,227,26,76,102,37,1,77,69,146,332,0.4397590361445783,17,59,0.288135593220339,129,273,0.4725274725274725,0.465,39,55,0.7090909090909091
Ben Uzoh,uzohbe01,PG,23,TOT,2012,18,370.0,81,61,19,48,67,17,3,19,31,35,99,0.3535353535353535,0,1,0.0,35,98,0.3571428571428571,0.354,11,19,0.5789473684210527
Anderson Varejão,varejan01,C,29,CLE,2012,25,785.0,271,43,109,178,287,35,17,45,62,114,222,0.5135135135135135,0,4,0.0,114,218,0.5229357798165137,0.514,43,64,0.671875
Greivis Vásquez,vasqugr01,PG,25,NOH,2012,66,1706.0,589,359,23,150,173,60,8,148,126,225,523,0.4302103250478011,43,135,0.3185185185185185,182,388,0.4690721649484536,0.471,96,117,0.8205128205128205
Jan Veselý,veselja01,PF,21,WAS,2012,57,1078.0,267,47,101,148,249,39,32,60,156,117,218,0.536697247706422,0,1,0.0,117,217,0.5391705069124424,0.537,33,62,0.532258064516129
Charlie Villanueva,villach01,PF,27,DET,2012,13,180.0,91,6,9,39,48,7,5,7,25,35,91,0.3846153846153846,15,45,0.3333333333333333,20,46,0.4347826086956521,0.467,6,7,0.8571428571428571
Nikola Vučević,vucevni01,C,21,PHI,2012,51,812.0,283,31,88,158,246,20,34,33,111,131,291,0.4501718213058419,3,8,0.375,128,283,0.4522968197879858,0.455,18,34,0.5294117647058824
Dwyane Wade,wadedw01,SG,30,MIA,2012,49,1625.0,1082,225,73,164,237,82,63,129,110,416,837,0.4970131421744325,15,56,0.2678571428571428,401,781,0.5134443021766966,0.506,235,297,0.7912457912457912
Von Wafer,wafervo01,SG,26,ORL,2012,33,469.0,194,29,6,39,45,10,3,35,26,71,157,0.4522292993630573,14,39,0.358974358974359,57,118,0.4830508474576271,0.497,38,54,0.7037037037037037
Henry Walker,walkebi01,SG,24,NYK,2012,32,620.0,189,37,9,71,80,19,7,35,84,68,171,0.3976608187134502,36,113,0.3185840707964602,32,58,0.5517241379310345,0.503,17,20,0.85
Kemba Walker,walkeke02,PG,21,CHA,2012,66,1792.0,799,289,30,204,234,60,20,119,79,281,767,0.3663624511082138,69,226,0.3053097345132743,212,541,0.3918669131238447,0.411,168,213,0.7887323943661971
John Wall,walljo01,PG,21,WAS,2012,66,2386.0,1076,530,48,252,300,95,57,255,137,378,894,0.4228187919463087,3,42,0.0714285714285714,375,852,0.4401408450704225,0.424,317,402,0.7885572139303483
Ben Wallace,wallabe01,C,37,DET,2012,62,980.0,85,43,81,188,269,47,51,34,60,34,86,0.3953488372093023,1,4,0.25,33,82,0.4024390243902439,0.401,16,47,0.3404255319148936
Gerald Wallace,wallage01,SF,29,TOT,2012,58,2076.0,800,164,87,299,386,85,36,111,145,287,632,0.4541139240506329,46,150,0.3066666666666666,241,482,0.5,0.491,180,225,0.8
Luke Walton,waltolu01,PF-SF,31,TOT,2012,30,364.0,55,35,13,36,49,5,1,27,41,24,65,0.3692307692307692,7,20,0.35,17,45,0.3777777777777777,0.423,0,0,0.0
Hakim Warrick,warriha01,PF,29,PHO,2012,35,503.0,225,30,31,61,92,8,3,36,35,74,180,0.4111111111111111,1,10,0.1,73,170,0.4294117647058823,0.414,76,99,0.7676767676767676
Darryl Watkins,watkida01,C,27,NOH,2012,5,98.0,23,3,8,19,27,5,4,8,14,7,14,0.5,0,0,0.0,7,14,0.5,0.5,9,18,0.5
C.J. Watson,watsocj01,PG,27,CHI,2012,49,1159.0,474,200,21,84,105,45,8,97,103,161,437,0.3684210526315789,68,173,0.3930635838150289,93,264,0.3522727272727273,0.446,84,104,0.8076923076923077
Earl Watson,watsoea01,PG,32,UTA,2012,50,1033.0,149,217,30,91,121,54,22,85,105,54,160,0.3375,10,52,0.1923076923076923,44,108,0.4074074074074074,0.369,31,46,0.6739130434782609
Martell Webster,webstma02,SF,25,MIN,2012,47,1140.0,324,40,42,126,168,31,17,46,86,115,272,0.4227941176470588,37,109,0.3394495412844037,78,163,0.4785276073619632,0.491,57,72,0.7916666666666666
David West,westda01,PF,31,IND,2012,66,1925.0,842,140,118,315,433,52,46,93,160,349,716,0.4874301675977653,2,9,0.2222222222222222,347,707,0.4908062234794908,0.489,142,176,0.8068181818181818
Delonte West,westde01,PG,28,DAL,2012,44,1060.0,421,139,13,88,101,58,11,76,67,166,360,0.4611111111111111,27,76,0.3552631578947368,139,284,0.4894366197183099,0.499,62,70,0.8857142857142857
Russell Westbrook,westbru01,PG,23,OKC,2012,66,2331.0,1558,362,96,205,301,112,21,239,147,578,1266,0.4565560821484992,62,196,0.3163265306122449,516,1070,0.4822429906542056,0.481,340,413,0.8232445520581114
D.J. White,whitedj01,PF,25,CHA,2012,58,1098.0,392,47,50,159,209,17,23,43,94,174,353,0.4929178470254957,1,1,1.0,173,352,0.4914772727272727,0.494,43,61,0.7049180327868853
Hassan Whiteside,whiteha01,C,22,SAC,2012,18,109.0,29,0,16,23,39,3,15,5,12,12,27,0.4444444444444444,0,0,0.0,12,27,0.4444444444444444,0.444,5,12,0.4166666666666667
Chris Wilcox,wilcoch01,C,29,BOS,2012,28,481.0,152,12,38,84,122,11,9,30,64,64,107,0.5981308411214953,0,0,0.0,64,107,0.5981308411214953,0.598,24,39,0.6153846153846154
Damien Wilkins,wilkida02,SF,32,DET,2012,60,922.0,193,44,22,78,100,29,13,30,85,76,193,0.3937823834196891,7,23,0.3043478260869565,69,170,0.4058823529411764,0.412,34,54,0.6296296296296297
Deron Williams,willide01,PG,27,NJN,2012,55,1999.0,1154,481,23,160,183,67,20,219,121,391,961,0.4068678459937565,115,342,0.3362573099415205,276,619,0.4458804523424879,0.467,257,305,0.8426229508196721
Derrick Williams,willide02,PF,20,MIN,2012,66,1418.0,583,38,77,234,311,30,31,77,95,205,498,0.4116465863453815,37,138,0.2681159420289855,168,360,0.4666666666666667,0.449,136,195,0.6974358974358974
Elliot Williams,williel01,SG,22,POR,2012,24,149.0,88,6,7,12,19,6,3,5,18,37,74,0.5,8,27,0.2962962962962963,29,47,0.6170212765957447,0.554,6,18,0.3333333333333333
Jordan Williams,willijo03,C,21,NJN,2012,43,635.0,197,11,66,90,156,21,15,23,61,77,152,0.506578947368421,0,0,0.0,77,152,0.506578947368421,0.507,43,66,0.6515151515151515
Lou Williams,willilo02,PG,25,PHI,2012,64,1682.0,956,221,30,125,155,53,18,71,90,318,782,0.4066496163682864,83,229,0.3624454148471616,235,553,0.4249547920433996,0.46,237,292,0.8116438356164384
Marvin Williams,willima02,SF,25,ATL,2012,57,1500.0,579,71,76,218,294,47,18,39,84,203,470,0.4319148936170213,58,149,0.3892617449664429,145,321,0.4517133956386293,0.494,115,146,0.7876712328767124
Mo Williams,willima01,SG,29,LAC,2012,52,1472.0,685,160,23,76,99,51,7,86,103,260,611,0.425531914893617,93,239,0.3891213389121339,167,372,0.4489247311827957,0.502,72,80,0.9
Reggie Williams,willire02,SF,25,CHA,2012,33,747.0,274,60,27,66,93,20,3,33,34,106,255,0.4156862745098039,33,107,0.308411214953271,73,148,0.4932432432432432,0.48,29,40,0.725
Sean Williams,willise01,C,25,TOT,2012,11,107.0,40,5,13,12,25,4,8,10,18,14,22,0.6363636363636364,0,0,0.0,14,22,0.6363636363636364,0.636,12,13,0.9230769230769232
Shawne Williams,willish03,SF,25,NJN,2012,25,514.0,113,16,20,48,68,10,11,13,44,42,147,0.2857142857142857,21,87,0.2413793103448276,21,60,0.35,0.357,8,11,0.7272727272727273
Shelden Williams,willish02,C,28,NJN,2012,58,1276.0,268,35,141,209,350,47,39,66,149,96,201,0.4776119402985074,0,0,0.0,96,201,0.4776119402985074,0.478,76,104,0.7307692307692307
Terrence Williams,willite01,SG,24,TOT,2012,30,550.0,213,65,13,89,102,20,7,43,35,85,198,0.4292929292929293,16,46,0.3478260869565217,69,152,0.4539473684210526,0.47,27,46,0.5869565217391305
Metta World Peace,artesro01,SF,32,LAL,2012,64,1720.0,493,140,71,147,218,69,27,69,137,183,465,0.3935483870967742,56,189,0.2962962962962963,127,276,0.4601449275362319,0.454,71,115,0.6173913043478261
Brandan Wright,wrighbr03,C,24,DAL,2012,49,791.0,340,13,62,112,174,22,63,21,61,144,233,0.6180257510729614,0,1,0.0,144,232,0.6206896551724138,0.618,52,82,0.6341463414634146
Chris Wright,wrighch01,SF,23,GSW,2012,24,186.0,70,4,19,26,45,7,13,8,22,23,45,0.5111111111111111,0,0,0.0,23,45,0.5111111111111111,0.511,24,31,0.7741935483870968
Dorell Wright,wrighdo01,SF,26,GSW,2012,61,1650.0,629,94,60,218,278,58,26,51,97,222,526,0.4220532319391635,105,292,0.3595890410958904,117,234,0.5,0.522,80,98,0.8163265306122449
Nick Young,youngni01,SG,26,TOT,2012,62,1729.0,879,56,31,102,133,44,17,83,141,316,784,0.4030612244897959,103,282,0.3652482269503546,213,502,0.4243027888446215,0.469,144,169,0.8520710059171598
Sam Young,youngsa01,SF,26,TOT,2012,35,375.0,114,15,20,42,62,17,6,16,23,45,127,0.3543307086614173,5,17,0.2941176470588235,40,110,0.3636363636363636,0.374,19,26,0.7307692307692307
Thaddeus Young,youngth01,PF,23,PHI,2012,63,1755.0,808,74,137,188,325,64,41,55,127,348,687,0.5065502183406113,1,4,0.25,347,683,0.5080527086383602,0.507,111,144,0.7708333333333334
Quincy Acy,acyqu01,PF,22,TOR,2013,29,342.0,116,11,30,47,77,13,15,17,53,42,75,0.56,1,2,0.5,41,73,0.5616438356164384,0.567,31,38,0.8157894736842105
Jeff Adrien,adrieje01,PF,26,CHA,2013,52,713.0,209,36,68,128,196,18,27,32,80,72,168,0.4285714285714285,0,2,0.0,72,166,0.4337349397590361,0.429,65,100,0.65
Arron Afflalo,afflaar01,SF,27,ORL,2013,64,2307.0,1057,206,29,210,239,40,11,138,137,397,905,0.4386740331491712,72,240,0.3,325,665,0.4887218045112781,0.478,191,223,0.8565022421524664
Josh Akognon,akognjo01,PG,26,DAL,2013,3,9.0,5,1,0,1,1,0,0,0,3,2,4,0.5,1,2,0.5,1,2,0.5,0.625,0,0,0.0
Cole Aldrich,aldrico01,C,24,TOT,2013,45,388.0,100,9,30,90,120,5,23,23,60,44,80,0.55,0,0,0.0,44,80,0.55,0.55,12,20,0.6
LaMarcus Aldridge,aldrila01,PF,27,POR,2013,74,2790.0,1560,192,175,495,670,62,91,143,187,638,1318,0.4840667678300455,2,14,0.1428571428571428,636,1304,0.4877300613496932,0.485,282,348,0.8103448275862069
Lavoy Allen,allenla01,C,23,PHI,2013,79,1669.0,455,73,159,236,395,24,55,55,180,206,454,0.4537444933920704,0,1,0.0,206,453,0.4547461368653421,0.454,43,60,0.7166666666666667
Ray Allen,allenra02,SG,37,MIA,2013,79,2035.0,863,135,40,177,217,67,15,103,129,292,651,0.4485407066052227,139,332,0.4186746987951807,153,319,0.4796238244514106,0.555,140,158,0.8860759493670886
Tony Allen,allento01,SG,31,MEM,2013,79,2109.0,705,98,121,242,363,119,44,94,211,284,638,0.445141065830721,3,24,0.125,281,614,0.4576547231270358,0.447,134,187,0.7165775401069518
Al-Farouq Aminu,aminual01,SF,22,NOH,2013,76,2066.0,555,103,139,446,585,92,51,116,153,225,474,0.4746835443037974,4,19,0.2105263157894736,221,455,0.4857142857142857,0.479,101,137,0.7372262773722628
Lou Amundson,amundlo01,PF,30,TOT,2013,39,372.0,76,11,48,58,106,16,12,19,53,32,81,0.3950617283950617,0,0,0.0,32,81,0.3950617283950617,0.395,12,36,0.3333333333333333
Chris Andersen,anderch01,C,34,MIA,2013,42,624.0,207,17,57,115,172,16,44,24,89,71,123,0.5772357723577236,2,3,0.6666666666666666,69,120,0.575,0.585,63,93,0.6774193548387096
Alan Anderson,anderal01,SF,30,TOR,2013,65,1495.0,693,103,34,114,148,48,7,80,131,236,616,0.3831168831168831,95,285,0.3333333333333333,141,331,0.4259818731117825,0.46,126,147,0.8571428571428571
James Anderson,anderja01,SG-SF,23,TOT,2013,39,401.0,149,42,18,54,72,15,5,25,25,52,126,0.4126984126984127,21,60,0.35,31,66,0.4696969696969697,0.496,24,28,0.8571428571428571
Ryan Anderson,anderry01,PF,24,NOH,2013,81,2503.0,1309,97,191,328,519,42,31,97,179,472,1115,0.4233183856502242,213,557,0.3824057450628366,259,558,0.4641577060931899,0.519,152,180,0.8444444444444444
Carmelo Anthony,anthoca01,PF,28,NYK,2013,67,2482.0,1920,171,134,326,460,52,32,175,205,669,1489,0.4492948287441236,157,414,0.3792270531400966,512,1075,0.4762790697674419,0.502,425,512,0.830078125
Joel Anthony,anthojo01,C,30,MIA,2013,62,566.0,87,13,45,70,115,13,42,22,49,35,68,0.5147058823529411,0,0,0.0,35,68,0.5147058823529411,0.515,17,28,0.6071428571428571
Trevor Ariza,arizatr01,SF,27,WAS,2013,56,1471.0,530,113,44,222,266,72,20,84,72,188,451,0.4168514412416851,76,209,0.3636363636363636,112,242,0.4628099173553719,0.501,78,95,0.8210526315789474
Darrell Arthur,arthuda01,PF,24,MEM,2013,59,970.0,362,33,68,101,169,24,33,43,126,162,359,0.4512534818941504,5,18,0.2777777777777778,157,341,0.4604105571847507,0.458,33,46,0.717391304347826
Ömer Aşık,asikom01,C,26,HOU,2013,82,2464.0,832,75,275,681,956,46,87,173,223,332,614,0.5407166123778502,0,1,0.0,332,613,0.5415986949429038,0.541,168,299,0.5618729096989966
D.J. Augustin,augusdj01,PG,25,IND,2013,76,1226.0,356,170,20,71,91,34,3,68,64,103,294,0.3503401360544217,67,190,0.3526315789473684,36,104,0.3461538461538461,0.464,83,99,0.8383838383838383
Gustavo Ayón,ayongu01,C,27,TOT,2013,55,734.0,204,71,60,139,199,22,17,47,107,92,167,0.5508982035928144,0,0,0.0,92,167,0.5508982035928144,0.551,20,50,0.4
Jeff Ayres,pendeje02,PF,25,IND,2013,37,369.0,145,15,29,75,104,6,12,23,44,61,126,0.4841269841269841,2,4,0.5,59,122,0.4836065573770491,0.492,21,23,0.9130434782608696
Luke Babbitt,babbilu01,PF,23,POR,2013,62,730.0,244,29,15,122,137,14,5,22,82,86,234,0.3675213675213675,62,178,0.348314606741573,24,56,0.4285714285714285,0.5,10,13,0.7692307692307693
Leandro Barbosa,barbole01,PG,30,BOS,2013,41,513.0,215,58,8,38,46,17,6,21,51,83,193,0.4300518134715025,18,47,0.3829787234042553,65,146,0.4452054794520548,0.477,31,41,0.7560975609756098
J.J. Barea,bareajo01,PG,28,MIN,2013,74,1713.0,834,294,34,173,207,32,0,145,131,316,758,0.41688654353562,97,280,0.3464285714285714,219,478,0.4581589958158996,0.481,105,134,0.7835820895522388
Andrea Bargnani,bargnan01,PF,27,TOR,2013,35,1003.0,443,38,26,102,128,21,23,54,64,170,426,0.3990610328638497,38,123,0.3089430894308943,132,303,0.4356435643564356,0.444,65,77,0.8441558441558441
Harrison Barnes,barneha02,SF,20,GSW,2013,81,2058.0,748,98,53,280,333,52,14,101,140,276,628,0.4394904458598726,52,145,0.3586206896551724,224,483,0.463768115942029,0.481,144,190,0.7578947368421053
Matt Barnes,barnema02,SF,32,LAC,2013,80,2058.0,822,123,111,255,366,82,63,90,233,312,675,0.4622222222222222,111,325,0.3415384615384615,201,350,0.5742857142857143,0.544,87,117,0.7435897435897436
Earl Barron,barroea01,C,31,TOT,2013,12,159.0,39,5,22,39,61,5,6,11,24,18,51,0.3529411764705882,0,0,0.0,18,51,0.3529411764705882,0.353,3,7,0.4285714285714285
Will Barton,bartowi01,SG,22,POR,2013,73,894.0,295,58,36,109,145,34,9,60,56,118,309,0.3818770226537217,9,65,0.1384615384615384,109,244,0.4467213114754098,0.396,50,65,0.7692307692307693
Brandon Bass,bassbr01,PF,27,BOS,2013,81,2239.0,701,84,129,296,425,44,64,80,188,286,589,0.4855687606112054,0,2,0.0,286,587,0.4872231686541737,0.486,129,150,0.86
Shane Battier,battish01,SF,34,MIA,2013,72,1786.0,472,72,37,128,165,41,55,34,149,152,362,0.4198895027624309,136,316,0.430379746835443,16,46,0.3478260869565217,0.608,32,38,0.8421052631578947
Nicolas Batum,batumni01,SF,24,POR,2013,73,2807.0,1047,360,97,315,412,91,83,190,139,352,833,0.4225690276110444,165,444,0.3716216216216216,187,389,0.480719794344473,0.522,178,210,0.8476190476190476
Jerryd Bayless,bayleje01,PG,24,MEM,2013,80,1765.0,693,264,22,154,176,59,17,120,168,260,621,0.4186795491143317,71,201,0.3532338308457711,189,420,0.45,0.476,102,122,0.8360655737704918
Aron Baynes,baynear01,C,26,SAS,2013,16,141.0,43,5,12,20,32,1,6,11,23,18,36,0.5,0,1,0.0,18,35,0.5142857142857142,0.5,7,12,0.5833333333333334
Kent Bazemore,bazemke01,SG,23,GSW,2013,61,267.0,123,22,5,17,22,17,4,18,27,43,116,0.3706896551724138,10,34,0.2941176470588235,33,82,0.4024390243902439,0.414,27,44,0.6136363636363636
Bradley Beal,bealbr01,SG,19,WAS,2013,56,1745.0,780,137,43,168,211,50,29,90,113,282,687,0.4104803493449782,91,236,0.3855932203389831,191,451,0.4235033259423503,0.477,125,159,0.7861635220125787
Michael Beasley,beaslmi01,SF,24,PHO,2013,75,1554.0,759,111,52,230,282,31,34,144,107,310,766,0.4046997389033943,45,144,0.3125,265,622,0.4260450160771704,0.434,94,126,0.746031746031746
Rodrigue Beaubois,beaubro01,PG,24,DAL,2013,45,549.0,181,84,9,48,57,19,4,33,54,65,176,0.3693181818181818,21,72,0.2916666666666667,44,104,0.4230769230769231,0.429,30,38,0.7894736842105263
Marco Belinelli,belinma01,SG,26,CHI,2013,73,1882.0,702,148,13,127,140,44,6,82,140,241,610,0.3950819672131147,79,221,0.3574660633484163,162,389,0.416452442159383,0.46,141,168,0.8392857142857143
Patrick Beverley,beverpa01,PG,24,HOU,2013,41,713.0,228,117,45,64,109,37,21,44,83,79,189,0.4179894179894179,36,96,0.375,43,93,0.4623655913978494,0.513,34,41,0.8292682926829268
Andris Biedriņš,biedran01,C,26,GSW,2013,53,495.0,24,14,34,119,153,15,42,14,101,10,21,0.4761904761904761,0,0,0.0,10,21,0.4761904761904761,0.476,4,13,0.3076923076923077
Chauncey Billups,billuch01,SG,36,LAC,2013,22,418.0,184,49,2,30,32,12,1,26,25,53,132,0.4015151515151515,33,90,0.3666666666666666,20,42,0.4761904761904761,0.527,45,48,0.9375
Bismack Biyombo,biyombi01,C,20,CHA,2013,80,2186.0,386,35,194,388,582,28,143,82,195,156,346,0.4508670520231214,0,0,0.0,156,346,0.4508670520231214,0.451,74,142,0.5211267605633803
DeJuan Blair,blairde01,PF,23,SAS,2013,61,851.0,328,45,66,164,230,37,10,49,112,142,271,0.5239852398523985,0,1,0.0,142,270,0.5259259259259259,0.524,44,70,0.6285714285714286
Steve Blake,blakest01,PG,32,LAL,2013,45,1175.0,327,173,21,111,132,34,6,62,83,114,270,0.4222222222222222,72,171,0.4210526315789473,42,99,0.4242424242424242,0.556,27,35,0.7714285714285715
Andray Blatche,blatcan01,C,26,BRK,2013,82,1555.0,843,85,161,256,417,86,54,123,163,346,676,0.5118343195266272,3,22,0.1363636363636363,343,654,0.5244648318042814,0.514,148,216,0.6851851851851852
Eric Bledsoe,bledser01,PG,23,LAC,2013,76,1553.0,643,233,78,147,225,109,55,137,112,253,568,0.4454225352112676,31,78,0.3974358974358974,222,490,0.4530612244897959,0.473,106,134,0.7910447761194029
Keith Bogans,boganke01,SG,32,BRK,2013,74,1408.0,311,76,16,104,120,28,4,49,108,108,284,0.380281690140845,84,245,0.3428571428571428,24,39,0.6153846153846154,0.528,11,17,0.6470588235294118
Andrew Bogut,bogutan01,C,28,GSW,2013,32,786.0,186,67,68,177,245,20,55,35,85,83,184,0.4510869565217391,1,1,1.0,82,183,0.448087431693989,0.454,19,38,0.5
Matt Bonner,bonnema01,PF,32,SAS,2013,68,909.0,288,36,25,104,129,17,19,16,86,112,230,0.4869565217391304,53,120,0.4416666666666666,59,110,0.5363636363636364,0.602,11,15,0.7333333333333333
Trevor Booker,booketr01,PF,25,WAS,2013,48,887.0,256,40,98,141,239,32,16,31,95,108,220,0.4909090909090909,0,5,0.0,108,215,0.5023255813953489,0.491,40,72,0.5555555555555556
Carlos Boozer,boozeca01,PF,31,CHI,2013,79,2546.0,1281,179,175,596,771,66,28,176,239,544,1140,0.4771929824561403,0,2,0.0,544,1138,0.4780316344463972,0.477,193,264,0.7310606060606061
Chris Bosh,boshch01,C,28,MIA,2013,74,2454.0,1232,123,131,370,501,66,101,128,168,485,907,0.5347298787210585,21,74,0.2837837837837837,464,833,0.5570228091236494,0.546,241,302,0.7980132450331126
Avery Bradley,bradlav01,PG,22,BOS,2013,50,1435.0,461,104,30,81,111,64,19,72,129,192,478,0.401673640167364,40,126,0.3174603174603174,152,352,0.4318181818181818,0.444,37,49,0.7551020408163265
Elton Brand,brandel01,C,33,DAL,2013,72,1527.0,518,70,130,300,430,50,90,57,192,226,478,0.4728033472803347,0,1,0.0,226,477,0.4737945492662473,0.473,66,93,0.7096774193548387
Corey Brewer,breweco01,SF,26,DEN,2013,82,2003.0,990,124,55,180,235,118,23,102,154,375,883,0.4246885617214043,91,307,0.2964169381107492,284,576,0.4930555555555556,0.476,149,216,0.6898148148148148
Ronnie Brewer,brewero02,SF,27,TOT,2013,60,853.0,179,50,42,98,140,43,6,18,33,70,198,0.3535353535353535,23,76,0.3026315789473684,47,122,0.3852459016393442,0.412,16,39,0.4102564102564102
Aaron Brooks,brookaa01,PG,28,TOT,2013,53,997.0,376,114,13,67,80,30,10,67,94,143,316,0.4525316455696203,50,134,0.373134328358209,93,182,0.510989010989011,0.532,40,52,0.7692307692307693
MarShon Brooks,brookma01,SG,24,BRK,2013,73,912.0,394,76,32,72,104,34,16,69,93,155,335,0.4626865671641791,15,55,0.2727272727272727,140,280,0.5,0.485,69,94,0.7340425531914894
Kwame Brown,brownkw01,C,30,PHI,2013,22,269.0,41,9,23,51,74,6,10,8,37,17,37,0.4594594594594595,0,0,0.0,17,37,0.4594594594594595,0.459,7,19,0.3684210526315789
Shannon Brown,brownsh01,SG,27,PHO,2013,59,1402.0,617,108,44,105,149,59,15,74,92,240,571,0.4203152364273205,39,141,0.2765957446808511,201,430,0.4674418604651162,0.454,98,125,0.784
Kobe Bryant,bryanko01,SG,34,LAL,2013,78,3013.0,2133,469,66,367,433,106,25,287,173,738,1595,0.4626959247648903,132,407,0.3243243243243243,606,1188,0.51010101010101,0.504,525,626,0.8386581469648562
Chase Budinger,budinch01,SF,24,MIN,2013,23,508.0,216,25,15,56,71,14,7,23,29,79,191,0.4136125654450261,26,81,0.3209876543209876,53,110,0.4818181818181818,0.482,32,42,0.7619047619047619
Alec Burks,burksal01,SG,21,UTA,2013,64,1137.0,451,92,37,108,145,35,13,74,114,163,388,0.4201030927835051,33,92,0.358695652173913,130,296,0.4391891891891892,0.463,92,129,0.7131782945736435
Caron Butler,butleca01,SF,32,LAC,2013,78,1879.0,813,78,41,182,223,51,11,72,139,305,720,0.4236111111111111,128,330,0.3878787878787879,177,390,0.4538461538461538,0.513,75,90,0.8333333333333334
Jimmy Butler,butleji01,SF,23,CHI,2013,82,2134.0,705,115,136,192,328,78,31,62,97,239,512,0.466796875,40,105,0.3809523809523809,199,407,0.4889434889434889,0.506,187,233,0.8025751072961373
Will Bynum,bynumwi01,PG,30,DET,2013,65,1219.0,636,231,28,69,97,45,5,125,128,253,540,0.4685185185185185,24,76,0.3157894736842105,229,464,0.4935344827586206,0.491,106,131,0.8091603053435115
José Calderón,caldejo01,PG,31,TOT,2013,73,2160.0,826,518,20,156,176,58,8,126,99,312,635,0.4913385826771653,130,282,0.4609929078014184,182,353,0.5155807365439093,0.594,72,80,0.9
Marcus Camby,cambyma01,PF,38,NYK,2013,24,250.0,42,14,24,56,80,7,14,15,28,17,53,0.320754716981132,0,0,0.0,17,53,0.320754716981132,0.321,8,19,0.4210526315789473
DeMarre Carroll,carrode01,SF,26,UTA,2013,66,1111.0,393,61,87,101,188,58,24,34,119,149,324,0.4598765432098765,20,70,0.2857142857142857,129,254,0.5078740157480315,0.491,75,98,0.7653061224489796
Matt Carroll,carroma01,SG,32,CHA,2013,1,6.0,0,1,0,0,0,0,0,0,1,0,0,0.0,0,0,0.0,0,0,0.0,0.0,0,0,0.0
Vince Carter,cartevi01,SF,36,DAL,2013,81,2093.0,1088,194,58,276,334,74,44,106,226,372,855,0.4350877192982456,162,399,0.4060150375939849,210,456,0.4605263157894737,0.53,182,223,0.8161434977578476
Omri Casspi,casspom01,SF,24,CLE,2013,43,503.0,173,28,20,94,114,25,12,22,45,63,160,0.39375,25,76,0.3289473684210526,38,84,0.4523809523809524,0.472,22,41,0.5365853658536586
Mario Chalmers,chalmma01,PG,26,MIA,2013,77,2068.0,666,273,19,152,171,118,12,119,196,227,529,0.4291115311909262,123,301,0.4086378737541528,104,228,0.4561403508771929,0.545,89,112,0.7946428571428571
Tyson Chandler,chandty01,C,30,NYK,2013,66,2164.0,689,62,269,434,703,42,75,87,188,255,400,0.6375,0,0,0.0,255,400,0.6375,0.638,179,258,0.6937984496124031
Wilson Chandler,chandwi01,PF,25,DEN,2013,43,1079.0,560,58,45,173,218,45,12,60,119,210,455,0.4615384615384615,52,126,0.4126984126984127,158,329,0.4802431610942249,0.519,88,111,0.7927927927927928
Josh Childress,childjo01,SF,29,BRK,2013,14,100.0,14,5,6,9,15,2,2,0,3,6,21,0.2857142857142857,1,3,0.3333333333333333,5,18,0.2777777777777778,0.31,1,2,0.5
Earl Clark,clarkea01,PF,25,LAL,2013,59,1363.0,428,65,82,243,325,36,44,62,102,170,386,0.4404145077720207,35,104,0.3365384615384615,135,282,0.4787234042553192,0.486,53,76,0.6973684210526315
Victor Claver,clavevi01,SF,24,POR,2013,49,812.0,187,43,31,88,119,26,12,43,75,74,189,0.3915343915343915,25,87,0.2873563218390804,49,102,0.4803921568627451,0.458,14,30,0.4666666666666667
Norris Cole,coleno01,PG,24,MIA,2013,80,1590.0,445,164,18,112,130,57,7,104,155,179,425,0.4211764705882353,35,98,0.3571428571428571,144,327,0.4403669724770642,0.462,52,80,0.65
Jason Collins,collija04,C,34,TOT,2013,38,384.0,41,8,22,38,60,12,10,18,85,9,29,0.3103448275862069,0,0,0.0,9,29,0.3103448275862069,0.31,23,32,0.71875
Darren Collison,collida01,PG,25,DAL,2013,81,2372.0,972,415,31,188,219,100,8,173,139,341,724,0.4709944751381215,48,136,0.3529411764705882,293,588,0.4982993197278911,0.504,242,275,0.88
Nick Collison,collini01,C,32,OKC,2013,81,1583.0,412,121,123,210,333,51,30,69,197,176,296,0.5945945945945946,0,4,0.0,176,292,0.6027397260273972,0.595,60,78,0.7692307692307693
Mike Conley,conlemi01,PG,25,MEM,2013,80,2757.0,1168,487,43,182,225,174,24,189,171,414,940,0.4404255319148936,106,293,0.3617747440273037,308,647,0.4760432766615147,0.497,234,282,0.8297872340425532
Will Conroy,conrowi01,PG,30,MIN,2013,4,20.0,1,0,1,0,1,0,0,0,1,0,9,0.0,0,3,0.0,0,6,0.0,0.0,1,2,0.5
Daequan Cook,cookda02,SG,25,TOT,2013,49,441.0,137,19,7,54,61,8,7,15,26,51,167,0.3053892215568862,26,91,0.2857142857142857,25,76,0.3289473684210526,0.383,9,12,0.75
Chris Copeland,copelch01,PF,28,NYK,2013,56,862.0,486,27,34,85,119,16,12,50,104,182,380,0.4789473684210526,59,140,0.4214285714285714,123,240,0.5125,0.557,63,83,0.7590361445783133
DeMarcus Cousins,couside01,C,22,SAC,2013,75,2289.0,1280,199,222,524,746,108,55,225,269,482,1036,0.4652509652509652,4,22,0.1818181818181818,478,1014,0.4714003944773176,0.467,312,423,0.7375886524822695
Jamal Crawford,crawfja01,SG,32,LAC,2013,76,2230.0,1255,193,22,106,128,79,13,146,71,445,1016,0.4379921259842519,149,396,0.3762626262626262,296,620,0.4774193548387097,0.511,216,248,0.8709677419354839
Jordan Crawford,crawfjo02,SG,24,TOT,2013,70,1709.0,814,225,44,165,209,39,7,141,106,301,725,0.4151724137931034,83,246,0.3373983739837398,218,479,0.4551148225469729,0.472,129,159,0.8113207547169812
Jae Crowder,crowdja01,SF,22,DAL,2013,78,1353.0,392,94,35,152,187,63,17,49,128,141,367,0.3841961852861035,63,192,0.328125,78,175,0.4457142857142857,0.47,47,73,0.6438356164383562
Dante Cunningham,cunnida01,PF,25,MIN,2013,80,2010.0,695,67,142,266,408,84,38,56,153,314,671,0.4679582712369597,0,6,0.0,314,665,0.4721804511278195,0.468,67,103,0.6504854368932039
Jared Cunningham,cunnija01,SG,21,DAL,2013,8,26.0,16,1,1,2,3,1,0,2,3,6,14,0.4285714285714285,2,3,0.6666666666666666,4,11,0.3636363636363636,0.5,2,2,1.0
Eddy Curry,curryed01,C,30,DAL,2013,2,25.0,9,0,2,2,4,0,0,3,7,4,8,0.5,0,0,0.0,4,8,0.5,0.5,1,4,0.25
Stephen Curry,curryst01,PG,24,GSW,2013,78,2983.0,1786,539,59,255,314,126,12,240,198,626,1388,0.4510086455331412,272,600,0.4533333333333333,354,788,0.449238578680203,0.549,262,291,0.9003436426116839
Samuel Dalembert,dalemsa01,C,31,MIL,2013,47,765.0,313,21,105,171,276,17,53,51,90,137,253,0.541501976284585,1,1,1.0,136,252,0.5396825396825397,0.543,38,55,0.6909090909090909
Marquis Daniels,daniema01,SF,32,MIL,2013,59,1085.0,324,65,48,102,150,51,10,45,77,132,351,0.376068376068376,20,72,0.2777777777777778,112,279,0.4014336917562724,0.405,40,54,0.7407407407407407
Anthony Davis,davisan02,PF,19,NOH,2013,64,1846.0,867,63,165,357,522,75,112,89,158,349,676,0.5162721893491125,0,6,0.0,349,670,0.5208955223880597,0.516,169,225,0.7511111111111111
Ed Davis,davised01,C-PF,23,TOT,2013,81,1631.0,623,63,152,308,460,38,85,63,191,260,482,0.5394190871369294,0,0,0.0,260,482,0.5394190871369294,0.539,103,167,0.6167664670658682
Glen Davis,davisgl01,PF,27,ORL,2013,34,1064.0,512,70,55,191,246,32,21,64,88,214,478,0.4476987447698745,0,2,0.0,214,476,0.4495798319327731,0.448,84,117,0.717948717948718
Austin Daye,dayeau01,SF,24,TOT,2013,55,676.0,247,42,16,107,123,14,22,29,82,90,208,0.4326923076923077,41,98,0.4183673469387755,49,110,0.4454545454545454,0.531,26,34,0.7647058823529411
Nando De Colo,decolna01,SG,25,SAS,2013,72,920.0,276,138,23,115,138,41,6,81,87,105,241,0.4356846473029045,31,82,0.3780487804878049,74,159,0.4654088050314465,0.5,35,44,0.7954545454545454
Carlos Delfino,delfica01,SF,30,HOU,2013,67,1689.0,708,135,18,202,220,68,9,72,114,251,620,0.4048387096774193,158,421,0.3752969121140142,93,199,0.4673366834170854,0.532,48,56,0.8571428571428571
Luol Deng,denglu01,SF,27,CHI,2013,75,2903.0,1237,222,162,314,476,81,32,144,105,466,1093,0.4263494967978042,75,233,0.3218884120171674,391,860,0.4546511627906976,0.461,230,282,0.8156028368794326
Justin Dentmon,dentmju01,PG,27,DAL,2013,2,4.0,0,0,0,0,0,0,0,0,0,0,2,0.0,0,0,0.0,0,2,0.0,0.0,0,0,0.0
DeMar DeRozan,derozde01,SG,23,TOR,2013,82,3013.0,1485,204,48,272,320,76,24,151,173,548,1231,0.4451665312753858,34,120,0.2833333333333333,514,1111,0.4626462646264626,0.459,355,427,0.8313817330210773
Boris Diaw,diawbo01,PF,30,SAS,2013,75,1709.0,435,180,66,188,254,52,27,84,143,179,332,0.5391566265060241,30,78,0.3846153846153846,149,254,0.5866141732283464,0.584,47,65,0.7230769230769231
DeSagana Diop,diopde01,C,31,CHA,2013,22,226.0,16,13,10,41,51,5,16,8,19,8,27,0.2962962962962963,0,1,0.0,8,26,0.3076923076923077,0.296,0,1,0.0
Keyon Dooling,doolike01,PG,32,MEM,2013,7,82.0,31,8,0,1,1,1,0,5,8,10,21,0.4761904761904761,5,12,0.4166666666666667,5,9,0.5555555555555556,0.595,6,7,0.8571428571428571
Toney Douglas,douglto01,PG,26,TOT,2013,71,1289.0,534,151,34,104,138,71,3,81,145,188,466,0.4034334763948498,82,216,0.3796296296296296,106,250,0.424,0.491,76,84,0.9047619047619048
Chris Douglas-Roberts,douglch01,SG,26,DAL,2013,6,63.0,17,4,0,5,5,2,0,1,4,5,14,0.3571428571428571,0,4,0.0,5,10,0.5,0.357,7,10,0.7
Goran Dragić,dragigo01,PG,26,PHO,2013,77,2581.0,1134,569,60,178,238,124,26,212,214,401,906,0.4426048565121412,88,276,0.3188405797101449,313,630,0.4968253968253968,0.491,244,326,0.7484662576687117
Andre Drummond,drumman01,C,19,DET,2013,60,1243.0,476,30,169,288,457,59,95,57,144,208,342,0.6081871345029239,1,2,0.5,207,340,0.6088235294117647,0.61,59,159,0.3710691823899371
Jared Dudley,dudleja01,SF,27,PHO,2013,79,2170.0,861,203,79,166,245,75,8,101,128,313,669,0.4678624813153961,106,271,0.3911439114391143,207,398,0.5201005025125628,0.547,129,162,0.7962962962962963
Chris Duhon,duhonch01,PG,30,LAL,2013,46,820.0,133,133,11,57,68,20,1,40,56,47,123,0.3821138211382114,33,91,0.3626373626373626,14,32,0.4375,0.516,6,13,0.4615384615384615
Tim Duncan,duncati01,C,36,SAS,2013,69,2078.0,1227,184,124,562,686,50,183,147,117,490,976,0.5020491803278688,2,7,0.2857142857142857,488,969,0.5036119711042312,0.503,245,300,0.8166666666666667
Mike Dunleavy,dunlemi02,SF,32,MIL,2013,75,1943.0,785,145,31,260,291,39,35,90,135,276,624,0.4423076923076923,128,299,0.4280936454849498,148,325,0.4553846153846154,0.545,105,128,0.8203125
Kevin Durant,duranke01,SF,24,OKC,2013,81,3119.0,2280,374,46,594,640,116,105,280,143,731,1433,0.5101186322400558,139,334,0.4161676646706587,592,1099,0.5386715195632393,0.559,679,750,0.9053333333333332
Devin Ebanks,ebankde01,SF,23,LAL,2013,19,197.0,65,10,10,31,41,3,1,11,23,24,73,0.3287671232876712,6,22,0.2727272727272727,18,51,0.3529411764705882,0.37,11,14,0.7857142857142857
Wayne Ellington,ellinwa01,SG,25,TOT,2013,78,1661.0,614,104,25,141,166,45,3,57,81,226,529,0.4272211720226843,94,240,0.3916666666666666,132,289,0.4567474048442906,0.516,68,75,0.9066666666666666
Monta Ellis,ellismo01,SG,27,MIL,2013,82,3076.0,1577,496,45,271,316,169,36,254,164,597,1436,0.4157381615598886,94,328,0.2865853658536585,503,1108,0.453971119133574,0.448,289,374,0.7727272727272727
Kim English,engliki01,SG,24,DET,2013,41,407.0,119,26,8,29,37,16,3,19,46,42,112,0.375,14,50,0.28,28,62,0.4516129032258064,0.438,21,29,0.7241379310344828
Jeremy Evans,evansje01,PF,25,UTA,2013,37,215.0,75,11,26,32,58,8,13,8,30,27,44,0.6136363636363636,0,1,0.0,27,43,0.627906976744186,0.614,21,33,0.6363636363636364
Reggie Evans,evansre01,PF,32,BRK,2013,80,1967.0,363,43,260,628,888,74,13,111,199,125,261,0.4789272030651341,0,0,0.0,125,261,0.4789272030651341,0.479,113,222,0.509009009009009
Tyreke Evans,evansty01,SG,23,SAC,2013,65,2016.0,987,229,56,231,287,90,27,128,133,366,765,0.4784313725490196,45,133,0.3383458646616541,321,632,0.5079113924050633,0.508,210,271,0.7749077490774908
Festus Ezeli,ezelife01,C,23,GSW,2013,78,1120.0,191,22,141,172,313,23,74,63,157,74,169,0.4378698224852071,0,0,0.0,74,169,0.4378698224852071,0.438,43,81,0.5308641975308642
Kenneth Faried,farieke01,PF,23,DEN,2013,80,2248.0,923,77,260,474,734,81,83,113,234,380,689,0.5515239477503628,0,0,0.0,380,689,0.5515239477503628,0.552,163,266,0.6127819548872181
Derrick Favors,favorde01,PF,21,UTA,2013,77,1787.0,727,75,184,362,546,67,130,129,247,274,568,0.4823943661971831,0,5,0.0,274,563,0.4866785079928952,0.482,179,260,0.6884615384615385
Raymond Felton,feltora01,PG,28,NYK,2013,68,2313.0,948,372,51,143,194,94,14,155,130,377,882,0.427437641723356,93,258,0.3604651162790697,284,624,0.4551282051282051,0.48,101,128,0.7890625
Landry Fields,fieldla01,SF,24,TOR,2013,51,1037.0,240,60,59,149,208,32,8,42,63,102,223,0.4573991031390134,2,14,0.1428571428571428,100,209,0.4784688995215311,0.462,34,53,0.6415094339622641
Derek Fisher,fishede01,SG-PG,38,TOT,2013,33,575.0,175,47,2,35,37,19,3,30,55,55,161,0.3416149068322981,30,80,0.375,25,81,0.3086419753086419,0.435,35,38,0.9210526315789472
Evan Fournier,fournev01,SG,20,DEN,2013,38,428.0,202,44,6,29,35,19,1,32,65,75,152,0.4934210526315789,22,54,0.4074074074074074,53,98,0.5408163265306123,0.566,30,39,0.7692307692307693
Randy Foye,foyera01,SG,29,UTA,2013,82,2249.0,882,167,17,110,127,66,27,92,190,293,738,0.3970189701897019,178,434,0.4101382488479262,115,304,0.3782894736842105,0.518,118,144,0.8194444444444444
Jimmer Fredette,fredeji01,SG,23,SAC,2013,69,967.0,494,92,19,52,71,31,3,68,64,172,409,0.4205378973105134,65,156,0.4166666666666667,107,253,0.4229249011857707,0.5,85,99,0.8585858585858586
Enes Freedom,kanteen01,C,20,UTA,2013,70,1078.0,506,31,135,169,304,28,32,101,116,206,379,0.5435356200527705,1,1,1.0,205,378,0.5423280423280423,0.545,93,117,0.7948717948717948
Joel Freeland,freeljo01,PF,25,POR,2013,51,477.0,134,13,40,79,119,13,11,19,67,58,142,0.4084507042253521,0,0,0.0,58,142,0.4084507042253521,0.408,18,27,0.6666666666666666
Danilo Gallinari,gallida01,SF,24,DEN,2013,71,2309.0,1149,176,65,302,367,64,36,111,130,364,871,0.417910447761194,135,362,0.3729281767955801,229,509,0.449901768172888,0.495,286,348,0.8218390804597702
Francisco García,garcifr01,SG-SF,31,TOT,2013,58,1029.0,321,63,8,83,91,46,38,32,88,118,300,0.3933333333333333,67,179,0.3743016759776536,51,121,0.4214876033057851,0.505,18,21,0.8571428571428571
Kevin Garnett,garneke01,C,36,BOS,2013,68,2022.0,1004,159,75,455,530,78,62,110,154,422,850,0.4964705882352941,2,16,0.125,420,834,0.5035971223021583,0.498,158,201,0.7860696517412935
Diante Garrett,garredi02,PG,24,PHO,2013,19,149.0,40,31,5,10,15,10,0,16,5,16,49,0.3265306122448979,3,15,0.2,13,34,0.3823529411764705,0.357,5,10,0.5
Marc Gasol,gasolma01,C,28,MEM,2013,80,2796.0,1127,318,184,438,622,80,139,157,255,429,869,0.4936708860759494,1,14,0.0714285714285714,428,855,0.5005847953216375,0.494,268,316,0.8481012658227848
Pau Gasol,gasolpa01,PF,32,LAL,2013,49,1655.0,673,200,111,310,421,24,61,104,93,270,579,0.466321243523316,8,28,0.2857142857142857,262,551,0.4754990925589836,0.473,125,178,0.702247191011236
Rudy Gay,gayru01,SF,26,TOT,2013,75,2687.0,1366,202,99,362,461,113,53,198,182,521,1253,0.4158020750199521,84,260,0.3230769230769231,437,993,0.4400805639476334,0.449,240,295,0.8135593220338984
Alonzo Gee,geeal01,SF,25,CLE,2013,82,2541.0,842,133,75,245,320,107,29,132,199,305,744,0.4099462365591398,69,219,0.3150684931506849,236,525,0.4495238095238095,0.456,163,205,0.7951219512195122
Mickaël Gelabale,gelabmi01,SF,29,MIN,2013,36,644.0,181,26,32,67,99,16,4,16,47,72,139,0.5179856115107914,16,52,0.3076923076923077,56,87,0.6436781609195402,0.576,21,24,0.875
Paul George,georgpa01,SF,22,IND,2013,79,2972.0,1377,327,88,515,603,143,51,233,227,493,1176,0.4192176870748299,170,469,0.3624733475479744,323,707,0.4568599717114568,0.491,221,274,0.8065693430656934
Daniel Gibson,gibsoda01,PG,26,CLE,2013,46,919.0,250,82,5,55,60,30,4,31,89,84,247,0.340080971659919,56,163,0.3435582822085889,28,84,0.3333333333333333,0.453,26,37,0.7027027027027027
Taj Gibson,gibsota01,PF,27,CHI,2013,65,1459.0,517,61,125,220,345,27,90,76,166,214,441,0.4852607709750567,0,4,0.0,214,437,0.4897025171624714,0.485,89,131,0.6793893129770993
Manu Ginóbili,ginobma01,SG,35,SAS,2013,60,1393.0,705,274,30,171,201,80,13,132,114,229,539,0.424860853432282,83,235,0.3531914893617021,146,304,0.4802631578947368,0.502,164,206,0.7961165048543689
Drew Gooden,goodedr01,C,31,MIL,2013,16,151.0,52,6,13,18,31,5,6,9,21,20,61,0.3278688524590163,1,5,0.2,19,56,0.3392857142857143,0.336,11,16,0.6875
Ben Gordon,gordobe01,SG,29,CHA,2013,75,1560.0,840,141,18,112,130,35,16,136,134,310,760,0.4078947368421052,113,292,0.386986301369863,197,468,0.4209401709401709,0.482,107,127,0.84251968503937
Eric Gordon,gordoer01,SG,24,NOH,2013,42,1264.0,713,137,10,67,77,45,8,117,75,235,584,0.4023972602739726,56,173,0.3236994219653179,179,411,0.4355231143552311,0.45,187,222,0.8423423423423423
Marcin Gortat,gortama01,C,28,PHO,2013,61,1876.0,680,75,128,388,516,40,98,99,127,295,566,0.5212014134275619,0,3,0.0,295,563,0.5239786856127886,0.521,90,138,0.6521739130434783
Andrew Goudelock,goudean01,SG,24,LAL,2013,1,6.0,0,0,1,0,1,0,0,0,0,0,2,0.0,0,0,0.0,0,2,0.0,0.0,0,0,0.0
Danny Granger,grangda01,SF,29,IND,2013,5,74.0,27,3,3,6,9,2,1,4,6,10,35,0.2857142857142857,2,10,0.2,8,25,0.32,0.314,5,8,0.625
Aaron Gray,grayaa01,C,28,TOR,2013,42,513.0,119,33,48,85,133,7,5,36,85,48,90,0.5333333333333333,0,0,0.0,48,90,0.5333333333333333,0.533,23,44,0.5227272727272727
Danny Green,greenda02,SG,25,SAS,2013,80,2201.0,838,141,36,208,244,92,54,94,124,297,663,0.4479638009049774,177,413,0.4285714285714285,120,250,0.48,0.581,67,79,0.8481012658227848
Draymond Green,greendr01,SF,22,GSW,2013,79,1061.0,227,53,58,202,260,42,25,51,159,84,257,0.3268482490272373,14,67,0.208955223880597,70,190,0.3684210526315789,0.354,45,55,0.8181818181818182
Gerald Green,greenge01,SF,27,IND,2013,60,1080.0,421,50,31,110,141,19,23,53,64,155,424,0.365566037735849,59,188,0.3138297872340425,96,236,0.4067796610169492,0.435,52,65,0.8
Jeff Green,greenje02,PF,26,BOS,2013,81,2252.0,1036,128,55,263,318,56,68,132,175,376,806,0.4665012406947891,70,182,0.3846153846153846,306,624,0.4903846153846153,0.51,214,265,0.8075471698113208
Willie Green,greenwi01,SG,31,LAC,2013,72,1188.0,450,55,17,80,97,29,12,31,96,178,386,0.4611398963730569,71,166,0.4277108433734939,107,220,0.4863636363636364,0.553,23,32,0.71875
Blake Griffin,griffbl01,PF,23,LAC,2013,80,2598.0,1440,299,186,476,662,97,50,185,231,577,1072,0.5382462686567164,5,28,0.1785714285714285,572,1044,0.5478927203065134,0.541,281,426,0.6596244131455399
Hamed Haddadi,haddaha01,C,27,TOT,2013,30,322.0,84,12,43,68,111,6,27,31,60,35,82,0.4268292682926829,0,0,0.0,35,82,0.4268292682926829,0.427,14,27,0.5185185185185185
Jordan Hamilton,hamiljo02,SF,22,DEN,2013,40,397.0,208,23,32,63,95,15,8,19,24,84,201,0.417910447761194,27,73,0.3698630136986301,57,128,0.4453125,0.485,13,26,0.5
Richard Hamilton,hamilri01,SG,34,CHI,2013,50,1088.0,490,119,16,67,83,24,5,84,93,204,475,0.4294736842105263,16,52,0.3076923076923077,188,423,0.4444444444444444,0.446,66,77,0.8571428571428571
Ben Hansbrough,hansbbe01,PG,25,IND,2013,28,200.0,57,21,2,16,18,7,2,18,23,15,45,0.3333333333333333,6,23,0.2608695652173913,9,22,0.4090909090909091,0.4,21,27,0.7777777777777778
Tyler Hansbrough,hansbty01,PF,27,IND,2013,81,1366.0,568,36,161,212,373,29,18,78,152,176,407,0.4324324324324324,0,3,0.0,176,404,0.4356435643564356,0.432,216,300,0.72
James Harden,hardeja01,SG,23,HOU,2013,78,2985.0,2023,455,62,317,379,142,38,295,178,585,1337,0.43754674644727,179,486,0.3683127572016461,406,851,0.4770857814336075,0.504,674,792,0.851010101010101
Maurice Harkless,harklma01,SF,19,ORL,2013,76,1974.0,625,50,122,213,335,88,62,69,144,260,564,0.4609929078014184,32,117,0.2735042735042735,228,447,0.5100671140939598,0.489,73,128,0.5703125
Josh Harrellson,harrejo01,C,23,MIA,2013,6,31.0,10,0,3,4,7,1,1,3,4,4,9,0.4444444444444444,1,5,0.2,3,4,0.75,0.5,1,2,0.5
Al Harrington,harrial01,C,32,ORL,2013,10,119.0,51,10,6,21,27,4,1,7,18,20,57,0.3508771929824561,8,30,0.2666666666666666,12,27,0.4444444444444444,0.421,3,4,0.75
Devin Harris,harride01,SG,29,ATL,2013,58,1421.0,577,197,6,110,116,64,13,88,103,194,443,0.437923250564334,77,230,0.3347826086956522,117,213,0.5492957746478874,0.525,112,154,0.7272727272727273
Terrel Harris,harrite01,SG,25,TOT,2013,20,137.0,15,9,4,22,26,2,3,17,17,4,27,0.1481481481481481,0,8,0.0,4,19,0.2105263157894736,0.148,7,10,0.7
Tobias Harris,harrito02,SF-PF,20,TOT,2013,55,1299.0,603,69,73,214,287,32,44,66,120,233,512,0.455078125,34,108,0.3148148148148148,199,404,0.4925742574257425,0.488,103,137,0.7518248175182481
Udonis Haslem,hasleud01,PF,32,MIA,2013,75,1414.0,290,38,97,307,404,30,15,45,173,129,251,0.5139442231075697,0,0,0.0,129,251,0.5139442231075697,0.514,32,45,0.7111111111111111
Spencer Hawes,hawessp01,C,24,PHI,2013,82,2233.0,905,183,173,417,590,24,113,131,233,376,811,0.4636251541307028,31,87,0.3563218390804598,345,724,0.4765193370165745,0.483,122,157,0.7770700636942676
Chuck Hayes,hayesch01,C,29,SAC,2013,74,1209.0,198,112,113,186,299,31,18,44,114,84,190,0.4421052631578947,0,1,0.0,84,189,0.4444444444444444,0.442,30,48,0.625
Gordon Hayward,haywago01,SF,22,UTA,2013,72,2104.0,1017,213,51,174,225,58,38,120,125,336,773,0.4346701164294955,102,246,0.4146341463414634,234,527,0.444022770398482,0.501,243,294,0.826530612244898
Lazar Hayward,haywala01,SF,26,MIN,2013,4,31.0,10,3,0,4,4,2,0,0,3,2,10,0.2,0,4,0.0,2,6,0.3333333333333333,0.2,6,6,1.0
Brendan Haywood,haywobr01,C,33,CHA,2013,61,1162.0,216,29,125,165,290,16,49,50,125,93,216,0.4305555555555556,0,1,0.0,93,215,0.4325581395348837,0.431,30,66,0.4545454545454545
Gerald Henderson,hendege02,SG,25,CHA,2013,68,2133.0,1055,177,55,195,250,68,34,108,149,382,855,0.4467836257309941,33,100,0.33,349,755,0.462251655629139,0.466,258,313,0.8242811501597445
Xavier Henry,henryxa01,SF,21,NOH,2013,50,625.0,194,13,21,69,90,16,5,31,72,66,161,0.4099378881987577,4,11,0.3636363636363636,62,150,0.4133333333333333,0.422,58,92,0.6304347826086957
John Henson,hensojo01,PF,22,MIL,2013,63,827.0,380,31,116,181,297,19,42,47,83,162,336,0.4821428571428571,0,3,0.0,162,333,0.4864864864864865,0.482,56,105,0.5333333333333333
Roy Hibbert,hibbero01,C,26,IND,2013,79,2269.0,937,113,296,360,656,39,206,162,279,385,859,0.4481955762514552,1,4,0.25,384,855,0.4491228070175438,0.449,166,224,0.7410714285714286
J.J. Hickson,hicksjj01,C,24,POR,2013,80,2323.0,1018,88,266,562,828,48,51,145,160,418,744,0.5618279569892473,0,2,0.0,418,742,0.5633423180592992,0.562,182,268,0.6791044776119403
Cory Higgins,higgico01,SG,23,CHA,2013,6,32.0,14,5,1,2,3,3,0,0,5,6,19,0.3157894736842105,1,5,0.2,5,14,0.3571428571428571,0.342,1,2,0.5
Nenê,hilarne01,PF,30,WAS,2013,61,1659.0,766,177,101,306,407,55,37,139,171,285,594,0.4797979797979798,0,1,0.0,285,593,0.4806070826306914,0.48,196,269,0.7286245353159851
George Hill,hillge01,PG,26,IND,2013,76,2620.0,1076,355,47,237,284,81,26,116,134,386,871,0.4431687715269805,130,353,0.3682719546742209,256,518,0.4942084942084942,0.518,174,213,0.8169014084507042
Grant Hill,hillgr01,SF,40,LAC,2013,29,437.0,93,26,6,43,49,11,7,25,39,38,98,0.3877551020408163,3,11,0.2727272727272727,35,87,0.4022988505747126,0.403,14,24,0.5833333333333334
Jordan Hill,hilljo01,PF,25,LAL,2013,29,458.0,194,13,82,84,166,8,19,26,55,77,155,0.4967741935483871,0,2,0.0,77,153,0.5032679738562091,0.497,40,61,0.6557377049180327
Kirk Hinrich,hinriki01,PG,32,CHI,2013,60,1764.0,459,314,16,142,158,63,25,99,192,159,422,0.3767772511848341,71,182,0.3901098901098901,88,240,0.3666666666666666,0.461,70,98,0.7142857142857143
Jrue Holiday,holidjr01,PG,22,PHI,2013,78,2926.0,1383,625,89,240,329,123,32,292,170,555,1288,0.4309006211180124,91,247,0.3684210526315789,464,1041,0.4457252641690682,0.466,182,242,0.7520661157024794
Justin Holiday,holidju01,SG,23,PHI,2013,9,142.0,42,15,0,14,14,3,6,9,7,16,48,0.3333333333333333,4,16,0.25,12,32,0.375,0.375,6,8,0.75
Ryan Hollins,holliry01,C,28,LAC,2013,60,663.0,206,11,50,89,139,6,34,44,133,70,114,0.6140350877192983,0,0,0.0,70,114,0.6140350877192983,0.614,66,88,0.75
Tyler Honeycutt,honeyty01,SF,22,SAC,2013,9,32.0,8,2,3,7,10,0,1,5,2,3,11,0.2727272727272727,0,2,0.0,3,9,0.3333333333333333,0.273,2,2,1.0
Al Horford,horfoal01,C,26,ATL,2013,74,2756.0,1289,240,195,562,757,78,78,147,163,576,1060,0.5433962264150943,3,6,0.5,573,1054,0.5436432637571158,0.545,134,208,0.6442307692307693
Dwight Howard,howardw01,C,27,LAL,2013,76,2722.0,1296,108,251,694,945,84,186,225,291,470,813,0.5781057810578106,1,6,0.1666666666666666,469,807,0.5811648079306072,0.579,355,721,0.492371705963939
Josh Howard,howarjo01,SF,32,MIN,2013,11,207.0,74,4,9,27,36,10,3,10,18,31,77,0.4025974025974026,5,16,0.3125,26,61,0.4262295081967213,0.435,7,12,0.5833333333333334
Juwan Howard,howarju01,PF,39,MIA,2013,7,51.0,21,6,0,8,8,0,0,4,9,10,19,0.5263157894736842,0,0,0.0,10,19,0.5263157894736842,0.526,1,1,1.0
Kris Humphries,humphkr01,PF,27,BRK,2013,65,1191.0,375,32,126,239,365,16,33,57,127,139,310,0.4483870967741935,0,2,0.0,139,308,0.4512987012987013,0.448,97,123,0.7886178861788617
Serge Ibaka,ibakase01,PF,23,OKC,2013,80,2486.0,1055,43,222,395,617,28,242,125,213,446,778,0.5732647814910026,20,57,0.3508771929824561,426,721,0.5908460471567267,0.586,143,191,0.7486910994764397
Andre Iguodala,iguodan01,SG,29,DEN,2013,80,2779.0,1038,433,82,341,423,139,52,206,127,396,879,0.4505119453924914,91,287,0.3170731707317073,305,592,0.5152027027027027,0.502,155,270,0.5740740740740741
Ersan İlyasova,ilyaser01,PF,25,MIL,2013,73,2012.0,962,117,154,366,520,68,36,75,185,371,803,0.4620174346201743,95,214,0.4439252336448598,276,589,0.4685908319185059,0.521,125,157,0.7961783439490446
Kyrie Irving,irvinky01,PG,20,CLE,2013,59,2048.0,1325,350,34,182,216,89,21,191,146,484,1070,0.4523364485981308,109,279,0.3906810035842294,375,791,0.4740834386852086,0.503,248,290,0.8551724137931035
Royal Ivey,iveyro01,SG,31,PHI,2013,53,698.0,170,32,16,41,57,23,3,20,73,62,144,0.4305555555555556,37,88,0.4204545454545454,25,56,0.4464285714285714,0.559,9,16,0.5625
Jarrett Jack,jackja01,SG,29,GSW,2013,79,2349.0,1023,439,21,222,243,60,11,157,134,387,857,0.4515752625437573,82,203,0.4039408866995074,305,654,0.4663608562691131,0.499,167,198,0.8434343434343434
Reggie Jackson,jacksre01,PG,22,OKC,2013,70,993.0,374,122,21,145,166,29,13,53,84,149,325,0.4584615384615385,24,104,0.2307692307692307,125,221,0.5656108597285068,0.495,52,62,0.8387096774193549
Stephen Jackson,jacksst02,SF,34,SAS,2013,55,1075.0,341,80,22,133,155,37,14,77,89,123,330,0.3727272727272727,46,170,0.2705882352941176,77,160,0.48125,0.442,49,70,0.7
Bernard James,jamesbe01,C,27,DAL,2013,46,457.0,131,6,52,79,131,12,38,18,64,53,103,0.5145631067961165,0,2,0.0,53,101,0.5247524752475248,0.515,25,41,0.6097560975609756
Damion James,jamesda01,SF,25,BRK,2013,2,0.0,0,0,0,1,1,0,0,0,0,0,0,0.0,0,0,0.0,0,0,0.0,0.0,0,0,0.0
LeBron James,jamesle01,PF,28,MIA,2013,76,2877.0,2036,551,97,513,610,129,67,226,110,765,1354,0.5649926144756278,103,254,0.405511811023622,662,1100,0.6018181818181818,0.603,403,535,0.7532710280373832
Mike James,jamesmi01,PG,37,DAL,2013,45,862.0,273,139,9,63,72,26,3,55,95,101,271,0.3726937269372694,48,125,0.384,53,146,0.363013698630137,0.461,23,29,0.7931034482758621
Antawn Jamison,jamisan01,PF,36,LAL,2013,76,1636.0,712,50,109,253,362,30,22,53,124,267,575,0.4643478260869565,84,233,0.3605150214592275,183,342,0.5350877192982456,0.537,94,136,0.6911764705882353
Al Jefferson,jeffeal01,C,28,UTA,2013,78,2578.0,1391,164,156,564,720,80,89,105,170,611,1236,0.494336569579288,2,17,0.1176470588235294,609,1219,0.4995898277276456,0.495,167,217,0.7695852534562212
Richard Jefferson,jefferi01,SF,32,GSW,2013,56,568.0,176,31,5,79,84,14,7,23,45,62,136,0.4558823529411764,14,45,0.3111111111111111,48,91,0.5274725274725275,0.507,38,53,0.7169811320754716
Jared Jeffries,jeffrja01,PF,31,POR,2013,38,350.0,44,14,26,34,60,6,6,17,58,16,54,0.2962962962962963,0,2,0.0,16,52,0.3076923076923077,0.296,12,23,0.5217391304347826
Charles Jenkins,jenkich01,SG-PG,23,TOT,2013,59,441.0,111,44,8,24,32,15,2,21,22,49,121,0.4049586776859504,1,2,0.5,48,119,0.4033613445378151,0.409,12,22,0.5454545454545454
John Jenkins,jenkijo01,SG,21,ATL,2013,61,902.0,374,56,17,77,94,12,10,40,37,131,294,0.445578231292517,53,138,0.3840579710144927,78,156,0.5,0.536,59,70,0.8428571428571429
Brandon Jennings,jennibr01,PG,23,MIL,2013,80,2897.0,1397,521,59,187,246,125,10,203,155,497,1247,0.3985565356856455,173,461,0.3752711496746204,324,786,0.4122137404580153,0.468,230,281,0.8185053380782918
Jonas Jerebko,jerebjo01,PF,25,DET,2013,49,892.0,377,43,68,117,185,38,8,42,90,142,316,0.4493670886075949,25,83,0.3012048192771084,117,233,0.5021459227467812,0.489,68,88,0.7727272727272727
Amir Johnson,johnsam01,PF,25,TOR,2013,81,2325.0,813,122,227,384,611,81,110,117,301,336,606,0.5544554455445545,5,13,0.3846153846153846,331,593,0.5581787521079258,0.559,136,187,0.7272727272727273
Chris Johnson,johnsch03,C,27,MIN,2013,30,284.0,117,8,20,40,60,7,28,13,49,48,75,0.64,0,0,0.0,48,75,0.64,0.64,21,34,0.6176470588235294
Chris Johnson,johnsch04,SF,22,MEM,2013,8,102.0,29,2,5,6,11,4,0,3,5,11,25,0.44,6,18,0.3333333333333333,5,7,0.7142857142857143,0.56,1,2,0.5
Ivan Johnson,johnsiv01,PF,28,ATL,2013,69,1035.0,452,46,76,190,266,56,14,71,131,185,356,0.5196629213483146,1,13,0.0769230769230769,184,343,0.5364431486880467,0.521,81,131,0.6183206106870229
James Johnson,johnsja01,SF,25,SAC,2013,54,878.0,276,58,49,96,145,41,50,68,99,117,283,0.4134275618374558,2,21,0.0952380952380952,115,262,0.4389312977099237,0.417,40,67,0.5970149253731343
Joe Johnson,johnsjo02,SG,31,BRK,2013,72,2642.0,1170,253,53,165,218,49,14,123,99,445,1052,0.4230038022813688,148,395,0.3746835443037974,297,657,0.4520547945205479,0.493,132,161,0.8198757763975155
Orlando Johnson,johnsor01,SG,23,IND,2013,51,619.0,203,47,20,90,110,11,9,29,51,72,180,0.4,36,94,0.3829787234042553,36,86,0.4186046511627907,0.5,23,32,0.71875
Wesley Johnson,johnswe01,SF,25,PHO,2013,50,953.0,399,34,21,102,123,22,18,48,56,161,396,0.4065656565656566,50,155,0.3225806451612903,111,241,0.4605809128630705,0.47,27,35,0.7714285714285715
Darius Johnson-Odom,johnsda03,SG,23,LAL,2013,4,6.0,0,1,1,3,4,0,0,0,0,0,4,0.0,0,1,0.0,0,3,0.0,0.0,0,0,0.0
Dahntay Jones,jonesda02,SF,32,TOT,2013,78,1016.0,262,48,24,77,101,22,6,38,119,82,222,0.3693693693693693,11,49,0.2244897959183673,71,173,0.4104046242774566,0.394,87,113,0.7699115044247787
DeQuan Jones,jonesde01,SF,22,ORL,2013,63,803.0,233,16,17,88,105,19,22,30,55,95,218,0.4357798165137614,9,35,0.2571428571428571,86,183,0.4699453551912568,0.456,34,51,0.6666666666666666
Dominique Jones,jonesdo02,PG,24,DAL,2013,29,338.0,116,83,18,27,45,14,2,38,29,40,109,0.3669724770642202,1,9,0.1111111111111111,39,100,0.39,0.372,35,53,0.660377358490566
James Jones,jonesja02,SF,32,MIA,2013,38,221.0,60,13,0,22,22,2,6,3,16,21,61,0.3442622950819672,16,53,0.3018867924528302,5,8,0.625,0.475,2,4,0.5
Kevin Jones,joneske01,PF,23,CLE,2013,32,334.0,95,10,38,40,78,9,5,8,25,43,107,0.4018691588785046,0,0,0.0,43,107,0.4018691588785046,0.402,9,15,0.6
Perry Jones,jonespe01,SF,21,OKC,2013,38,280.0,88,10,12,50,62,5,6,15,23,39,99,0.3939393939393939,0,2,0.0,39,97,0.4020618556701031,0.394,10,15,0.6666666666666666
Solomon Jones,jonesso01,PF,28,NYK,2013,2,26.0,0,0,1,2,3,0,1,3,3,0,1,0.0,0,0,0.0,0,1,0.0,0.0,0,0,0.0
Terrence Jones,joneste01,PF,21,HOU,2013,19,276.0,104,15,28,37,65,12,19,13,21,43,94,0.4574468085106383,5,19,0.2631578947368421,38,75,0.5066666666666667,0.484,13,17,0.7647058823529411
DeAndre Jordan,jordade01,C,24,LAC,2013,82,2010.0,724,28,210,384,594,48,112,100,192,314,488,0.6434426229508197,0,0,0.0,314,488,0.6434426229508197,0.643,96,249,0.3855421686746988
Cory Joseph,josepco01,PG,21,SAS,2013,28,388.0,126,53,12,40,52,15,4,21,25,51,110,0.4636363636363636,6,21,0.2857142857142857,45,89,0.5056179775280899,0.491,18,21,0.8571428571428571
Kris Joseph,josepkr01,SF,24,TOT,2013,10,54.0,9,1,1,6,7,3,0,2,3,2,14,0.1428571428571428,0,3,0.0,2,11,0.1818181818181818,0.143,5,8,0.625
Chris Kaman,kamanch01,C,30,DAL,2013,66,1363.0,693,51,97,275,372,29,52,103,141,313,617,0.5072933549432739,0,1,0.0,313,616,0.5081168831168831,0.507,67,85,0.788235294117647
Jason Kidd,kiddja01,SG,39,NYK,2013,76,2043.0,458,249,50,273,323,125,25,76,125,152,409,0.3716381418092909,114,325,0.3507692307692308,38,84,0.4523809523809524,0.511,40,48,0.8333333333333334
Michael Kidd-Gilchrist,kiddgmi01,SF,19,CHA,2013,78,2025.0,704,117,131,324,455,54,70,101,164,281,613,0.4584013050570962,2,9,0.2222222222222222,279,604,0.4619205298013245,0.46,140,187,0.7486631016042781
Andrei Kirilenko,kirilan01,SF,31,MIN,2013,64,2034.0,791,177,102,260,362,96,62,119,82,284,560,0.5071428571428571,35,120,0.2916666666666667,249,440,0.5659090909090909,0.538,188,250,0.752
Linas Kleiza,kleizli01,SF,28,TOR,2013,20,376.0,148,16,10,42,52,4,2,14,45,48,144,0.3333333333333333,20,66,0.303030303030303,28,78,0.358974358974359,0.403,32,38,0.8421052631578947
Brandon Knight,knighbr03,PG,21,DET,2013,75,2365.0,999,303,54,193,247,58,8,205,157,357,878,0.4066059225512528,120,327,0.3669724770642202,237,551,0.4301270417422868,0.475,165,225,0.7333333333333333
Kyle Korver,korveky01,SF,31,ATL,2013,74,2259.0,810,146,23,270,293,70,37,70,170,277,601,0.4608985024958402,189,414,0.4565217391304347,88,187,0.4705882352941176,0.618,67,78,0.8589743589743589
Kosta Koufos,koufoko01,C,23,DEN,2013,81,1817.0,648,32,211,351,562,44,103,53,246,295,508,0.5807086614173228,0,1,0.0,295,507,0.5818540433925049,0.581,58,104,0.5576923076923077
Viacheslav Kravtsov,kravtvi01,C,25,DET,2013,25,224.0,77,9,24,21,45,5,9,14,32,33,46,0.717391304347826,0,0,0.0,33,46,0.717391304347826,0.717,11,37,0.2972972972972973
Doron Lamb,lambdo01,SG,21,TOT,2013,47,577.0,154,32,8,38,46,13,0,26,52,60,163,0.3680981595092024,14,37,0.3783783783783784,46,126,0.365079365079365,0.411,20,34,0.5882352941176471
Jeremy Lamb,lambje01,SF,20,OKC,2013,23,147.0,71,5,5,13,18,2,2,6,13,24,68,0.3529411764705882,9,30,0.3,15,38,0.3947368421052631,0.419,14,14,1.0
Carl Landry,landrca01,PF,29,GSW,2013,81,1876.0,874,65,180,303,483,35,31,115,190,325,602,0.5398671096345515,1,3,0.3333333333333333,324,599,0.5409015025041736,0.541,223,273,0.8168498168498168
Ty Lawson,lawsoty01,PG,25,DEN,2013,73,2513.0,1216,501,36,162,198,107,8,182,135,448,971,0.4613800205973223,85,232,0.3663793103448275,363,739,0.4912043301759134,0.505,235,311,0.7556270096463023
Courtney Lee,leeco01,SG,27,BOS,2013,78,1941.0,612,143,31,159,190,89,21,84,139,246,530,0.4641509433962264,58,156,0.3717948717948718,188,374,0.5026737967914439,0.519,62,72,0.8611111111111112
David Lee,leeda02,PF,29,GSW,2013,79,2907.0,1459,279,218,668,886,67,22,207,246,602,1160,0.5189655172413793,0,4,0.0,602,1156,0.5207612456747405,0.519,255,320,0.796875
Malcolm Lee,leema01,SG,22,MIN,2013,16,289.0,78,20,15,24,39,12,6,10,30,29,76,0.3815789473684211,8,24,0.3333333333333333,21,52,0.4038461538461538,0.434,12,20,0.6
Kawhi Leonard,leonaka01,SF,21,SAS,2013,58,1810.0,689,93,63,283,346,97,32,62,99,260,526,0.494296577946768,65,174,0.3735632183908046,195,352,0.5539772727272727,0.556,104,126,0.8253968253968254
Meyers Leonard,leoname01,C,20,POR,2013,69,1206.0,377,33,80,175,255,11,38,49,168,151,277,0.5451263537906137,3,7,0.4285714285714285,148,270,0.5481481481481482,0.551,72,89,0.8089887640449438
Jon Leuer,leuerjo01,PF-C,23,TOT,2013,28,187.0,56,8,13,24,37,6,0,8,21,25,52,0.4807692307692308,0,3,0.0,25,49,0.5102040816326531,0.481,6,13,0.4615384615384615
Rashard Lewis,lewisra02,PF,33,MIA,2013,55,792.0,285,30,19,102,121,21,14,33,67,103,249,0.4136546184738955,51,131,0.3893129770992366,52,118,0.4406779661016949,0.516,28,45,0.6222222222222222
DeAndre Liggins,liggide01,SG,24,OKC,2013,39,290.0,58,15,13,40,53,18,3,14,33,21,47,0.4468085106382978,7,19,0.3684210526315789,14,28,0.5,0.521,9,18,0.5
Damian Lillard,lillada01,PG,22,POR,2013,82,3167.0,1562,531,42,215,257,74,19,243,172,553,1288,0.4293478260869565,185,503,0.36779324055666,368,785,0.4687898089171974,0.501,271,321,0.8442367601246106
Jeremy Lin,linje01,PG,24,HOU,2013,82,2640.0,1095,497,32,215,247,134,29,236,205,396,897,0.4414715719063545,87,257,0.3385214007782101,309,640,0.4828125,0.49,216,275,0.7854545454545454
Shaun Livingston,livinsh01,PG,27,TOT,2013,66,1455.0,417,215,31,127,158,48,31,76,127,166,346,0.4797687861271676,0,4,0.0,166,342,0.4853801169590643,0.48,85,98,0.8673469387755102
Brook Lopez,lopezbr01,C,24,BRK,2013,74,2253.0,1437,70,208,304,512,33,154,131,152,570,1094,0.5210237659963437,0,1,0.0,570,1093,0.5215004574565416,0.521,297,392,0.7576530612244898
Robin Lopez,lopezro01,C,24,NOH,2013,82,2136.0,929,64,226,236,462,32,128,110,167,384,719,0.5340751043115438,0,0,0.0,384,719,0.5340751043115438,0.534,161,207,0.7777777777777778
Kevin Love,loveke01,PF,24,MIN,2013,18,618.0,330,42,64,188,252,13,9,39,34,105,298,0.3523489932885906,20,92,0.217391304347826,85,206,0.4126213592233009,0.386,100,142,0.704225352112676
Kyle Lowry,lowryky01,PG,26,TOR,2013,68,2020.0,791,435,56,265,321,94,24,157,218,250,623,0.4012841091492777,101,279,0.3620071684587813,149,344,0.4331395348837209,0.482,190,239,0.7949790794979079
John Lucas III,lucasjo02,PG,30,TOR,2013,63,827.0,333,105,8,57,65,23,1,26,50,129,334,0.3862275449101796,57,151,0.3774834437086092,72,183,0.3934426229508196,0.472,18,25,0.72
Scott Machado,machasc01,PG,22,HOU,2013,6,21.0,8,6,0,1,1,2,0,8,0,3,6,0.5,0,1,0.0,3,5,0.6,0.5,2,2,1.0
Shelvin Mack,macksh01,PG-SG,22,TOT,2013,31,416.0,143,68,3,37,40,15,0,34,39,58,126,0.4603174603174603,18,49,0.3673469387755102,40,77,0.5194805194805194,0.532,9,16,0.5625
Corey Maggette,maggeco01,SF,33,DET,2013,18,257.0,95,19,5,20,25,6,2,17,42,27,76,0.3552631578947368,5,21,0.238095238095238,22,55,0.4,0.388,36,48,0.75
Ian Mahinmi,mahinia01,C,26,IND,2013,80,1322.0,402,27,115,196,311,39,66,92,201,149,329,0.4528875379939209,0,2,0.0,149,327,0.45565749235474,0.453,104,171,0.6081871345029239
Shawn Marion,mariosh01,PF,34,DAL,2013,67,2010.0,812,163,146,379,525,75,47,103,111,355,690,0.5144927536231884,23,73,0.3150684931506849,332,617,0.5380875202593193,0.531,79,101,0.7821782178217822
Kendall Marshall,marshke01,PG,21,PHO,2013,48,702.0,143,143,4,38,42,22,4,57,48,56,151,0.3708609271523179,23,73,0.3150684931506849,33,78,0.4230769230769231,0.447,8,14,0.5714285714285714
Cartier Martin,martica01,SF,28,WAS,2013,41,694.0,270,20,11,89,100,19,6,32,58,96,252,0.3809523809523809,58,146,0.3972602739726027,38,106,0.3584905660377358,0.496,20,28,0.7142857142857143
Kenyon Martin,martike01,C,35,NYK,2013,18,431.0,129,8,34,61,95,16,17,16,64,56,93,0.6021505376344086,0,0,0.0,56,93,0.6021505376344086,0.602,17,40,0.425
Kevin Martin,martike02,SG,29,OKC,2013,77,2136.0,1077,106,31,147,178,72,8,101,138,350,778,0.4498714652956298,158,371,0.4258760107816711,192,407,0.4717444717444717,0.551,219,246,0.8902439024390244
Roger Mason,masonro01,SG,32,NOH,2013,69,1219.0,369,74,11,121,132,26,11,51,104,132,305,0.4327868852459016,66,159,0.4150943396226415,66,146,0.4520547945205479,0.541,39,43,0.9069767441860463
Wesley Matthews,matthwe02,SG,26,POR,2013,69,2403.0,1022,174,35,156,191,90,18,109,172,352,808,0.4356435643564356,169,425,0.3976470588235294,183,383,0.4778067885117493,0.54,149,187,0.7967914438502673
Jason Maxiell,maxieja01,PF,29,DET,2013,72,1789.0,498,54,135,274,409,32,95,81,172,204,457,0.4463894967177242,0,0,0.0,204,457,0.4463894967177242,0.446,90,145,0.6206896551724138
Eric Maynor,maynoer01,PG-SG,25,TOT,2013,64,963.0,291,182,9,37,46,22,1,79,55,106,281,0.3772241992882562,34,96,0.3541666666666667,72,185,0.3891891891891892,0.438,45,62,0.7258064516129032
O.J. Mayo,mayooj01,SG,25,DAL,2013,82,2913.0,1255,361,36,255,291,93,23,210,195,461,1026,0.449317738791423,142,349,0.4068767908309456,319,677,0.4711964549483013,0.519,191,233,0.8197424892703863
Luc Mbah a Moute,mbahalu01,SF,26,MIL,2013,58,1326.0,387,55,89,167,256,42,14,70,82,151,377,0.4005305039787798,13,37,0.3513513513513513,138,340,0.4058823529411764,0.418,72,126,0.5714285714285714
JaVale McGee,mcgeeja01,C,25,DEN,2013,79,1433.0,717,24,158,223,381,30,157,90,184,303,527,0.5749525616698292,1,1,1.0,302,526,0.5741444866920152,0.576,110,186,0.5913978494623656
Dominic McGuire,mcguido01,SF,27,TOT,2013,26,387.0,51,20,19,59,78,13,11,12,39,24,56,0.4285714285714285,0,0,0.0,24,56,0.4285714285714285,0.429,3,10,0.3
Josh McRoberts,mcrobjo01,PF,25,TOT,2013,67,1487.0,401,141,93,232,325,32,27,66,131,156,343,0.4548104956268221,24,84,0.2857142857142857,132,259,0.5096525096525096,0.49,65,85,0.7647058823529411
Jodie Meeks,meeksjo01,SG,25,LAL,2013,78,1663.0,618,69,37,134,171,58,5,52,103,205,530,0.3867924528301887,122,342,0.3567251461988304,83,188,0.4414893617021276,0.502,86,96,0.8958333333333334
Fab Melo,melofa01,C,22,BOS,2013,6,36.0,7,0,0,3,3,2,2,1,7,3,6,0.5,0,0,0.0,3,6,0.5,0.5,1,4,0.25
Khris Middleton,middlkh01,SG,21,DET,2013,27,475.0,165,28,4,46,50,15,4,11,53,62,141,0.4397163120567376,14,45,0.3111111111111111,48,96,0.5,0.489,27,32,0.84375
C.J. Miles,milescj01,SF,25,CLE,2013,65,1364.0,729,63,24,150,174,49,17,69,138,255,614,0.4153094462540717,126,328,0.3841463414634146,129,286,0.451048951048951,0.518,93,107,0.8691588785046729
Darko Miličić,milicda01,C,27,BOS,2013,1,5.0,0,0,0,1,1,0,0,2,1,0,1,0.0,0,0,0.0,0,1,0.0,0.0,0,0,0.0
Andre Miller,millean02,PG,36,DEN,2013,82,2151.0,786,484,60,178,238,73,11,172,159,303,632,0.4794303797468354,17,64,0.265625,286,568,0.5035211267605634,0.493,163,194,0.8402061855670103
Darius Miller,milleda01,SF,22,NOH,2013,52,694.0,118,44,8,70,78,17,12,23,89,44,108,0.4074074074074074,22,56,0.3928571428571428,22,52,0.4230769230769231,0.509,8,8,1.0
Mike Miller,millemi01,SF,32,MIA,2013,59,900.0,281,99,18,139,157,21,4,35,63,100,231,0.4329004329004329,73,175,0.4171428571428571,27,56,0.4821428571428571,0.591,8,11,0.7272727272727273
Quincy Miller,millequ01,PF,20,DEN,2013,7,26.0,9,3,1,1,2,1,0,1,3,4,12,0.3333333333333333,0,1,0.0,4,11,0.3636363636363636,0.333,1,2,0.5
Patty Mills,millspa02,PG,24,SAS,2013,58,656.0,294,62,9,41,50,26,4,39,55,113,241,0.4688796680497925,52,130,0.4,61,111,0.5495495495495496,0.577,16,19,0.8421052631578947
Paul Millsap,millspa01,PF,27,UTA,2013,78,2375.0,1135,201,177,377,554,102,80,138,232,429,875,0.4902857142857142,13,39,0.3333333333333333,416,836,0.4976076555023923,0.498,264,356,0.7415730337078652
Nazr Mohammed,mohamna01,C,35,CHI,2013,63,693.0,166,26,73,122,195,21,32,24,97,66,180,0.3666666666666666,0,2,0.0,66,178,0.3707865168539326,0.367,34,47,0.723404255319149
Greg Monroe,monrogr01,C,22,DET,2013,81,2687.0,1298,281,236,541,777,105,55,234,190,514,1058,0.4858223062381852,0,4,0.0,514,1054,0.4876660341555977,0.486,270,392,0.6887755102040817
E'Twaun Moore,mooreet01,SG,23,ORL,2013,75,1682.0,588,206,48,119,167,51,23,105,122,237,598,0.3963210702341137,67,197,0.3401015228426396,170,401,0.4239401496259352,0.452,47,59,0.7966101694915254
Darius Morris,morrida01,PG,22,LAL,2013,48,683.0,194,76,24,33,57,21,2,45,58,73,188,0.3882978723404255,24,66,0.3636363636363636,49,122,0.4016393442622951,0.452,24,37,0.6486486486486487
Marcus Morris,morrima03,PF-SF,23,TOT,2013,77,1524.0,596,62,80,197,277,45,20,77,160,222,526,0.4220532319391635,86,233,0.3690987124463519,136,293,0.4641638225255973,0.504,66,117,0.5641025641025641
Markieff Morris,morrima02,PF,23,PHO,2013,82,1837.0,670,108,131,265,396,77,64,104,209,266,653,0.4073506891271056,45,134,0.3358208955223881,221,519,0.4258188824662813,0.442,93,127,0.7322834645669292
Anthony Morrow,morroan01,SG,27,TOT,2013,41,383.0,164,13,11,19,30,13,1,8,43,64,145,0.4413793103448276,16,43,0.3720930232558139,48,102,0.4705882352941176,0.497,20,22,0.9090909090909092
Donatas Motiejūnas,motiedo01,PF,22,HOU,2013,44,538.0,250,31,36,57,93,7,10,37,73,97,213,0.4553990610328638,24,83,0.2891566265060241,73,130,0.5615384615384615,0.512,32,51,0.6274509803921569
Arnett Moultrie,moultar01,PF,22,PHI,2013,47,542.0,174,10,76,69,145,17,10,19,43,78,134,0.582089552238806,0,0,0.0,78,134,0.582089552238806,0.582,18,28,0.6428571428571429
Timofey Mozgov,mozgoti01,C,26,DEN,2013,41,366.0,108,9,50,57,107,6,18,25,57,44,87,0.5057471264367817,0,2,0.0,44,85,0.5176470588235295,0.506,20,26,0.7692307692307693
Byron Mullens,mulleby01,PF,23,CHA,2013,53,1428.0,564,81,71,266,337,34,32,74,110,217,563,0.3854351687388987,66,208,0.3173076923076923,151,355,0.4253521126760563,0.444,64,99,0.6464646464646465
Kevin Murphy,murphke01,SG,22,UTA,2013,17,52.0,15,2,0,4,4,1,0,3,4,7,28,0.25,1,5,0.2,6,23,0.2608695652173913,0.268,0,0,0.0
Troy Murphy,murphtr01,PF,32,DAL,2013,14,256.0,65,7,7,42,49,10,6,7,29,22,61,0.360655737704918,11,35,0.3142857142857143,11,26,0.4230769230769231,0.451,10,11,0.9090909090909092
Steve Nash,nashst01,PG,38,LAL,2013,50,1627.0,636,333,26,116,142,30,5,126,70,236,475,0.4968421052631579,57,130,0.4384615384615384,179,345,0.518840579710145,0.557,107,116,0.9224137931034484
Gary Neal,nealga01,SG,28,SAS,2013,68,1484.0,645,129,13,130,143,30,2,69,93,246,597,0.4120603015075377,89,251,0.3545816733067729,157,346,0.453757225433526,0.487,64,74,0.8648648648648649
Jameer Nelson,nelsoja01,PG,30,ORL,2013,56,1977.0,822,413,23,186,209,71,6,154,161,306,780,0.3923076923076923,121,355,0.3408450704225352,185,425,0.4352941176470588,0.47,89,102,0.8725490196078431
Andrew Nicholson,nichoan01,PF,23,ORL,2013,75,1249.0,587,44,69,189,258,24,32,79,133,256,486,0.5267489711934157,0,0,0.0,256,486,0.5267489711934157,0.527,75,94,0.7978723404255319
Joakim Noah,noahjo01,C,27,CHI,2013,66,2426.0,784,262,260,473,733,78,141,176,185,303,630,0.4809523809523809,0,5,0.0,303,625,0.4848,0.481,178,237,0.7510548523206751
Steve Novak,novakst01,SF,29,NYK,2013,81,1641.0,535,35,17,135,152,28,8,12,97,178,430,0.413953488372093,149,351,0.4245014245014245,29,79,0.3670886075949367,0.587,30,33,0.9090909090909092
Dirk Nowitzki,nowitdi01,PF,34,DAL,2013,53,1661.0,917,132,37,326,363,38,37,70,93,343,728,0.4711538461538461,65,157,0.4140127388535032,278,571,0.4868651488616462,0.516,166,193,0.8601036269430051
Jermaine O'Neal,onealje01,C,34,PHO,2013,55,1029.0,454,42,82,211,293,19,78,73,126,179,371,0.4824797843665768,0,0,0.0,179,371,0.4824797843665768,0.482,96,115,0.8347826086956521
Kyle O'Quinn,oquinky01,C,22,ORL,2013,57,638.0,232,52,65,144,209,11,26,37,107,101,197,0.5126903553299492,0,1,0.0,101,196,0.5153061224489796,0.513,30,45,0.6666666666666666
Lamar Odom,odomla01,PF,33,LAC,2013,82,1616.0,330,142,117,363,480,69,58,86,214,146,366,0.3989071038251366,18,90,0.2,128,276,0.463768115942029,0.423,20,42,0.4761904761904761
Tim Ohlbrecht,ohlbrti01,C,24,HOU,2013,3,12.0,3,1,0,1,1,1,0,4,1,1,3,0.3333333333333333,0,0,0.0,1,3,0.3333333333333333,0.333,1,1,1.0
Emeka Okafor,okafoem01,C,30,WAS,2013,79,2052.0,765,93,199,493,692,45,77,107,145,328,687,0.4774381368267831,0,0,0.0,328,687,0.4774381368267831,0.477,109,191,0.5706806282722513
Daniel Orton,ortonda01,C,22,OKC,2013,13,104.0,33,4,13,13,26,4,3,4,13,12,26,0.4615384615384615,0,0,0.0,12,26,0.4615384615384615,0.462,9,17,0.5294117647058824
Travis Outlaw,outlatr01,SF,28,SAC,2013,38,444.0,200,21,17,44,61,11,8,19,35,74,177,0.4180790960451977,14,50,0.28,60,127,0.4724409448818897,0.458,38,52,0.7307692307692307
Zaza Pachulia,pachuza01,C,28,ATL,2013,52,1134.0,306,79,132,204,336,35,12,70,128,114,241,0.4730290456431535,0,3,0.0,114,238,0.4789915966386555,0.473,78,103,0.7572815533980582
Jannero Pargo,pargoja01,PG,33,TOT,2013,32,507.0,207,67,10,25,35,18,3,41,42,78,212,0.3679245283018867,39,116,0.3362068965517241,39,96,0.40625,0.46,12,13,0.9230769230769232
Jeremy Pargo,pargoje01,PG-SG,26,TOT,2013,39,655.0,265,92,8,41,49,13,2,50,46,99,250,0.396,25,74,0.3378378378378378,74,176,0.4204545454545454,0.446,42,62,0.6774193548387096
Tony Parker,parketo01,PG,30,SAS,2013,66,2174.0,1341,499,18,180,198,54,6,170,92,519,995,0.521608040201005,24,68,0.3529411764705882,495,927,0.5339805825242718,0.534,279,330,0.8454545454545455
Chandler Parsons,parsoch01,SF,24,HOU,2013,76,2758.0,1177,269,79,325,404,75,32,147,148,456,939,0.4856230031948881,152,395,0.3848101265822785,304,544,0.5588235294117647,0.567,113,155,0.7290322580645161
Patrick Patterson,pattepa01,PF,23,TOT,2013,71,1775.0,737,81,113,224,337,31,40,61,138,319,623,0.5120385232744783,51,132,0.3863636363636363,268,491,0.5458248472505092,0.553,48,63,0.7619047619047619
Chris Paul,paulch01,PG,27,LAC,2013,70,2335.0,1186,678,53,209,262,169,10,159,143,412,856,0.4813084112149532,76,232,0.3275862068965517,336,624,0.5384615384615384,0.526,286,323,0.8854489164086687
Sasha Pavlović,pavloal01,SG,29,POR,2013,39,528.0,103,32,7,49,56,24,5,14,59,42,119,0.3529411764705882,18,60,0.3,24,59,0.4067796610169492,0.429,1,6,0.1666666666666666
Nikola Peković,pekovni01,C,27,MIN,2013,62,1959.0,1011,53,230,315,545,43,50,101,143,385,741,0.5195681511470985,0,0,0.0,385,741,0.5195681511470985,0.52,241,324,0.7438271604938271
Kendrick Perkins,perkike01,C,28,OKC,2013,78,1954.0,330,111,110,356,466,43,83,109,227,143,313,0.4568690095846645,0,1,0.0,143,312,0.4583333333333333,0.457,44,72,0.6111111111111112
Johan Petro,petrojo01,C,27,ATL,2013,31,352.0,108,16,33,79,112,10,9,24,48,48,110,0.4363636363636363,1,4,0.25,47,106,0.4433962264150943,0.441,11,12,0.9166666666666666
Paul Pierce,piercpa01,SF,35,BOS,2013,77,2575.0,1430,370,45,442,487,84,30,214,210,476,1092,0.4358974358974359,145,382,0.3795811518324607,331,710,0.4661971830985915,0.502,333,423,0.7872340425531915
Mickaël Piétrus,pietrmi01,SF,30,TOR,2013,19,386.0,100,9,5,31,36,12,6,16,33,34,98,0.3469387755102041,20,64,0.3125,14,34,0.4117647058823529,0.449,12,18,0.6666666666666666
Dexter Pittman,pittmde01,C,24,TOT,2013,11,32.0,8,0,7,5,12,0,0,3,8,4,11,0.3636363636363636,0,0,0.0,4,11,0.3636363636363636,0.364,0,3,0.0
Miles Plumlee,plumlmi01,C,24,IND,2013,14,55.0,13,2,12,10,22,0,3,3,5,5,21,0.238095238095238,0,0,0.0,5,21,0.238095238095238,0.238,3,4,0.75
Quincy Pondexter,pondequ01,SF,24,MEM,2013,59,1243.0,375,61,43,89,132,35,6,42,95,128,299,0.4280936454849498,60,152,0.3947368421052631,68,147,0.4625850340136054,0.528,59,75,0.7866666666666666
A.J. Price,priceaj01,PG,26,WAS,2013,57,1278.0,441,205,20,94,114,33,3,64,73,161,413,0.3898305084745763,70,200,0.35,91,213,0.4272300469483568,0.475,49,62,0.7903225806451613
Ronnie Price,pricero01,PG,29,POR,2013,39,510.0,105,73,13,31,44,26,3,34,61,39,120,0.325,10,39,0.2564102564102564,29,81,0.3580246913580246,0.367,17,24,0.7083333333333334
Pablo Prigioni,prigipa01,PG,35,NYK,2013,78,1263.0,275,236,41,102,143,69,2,86,127,100,220,0.4545454545454545,53,134,0.3955223880597014,47,86,0.5465116279069767,0.575,22,25,0.88
Tayshaun Prince,princta01,SF,32,TOT,2013,82,2631.0,852,196,72,292,364,48,25,89,86,359,820,0.4378048780487805,38,94,0.4042553191489361,321,726,0.4421487603305785,0.461,96,130,0.7384615384615385
Joel Przybilla,przybjo01,C,33,MIL,2013,12,68.0,2,4,5,16,21,1,2,4,10,1,4,0.25,0,0,0.0,1,4,0.25,0.25,0,2,0.0
Chris Quinn,quinnch01,SG,29,CLE,2013,7,78.0,10,9,1,1,2,3,0,6,4,4,16,0.25,0,5,0.0,4,11,0.3636363636363636,0.25,2,2,1.0
Vladimir Radmanović,radmavl01,PF,32,CHI,2013,25,144.0,33,8,10,18,28,8,4,7,29,13,43,0.3023255813953488,5,27,0.1851851851851851,8,16,0.5,0.36,2,3,0.6666666666666666
Anthony Randolph,randoan01,PF,23,DEN,2013,39,329.0,143,12,29,66,95,19,21,37,41,56,114,0.4912280701754385,0,8,0.0,56,106,0.5283018867924528,0.491,31,45,0.6888888888888889
Shavlik Randolph,randosh01,PF,29,BOS,2013,16,198.0,67,4,28,42,70,8,7,10,38,28,48,0.5833333333333334,0,0,0.0,28,48,0.5833333333333334,0.583,11,27,0.4074074074074074
Zach Randolph,randoza01,PF,31,MEM,2013,76,2607.0,1169,108,310,544,854,61,31,150,180,471,1024,0.4599609375,2,23,0.0869565217391304,469,1001,0.4685314685314685,0.461,225,300,0.75
J.J. Redick,redicjj01,SG,28,TOT,2013,78,2379.0,1100,296,17,154,171,38,9,138,117,382,880,0.4340909090909091,165,451,0.3658536585365853,217,429,0.5058275058275058,0.528,171,190,0.9
Jason Richardson,richaja01,SG,32,PHI,2013,33,936.0,347,51,19,108,127,40,15,26,57,135,336,0.4017857142857143,57,167,0.3413173652694611,78,169,0.4615384615384615,0.487,20,33,0.6060606060606061
Quentin Richardson,richaqu01,SF,32,NYK,2013,1,29.0,5,1,5,5,10,0,0,2,1,1,11,0.0909090909090909,1,4,0.25,0,7,0.0,0.136,2,2,1.0
Luke Ridnour,ridnolu01,SG,31,MIN,2013,82,2474.0,939,311,41,165,206,82,15,130,187,367,811,0.4525277435265105,66,212,0.3113207547169811,301,599,0.5025041736227045,0.493,139,164,0.8475609756097561
Austin Rivers,riverau01,SG,20,NOH,2013,61,1418.0,377,127,16,93,109,26,9,74,122,145,390,0.3717948717948718,28,86,0.3255813953488372,117,304,0.3848684210526316,0.408,59,108,0.5462962962962963
Brian Roberts,roberbr01,PG,27,NOH,2013,78,1324.0,555,219,17,80,97,37,3,71,108,213,511,0.4168297455968688,59,153,0.3856209150326797,154,358,0.4301675977653631,0.475,70,77,0.9090909090909092
Nate Robinson,robinna01,PG,28,CHI,2013,82,2086.0,1074,358,29,155,184,85,10,144,207,399,921,0.4332247557003257,141,348,0.4051724137931034,258,573,0.450261780104712,0.51,135,169,0.7988165680473372
Thomas Robinson,robinth01,PF,21,TOT,2013,70,1056.0,333,46,122,193,315,41,26,88,124,138,321,0.4299065420560747,0,1,0.0,138,320,0.43125,0.43,57,109,0.5229357798165137
Rajon Rondo,rondora01,PG,26,BOS,2013,38,1423.0,522,420,43,169,212,70,9,148,96,225,465,0.4838709677419355,12,50,0.24,213,415,0.5132530120481927,0.497,60,93,0.6451612903225806
Terrence Ross,rosste01,SG,21,TOR,2013,73,1239.0,467,53,35,109,144,43,14,48,122,186,457,0.4070021881838074,65,196,0.3316326530612244,121,261,0.4636015325670498,0.478,30,42,0.7142857142857143
Brandon Roy,roybr01,SG,28,MIN,2013,5,122.0,29,23,3,11,14,3,0,7,5,11,35,0.3142857142857143,0,9,0.0,11,26,0.4230769230769231,0.314,7,10,0.7
Ricky Rubio,rubiori01,PG,22,MIN,2013,57,1691.0,608,418,44,185,229,137,5,172,143,185,514,0.3599221789883268,27,92,0.2934782608695652,158,422,0.3744075829383886,0.386,211,264,0.7992424242424242
Brandon Rush,rushbr01,SF,27,GSW,2013,2,25.0,14,2,0,1,1,0,0,3,5,6,9,0.6666666666666666,0,2,0.0,6,7,0.8571428571428571,0.667,2,3,0.6666666666666666
Robert Sacre,sacrero01,C,23,LAL,2013,32,203.0,43,6,9,25,34,0,10,10,38,18,48,0.375,0,0,0.0,18,48,0.375,0.375,7,11,0.6363636363636364
John Salmons,salmojo01,SF,33,SAC,2013,76,2278.0,672,226,33,174,207,51,25,85,143,244,612,0.3986928104575163,99,267,0.3707865168539326,145,345,0.4202898550724637,0.48,85,110,0.7727272727272727
Samardo Samuels,samuesa01,C,24,CLE,2013,18,196.0,58,8,10,18,28,3,3,6,30,22,60,0.3666666666666666,0,1,0.0,22,59,0.3728813559322034,0.367,14,24,0.5833333333333334
Larry Sanders,sandela01,C,24,MIL,2013,71,1937.0,696,83,224,448,672,53,201,87,233,306,605,0.5057851239669422,0,2,0.0,306,603,0.5074626865671642,0.506,84,136,0.6176470588235294
Luis Scola,scolalu01,PF,32,PHO,2013,82,2184.0,1048,182,158,383,541,67,35,126,257,432,915,0.4721311475409836,3,16,0.1875,429,899,0.4771968854282536,0.474,181,230,0.7869565217391304
Mike Scott,scottmi01,PF,24,ATL,2013,40,376.0,183,12,39,71,110,4,2,21,32,70,147,0.4761904761904761,0,1,0.0,70,146,0.4794520547945205,0.476,43,56,0.7678571428571429
Thabo Sefolosha,sefolth01,SG,28,OKC,2013,81,2229.0,613,125,58,259,317,103,44,64,177,224,466,0.4806866952789699,108,258,0.4186046511627907,116,208,0.5576923076923077,0.597,57,69,0.8260869565217391
Josh Selby,selbyjo01,PG,21,MEM,2013,10,59.0,20,4,0,5,5,2,0,7,7,6,22,0.2727272727272727,1,6,0.1666666666666666,5,16,0.3125,0.295,7,11,0.6363636363636364
Kevin Séraphin,serapke01,C,23,WAS,2013,79,1721.0,721,57,107,239,346,24,59,130,211,330,716,0.4608938547486033,0,0,0.0,330,716,0.4608938547486033,0.461,61,88,0.6931818181818182
Ramon Sessions,sessira01,SG,26,CHA,2013,61,1652.0,876,230,27,142,169,48,7,104,91,276,676,0.408284023668639,33,107,0.308411214953271,243,569,0.4270650263620387,0.433,291,347,0.8386167146974063
Tornike Shengelia,shengto01,SF,21,BRK,2013,19,93.0,30,3,9,14,23,3,1,11,11,10,23,0.4347826086956521,1,2,0.5,9,21,0.4285714285714285,0.457,9,16,0.5625
Iman Shumpert,shumpim01,SG,22,NYK,2013,45,996.0,305,75,31,105,136,43,7,37,99,109,275,0.3963636363636363,51,127,0.4015748031496063,58,148,0.3918918918918919,0.489,36,47,0.7659574468085106
Alexey Shved,shvedal01,SG,24,MIN,2013,77,1840.0,665,286,41,134,175,54,27,147,117,236,635,0.3716535433070866,85,288,0.2951388888888889,151,347,0.4351585014409221,0.439,108,150,0.72
Henry Sims,simshe01,C,22,NOH,2013,2,5.0,4,0,2,0,2,0,0,1,1,2,3,0.6666666666666666,0,0,0.0,2,3,0.6666666666666666,0.667,0,0,0.0
Kyle Singler,singlky01,SF,24,DET,2013,82,2293.0,720,77,109,221,330,57,37,98,217,275,642,0.4283489096573208,70,200,0.35,205,442,0.4638009049773756,0.483,100,124,0.8064516129032258
Chris Singleton,singlch01,PF,23,WAS,2013,57,924.0,231,37,51,133,184,38,24,45,124,92,241,0.3817427385892116,7,36,0.1944444444444444,85,205,0.4146341463414634,0.396,40,70,0.5714285714285714
Donald Sloan,sloando01,SG-PG,25,TOT,2013,23,263.0,81,38,3,25,28,5,0,14,17,27,78,0.3461538461538461,7,19,0.3684210526315789,20,59,0.3389830508474576,0.391,20,25,0.8
Greg Smith,smithgr02,C,22,HOU,2013,70,1110.0,421,25,111,210,321,18,40,41,175,170,274,0.6204379562043796,0,1,0.0,170,273,0.6227106227106227,0.62,81,130,0.6230769230769231
Ish Smith,smithis01,PG,24,TOT,2013,52,516.0,123,87,12,49,61,21,9,37,26,56,159,0.3522012578616352,8,27,0.2962962962962963,48,132,0.3636363636363636,0.377,3,7,0.4285714285714285
J.R. Smith,smithjr01,SG,27,NYK,2013,80,2678.0,1446,218,64,361,425,100,24,134,226,527,1249,0.421937550040032,155,436,0.3555045871559633,372,813,0.4575645756457565,0.484,237,311,0.7620578778135049
Jason Smith,smithja02,C,26,NOH,2013,51,876.0,420,34,64,122,186,15,45,55,123,167,341,0.4897360703812317,0,4,0.0,167,337,0.4955489614243323,0.49,86,102,0.8431372549019608
Josh Smith,smithjo03,PF,27,ATL,2013,76,2683.0,1327,321,133,506,639,94,136,226,175,550,1182,0.4653130287648054,61,201,0.3034825870646766,489,981,0.4984709480122324,0.491,166,321,0.5171339563862928
Nolan Smith,smithno01,PG,24,POR,2013,40,288.0,110,35,7,20,27,7,1,29,26,42,114,0.3684210526315789,6,28,0.2142857142857142,36,86,0.4186046511627907,0.395,20,28,0.7142857142857143
Marreese Speights,speigma01,C,25,TOT,2013,79,1300.0,658,47,146,240,386,24,53,80,175,260,584,0.4452054794520548,3,10,0.3,257,574,0.4477351916376306,0.448,135,175,0.7714285714285715
Tiago Splitter,splitti01,PF,28,SAS,2013,81,1997.0,838,130,144,371,515,63,64,100,161,315,563,0.5595026642984015,0,2,0.0,315,561,0.5614973262032086,0.56,208,285,0.7298245614035088
Jerry Stackhouse,stackje01,SF,38,BRK,2013,37,544.0,182,35,5,28,33,7,4,24,31,66,172,0.3837209302325581,30,89,0.3370786516853932,36,83,0.4337349397590361,0.471,20,23,0.8695652173913043
Lance Stephenson,stephla01,SG,22,IND,2013,78,2278.0,687,223,47,257,304,81,16,109,162,275,598,0.459866220735786,62,188,0.3297872340425531,213,410,0.5195121951219512,0.512,75,115,0.6521739130434783
DeShawn Stevenson,stevede01,SG,31,ATL,2013,56,1158.0,284,52,18,104,122,29,6,23,69,98,262,0.3740458015267175,76,209,0.3636363636363636,22,53,0.4150943396226415,0.519,12,23,0.5217391304347826
Greg Stiemsma,stiemgr01,C,27,MIN,2013,76,1209.0,307,30,61,200,261,44,90,59,184,127,278,0.4568345323741007,0,0,0.0,127,278,0.4568345323741007,0.457,53,69,0.7681159420289855
Julyan Stone,stoneju01,PG,24,DEN,2013,4,28.0,7,2,2,1,3,1,0,2,4,2,2,1.0,0,0,0.0,2,2,1.0,1.0,3,4,0.75
Amar'e Stoudemire,stoudam01,PF,30,NYK,2013,29,682.0,413,13,60,85,145,10,21,50,89,154,267,0.5767790262172284,0,0,0.0,154,267,0.5767790262172284,0.577,105,130,0.8076923076923077
Rodney Stuckey,stuckro01,SG,26,DET,2013,76,2171.0,876,270,43,169,212,51,17,134,127,304,748,0.4064171122994652,55,182,0.3021978021978022,249,566,0.4399293286219081,0.443,213,272,0.7830882352941176
Jared Sullinger,sullija01,PF,20,BOS,2013,45,892.0,270,35,92,172,264,22,22,29,154,111,225,0.4933333333333333,1,5,0.2,110,220,0.5,0.496,47,63,0.746031746031746
DaJuan Summers,summeda01,PF,25,LAC,2013,2,7.0,2,1,0,2,2,0,0,0,0,1,4,0.25,0,0,0.0,1,4,0.25,0.25,0,0,0.0
Jeff Taylor,tayloje03,SF,23,CHA,2013,77,1507.0,472,63,51,99,150,47,15,48,136,172,399,0.4310776942355889,53,154,0.3441558441558441,119,245,0.4857142857142857,0.497,75,103,0.7281553398058253
Tyshawn Taylor,tayloty01,PG,22,BRK,2013,38,221.0,85,21,2,16,18,13,0,25,25,32,87,0.367816091954023,6,13,0.4615384615384615,26,74,0.3513513513513513,0.402,15,27,0.5555555555555556
Jeff Teague,teaguje01,PG,24,ATL,2013,80,2628.0,1166,579,25,155,180,117,28,230,181,439,974,0.4507186858316221,89,248,0.3588709677419355,350,726,0.4820936639118457,0.496,199,226,0.8805309734513275
Marquis Teague,teaguma01,PG,19,CHI,2013,48,392.0,99,63,3,41,44,9,7,35,47,43,113,0.3805309734513274,4,23,0.1739130434782608,39,90,0.4333333333333333,0.398,9,16,0.5625
Mirza Teletović,teletmi01,PF,27,BRK,2013,53,499.0,188,23,33,62,95,13,8,20,53,71,185,0.3837837837837838,37,108,0.3425925925925926,34,77,0.4415584415584415,0.484,9,11,0.8181818181818182
Sebastian Telfair,telfase01,PG,27,TOT,2013,59,980.0,331,153,13,71,84,37,11,64,104,112,309,0.3624595469255663,53,150,0.3533333333333333,59,159,0.3710691823899371,0.448,54,69,0.782608695652174
Garrett Temple,templga01,SG,26,WAS,2013,51,1156.0,262,115,29,94,123,50,17,61,94,105,258,0.4069767441860465,26,80,0.325,79,178,0.4438202247191011,0.457,26,37,0.7027027027027027
Jason Terry,terryja01,SG,35,BOS,2013,79,2124.0,799,198,19,140,159,66,11,102,110,281,648,0.4336419753086419,123,331,0.3716012084592145,158,317,0.4984227129337539,0.529,114,131,0.8702290076335878
Hasheem Thabeet,thabeha01,C,25,OKC,2013,66,770.0,160,11,69,126,195,30,60,41,148,64,106,0.6037735849056604,0,0,0.0,64,106,0.6037735849056604,0.604,32,53,0.6037735849056604
Isaiah Thomas,thomais02,PG,23,SAC,2013,79,2122.0,1100,316,29,132,161,67,3,140,167,366,832,0.4399038461538461,115,321,0.3582554517133956,251,511,0.4911937377690802,0.509,253,287,0.8815331010452961
Kurt Thomas,thomaku01,PF,40,NYK,2013,39,392.0,97,21,24,65,89,10,16,8,52,45,83,0.5421686746987951,1,1,1.0,44,82,0.5365853658536586,0.548,6,13,0.4615384615384615
Lance Thomas,thomala01,SF,24,NOH,2013,59,646.0,149,17,44,71,115,11,7,14,78,53,106,0.5,0,0,0.0,53,106,0.5,0.5,43,59,0.7288135593220338
Malcolm Thomas,thomama01,PF,24,TOT,2013,12,57.0,15,4,5,11,16,2,2,3,8,5,10,0.5,0,0,0.0,5,10,0.5,0.5,5,8,0.625
Tyrus Thomas,thomaty01,PF,26,CHA,2013,26,360.0,125,19,16,44,60,14,15,17,51,48,136,0.3529411764705882,3,8,0.375,45,128,0.3515625,0.364,26,31,0.8387096774193549
Jason Thompson,thompja02,PF,26,SAC,2013,82,2285.0,891,84,172,377,549,48,61,101,227,374,745,0.5020134228187919,0,3,0.0,374,742,0.5040431266846361,0.502,143,206,0.6941747572815534
Klay Thompson,thompkl01,SG,22,GSW,2013,82,2936.0,1359,183,32,274,306,86,45,157,237,508,1205,0.4215767634854772,211,526,0.4011406844106464,297,679,0.4374079528718704,0.509,132,157,0.8407643312101911
Tristan Thompson,thomptr01,PF,21,CLE,2013,82,2564.0,957,108,306,467,773,60,71,123,234,390,799,0.4881101376720901,0,3,0.0,390,796,0.4899497487437186,0.488,177,291,0.6082474226804123
Marcus Thornton,thornma01,SG,25,SAC,2013,72,1726.0,916,91,50,131,181,61,4,68,105,332,774,0.4289405684754522,141,379,0.3720316622691293,191,395,0.4835443037974684,0.52,111,126,0.8809523809523809
Jamaal Tinsley,tinslja01,PG,34,UTA,2013,66,1221.0,229,290,17,98,115,64,14,106,106,86,234,0.3675213675213675,39,127,0.3070866141732283,47,107,0.4392523364485981,0.451,18,26,0.6923076923076923
Anthony Tolliver,tollian01,SF,27,ATL,2013,62,963.0,253,32,31,124,155,15,12,36,66,82,216,0.3796296296296296,45,133,0.3383458646616541,37,83,0.4457831325301205,0.484,44,51,0.8627450980392157
P.J. Tucker,tuckepj01,SG,27,PHO,2013,79,1910.0,506,109,132,218,350,62,19,67,145,210,444,0.4729729729729729,22,70,0.3142857142857143,188,374,0.5026737967914439,0.498,64,86,0.7441860465116279
Ronny Turiaf,turiaro01,C,30,LAC,2013,65,701.0,121,35,45,107,152,19,35,29,80,49,97,0.5051546391752577,0,0,0.0,49,97,0.5051546391752577,0.505,23,63,0.365079365079365
Hedo Türkoğlu,turkohe01,SF,33,ORL,2013,11,189.0,32,23,4,22,26,7,1,12,11,14,53,0.2641509433962264,1,24,0.0416666666666666,13,29,0.4482758620689655,0.274,3,6,0.5
Evan Turner,turneev01,SF,24,PHI,2013,82,2892.0,1094,354,56,461,517,71,17,187,197,441,1053,0.4188034188034188,58,159,0.3647798742138364,383,894,0.4284116331096196,0.446,154,208,0.7403846153846154
Jeremy Tyler,tylerje01,C,21,TOT,2013,21,68.0,22,1,6,14,20,1,2,6,10,9,24,0.375,0,0,0.0,9,24,0.375,0.375,4,6,0.6666666666666666
Ekpe Udoh,udohek01,C,25,MIL,2013,76,1312.0,323,43,113,138,251,39,85,43,139,117,269,0.4349442379182156,0,1,0.0,117,268,0.4365671641791044,0.435,89,119,0.7478991596638656
Beno Udrih,udrihbe01,SG-PG,30,TOT,2013,66,1457.0,538,302,34,107,141,41,3,108,90,210,476,0.4411764705882353,34,102,0.3333333333333333,176,374,0.4705882352941176,0.477,84,103,0.8155339805825242
Jonas Valančiūnas,valanjo01,C,20,TOR,2013,62,1482.0,554,45,121,251,372,17,78,94,188,204,366,0.5573770491803278,0,0,0.0,204,366,0.5573770491803278,0.557,146,185,0.7891891891891892
Anderson Varejão,varejan01,C,30,CLE,2013,25,901.0,353,84,138,223,361,37,14,44,68,138,289,0.4775086505190311,0,5,0.0,138,284,0.4859154929577465,0.478,77,102,0.7549019607843137
Jarvis Varnado,varnaja01,PF,24,TOT,2013,13,58.0,8,3,2,7,9,1,2,6,10,3,7,0.4285714285714285,0,0,0.0,3,7,0.4285714285714285,0.429,2,4,0.5
Greivis Vásquez,vasqugr01,PG,26,NOH,2013,78,2685.0,1083,704,43,294,337,66,6,247,190,438,1012,0.4328063241106719,83,243,0.3415637860082304,355,769,0.4616384915474642,0.474,124,154,0.8051948051948052
Jan Veselý,veselja01,PF,22,WAS,2013,51,601.0,126,28,43,79,122,15,17,27,107,57,114,0.5,0,1,0.0,57,113,0.504424778761062,0.5,12,39,0.3076923076923077
Charlie Villanueva,villach01,PF,28,DET,2013,69,1092.0,467,54,49,192,241,31,39,39,96,175,464,0.3771551724137931,90,259,0.3474903474903475,85,205,0.4146341463414634,0.474,27,49,0.5510204081632653
Nikola Vučević,vucevni01,C,22,ORL,2013,77,2559.0,1008,143,273,644,917,61,79,141,218,461,889,0.5185601799775028,0,3,0.0,461,886,0.5203160270880361,0.519,86,126,0.6825396825396826
Dwyane Wade,wadedw01,SG,31,MIA,2013,69,2391.0,1463,352,86,258,344,128,56,194,140,569,1093,0.5205855443732845,17,66,0.2575757575757575,552,1027,0.5374878286270691,0.528,308,425,0.7247058823529412
Dion Waiters,waitedi01,SG,21,CLE,2013,61,1756.0,894,183,22,127,149,59,16,121,113,336,815,0.4122699386503067,63,203,0.3103448275862069,273,612,0.446078431372549,0.451,159,213,0.7464788732394366
Kemba Walker,walkeke02,PG,22,CHA,2013,82,2859.0,1455,471,60,223,283,160,31,200,153,526,1244,0.4228295819935691,107,332,0.322289156626506,419,912,0.4594298245614035,0.466,296,371,0.7978436657681941
John Wall,walljo01,PG,22,WAS,2013,49,1602.0,906,373,35,161,196,65,37,157,117,324,735,0.4408163265306122,12,45,0.2666666666666666,312,690,0.4521739130434782,0.449,246,306,0.803921568627451
Gerald Wallace,wallage01,SF,30,BRK,2013,69,2076.0,531,181,69,250,319,97,46,110,118,182,458,0.3973799126637554,46,163,0.2822085889570552,136,295,0.4610169491525424,0.448,121,190,0.6368421052631579
Rasheed Wallace,wallara01,C,38,NYK,2013,21,296.0,146,6,11,72,83,13,15,10,40,55,142,0.3873239436619718,22,69,0.3188405797101449,33,73,0.4520547945205479,0.465,14,20,0.7
Luke Walton,waltolu01,PF,32,CLE,2013,50,857.0,172,166,38,107,145,42,13,60,98,71,181,0.3922651933701657,20,67,0.2985074626865671,51,114,0.4473684210526316,0.448,10,20,0.5
Hakim Warrick,warriha01,PF,30,TOT,2013,28,489.0,194,25,21,68,89,13,6,29,37,67,165,0.406060606060606,0,3,0.0,67,162,0.4135802469135802,0.406,60,88,0.6818181818181818
C.J. Watson,watsocj01,PG,28,BRK,2013,80,1521.0,543,161,38,107,145,66,12,69,123,192,459,0.4183006535947712,88,214,0.411214953271028,104,245,0.4244897959183673,0.514,71,91,0.7802197802197802
Earl Watson,watsoea01,PG,33,UTA,2013,48,829.0,96,190,23,64,87,40,8,69,94,37,120,0.3083333333333333,5,28,0.1785714285714285,32,92,0.3478260869565217,0.329,17,25,0.68
Maalik Wayns,waynsma01,PG,21,TOT,2013,27,202.0,76,27,1,6,7,6,0,15,26,26,88,0.2954545454545454,7,31,0.2258064516129032,19,57,0.3333333333333333,0.335,17,19,0.8947368421052632
Martell Webster,webstma02,SF,26,WAS,2013,76,2200.0,869,143,53,241,294,49,17,90,166,281,636,0.4418238993710692,139,329,0.4224924012158054,142,307,0.4625407166123778,0.551,168,198,0.8484848484848485
David West,westda01,PF,32,IND,2013,73,2435.0,1250,213,145,418,563,74,69,157,149,502,1009,0.4975222993062438,4,19,0.2105263157894736,498,990,0.503030303030303,0.5,242,315,0.7682539682539683
Russell Westbrook,westbru01,PG,24,OKC,2013,82,2861.0,1903,607,111,317,428,145,24,273,189,673,1535,0.4384364820846905,97,300,0.3233333333333333,576,1235,0.4663967611336032,0.47,460,575,0.8
D.J. White,whitedj01,PF,26,BOS,2013,12,86.0,29,4,4,9,13,1,6,2,5,12,23,0.5217391304347826,0,0,0.0,12,23,0.5217391304347826,0.522,5,9,0.5555555555555556
James White,whiteja02,SF,30,NYK,2013,57,435.0,125,29,5,43,48,13,4,17,44,50,116,0.4310344827586206,14,41,0.3414634146341463,36,75,0.48,0.491,11,19,0.5789473684210527
Chris Wilcox,wilcoch01,C,30,BOS,2013,61,830.0,259,22,55,125,180,32,28,34,125,110,153,0.7189542483660131,0,1,0.0,110,152,0.7236842105263158,0.719,39,58,0.6724137931034483
Damien Wilkins,wilkida02,SG,33,PHI,2013,61,1095.0,388,91,32,73,105,37,18,49,98,145,316,0.4588607594936709,17,51,0.3333333333333333,128,265,0.4830188679245283,0.486,81,109,0.7431192660550459
Deron Williams,willide01,PG,28,BRK,2013,78,2842.0,1476,604,29,203,232,75,30,218,194,495,1124,0.4403914590747331,169,447,0.378076062639821,326,677,0.4815361890694239,0.516,317,369,0.8590785907859079
Derrick Williams,willide02,PF,21,MIN,2013,78,1916.0,933,46,96,334,430,44,37,101,127,338,786,0.4300254452926209,65,196,0.3316326530612244,273,590,0.4627118644067796,0.471,192,272,0.7058823529411765
Lou Williams,willilo02,SG,26,ATL,2013,39,1119.0,551,139,8,72,80,44,10,74,55,187,443,0.4221218961625282,72,196,0.3673469387755102,115,247,0.4655870445344129,0.503,105,121,0.8677685950413223
Marvin Williams,willima02,SF,26,UTA,2013,73,1727.0,529,77,55,208,263,37,38,60,98,199,470,0.4234042553191489,54,166,0.3253012048192771,145,304,0.4769736842105263,0.481,77,99,0.7777777777777778
Mo Williams,willima01,PG,30,UTA,2013,46,1418.0,592,285,24,86,110,46,9,125,105,229,533,0.4296435272045028,59,154,0.3831168831168831,170,379,0.4485488126649076,0.485,75,85,0.8823529411764706
Reggie Williams,willire02,SF,26,CHA,2013,40,380.0,146,39,8,43,51,12,1,19,19,57,132,0.4318181818181818,22,72,0.3055555555555556,35,60,0.5833333333333334,0.515,10,21,0.4761904761904761
Terrence Williams,willite01,SF,25,BOS,2013,24,318.0,110,38,4,40,44,11,2,22,13,48,97,0.4948453608247423,5,15,0.3333333333333333,43,82,0.524390243902439,0.521,9,21,0.4285714285714285
Metta World Peace,artesro01,SF,33,LAL,2013,75,2530.0,929,112,101,271,372,122,42,98,198,332,824,0.4029126213592233,141,412,0.3422330097087379,191,412,0.4635922330097087,0.488,124,169,0.7337278106508875
Brandan Wright,wrighbr03,C,25,DAL,2013,64,1149.0,541,38,85,175,260,26,76,34,78,241,404,0.5965346534653465,0,3,0.0,241,401,0.600997506234414,0.597,59,96,0.6145833333333334
Chris Wright,wrighch02,SG,23,DAL,2013,3,4.0,2,0,0,0,0,0,0,1,0,1,2,0.5,0,0,0.0,1,2,0.5,0.5,0,0,0.0
Dorell Wright,wrighdo01,SF,27,PHI,2013,79,1783.0,729,150,42,260,302,62,35,64,98,237,599,0.3956594323873121,135,361,0.3739612188365651,102,238,0.4285714285714285,0.508,120,141,0.851063829787234
Tony Wroten,wroteto01,SG,19,MEM,2013,35,272.0,91,43,13,15,28,8,4,29,34,33,86,0.3837209302325581,4,16,0.25,29,70,0.4142857142857143,0.407,21,29,0.7241379310344828
Nick Young,youngni01,SG,27,PHI,2013,59,1411.0,628,84,24,106,130,36,14,50,84,224,542,0.4132841328413284,75,210,0.3571428571428571,149,332,0.4487951807228915,0.482,105,128,0.8203125
Sam Young,youngsa01,SG,27,IND,2013,56,693.0,155,42,26,97,123,15,8,33,62,58,148,0.3918918918918919,16,52,0.3076923076923077,42,96,0.4375,0.446,23,43,0.5348837209302325
Thaddeus Young,youngth01,PF,24,PHI,2013,76,2629.0,1127,125,182,389,571,133,55,90,191,509,958,0.5313152400835073,1,8,0.125,508,950,0.5347368421052632,0.532,108,188,0.574468085106383
Luke Zeller,zellelu01,C,25,PHO,2013,16,58.0,19,3,1,9,10,0,0,0,5,9,26,0.3461538461538461,1,5,0.2,8,21,0.3809523809523809,0.365,0,0,0.0
Tyler Zeller,zellety01,C,23,CLE,2013,77,2033.0,610,96,159,279,438,35,70,95,251,245,559,0.4382826475849731,0,4,0.0,245,555,0.4414414414414414,0.438,120,157,0.7643312101910829
Quincy Acy,acyqu01,SF,23,TOT,2014,63,847.0,171,28,72,144,216,23,26,30,122,66,141,0.4680851063829787,4,15,0.2666666666666666,62,126,0.492063492063492,0.482,35,53,0.660377358490566
Steven Adams,adamsst01,C,20,OKC,2014,81,1197.0,265,43,142,190,332,40,57,71,203,93,185,0.5027027027027027,0,0,0.0,93,185,0.5027027027027027,0.503,79,136,0.5808823529411765
Jeff Adrien,adrieje01,PF,27,TOT,2014,53,961.0,362,38,102,204,306,24,36,39,108,143,275,0.52,0,0,0.0,143,275,0.52,0.52,76,119,0.6386554621848739
Arron Afflalo,afflaar01,SG,28,ORL,2014,73,2552.0,1330,248,32,230,262,35,3,146,136,464,1011,0.4589515331355094,128,300,0.4266666666666667,336,711,0.4725738396624472,0.522,274,336,0.8154761904761905
Alexis Ajinça,ajincal01,C,25,NOP,2014,56,951.0,328,40,94,183,277,23,46,63,187,136,249,0.5461847389558233,0,1,0.0,136,248,0.5483870967741935,0.546,56,67,0.835820895522388
Cole Aldrich,aldrico01,C,25,NYK,2014,46,330.0,92,14,37,92,129,8,30,18,40,33,61,0.5409836065573771,0,0,0.0,33,61,0.5409836065573771,0.541,26,30,0.8666666666666667
LaMarcus Aldridge,aldrila01,PF,28,POR,2014,69,2498.0,1603,178,166,599,765,63,68,123,147,652,1423,0.4581869290231904,3,15,0.2,649,1408,0.4609375,0.459,296,360,0.8222222222222222
Lavoy Allen,allenla01,PF,24,TOT,2014,65,1072.0,303,71,119,192,311,24,33,44,126,134,300,0.4466666666666666,2,13,0.1538461538461538,132,287,0.4599303135888501,0.45,33,50,0.66
Ray Allen,allenra02,SG,38,MIA,2014,73,1936.0,701,143,23,182,205,54,8,84,115,240,543,0.4419889502762431,116,309,0.3754045307443365,124,234,0.5299145299145299,0.549,105,116,0.9051724137931034
Tony Allen,allento01,SG,32,MEM,2014,55,1278.0,495,94,79,129,208,90,19,90,121,204,413,0.4939467312348668,11,47,0.2340425531914893,193,366,0.5273224043715847,0.507,76,121,0.628099173553719
Al-Farouq Aminu,aminual01,SF,23,NOP,2014,80,2045.0,572,114,129,367,496,82,38,88,147,234,494,0.4736842105263157,13,48,0.2708333333333333,221,446,0.4955156950672645,0.487,91,137,0.6642335766423357
Lou Amundson,amundlo01,PF,31,TOT,2014,19,185.0,38,6,28,27,55,9,11,14,49,16,32,0.5,0,0,0.0,16,32,0.5,0.5,6,24,0.25
Chris Andersen,anderch01,C,35,MIA,2014,72,1396.0,477,19,129,250,379,32,97,53,162,177,275,0.6436363636363637,3,12,0.25,174,263,0.6615969581749049,0.649,120,169,0.7100591715976331
Alan Anderson,anderal01,SF,31,BRK,2014,78,1773.0,564,81,40,135,175,48,11,62,147,194,485,0.4,84,248,0.3387096774193548,110,237,0.4641350210970464,0.487,92,118,0.7796610169491526
James Anderson,anderja01,SG,24,PHI,2014,80,2309.0,810,149,59,241,300,74,28,106,154,309,717,0.4309623430962343,115,351,0.3276353276353276,194,366,0.5300546448087432,0.511,77,106,0.7264150943396226
Ryan Anderson,anderry01,PF,25,NOP,2014,22,795.0,436,17,66,76,142,10,7,20,47,155,354,0.4378531073446328,67,164,0.4085365853658536,88,190,0.4631578947368421,0.532,59,62,0.9516129032258064
Giannis Antetokounmpo,antetgi01,SF,19,MIL,2014,77,1897.0,525,150,78,261,339,60,61,122,173,173,418,0.4138755980861244,41,118,0.3474576271186441,132,300,0.44,0.463,138,202,0.6831683168316832
Carmelo Anthony,anthoca01,PF,29,NYK,2014,77,2982.0,2112,242,145,477,622,95,51,198,224,743,1643,0.4522215459525259,167,415,0.4024096385542168,576,1228,0.4690553745928338,0.503,459,541,0.8484288354898336
Joel Anthony,anthojo01,C,31,TOT,2014,33,186.0,28,2,15,23,38,3,12,3,17,12,32,0.375,0,0,0.0,12,32,0.375,0.375,4,8,0.5
Pero Antić,anticpe01,C,31,ATL,2014,50,925.0,352,58,57,152,209,19,12,55,126,123,294,0.4183673469387755,56,171,0.327485380116959,67,123,0.5447154471544715,0.514,50,66,0.7575757575757576
Trevor Ariza,arizatr01,SF,28,WAS,2014,77,2723.0,1107,191,99,376,475,126,20,132,179,389,853,0.4560375146541617,180,442,0.4072398190045249,209,411,0.5085158150851582,0.562,149,193,0.772020725388601
Hilton Armstrong,armsthi01,C,29,GSW,2014,15,97.0,25,5,19,28,47,4,4,6,11,9,19,0.4736842105263157,0,0,0.0,9,19,0.4736842105263157,0.474,7,16,0.4375
Darrell Arthur,arthuda01,SF,25,DEN,2014,68,1161.0,401,61,52,158,210,39,47,58,185,162,410,0.3951219512195122,24,64,0.375,138,346,0.3988439306358382,0.424,53,62,0.8548387096774194
Ömer Aşık,asikom01,C,27,HOU,2014,48,968.0,280,25,101,277,378,14,37,59,92,101,190,0.531578947368421,0,0,0.0,101,190,0.531578947368421,0.532,78,126,0.6190476190476191
D.J. Augustin,augusdj01,PG,26,TOT,2014,71,1939.0,930,313,15,115,130,53,3,125,147,298,718,0.415041782729805,133,332,0.4006024096385542,165,386,0.4274611398963731,0.508,201,227,0.8854625550660793
Gustavo Ayón,ayongu01,C,28,ATL,2014,26,429.0,112,28,42,83,125,25,10,29,47,52,102,0.5098039215686274,0,0,0.0,52,102,0.5098039215686274,0.51,8,20,0.4
Jeff Ayres,pendeje02,PF,26,SAS,2014,73,952.0,240,60,89,169,258,13,25,63,146,101,174,0.5804597701149425,0,0,0.0,101,174,0.5804597701149425,0.58,38,55,0.6909090909090909
Chris Babb,babbch01,SG,23,BOS,2014,14,132.0,22,3,4,13,17,6,0,3,13,8,30,0.2666666666666666,6,27,0.2222222222222222,2,3,0.6666666666666666,0.367,0,0,0.0
Luke Babbitt,babbilu01,PF,24,NOP,2014,27,473.0,170,29,18,70,88,7,11,15,52,60,154,0.3896103896103896,36,95,0.3789473684210526,24,59,0.4067796610169492,0.506,14,18,0.7777777777777778
Leandro Barbosa,barbole01,PG,31,PHO,2014,20,368.0,150,32,5,32,37,7,4,19,30,56,131,0.4274809160305343,7,25,0.28,49,106,0.4622641509433962,0.454,31,39,0.7948717948717948
J.J. Barea,bareajo01,PG,29,MIN,2014,79,1471.0,660,303,16,138,154,26,0,125,129,254,656,0.3871951219512195,73,231,0.316017316017316,181,425,0.4258823529411765,0.443,79,100,0.79
Andrea Bargnani,bargnan01,C,28,NYK,2014,42,1257.0,558,45,69,153,222,14,52,58,100,222,502,0.4422310756972111,30,108,0.2777777777777778,192,394,0.4873096446700508,0.472,84,102,0.8235294117647058
Harrison Barnes,barneha02,SF,21,GSW,2014,78,2204.0,738,116,66,245,311,65,20,84,158,271,679,0.3991163475699558,66,190,0.3473684210526316,205,489,0.4192229038854805,0.448,130,181,0.7182320441988951
Matt Barnes,barnema02,SF,33,LAC,2014,63,1735.0,625,125,60,232,292,56,28,85,185,231,527,0.4383301707779886,97,283,0.342756183745583,134,244,0.5491803278688525,0.53,66,90,0.7333333333333333
Will Barton,bartowi01,SG,23,POR,2014,41,387.0,166,33,16,58,74,9,7,18,31,65,156,0.4166666666666667,10,33,0.303030303030303,55,123,0.4471544715447154,0.449,26,32,0.8125
Brandon Bass,bassbr01,PF,28,BOS,2014,82,2266.0,911,87,161,309,470,36,71,102,190,352,725,0.4855172413793103,2,6,0.3333333333333333,350,719,0.4867872044506258,0.487,205,239,0.8577405857740585
Shane Battier,battish01,SF,35,MIA,2014,73,1468.0,298,63,34,104,138,50,39,21,124,105,275,0.3818181818181818,73,210,0.3476190476190476,32,65,0.4923076923076923,0.515,15,23,0.6521739130434783
Nicolas Batum,batumni01,SF,25,POR,2014,82,2956.0,1070,420,116,495,611,75,57,208,156,381,819,0.4652014652014652,145,402,0.3606965174129353,236,417,0.565947242206235,0.554,163,203,0.8029556650246306
Jerryd Bayless,bayleje01,PG,25,TOT,2014,72,1686.0,666,194,22,123,145,60,9,82,161,248,617,0.4019448946515397,76,212,0.3584905660377358,172,405,0.4246913580246914,0.464,94,118,0.7966101694915254
Aron Baynes,baynear01,C,27,SAS,2014,53,491.0,161,34,57,88,145,2,5,36,77,71,163,0.4355828220858895,0,0,0.0,71,163,0.4355828220858895,0.436,19,21,0.9047619047619048
Kent Bazemore,bazemke01,SG,24,TOT,2014,67,911.0,403,91,10,107,117,43,13,79,102,147,343,0.4285714285714285,43,128,0.3359375,104,215,0.4837209302325581,0.491,66,109,0.6055045871559633
Bradley Beal,bealbr01,SG,20,WAS,2014,73,2530.0,1249,243,54,219,273,71,18,128,153,481,1149,0.4186248912097476,138,343,0.4023323615160349,343,806,0.4255583126550868,0.479,149,189,0.7883597883597884
Michael Beasley,beaslmi01,SF,25,MIA,2014,55,831.0,436,42,31,141,172,23,21,57,93,177,355,0.4985915492957746,21,54,0.3888888888888889,156,301,0.5182724252491694,0.528,61,79,0.7721518987341772
Marco Belinelli,belinma01,SF,27,SAS,2014,80,2016.0,911,179,18,208,226,50,7,95,130,337,695,0.4848920863309353,126,293,0.4300341296928328,211,402,0.5248756218905473,0.576,111,131,0.8473282442748091
Anthony Bennett,bennean01,PF,20,CLE,2014,52,663.0,217,17,49,106,155,21,8,47,93,80,225,0.3555555555555555,13,53,0.2452830188679245,67,172,0.3895348837209302,0.384,44,69,0.6376811594202898
Patrick Beverley,beverpa01,PG,25,HOU,2014,56,1751.0,573,151,72,124,196,77,23,66,174,199,481,0.4137214137214137,92,255,0.3607843137254902,107,226,0.4734513274336283,0.509,83,102,0.8137254901960784
Andris Biedriņš,biedran01,C,27,UTA,2014,6,45.0,3,0,2,15,17,0,0,2,6,1,1,1.0,0,0,0.0,1,1,1.0,1.0,1,6,0.1666666666666666
Chauncey Billups,billuch01,SG,37,DET,2014,19,309.0,72,42,4,24,28,8,1,25,25,24,79,0.3037974683544304,14,48,0.2916666666666667,10,31,0.3225806451612903,0.392,10,12,0.8333333333333334
Bismack Biyombo,biyombi01,C,21,CHA,2014,77,1072.0,222,8,105,261,366,7,86,40,124,88,144,0.6111111111111112,0,0,0.0,88,144,0.6111111111111112,0.611,46,89,0.5168539325842697
DeJuan Blair,blairde01,PF,24,DAL,2014,78,1214.0,497,70,139,229,368,60,21,77,192,210,393,0.5343511450381679,0,2,0.0,210,391,0.5370843989769821,0.534,77,121,0.6363636363636364
Steve Blake,blakest01,PG,33,TOT,2014,55,1498.0,378,307,13,146,159,54,8,102,85,133,353,0.376770538243626,79,210,0.3761904761904762,54,143,0.3776223776223776,0.489,33,43,0.7674418604651163
Andray Blatche,blatcan01,PF,27,BRK,2014,73,1618.0,821,112,120,270,390,75,38,110,166,321,674,0.4762611275964392,15,54,0.2777777777777778,306,620,0.4935483870967742,0.487,164,221,0.7420814479638009
Eric Bledsoe,bledser01,PG,24,PHO,2014,43,1416.0,763,235,27,175,202,69,14,143,99,265,556,0.4766187050359712,50,140,0.3571428571428571,215,416,0.5168269230769231,0.522,183,237,0.7721518987341772
Vander Blue,blueva01,SG,21,BOS,2014,3,15.0,5,1,0,3,3,0,0,2,1,2,4,0.5,0,1,0.0,2,3,0.6666666666666666,0.5,1,5,0.2
Keith Bogans,boganke01,SG,33,BOS,2014,6,55.0,12,3,0,3,3,1,0,1,2,3,6,0.5,3,6,0.5,0,0,0.0,0.75,3,3,1.0
Andrew Bogut,bogutan01,C,29,GSW,2014,67,1769.0,492,112,182,489,671,47,121,97,210,235,375,0.6266666666666667,0,0,0.0,235,375,0.6266666666666667,0.627,22,64,0.34375
Matt Bonner,bonnema01,PF,33,SAS,2014,61,690.0,197,31,16,114,130,15,11,16,49,73,164,0.4451219512195122,42,98,0.4285714285714285,31,66,0.4696969696969697,0.573,9,12,0.75
Trevor Booker,booketr01,PF,26,WAS,2014,72,1553.0,491,64,149,230,379,41,45,58,131,222,403,0.5508684863523573,0,2,0.0,222,401,0.5536159600997507,0.551,47,76,0.618421052631579
Carlos Boozer,boozeca01,PF,32,CHI,2014,76,2141.0,1042,118,137,495,632,53,22,154,216,447,980,0.4561224489795918,0,2,0.0,447,978,0.4570552147239264,0.456,148,193,0.7668393782383419
Chris Bosh,boshch01,C,29,MIA,2014,79,2531.0,1281,87,98,424,522,80,78,125,192,492,953,0.5162644281217209,74,218,0.3394495412844037,418,735,0.5687074829931973,0.555,223,272,0.8198529411764706
Avery Bradley,bradlav01,SG,23,BOS,2014,60,1855.0,891,85,48,178,226,63,11,96,145,361,825,0.4375757575757575,79,200,0.395,282,625,0.4512,0.485,90,112,0.8035714285714286
Elton Brand,brandel01,C,34,ATL,2014,73,1414.0,419,74,97,264,361,40,88,60,192,179,332,0.5391566265060241,0,2,0.0,179,330,0.5424242424242425,0.539,61,94,0.648936170212766
Corey Brewer,breweco01,SF,27,MIN,2014,81,2609.0,998,135,63,144,207,151,30,105,210,388,807,0.4807930607187112,59,211,0.2796208530805687,329,596,0.552013422818792,0.517,163,227,0.7180616740088106
Ronnie Brewer,brewero02,SF,28,TOT,2014,24,160.0,7,10,2,12,14,6,1,2,4,3,15,0.2,1,8,0.125,2,7,0.2857142857142857,0.233,0,2,0.0
Aaron Brooks,brookaa01,PG,29,TOT,2014,72,1557.0,645,233,43,97,140,52,13,117,146,233,581,0.4010327022375215,96,248,0.3870967741935484,137,333,0.4114114114114114,0.484,83,95,0.8736842105263158
MarShon Brooks,brookma01,SG,25,TOT,2014,35,316.0,159,25,10,44,54,14,4,24,21,57,125,0.456,13,25,0.52,44,100,0.44,0.508,32,44,0.7272727272727273
Lorenzo Brown,brownlo01,PG,23,PHI,2014,26,224.0,64,41,8,20,28,13,3,16,19,26,86,0.3023255813953488,3,30,0.1,23,56,0.4107142857142857,0.32,9,13,0.6923076923076923
Shannon Brown,brownsh01,SG,28,TOT,2014,29,251.0,63,9,7,21,28,13,0,18,24,24,66,0.3636363636363636,0,2,0.0,24,64,0.375,0.364,15,21,0.7142857142857143
Kobe Bryant,bryanko01,SG,35,LAL,2014,6,177.0,83,38,2,24,26,7,1,34,9,31,73,0.4246575342465753,3,16,0.1875,28,57,0.4912280701754385,0.445,18,21,0.8571428571428571
Chase Budinger,budinch01,SF,25,MIN,2014,41,751.0,274,31,19,84,103,19,2,24,58,100,254,0.3937007874015748,42,120,0.35,58,134,0.4328358208955223,0.476,32,39,0.8205128205128205
Reggie Bullock,bullore01,SF,22,LAC,2014,43,395.0,115,12,11,43,54,9,1,13,26,43,121,0.3553719008264462,22,73,0.3013698630136986,21,48,0.4375,0.446,7,9,0.7777777777777778
Trey Burke,burketr01,PG,21,UTA,2014,70,2262.0,895,396,37,171,208,42,6,131,145,341,897,0.3801560758082497,111,336,0.3303571428571428,230,561,0.409982174688057,0.442,102,113,0.9026548672566372
Alec Burks,burksal01,SG,22,UTA,2014,78,2193.0,1089,212,59,198,257,69,14,149,190,380,831,0.457280385078219,50,143,0.3496503496503496,330,688,0.4796511627906977,0.487,279,373,0.7479892761394102
Caron Butler,butleca01,SF,33,TOT,2014,56,1419.0,587,82,21,208,229,47,17,60,120,213,540,0.3944444444444444,98,249,0.393574297188755,115,291,0.3951890034364261,0.485,63,75,0.84
Jimmy Butler,butleji01,SG,24,CHI,2014,67,2591.0,878,175,87,243,330,127,36,102,106,275,693,0.3968253968253968,68,240,0.2833333333333333,207,453,0.4569536423841059,0.446,260,338,0.7692307692307693
Rasual Butler,butlera01,SG,34,IND,2014,50,378.0,136,17,6,35,41,7,9,11,30,51,110,0.4636363636363636,26,62,0.4193548387096774,25,48,0.5208333333333334,0.582,8,14,0.5714285714285714
Dwight Buycks,buyckdw01,PG,24,TOR,2014,14,146.0,43,10,4,19,23,8,0,10,11,15,48,0.3125,5,17,0.2941176470588235,10,31,0.3225806451612903,0.365,8,9,0.8888888888888888
Andrew Bynum,bynuman01,C,26,TOT,2014,26,516.0,225,29,53,92,145,6,29,34,31,94,225,0.4177777777777778,0,0,0.0,94,225,0.4177777777777778,0.418,37,49,0.7551020408163265
Will Bynum,bynumwi01,PG,31,DET,2014,56,1054.0,485,216,24,75,99,39,7,103,121,184,430,0.427906976744186,20,62,0.3225806451612903,164,368,0.4456521739130434,0.451,97,121,0.8016528925619835
Nick Calathes,calatni01,SG,24,MEM,2014,71,1173.0,347,207,23,114,137,66,8,101,117,142,311,0.4565916398713826,19,61,0.3114754098360656,123,250,0.492,0.487,44,72,0.6111111111111112
José Calderón,caldejo01,PG,32,DAL,2014,81,2468.0,925,377,29,163,192,69,11,103,136,341,748,0.4558823529411764,191,425,0.4494117647058823,150,323,0.4643962848297213,0.584,52,63,0.8253968253968254
Kentavious Caldwell-Pope,caldwke01,SG,20,DET,2014,80,1583.0,470,55,38,118,156,75,12,28,145,182,460,0.3956521739130434,59,185,0.3189189189189189,123,275,0.4472727272727272,0.46,47,61,0.7704918032786885
Isaiah Canaan,canaais01,PG,22,HOU,2014,22,252.0,101,22,7,17,24,8,4,21,25,31,87,0.3563218390804598,18,55,0.3272727272727272,13,32,0.40625,0.46,21,29,0.7241379310344828
DeMarre Carroll,carrode01,SF,27,ATL,2014,73,2341.0,810,134,107,296,403,108,21,79,188,302,642,0.470404984423676,97,268,0.3619402985074627,205,374,0.5481283422459893,0.546,109,141,0.7730496453900709
Vince Carter,cartevi01,SG,37,DAL,2014,81,1973.0,967,212,67,217,284,61,35,108,209,330,811,0.406905055487053,146,371,0.3935309973045822,184,440,0.4181818181818181,0.497,161,196,0.8214285714285714
Michael Carter-Williams,cartemi01,PG,22,PHI,2014,70,2414.0,1167,441,101,336,437,130,43,247,213,427,1054,0.405123339658444,55,208,0.2644230769230769,372,846,0.4397163120567376,0.431,258,367,0.7029972752043597
Omri Casspi,casspom01,PF,25,HOU,2014,71,1283.0,490,88,55,205,260,44,14,72,100,173,410,0.4219512195121951,61,176,0.3465909090909091,112,234,0.4786324786324786,0.496,83,122,0.680327868852459
Mario Chalmers,chalmma01,PG,27,MIA,2014,73,2178.0,716,357,41,173,214,119,16,162,210,254,560,0.4535714285714285,87,226,0.3849557522123893,167,334,0.5,0.531,121,163,0.7423312883435583
Tyson Chandler,chandty01,C,31,NYK,2014,55,1662.0,480,59,159,370,529,36,63,71,145,191,322,0.593167701863354,0,1,0.0,191,321,0.5950155763239875,0.593,98,155,0.632258064516129
Wilson Chandler,chandwi01,SF,26,DEN,2014,62,1927.0,846,114,58,236,294,46,31,79,193,307,738,0.4159891598915989,122,351,0.3475783475783476,185,387,0.4780361757105943,0.499,110,152,0.7236842105263158
Josh Childress,childjo01,SF,30,NOP,2014,4,24.0,0,2,0,3,3,1,0,1,1,0,0,0.0,0,0,0.0,0,0,0.0,0.0,0,0,0.0
Dionte Christmas,chrisdi01,SF,27,PHO,2014,31,198.0,71,8,13,25,38,2,3,6,19,22,62,0.3548387096774194,9,31,0.2903225806451613,13,31,0.4193548387096774,0.427,18,24,0.75
Earl Clark,clarkea01,PF,26,TOT,2014,54,768.0,257,18,22,121,143,17,25,31,67,97,261,0.3716475095785441,41,122,0.3360655737704918,56,139,0.4028776978417266,0.45,22,34,0.6470588235294118
Ian Clark,clarkia01,SG,22,UTA,2014,23,172.0,68,15,3,16,19,8,2,14,24,26,67,0.3880597014925373,11,31,0.3548387096774194,15,36,0.4166666666666667,0.47,5,7,0.7142857142857143
Victor Claver,clavevi01,SF,25,POR,2014,21,184.0,47,12,9,30,39,3,3,11,16,17,42,0.4047619047619047,3,18,0.1666666666666666,14,24,0.5833333333333334,0.44,10,11,0.9090909090909092
Norris Cole,coleno01,PG,25,MIA,2014,82,2014.0,527,248,17,143,160,77,5,127,156,207,500,0.414,60,174,0.3448275862068966,147,326,0.450920245398773,0.474,53,68,0.7794117647058824
Jason Collins,collija04,C,35,BRK,2014,22,172.0,25,4,7,12,19,8,1,7,30,11,24,0.4583333333333333,0,3,0.0,11,21,0.5238095238095238,0.458,3,4,0.75
Darren Collison,collida01,PG,26,LAC,2014,80,2069.0,911,297,47,141,188,93,15,132,150,324,694,0.4668587896253602,71,189,0.3756613756613756,253,505,0.500990099009901,0.518,192,224,0.8571428571428571
Nick Collison,collini01,PF,33,OKC,2014,81,1353.0,338,104,116,177,293,30,28,71,187,134,241,0.5560165975103735,4,17,0.2352941176470588,130,224,0.5803571428571429,0.564,66,93,0.7096774193548387
Mike Conley,conlemi01,PG,26,MEM,2014,73,2446.0,1256,441,41,172,213,110,13,150,141,463,1030,0.4495145631067961,105,291,0.3608247422680412,358,739,0.4844384303112314,0.5,225,276,0.8152173913043478
Chris Copeland,copelch01,SF,29,IND,2014,41,265.0,153,18,7,25,32,3,7,14,38,55,117,0.4700854700854701,33,79,0.4177215189873418,22,38,0.5789473684210527,0.611,10,14,0.7142857142857143
DeMarcus Cousins,couside01,C,23,SAC,2014,71,2298.0,1614,207,218,613,831,109,91,251,270,591,1191,0.4962216624685138,0,7,0.0,591,1184,0.4991554054054054,0.496,432,595,0.7260504201680672
Robert Covington,covinro01,SF,23,HOU,2014,7,34.0,16,0,2,3,5,2,0,1,3,6,14,0.4285714285714285,4,11,0.3636363636363636,2,3,0.6666666666666666,0.571,0,0,0.0
Allen Crabbe,crabbal01,SG,21,POR,2014,15,100.0,33,6,1,8,9,2,1,3,10,12,33,0.3636363636363636,6,14,0.4285714285714285,6,19,0.3157894736842105,0.455,3,4,0.75
Jamal Crawford,crawfja01,SG,33,LAC,2014,69,2094.0,1282,223,34,124,158,59,12,135,120,421,1011,0.4164193867457962,161,446,0.3609865470852018,260,565,0.4601769911504424,0.496,279,322,0.8664596273291926
Jordan Crawford,crawfjo02,SG-PG,25,TOT,2014,81,1859.0,890,281,28,155,183,47,5,134,120,327,788,0.4149746192893401,90,285,0.3157894736842105,237,503,0.4711729622266402,0.472,146,169,0.863905325443787
Jae Crowder,crowdja01,SF,23,DAL,2014,78,1254.0,356,60,46,148,194,59,21,41,100,130,296,0.4391891891891892,50,151,0.3311258278145695,80,145,0.5517241379310345,0.524,46,61,0.7540983606557377
Dante Cunningham,cunnida01,PF,26,MIN,2014,81,1635.0,510,83,112,218,330,62,58,42,146,236,509,0.4636542239685658,0,5,0.0,236,504,0.4682539682539682,0.464,38,67,0.5671641791044776
Jared Cunningham,cunnija01,SG,22,TOT,2014,13,80.0,26,8,1,5,6,3,0,2,16,6,21,0.2857142857142857,1,7,0.1428571428571428,5,14,0.3571428571428571,0.31,13,16,0.8125
Seth Curry,curryse01,PG,23,TOT,2014,2,13.0,3,0,0,1,1,2,0,0,0,1,3,0.3333333333333333,1,1,1.0,0,2,0.0,0.5,0,0,0.0
Stephen Curry,curryst01,PG,25,GSW,2014,78,2846.0,1873,666,46,288,334,128,14,294,194,652,1383,0.4714389009399855,261,615,0.424390243902439,391,768,0.5091145833333334,0.566,308,348,0.8850574712643678
Samuel Dalembert,dalemsa01,C,32,DAL,2014,80,1614.0,529,38,200,341,541,41,94,90,210,214,377,0.5676392572944297,0,1,0.0,214,376,0.5691489361702128,0.568,101,137,0.7372262773722628
Troy Daniels,danietr01,SG,22,HOU,2014,5,75.0,42,5,0,4,4,0,0,3,6,15,31,0.4838709677419355,12,25,0.48,3,6,0.5,0.677,0,0,0.0
Gigi Datome,datomlu01,SF,26,DET,2014,34,238.0,83,11,14,32,46,6,1,11,20,34,97,0.3505154639175257,7,39,0.1794871794871795,27,58,0.4655172413793103,0.387,8,10,0.8
Brandon Davies,daviebr01,PF,22,PHI,2014,51,575.0,144,28,38,71,109,24,8,35,92,54,128,0.421875,2,10,0.2,52,118,0.4406779661016949,0.43,34,53,0.6415094339622641
Anthony Davis,davisan02,PF,20,NOP,2014,67,2358.0,1394,105,207,466,673,89,189,109,200,522,1005,0.5194029850746269,2,9,0.2222222222222222,520,996,0.5220883534136547,0.52,348,440,0.7909090909090909
Ed Davis,davised01,PF,24,MEM,2014,63,956.0,357,27,92,168,260,17,43,40,114,155,290,0.5344827586206896,0,0,0.0,155,290,0.5344827586206896,0.534,47,89,0.5280898876404494
Glen Davis,davisgl01,PF,28,TOT,2014,68,1662.0,641,77,108,243,351,58,29,76,159,271,593,0.4569983136593591,4,11,0.3636363636363636,267,582,0.4587628865979381,0.46,95,137,0.6934306569343066
Austin Daye,dayeau01,SF,25,TOT,2014,22,148.0,66,8,5,22,27,4,4,5,18,24,68,0.3529411764705882,12,37,0.3243243243243243,12,31,0.3870967741935484,0.441,6,10,0.6
Nando De Colo,decolna01,SF,26,TOT,2014,47,494.0,177,65,14,59,73,22,6,35,48,64,153,0.4183006535947712,18,53,0.3396226415094339,46,100,0.46,0.477,31,35,0.8857142857142857
Dewayne Dedmon,dedmode01,C,24,TOT,2014,31,390.0,97,5,38,89,127,7,22,18,66,38,83,0.4578313253012048,0,0,0.0,38,83,0.4578313253012048,0.458,21,32,0.65625
Matthew Dellavedova,dellama01,SG,23,CLE,2014,72,1271.0,339,187,29,94,123,33,5,60,121,122,296,0.4121621621621621,57,155,0.3677419354838709,65,141,0.4609929078014184,0.508,38,48,0.7916666666666666
Luol Deng,denglu01,SF,28,TOT,2014,63,2213.0,1011,183,99,262,361,62,9,114,111,371,860,0.4313953488372093,57,189,0.3015873015873015,314,671,0.4679582712369597,0.465,212,268,0.7910447761194029
DeMar DeRozan,derozde01,SG,24,TOR,2014,79,3017.0,1791,313,51,292,343,86,28,176,197,604,1407,0.4292821606254442,64,210,0.3047619047619048,540,1197,0.4511278195488721,0.452,519,630,0.8238095238095238
Boris Diaw,diawbo01,PF,31,SAS,2014,79,1974.0,717,222,74,252,326,44,32,121,140,302,580,0.5206896551724138,45,112,0.4017857142857143,257,468,0.5491452991452992,0.559,68,92,0.7391304347826086
Gorgui Dieng,dienggo01,C,24,MIN,2014,60,818.0,286,39,103,197,300,30,50,54,108,113,227,0.4977973568281938,1,1,1.0,112,226,0.495575221238938,0.5,59,93,0.6344086021505376
Toney Douglas,douglto01,PG,27,TOT,2014,51,675.0,202,68,18,69,87,19,5,34,81,73,190,0.3842105263157894,31,102,0.3039215686274509,42,88,0.4772727272727273,0.466,25,34,0.7352941176470589
Chris Douglas-Roberts,douglch01,SF,27,CHA,2014,49,1016.0,339,51,16,103,119,29,16,36,61,111,252,0.4404761904761904,51,132,0.3863636363636363,60,120,0.5,0.542,66,82,0.8048780487804879
Goran Dragić,dragigo01,SG,27,PHO,2014,76,2668.0,1542,447,69,176,245,104,22,213,206,552,1093,0.505032021957914,122,299,0.4080267558528428,430,794,0.5415617128463476,0.561,316,416,0.7596153846153846
Andre Drummond,drumman01,C,20,DET,2014,81,2619.0,1095,35,440,631,1071,101,131,110,273,479,769,0.6228868660598179,0,2,0.0,479,767,0.6245110821382008,0.623,137,328,0.4176829268292683
Jared Dudley,dudleja01,SF,28,LAC,2014,74,1729.0,511,104,36,124,160,41,10,56,146,196,447,0.4384787472035794,81,225,0.36,115,222,0.5180180180180181,0.529,38,58,0.6551724137931034
Tim Duncan,duncati01,C,37,SAS,2014,74,2158.0,1119,220,158,563,721,43,139,159,134,444,906,0.4900662251655629,0,5,0.0,444,901,0.4927857935627081,0.49,231,316,0.7310126582278481
Mike Dunleavy,dunlemi02,SF,33,CHI,2014,82,2584.0,929,186,46,299,345,64,46,108,163,333,774,0.4302325581395348,123,324,0.3796296296296296,210,450,0.4666666666666667,0.51,140,164,0.8536585365853658
Kevin Durant,duranke01,SF,25,OKC,2014,81,3122.0,2593,445,58,540,598,103,59,285,174,849,1688,0.5029620853080569,192,491,0.3910386965376782,657,1197,0.5488721804511278,0.56,703,805,0.8732919254658386
Shane Edwards,edwarsh01,SF,26,CLE,2014,2,12.0,2,0,1,1,2,0,0,1,1,1,3,0.3333333333333333,0,0,0.0,1,3,0.3333333333333333,0.333,0,0,0.0
Wayne Ellington,ellinwa01,SG,26,DAL,2014,45,393.0,145,19,8,35,43,16,2,11,33,55,126,0.4365079365079365,25,59,0.423728813559322,30,67,0.4477611940298507,0.536,10,11,0.9090909090909092
Monta Ellis,ellismo01,SG,28,DAL,2014,82,3023.0,1560,471,38,257,295,141,23,264,197,576,1278,0.4507042253521127,69,209,0.3301435406698564,507,1069,0.4742750233863423,0.478,339,430,0.7883720930232558
Melvin Ely,elyme01,C,35,NOP,2014,2,27.0,6,0,0,1,1,0,1,0,5,3,6,0.5,0,0,0.0,3,6,0.5,0.5,0,0,0.0
Jeremy Evans,evansje01,SF,26,UTA,2014,66,1209.0,401,44,120,190,310,42,46,40,139,175,332,0.5271084337349398,0,2,0.0,175,330,0.5303030303030303,0.527,51,75,0.68
Reggie Evans,evansre01,PF,33,TOT,2014,54,899.0,214,21,115,219,334,37,3,58,119,71,150,0.4733333333333333,0,0,0.0,71,150,0.4733333333333333,0.473,72,130,0.5538461538461539
Tyreke Evans,evansty01,SF,24,NOP,2014,72,2028.0,1042,363,76,265,341,84,21,175,155,391,897,0.4358974358974359,21,95,0.2210526315789473,370,802,0.4613466334164589,0.448,239,310,0.7709677419354839
Kenneth Faried,farieke01,PF,24,DEN,2014,80,2178.0,1096,96,238,446,684,70,69,135,193,447,820,0.5451219512195122,0,3,0.0,447,817,0.5471236230110159,0.545,202,311,0.6495176848874598
Jordan Farmar,farmajo01,PG,27,LAL,2014,41,912.0,416,199,20,84,104,38,8,95,65,151,364,0.4148351648351648,70,160,0.4375,81,204,0.3970588235294117,0.511,44,59,0.7457627118644068
Vítor Luiz Faverani,favervi01,C,25,BOS,2014,37,488.0,164,16,42,86,128,14,27,41,74,64,147,0.4353741496598639,12,40,0.3,52,107,0.4859813084112149,0.476,24,37,0.6486486486486487
Derrick Favors,favorde01,PF,22,UTA,2014,73,2201.0,970,91,199,438,637,75,108,129,236,390,747,0.5220883534136547,0,1,0.0,390,746,0.5227882037533512,0.522,190,284,0.6690140845070423
Carrick Felix,felixca01,SG,23,CLE,2014,7,38.0,19,4,1,5,6,0,0,4,4,7,14,0.5,2,5,0.4,5,9,0.5555555555555556,0.571,3,4,0.75
Raymond Felton,feltora01,PG,29,NYK,2014,65,2017.0,630,365,54,143,197,78,27,129,157,240,608,0.3947368421052631,62,195,0.3179487179487179,178,413,0.4309927360774818,0.446,88,122,0.7213114754098361
Landry Fields,fieldla01,SF,25,TOR,2014,30,322.0,68,20,15,44,59,10,3,11,25,27,67,0.4029850746268656,0,5,0.0,27,62,0.4354838709677419,0.403,14,22,0.6363636363636364
Derek Fisher,fishede01,SG,39,OKC,2014,81,1428.0,425,117,12,110,122,70,3,49,157,141,361,0.3905817174515235,88,229,0.3842794759825327,53,132,0.4015151515151515,0.512,55,71,0.7746478873239436
Evan Fournier,fournev01,SG,21,DEN,2014,76,1503.0,638,112,34,168,202,34,7,100,179,228,544,0.4191176470588235,89,237,0.3755274261603376,139,307,0.4527687296416938,0.501,93,123,0.7560975609756098
Randy Foye,foyera01,SG,30,DEN,2014,81,2485.0,1068,287,36,196,232,67,39,145,205,361,875,0.4125714285714286,189,498,0.3795180722891566,172,377,0.4562334217506631,0.521,157,185,0.8486486486486486
Jamaal Franklin,frankja01,SG,22,MEM,2014,21,161.0,39,6,4,19,23,4,2,11,23,16,39,0.4102564102564102,5,11,0.4545454545454545,11,28,0.3928571428571428,0.474,2,2,1.0
Jimmer Fredette,fredeji01,SG,24,TOT,2014,49,519.0,273,64,8,44,52,14,3,48,35,107,227,0.4713656387665198,40,84,0.4761904761904761,67,143,0.4685314685314685,0.559,19,21,0.9047619047619048
Enes Freedom,kanteen01,C,21,UTA,2014,80,2138.0,987,75,222,376,598,28,42,144,230,419,853,0.4912075029308324,0,1,0.0,419,852,0.4917840375586854,0.491,149,204,0.7303921568627451
Joel Freeland,freeljo01,C,26,POR,2014,52,727.0,174,36,88,120,208,10,22,32,95,77,162,0.4753086419753086,0,2,0.0,77,160,0.48125,0.475,20,29,0.6896551724137931
Channing Frye,fryech01,PF,30,PHO,2014,82,2312.0,910,98,73,343,416,60,63,89,245,336,778,0.4318766066838046,160,432,0.3703703703703703,176,346,0.5086705202312138,0.535,78,95,0.8210526315789474
Francisco García,garcifr01,SF,32,HOU,2014,55,1083.0,315,63,21,101,122,27,33,30,120,118,294,0.4013605442176871,69,193,0.3575129533678756,49,101,0.4851485148514851,0.519,10,19,0.5263157894736842
Kevin Garnett,garneke01,C,37,BRK,2014,54,1109.0,352,82,60,298,358,43,40,69,123,157,356,0.4410112359550562,0,3,0.0,157,353,0.4447592067988669,0.441,38,47,0.8085106382978723
Diante Garrett,garredi02,PG,25,UTA,2014,71,1048.0,248,120,11,86,97,41,5,75,75,101,265,0.3811320754716981,36,96,0.375,65,169,0.3846153846153846,0.449,10,12,0.8333333333333334
Marc Gasol,gasolma01,C,29,MEM,2014,59,1970.0,859,215,84,340,424,59,76,111,150,336,711,0.4725738396624472,2,11,0.1818181818181818,334,700,0.4771428571428571,0.474,185,241,0.7676348547717843
Pau Gasol,gasolpa01,C,33,LAL,2014,60,1884.0,1041,201,124,456,580,27,92,141,124,425,885,0.480225988700565,4,14,0.2857142857142857,421,871,0.4833524684270953,0.482,187,254,0.7362204724409449
Rudy Gay,gayru01,SF,27,TOT,2014,73,2531.0,1457,209,113,324,437,95,56,224,171,537,1179,0.455470737913486,65,197,0.3299492385786802,472,982,0.4806517311608961,0.483,318,387,0.8217054263565892
Alonzo Gee,geeal01,SF,26,CLE,2014,65,1020.0,258,47,35,114,149,39,15,44,96,98,236,0.4152542372881356,19,58,0.3275862068965517,79,178,0.4438202247191011,0.456,43,61,0.7049180327868853
Paul George,georgpa01,SF,23,IND,2014,80,2898.0,1737,283,64,478,542,151,22,224,198,577,1362,0.4236417033773862,182,500,0.364,395,862,0.4582366589327146,0.49,401,464,0.8642241379310345
Taj Gibson,gibsota01,PF,28,CHI,2014,82,2351.0,1069,91,200,358,558,41,112,150,207,429,896,0.4787946428571428,0,7,0.0,429,889,0.4825646794150731,0.479,211,281,0.7508896797153025
Manu Ginóbili,ginobma01,SG,36,SAS,2014,68,1550.0,838,293,30,172,202,70,17,139,128,294,627,0.4688995215311005,90,258,0.3488372093023256,204,369,0.5528455284552846,0.541,160,188,0.851063829787234
Rudy Gobert,goberru01,C,21,UTA,2014,45,434.0,104,7,51,104,155,8,41,32,57,36,74,0.4864864864864865,0,0,0.0,36,74,0.4864864864864865,0.486,32,65,0.4923076923076923
Ryan Gomes,gomesry01,SF,31,OKC,2014,5,34.0,6,1,0,4,4,0,0,1,5,3,8,0.375,0,2,0.0,3,6,0.5,0.375,0,0,0.0
Drew Gooden,goodedr01,C,32,WAS,2014,22,395.0,183,15,37,77,114,10,7,17,53,76,143,0.5314685314685315,7,17,0.4117647058823529,69,126,0.5476190476190477,0.556,24,27,0.8888888888888888
Archie Goodwin,goodwar01,SG,19,PHO,2014,52,533.0,194,20,25,62,87,20,11,44,45,76,167,0.4550898203592814,5,36,0.1388888888888889,71,131,0.5419847328244275,0.47,37,55,0.6727272727272727
Ben Gordon,gordobe01,SG,30,CHA,2014,19,279.0,99,21,3,24,27,10,2,21,18,37,108,0.3425925925925926,8,29,0.2758620689655172,29,79,0.3670886075949367,0.38,17,21,0.8095238095238095
Eric Gordon,gordoer01,SG,25,NOP,2014,64,2057.0,988,208,30,135,165,74,12,134,114,356,817,0.4357405140758874,101,258,0.3914728682170542,255,559,0.4561717352415027,0.498,175,223,0.7847533632286996
Marcin Gortat,gortama01,C,29,WAS,2014,81,2655.0,1068,138,202,565,767,41,121,126,201,455,840,0.5416666666666666,1,1,1.0,454,839,0.5411203814064363,0.542,157,229,0.6855895196506551
Danny Granger,grangda01,SF,30,TOT,2014,41,847.0,338,41,31,102,133,12,17,46,62,116,307,0.3778501628664495,43,128,0.3359375,73,179,0.4078212290502793,0.448,63,67,0.9402985074626866
Aaron Gray,grayaa01,C,29,TOT,2014,37,355.0,65,22,42,69,111,10,8,31,64,27,61,0.4426229508196721,0,1,0.0,27,60,0.45,0.443,11,20,0.55
Danny Green,greenda02,SG,26,SAS,2014,68,1651.0,618,104,25,204,229,65,61,76,107,218,505,0.4316831683168317,132,318,0.4150943396226415,86,187,0.4598930481283422,0.562,50,63,0.7936507936507936
Draymond Green,greendr01,SF,23,GSW,2014,82,1797.0,511,152,86,323,409,102,72,91,231,187,459,0.4074074074074074,55,165,0.3333333333333333,132,294,0.4489795918367347,0.467,82,123,0.6666666666666666
Gerald Green,greenge01,SG,28,PHO,2014,82,2330.0,1295,122,48,227,275,70,42,145,220,448,1006,0.4453280318091451,204,510,0.4,244,496,0.4919354838709677,0.547,195,230,0.8478260869565217
Jeff Green,greenje02,SF,27,BOS,2014,82,2805.0,1382,138,54,326,380,57,47,165,180,482,1171,0.4116140051238258,135,396,0.3409090909090909,347,775,0.447741935483871,0.469,283,356,0.7949438202247191
Willie Green,greenwi01,SG,32,LAC,2014,55,869.0,273,50,12,66,78,22,11,34,96,102,271,0.3763837638376384,41,121,0.3388429752066115,61,150,0.4066666666666667,0.452,28,34,0.8235294117647058
Blake Griffin,griffbl01,PF,24,LAC,2014,80,2863.0,1930,309,192,565,757,92,51,224,265,718,1359,0.5283296541574687,12,44,0.2727272727272727,706,1315,0.5368821292775665,0.533,482,674,0.7151335311572701
Jorge Gutiérrez,gutiejo01,PG,25,BRK,2014,15,244.0,62,30,3,19,22,10,1,14,37,25,54,0.4629629629629629,3,12,0.25,22,42,0.5238095238095238,0.491,9,12,0.75
Jordan Hamilton,hamiljo02,SF,23,TOT,2014,60,1019.0,404,52,32,162,194,44,20,46,67,147,376,0.3909574468085106,70,198,0.3535353535353535,77,178,0.4325842696629213,0.484,40,51,0.7843137254901961
Justin Hamilton,hamilju01,C,23,TOT,2014,8,72.0,26,0,4,3,7,5,0,4,8,9,20,0.45,3,9,0.3333333333333333,6,11,0.5454545454545454,0.525,5,5,1.0
Tyler Hansbrough,hansbty01,PF,28,TOR,2014,64,978.0,312,17,120,167,287,28,19,47,132,93,196,0.4744897959183674,0,2,0.0,93,194,0.4793814432989691,0.474,126,185,0.6810810810810811
Tim Hardaway Jr.,hardati02,SG,21,NYK,2014,81,1875.0,824,66,19,102,121,44,7,47,144,294,687,0.4279475982532751,130,358,0.3631284916201117,164,329,0.4984802431610942,0.523,106,128,0.828125
James Harden,hardeja01,SG,24,HOU,2014,73,2777.0,1851,446,61,283,344,115,29,265,177,549,1205,0.4556016597510373,177,483,0.3664596273291925,372,722,0.5152354570637119,0.529,576,665,0.8661654135338346
Maurice Harkless,harklma01,SF,20,ORL,2014,80,1950.0,592,80,69,195,264,97,50,86,140,224,483,0.463768115942029,59,154,0.3831168831168831,165,329,0.5015197568389058,0.525,85,143,0.5944055944055944
Josh Harrellson,harrejo01,C,24,DET,2014,32,317.0,93,15,30,46,76,6,15,10,44,38,82,0.4634146341463415,12,31,0.3870967741935484,26,51,0.5098039215686274,0.537,5,7,0.7142857142857143
Al Harrington,harrial01,PF,33,WAS,2014,34,511.0,225,28,15,65,80,14,0,34,72,82,207,0.3961352657004831,34,100,0.34,48,107,0.4485981308411215,0.478,27,35,0.7714285714285715
Devin Harris,harride01,PG,30,DAL,2014,40,818.0,315,178,8,77,85,28,2,59,72,96,254,0.3779527559055118,31,101,0.3069306930693069,65,153,0.4248366013071895,0.439,92,115,0.8
Elias Harris,harriel01,SF,24,LAL,2014,2,11.0,0,1,1,0,1,1,0,0,0,0,1,0.0,0,0,0.0,0,1,0.0,0.0,0,0,0.0
Manny Harris,harrima01,SG,24,LAL,2014,9,180.0,73,11,7,27,34,4,1,9,10,28,70,0.4,7,20,0.35,21,50,0.42,0.45,10,12,0.8333333333333334
Mike Harris,harrimi01,PF,30,UTA,2014,20,225.0,84,5,15,18,33,16,7,11,36,29,61,0.4754098360655737,0,2,0.0,29,59,0.4915254237288136,0.475,26,27,0.9629629629629628
Tobias Harris,harrito02,PF,21,ORL,2014,61,1850.0,893,82,88,336,424,41,24,78,143,332,716,0.4636871508379888,32,126,0.2539682539682539,300,590,0.5084745762711864,0.486,197,244,0.8073770491803278
Udonis Haslem,hasleud01,PF,33,MIA,2014,46,653.0,173,13,42,133,175,11,15,24,79,74,146,0.5068493150684932,0,0,0.0,74,146,0.5068493150684932,0.507,25,44,0.5681818181818182
Spencer Hawes,hawessp01,C,25,TOT,2014,80,2470.0,1053,240,131,529,660,44,94,173,237,403,883,0.4563986409966025,128,308,0.4155844155844156,275,575,0.4782608695652174,0.529,119,152,0.7828947368421053
Chuck Hayes,hayesch01,C,30,TOT,2014,61,754.0,132,35,69,141,210,34,12,33,95,56,130,0.4307692307692308,0,1,0.0,56,129,0.4341085271317829,0.431,20,25,0.8
Gordon Hayward,haywago01,SF,23,UTA,2014,77,2800.0,1248,400,62,329,391,110,40,212,155,426,1032,0.4127906976744186,85,280,0.3035714285714285,341,752,0.4534574468085106,0.454,311,381,0.8162729658792651
Gerald Henderson,hendege02,SG,26,CHA,2014,77,2461.0,1081,199,31,279,310,51,32,113,159,403,930,0.4333333333333333,40,115,0.3478260869565217,363,815,0.4453987730061349,0.455,235,309,0.7605177993527508
Xavier Henry,henryxa01,SF,22,LAL,2014,43,908.0,432,51,25,89,114,44,7,57,79,144,345,0.417391304347826,28,81,0.345679012345679,116,264,0.4393939393939394,0.458,116,177,0.655367231638418
John Henson,hensojo01,PF,23,MIL,2014,70,1856.0,779,113,171,326,497,41,116,114,185,344,639,0.5383411580594679,0,1,0.0,344,638,0.5391849529780565,0.538,91,177,0.5141242937853108
Roy Hibbert,hibbero01,C,27,IND,2014,81,2409.0,871,91,202,336,538,29,182,148,269,331,754,0.4389920424403183,2,5,0.4,329,749,0.4392523364485981,0.44,207,269,0.7695167286245354
J.J. Hickson,hicksjj01,PF,25,DEN,2014,69,1859.0,814,96,206,426,632,47,51,128,177,332,654,0.5076452599388379,0,8,0.0,332,646,0.5139318885448917,0.508,150,290,0.5172413793103449
Nenê,hilarne01,PF,31,WAS,2014,53,1560.0,754,153,65,229,294,64,47,117,164,299,594,0.5033670033670034,1,5,0.2,298,589,0.5059422750424448,0.504,155,266,0.5827067669172933
George Hill,hillge01,PG,27,IND,2014,76,2434.0,781,265,53,230,283,75,23,92,158,272,616,0.4415584415584415,95,260,0.3653846153846153,177,356,0.497191011235955,0.519,142,176,0.8068181818181818
Jordan Hill,hilljo01,PF,26,LAL,2014,72,1500.0,696,54,194,341,535,29,64,75,172,286,521,0.5489443378119002,0,1,0.0,286,520,0.55,0.549,124,181,0.6850828729281768
Solomon Hill,hillso01,SF,22,IND,2014,28,226.0,47,12,9,32,41,5,2,13,19,17,40,0.425,7,23,0.3043478260869565,10,17,0.5882352941176471,0.513,6,7,0.8571428571428571
Kirk Hinrich,hinriki01,PG,33,CHI,2014,73,2116.0,666,286,31,161,192,80,26,120,203,243,619,0.3925686591276252,85,242,0.3512396694214876,158,377,0.4190981432360742,0.461,95,125,0.76
Jrue Holiday,holidjr01,PG,23,NOP,2014,34,1143.0,487,268,28,114,142,56,12,105,92,203,454,0.4471365638766519,30,77,0.3896103896103896,173,377,0.4588859416445623,0.48,51,63,0.8095238095238095
Ryan Hollins,holliry01,PF,29,LAC,2014,61,482.0,141,8,31,59,90,9,31,29,87,53,72,0.7361111111111112,0,0,0.0,53,72,0.7361111111111112,0.736,35,56,0.625
Scotty Hopson,hopsosc01,SG,24,CLE,2014,2,7.0,1,1,0,0,0,1,0,0,0,0,4,0.0,0,2,0.0,0,2,0.0,0.0,1,2,0.5
Al Horford,horfoal01,C,27,ATL,2014,29,958.0,538,76,66,178,244,27,44,64,56,238,420,0.5666666666666667,4,11,0.3636363636363636,234,409,0.5721271393643031,0.571,58,85,0.6823529411764706
Dwight Howard,howardw01,C,28,HOU,2014,71,2396.0,1297,131,231,635,866,60,128,229,240,473,800,0.59125,2,7,0.2857142857142857,471,793,0.5939470365699874,0.593,349,638,0.5470219435736677
Robbie Hummel,hummero01,SF,24,MIN,2014,53,655.0,181,23,35,97,132,16,2,10,57,67,177,0.3785310734463277,32,89,0.3595505617977528,35,88,0.3977272727272727,0.469,15,16,0.9375
Kris Humphries,humphkr01,PF,28,BOS,2014,69,1376.0,579,67,127,282,409,31,61,64,136,231,461,0.5010845986984815,0,2,0.0,231,459,0.5032679738562091,0.501,117,144,0.8125
Serge Ibaka,ibakase01,PF,24,OKC,2014,81,2666.0,1227,85,224,485,709,39,219,123,233,524,978,0.5357873210633947,23,60,0.3833333333333333,501,918,0.545751633986928,0.548,156,199,0.7839195979899497
Andre Iguodala,iguodan01,SF,30,GSW,2014,63,2040.0,588,263,53,240,293,95,18,100,103,220,458,0.4803493449781659,62,175,0.3542857142857142,158,283,0.558303886925795,0.548,86,132,0.6515151515151515
Ersan İlyasova,ilyaser01,PF,26,MIL,2014,55,1478.0,618,72,107,235,342,46,8,61,135,237,579,0.4093264248704663,37,131,0.2824427480916031,200,448,0.4464285714285714,0.441,107,130,0.823076923076923
Kyrie Irving,irvinky01,PG,21,CLE,2014,71,2496.0,1478,433,52,207,259,108,23,190,163,532,1237,0.4300727566693613,123,344,0.3575581395348837,409,893,0.458006718924972,0.48,291,338,0.8609467455621301
Royal Ivey,iveyro01,SG,32,OKC,2014,2,5.0,0,0,0,1,1,0,0,0,1,0,2,0.0,0,1,0.0,0,1,0.0,0.0,0,0,0.0
Jarrett Jack,jackja01,PG,30,CLE,2014,80,2252.0,760,324,22,201,223,56,22,133,133,286,698,0.4097421203438395,63,185,0.3405405405405405,223,513,0.4346978557504873,0.455,125,149,0.8389261744966443
Reggie Jackson,jacksre01,PG,23,OKC,2014,80,2277.0,1047,331,43,270,313,85,9,168,142,403,916,0.4399563318777292,83,245,0.3387755102040816,320,671,0.4769001490312965,0.485,158,177,0.8926553672316384
Stephen Jackson,jacksst02,SF,35,LAC,2014,9,107.0,15,5,2,8,10,6,1,6,11,6,26,0.2307692307692307,1,14,0.0714285714285714,5,12,0.4166666666666667,0.25,2,4,0.5
Bernard James,jamesbe01,C,28,DAL,2014,30,146.0,28,3,15,27,42,3,8,10,24,11,23,0.4782608695652174,0,1,0.0,11,22,0.5,0.478,6,11,0.5454545454545454
Damion James,jamesda01,SF,26,SAS,2014,5,50.0,6,3,1,11,12,0,1,1,3,2,9,0.2222222222222222,0,2,0.0,2,7,0.2857142857142857,0.222,2,2,1.0
LeBron James,jamesle01,PF,29,MIA,2014,77,2902.0,2089,488,81,452,533,121,26,270,126,767,1353,0.5668883961566888,116,306,0.3790849673202614,651,1047,0.6217765042979942,0.61,439,585,0.7504273504273504
Mike James,jamesmi01,PG,38,CHI,2014,11,77.0,11,17,0,7,7,2,0,5,11,5,21,0.238095238095238,1,5,0.2,4,16,0.25,0.262,0,2,0.0
Antawn Jamison,jamisan01,PF,37,LAC,2014,22,248.0,84,7,9,46,55,9,3,7,29,29,92,0.3152173913043478,8,41,0.1951219512195122,21,51,0.4117647058823529,0.359,18,25,0.72
Othyus Jeffers,jeffeot01,SG,28,TOT,2014,6,47.0,9,1,1,8,9,0,0,1,3,3,6,0.5,0,2,0.0,3,4,0.75,0.5,3,4,0.75
Al Jefferson,jeffeal01,C,29,CHA,2014,73,2553.0,1594,155,156,636,792,67,79,124,176,700,1376,0.5087209302325582,3,15,0.2,697,1361,0.5121234386480529,0.51,191,277,0.6895306859205776
Richard Jefferson,jefferi01,SF,33,UTA,2014,82,2213.0,831,130,18,201,219,56,14,94,168,294,654,0.4495412844036697,123,301,0.4086378737541528,171,353,0.4844192634560906,0.544,120,162,0.7407407407407407
John Jenkins,jenkijo01,SG,22,ATL,2014,13,158.0,40,11,3,19,22,1,1,11,11,16,42,0.3809523809523809,4,18,0.2222222222222222,12,24,0.5,0.429,4,4,1.0
Brandon Jennings,jennibr01,PG,24,DET,2014,80,2728.0,1241,609,59,185,244,101,8,215,157,423,1135,0.3726872246696035,154,457,0.336980306345733,269,678,0.3967551622418879,0.441,241,321,0.7507788161993769
Jonas Jerebko,jerebjo01,PF,26,DET,2014,64,741.0,270,39,51,124,175,21,6,43,85,98,208,0.4711538461538461,31,74,0.4189189189189189,67,134,0.5,0.546,43,59,0.7288135593220338
Amir Johnson,johnsam01,PF,26,TOR,2014,77,2214.0,799,115,172,333,505,56,88,123,271,344,612,0.5620915032679739,20,66,0.303030303030303,324,546,0.5934065934065934,0.578,91,143,0.6363636363636364
Chris Johnson,johnsch04,SF,23,BOS,2014,40,789.0,250,31,31,66,97,27,4,22,63,85,214,0.397196261682243,43,127,0.3385826771653543,42,87,0.4827586206896552,0.498,37,43,0.8604651162790697
James Johnson,johnsja01,SF,26,MEM,2014,52,956.0,384,111,60,106,166,42,57,66,102,143,308,0.4642857142857143,22,87,0.2528735632183908,121,221,0.5475113122171946,0.5,76,90,0.8444444444444444
Joe Johnson,johnsjo02,SG,32,BRK,2014,79,2575.0,1245,216,48,222,270,47,10,120,129,462,1018,0.4538310412573674,162,404,0.400990099009901,300,614,0.4885993485342019,0.533,159,195,0.8153846153846154
Orlando Johnson,johnsor01,SG,24,TOT,2014,45,392.0,100,20,9,46,55,6,2,15,26,36,113,0.3185840707964602,9,47,0.1914893617021276,27,66,0.4090909090909091,0.358,19,26,0.7307692307692307
Wesley Johnson,johnswe01,SF,26,LAL,2014,79,2240.0,715,124,70,278,348,86,77,90,207,277,651,0.4254992319508449,100,271,0.3690036900369003,177,380,0.4657894736842105,0.502,61,77,0.7922077922077922
Darius Johnson-Odom,johnsda03,SG,24,PHI,2014,3,15.0,0,1,0,2,2,1,0,2,3,0,7,0.0,0,3,0.0,0,4,0.0,0.0,0,2,0.0
James Jones,jonesja02,SF,33,MIA,2014,20,236.0,97,9,2,21,23,3,4,4,6,31,68,0.4558823529411764,28,54,0.5185185185185185,3,14,0.2142857142857142,0.662,7,11,0.6363636363636364
Perry Jones,jonespe01,PF,22,OKC,2014,62,764.0,216,26,28,86,114,14,19,21,62,83,181,0.4585635359116022,22,61,0.360655737704918,61,120,0.5083333333333333,0.519,28,42,0.6666666666666666
Solomon Jones,jonesso01,PF,29,ORL,2014,11,85.0,14,2,8,8,16,2,2,2,12,6,17,0.3529411764705882,0,0,0.0,6,17,0.3529411764705882,0.353,2,4,0.5
Terrence Jones,joneste01,PF,22,HOU,2014,76,2078.0,921,87,162,366,528,53,99,71,139,386,712,0.5421348314606742,31,101,0.3069306930693069,355,611,0.5810147299509002,0.564,118,195,0.6051282051282051
DeAndre Jordan,jordade01,C,25,LAC,2014,82,2870.0,856,74,331,783,1114,80,203,123,264,348,515,0.6757281553398058,0,0,0.0,348,515,0.6757281553398058,0.676,160,374,0.427807486631016
Cory Joseph,josepco01,SG,22,SAS,2014,68,936.0,343,114,32,75,107,35,14,43,84,126,265,0.4754716981132075,12,38,0.3157894736842105,114,227,0.5022026431718062,0.498,79,96,0.8229166666666666
Chris Kaman,kamanch01,C,31,LAL,2014,39,736.0,404,58,54,175,229,11,40,74,93,176,346,0.5086705202312138,0,3,0.0,176,343,0.5131195335276968,0.509,52,68,0.7647058823529411
Sergey Karasev,karasse01,SF,20,CLE,2014,22,156.0,37,6,0,16,16,3,1,11,22,12,35,0.3428571428571428,4,19,0.2105263157894736,8,16,0.5,0.4,9,10,0.9
Ryan Kelly,kellyry01,PF,22,LAL,2014,59,1312.0,472,95,42,177,219,32,45,47,147,157,371,0.4231805929919137,48,142,0.3380281690140845,109,229,0.4759825327510917,0.488,110,135,0.8148148148148148
Michael Kidd-Gilchrist,kiddgmi01,SF,20,CHA,2014,62,1502.0,448,52,109,215,324,43,39,60,145,167,353,0.4730878186968839,1,9,0.1111111111111111,166,344,0.4825581395348837,0.475,113,184,0.6141304347826086
Andrei Kirilenko,kirilan01,PF,32,BRK,2014,45,857.0,226,72,55,91,146,40,19,54,65,82,160,0.5125,1,5,0.2,81,155,0.5225806451612903,0.516,61,119,0.5126050420168067
Brandon Knight,knighbr03,PG,22,MIL,2014,72,2400.0,1291,352,46,209,255,69,17,188,146,461,1092,0.4221611721611721,110,338,0.3254437869822485,351,754,0.4655172413793103,0.473,259,323,0.8018575851393189
Kyle Korver,korveky01,SG,32,ATL,2014,71,2408.0,850,208,22,260,282,70,24,102,147,289,609,0.4745484400656814,185,392,0.4719387755102041,104,217,0.4792626728110599,0.626,87,94,0.925531914893617
Kosta Koufos,koufoko01,C,24,MEM,2014,80,1349.0,514,39,160,258,418,32,71,67,182,227,459,0.494553376906318,0,0,0.0,227,459,0.494553376906318,0.495,60,93,0.6451612903225806
Viacheslav Kravtsov,kravtvi01,C,26,PHO,2014,20,59.0,20,1,9,8,17,0,1,6,7,8,15,0.5333333333333333,0,0,0.0,8,15,0.5333333333333333,0.533,4,8,0.5
Ognjen Kuzmić,kuzmiog01,C,23,GSW,2014,21,92.0,15,2,10,11,21,3,4,10,17,5,13,0.3846153846153846,0,0,0.0,5,13,0.3846153846153846,0.385,5,11,0.4545454545454545
Doron Lamb,lambdo01,SG,22,ORL,2014,53,695.0,191,43,8,41,49,11,1,27,54,63,160,0.39375,36,90,0.4,27,70,0.3857142857142857,0.506,29,36,0.8055555555555556
Jeremy Lamb,lambje01,SG,21,OKC,2014,78,1538.0,665,115,27,162,189,56,26,61,143,263,609,0.4318555008210181,88,247,0.3562753036437247,175,362,0.4834254143646408,0.504,51,64,0.796875
Carl Landry,landrca01,PF,30,SAC,2014,18,233.0,76,5,15,42,57,3,1,9,34,31,60,0.5166666666666667,0,0,0.0,31,60,0.5166666666666667,0.517,14,17,0.8235294117647058
Shane Larkin,larkish01,PG,21,DAL,2014,48,489.0,132,71,11,31,42,26,1,39,46,52,137,0.3795620437956204,12,38,0.3157894736842105,40,99,0.404040404040404,0.423,16,25,0.64
Ty Lawson,lawsoty01,PG,26,DEN,2014,62,2222.0,1090,543,40,175,215,100,10,200,113,347,806,0.4305210918114144,72,202,0.3564356435643564,275,604,0.4552980132450331,0.475,324,406,0.7980295566502463
Ricky Ledo,ledori01,SG,21,DAL,2014,11,33.0,19,2,0,2,2,1,0,2,2,6,17,0.3529411764705882,3,8,0.375,3,9,0.3333333333333333,0.441,4,4,1.0
Courtney Lee,leeco01,SG,28,TOT,2014,79,1973.0,761,115,29,158,187,65,28,73,127,295,614,0.4804560260586319,72,194,0.3711340206185567,223,420,0.530952380952381,0.539,99,112,0.8839285714285714
David Lee,leeda02,PF,30,GSW,2014,69,2288.0,1257,147,182,461,643,48,26,152,206,513,981,0.5229357798165137,0,1,0.0,513,980,0.523469387755102,0.523,231,296,0.7804054054054054
Alex Len,lenal01,C,20,PHO,2014,42,362.0,86,4,39,60,99,4,18,26,68,33,78,0.4230769230769231,0,0,0.0,33,78,0.4230769230769231,0.423,20,31,0.6451612903225806
Kawhi Leonard,leonaka01,SF,22,SAS,2014,66,1923.0,844,133,76,336,412,114,50,80,127,337,645,0.5224806201550387,69,182,0.3791208791208791,268,463,0.5788336933045356,0.576,101,126,0.8015873015873016
Meyers Leonard,leoname01,C,21,POR,2014,40,355.0,98,18,26,85,111,7,5,15,76,41,91,0.4505494505494505,0,6,0.0,41,85,0.4823529411764706,0.451,16,21,0.7619047619047619
Jon Leuer,leuerjo01,PF,24,MEM,2014,49,642.0,302,20,37,121,158,18,13,27,63,121,246,0.491869918699187,23,49,0.4693877551020408,98,197,0.4974619289340101,0.539,37,47,0.7872340425531915
Rashard Lewis,lewisra02,SF,34,MIA,2014,60,971.0,268,57,24,86,110,53,8,35,90,98,236,0.4152542372881356,46,134,0.3432835820895522,52,102,0.5098039215686274,0.513,26,33,0.7878787878787878
DeAndre Liggins,liggide01,SG,25,MIA,2014,1,1.0,2,0,1,0,1,0,0,0,0,1,1,1.0,0,0,0.0,1,1,1.0,1.0,0,0,0.0
Damian Lillard,lillada01,PG,23,POR,2014,82,2937.0,1695,457,35,253,288,64,22,193,197,553,1304,0.424079754601227,218,554,0.3935018050541516,335,750,0.4466666666666666,0.508,371,426,0.8708920187793427
Jeremy Lin,linje01,PG,25,HOU,2014,71,2054.0,890,294,34,153,187,68,27,176,166,295,662,0.445619335347432,82,229,0.3580786026200873,213,433,0.4919168591224018,0.508,218,265,0.8226415094339623
Shaun Livingston,livinsh01,PG,28,BRK,2014,76,1974.0,629,245,67,179,246,93,31,105,172,235,487,0.4825462012320328,1,6,0.1666666666666666,234,481,0.4864864864864865,0.484,158,191,0.8272251308900523
Brook Lopez,lopezbr01,C,25,BRK,2014,17,533.0,352,16,39,63,102,9,30,28,52,129,229,0.5633187772925764,0,1,0.0,129,228,0.5657894736842105,0.563,94,115,0.8173913043478261
Robin Lopez,lopezro01,C,25,POR,2014,82,2603.0,908,73,326,374,700,25,139,84,196,355,644,0.5512422360248447,0,1,0.0,355,643,0.552099533437014,0.551,198,242,0.8181818181818182
Kevin Love,loveke01,PF,25,MIN,2014,77,2797.0,2010,341,224,739,963,59,35,196,136,650,1421,0.4574243490499648,190,505,0.3762376237623762,460,916,0.5021834061135371,0.524,520,633,0.8214849921011058
Kyle Lowry,lowryky01,PG,27,TOR,2014,79,2862.0,1417,586,88,281,369,121,15,194,267,457,1080,0.4231481481481481,190,500,0.38,267,580,0.4603448275862069,0.511,313,385,0.812987012987013
John Lucas III,lucasjo02,PG,31,UTA,2014,42,591.0,159,42,12,27,39,14,0,22,41,62,190,0.3263157894736842,25,84,0.2976190476190476,37,106,0.3490566037735849,0.392,10,16,0.625
Shelvin Mack,macksh01,PG,23,ATL,2014,73,1490.0,544,271,21,139,160,50,2,89,100,209,501,0.4171656686626746,62,184,0.3369565217391304,147,317,0.4637223974763407,0.479,64,74,0.8648648648648649
Ian Mahinmi,mahinia01,C,27,IND,2014,77,1248.0,272,24,107,150,257,41,72,58,207,91,189,0.4814814814814814,0,1,0.0,91,188,0.4840425531914893,0.481,90,145,0.6206896551724138
Shawn Marion,mariosh01,SF,35,DAL,2014,76,2409.0,791,124,132,365,497,90,37,95,125,341,708,0.481638418079096,58,162,0.3580246913580246,283,546,0.5183150183150184,0.523,51,65,0.7846153846153846
Kendall Marshall,marshke01,PG,22,LAL,2014,54,1564.0,430,477,15,140,155,48,4,150,76,170,419,0.4057279236276849,71,178,0.398876404494382,99,241,0.4107883817427386,0.49,19,36,0.5277777777777778
Cartier Martin,martica01,SF,29,TOT,2014,59,870.0,329,33,13,97,110,27,7,34,71,111,264,0.4204545454545454,59,151,0.390728476821192,52,113,0.4601769911504424,0.532,48,65,0.7384615384615385
Kenyon Martin,martike01,PF,36,NYK,2014,32,633.0,137,50,36,98,134,25,27,26,85,63,123,0.5121951219512195,0,1,0.0,63,122,0.5163934426229508,0.512,11,19,0.5789473684210527
Kevin Martin,martike02,SG,30,MIN,2014,68,2177.0,1298,121,34,169,203,66,6,106,123,440,1023,0.4301075268817204,115,297,0.3872053872053872,325,726,0.4476584022038568,0.486,303,340,0.8911764705882353
Roger Mason,masonro01,SG,33,MIA,2014,25,260.0,74,19,1,21,22,6,1,9,26,25,67,0.373134328358209,17,48,0.3541666666666667,8,19,0.4210526315789473,0.5,7,7,1.0
Wesley Matthews,matthwe02,SG,27,POR,2014,82,2780.0,1343,197,51,238,289,76,14,110,176,445,1009,0.4410307234886025,201,511,0.3933463796477495,244,498,0.4899598393574297,0.541,252,301,0.8372093023255814
Jason Maxiell,maxieja01,PF,30,ORL,2014,34,488.0,109,9,28,58,86,8,20,14,47,47,105,0.4476190476190476,0,0,0.0,47,105,0.4476190476190476,0.448,15,31,0.4838709677419355
Eric Maynor,maynoer01,PG,26,TOT,2014,31,327.0,82,52,9,30,39,9,3,29,17,32,101,0.3168316831683168,12,37,0.3243243243243243,20,64,0.3125,0.376,6,11,0.5454545454545454
O.J. Mayo,mayooj01,SG,26,MIL,2014,52,1346.0,608,113,24,100,124,28,13,95,111,224,550,0.4072727272727273,84,227,0.3700440528634361,140,323,0.4334365325077399,0.484,76,88,0.8636363636363636
Luc Mbah a Moute,mbahalu01,PF-SF,27,TOT,2014,64,1003.0,224,36,56,90,146,30,14,40,68,87,193,0.4507772020725388,4,17,0.2352941176470588,83,176,0.4715909090909091,0.461,46,67,0.6865671641791045
Ray McCallum,mccalra01,PG,22,SAC,2014,45,897.0,280,120,18,61,79,22,9,39,69,113,300,0.3766666666666666,22,59,0.3728813559322034,91,241,0.3775933609958506,0.413,32,43,0.7441860465116279
CJ McCollum,mccolcj01,SG,22,POR,2014,38,476.0,201,27,7,41,48,14,2,35,53,74,178,0.4157303370786517,30,80,0.375,44,98,0.4489795918367347,0.5,23,34,0.6764705882352942
JaVale McGee,mcgeeja01,C,26,DEN,2014,5,79.0,35,2,10,7,17,1,7,8,16,17,38,0.4473684210526316,0,0,0.0,17,38,0.4473684210526316,0.447,1,1,1.0
Ben McLemore,mclembe01,SG,20,SAC,2014,82,2187.0,720,82,53,182,235,45,18,96,201,255,679,0.3755522827687776,95,297,0.3198653198653198,160,382,0.418848167539267,0.446,115,143,0.8041958041958042
Josh McRoberts,mcrobjo01,PF,26,CHA,2014,78,2360.0,661,333,85,288,373,58,46,83,189,247,566,0.4363957597173145,105,291,0.3608247422680412,142,275,0.5163636363636364,0.529,62,85,0.7294117647058823
Jodie Meeks,meeksjo01,SG,26,LAL,2014,77,2556.0,1209,138,30,164,194,111,4,111,119,413,892,0.4630044843049327,162,404,0.400990099009901,251,488,0.514344262295082,0.554,221,258,0.8565891472868217
Gal Mekel,mekelga01,PG,25,DAL,2014,31,292.0,73,63,5,22,27,4,1,31,31,30,86,0.3488372093023256,5,20,0.25,25,66,0.3787878787878788,0.378,8,12,0.6666666666666666
Khris Middleton,middlkh01,SF,22,MIL,2014,82,2460.0,990,169,60,250,310,83,20,123,243,376,854,0.4402810304449648,120,290,0.4137931034482758,256,564,0.4539007092198581,0.511,118,137,0.8613138686131386
C.J. Miles,milescj01,SG,26,CLE,2014,51,984.0,503,52,18,85,103,46,15,44,103,178,409,0.4352078239608802,83,211,0.3933649289099526,95,198,0.4797979797979798,0.537,64,75,0.8533333333333334
Andre Miller,millean02,SG,37,TOT,2014,58,982.0,283,197,28,102,130,34,9,61,75,106,231,0.4588744588744589,11,21,0.5238095238095238,95,210,0.4523809523809524,0.483,60,77,0.7792207792207793
Darius Miller,milleda01,SF,23,NOP,2014,45,723.0,200,43,9,43,52,24,9,22,88,73,166,0.4397590361445783,25,77,0.3246753246753247,48,89,0.5393258426966292,0.515,29,36,0.8055555555555556
Mike Miller,millemi01,SF,33,MEM,2014,82,1707.0,579,130,30,177,207,26,5,77,95,213,443,0.4808126410835214,107,233,0.4592274678111588,106,210,0.5047619047619047,0.602,46,56,0.8214285714285714
Quincy Miller,millequ01,PF,21,DEN,2014,52,789.0,257,26,36,111,147,22,32,48,70,94,256,0.3671875,30,94,0.3191489361702128,64,162,0.3950617283950617,0.426,39,55,0.7090909090909091
Patty Mills,millspa02,PG,25,SAS,2014,81,1527.0,826,149,34,135,169,68,9,63,114,309,666,0.4639639639639639,135,318,0.4245283018867924,174,348,0.5,0.565,73,82,0.8902439024390244
Paul Millsap,millspa01,PF,28,ATL,2014,74,2482.0,1328,232,154,473,627,129,78,185,210,483,1047,0.4613180515759312,76,212,0.3584905660377358,407,835,0.4874251497005988,0.498,286,391,0.731457800511509
Tony Mitchell,mitchto02,PF,21,DET,2014,21,79.0,22,2,15,11,26,6,3,4,9,5,12,0.4166666666666667,1,1,1.0,4,11,0.3636363636363636,0.458,11,19,0.5789473684210527
Tony Mitchell,mitchto03,SF,24,MIL,2014,3,10.0,6,1,1,0,1,1,0,0,0,3,5,0.6,0,1,0.0,3,4,0.75,0.6,0,0,0.0
Nazr Mohammed,mohamna01,C,36,CHI,2014,80,562.0,124,20,66,109,175,14,30,37,77,54,126,0.4285714285714285,0,0,0.0,54,126,0.4285714285714285,0.429,16,30,0.5333333333333333
Greg Monroe,monrogr01,PF,23,DET,2014,82,2690.0,1249,171,256,504,760,91,47,166,205,504,1015,0.496551724137931,0,1,0.0,504,1014,0.4970414201183432,0.497,241,367,0.6566757493188011
E'Twaun Moore,mooreet01,SG,24,ORL,2014,79,1506.0,499,112,29,107,136,60,13,55,106,195,456,0.4276315789473684,57,161,0.3540372670807453,138,295,0.4677966101694915,0.49,52,68,0.7647058823529411
Darius Morris,morrida01,PG,23,TOT,2014,27,313.0,107,44,7,19,26,13,0,27,33,39,96,0.40625,12,38,0.3157894736842105,27,58,0.4655172413793103,0.469,17,26,0.6538461538461539
Marcus Morris,morrima03,SF,24,PHO,2014,82,1800.0,796,88,84,235,319,72,18,95,157,288,651,0.4423963133640553,99,260,0.3807692307692307,189,391,0.4833759590792839,0.518,121,159,0.7610062893081762
Markieff Morris,morrima02,PF,24,PHO,2014,81,2153.0,1115,144,139,346,485,68,51,147,232,411,845,0.4863905325443787,34,108,0.3148148148148148,377,737,0.5115332428765265,0.507,259,327,0.7920489296636085
Anthony Morrow,morroan01,SG,28,NOP,2014,76,1426.0,636,59,29,111,140,38,12,51,102,238,520,0.4576923076923077,88,195,0.4512820512820513,150,325,0.4615384615384615,0.542,72,87,0.8275862068965517
Donatas Motiejūnas,motiedo01,PF,23,HOU,2014,62,952.0,341,34,60,165,225,20,21,49,132,131,296,0.4425675675675675,21,84,0.25,110,212,0.5188679245283019,0.478,58,96,0.6041666666666666
Arnett Moultrie,moultar01,PF,23,PHI,2014,12,187.0,36,2,11,24,35,8,4,7,22,16,38,0.4210526315789473,0,0,0.0,16,38,0.4210526315789473,0.421,4,5,0.8
Timofey Mozgov,mozgoti01,C,27,DEN,2014,82,1770.0,770,62,171,357,528,27,100,122,213,285,545,0.5229357798165137,4,24,0.1666666666666666,281,521,0.5393474088291746,0.527,196,260,0.7538461538461538
Shabazz Muhammad,muhamsh01,SG,21,MIN,2014,37,290.0,143,6,24,29,53,8,1,16,24,57,124,0.4596774193548387,3,11,0.2727272727272727,54,113,0.4778761061946903,0.472,26,40,0.65
Byron Mullens,mulleby01,C,24,TOT,2014,45,414.0,189,14,24,68,92,15,11,27,64,73,165,0.4424242424242424,33,89,0.3707865168539326,40,76,0.5263157894736842,0.542,10,20,0.5
Erik Murphy,murpher01,C,23,CHI,2014,24,62.0,6,2,2,6,8,0,4,2,7,3,13,0.2307692307692307,0,3,0.0,3,10,0.3,0.231,0,0,0.0
Toure' Murry,murryto01,PG,24,NYK,2014,51,373.0,140,49,13,31,44,19,1,34,46,56,129,0.4341085271317829,5,12,0.4166666666666667,51,117,0.4358974358974359,0.453,23,39,0.5897435897435898
Mike Muscala,muscami01,PF,22,ATL,2014,20,215.0,76,7,17,35,52,3,10,12,29,31,73,0.4246575342465753,0,3,0.0,31,70,0.4428571428571428,0.425,14,14,1.0
Hamady N'Diaye,ndiayha01,C,27,SAC,2014,14,74.0,6,3,5,13,18,0,4,3,15,3,9,0.3333333333333333,0,0,0.0,3,9,0.3333333333333333,0.333,0,1,0.0
Steve Nash,nashst01,PG,39,LAL,2014,15,313.0,102,86,4,25,29,7,2,31,18,36,94,0.3829787234042553,8,24,0.3333333333333333,28,70,0.4,0.426,22,24,0.9166666666666666
Gary Neal,nealga01,SG,29,TOT,2014,52,1114.0,548,83,10,80,90,18,0,64,65,193,471,0.4097664543524416,68,180,0.3777777777777777,125,291,0.4295532646048109,0.482,94,105,0.8952380952380953
Nemanja Nedović,nedovne01,SG,22,GSW,2014,24,142.0,26,13,3,12,15,0,1,13,13,8,39,0.2051282051282051,3,18,0.1666666666666666,5,21,0.238095238095238,0.244,7,8,0.875
Jameer Nelson,nelsoja01,PG,31,ORL,2014,68,2179.0,820,476,29,202,231,52,5,166,146,294,747,0.393574297188755,136,391,0.3478260869565217,158,356,0.4438202247191011,0.485,96,112,0.8571428571428571
Andrew Nicholson,nichoan01,PF,24,ORL,2014,76,1174.0,435,25,53,202,255,18,23,51,150,180,420,0.4285714285714285,28,89,0.3146067415730337,152,331,0.459214501510574,0.462,47,57,0.8245614035087719
Joakim Noah,noahjo01,C,28,CHI,2014,80,2820.0,1007,431,282,618,900,99,121,194,245,380,800,0.475,0,2,0.0,380,798,0.4761904761904761,0.475,247,335,0.7373134328358208
Steve Novak,novakst01,PF,30,TOR,2014,54,540.0,178,13,8,50,58,12,4,5,44,60,146,0.410958904109589,52,122,0.4262295081967213,8,24,0.3333333333333333,0.589,6,6,1.0
Dirk Nowitzki,nowitdi01,PF,35,DAL,2014,80,2628.0,1735,216,40,458,498,73,45,117,165,633,1273,0.4972505891594658,131,329,0.3981762917933131,502,944,0.5317796610169492,0.549,338,376,0.898936170212766
James Nunnally,nunnaja01,SF,23,TOT,2014,13,165.0,44,8,1,18,19,6,2,7,11,15,46,0.3260869565217391,8,25,0.32,7,21,0.3333333333333333,0.413,6,9,0.6666666666666666
Jermaine O'Neal,onealje01,PF,35,GSW,2014,44,883.0,349,25,85,157,242,14,40,52,102,125,248,0.5040322580645161,0,0,0.0,125,248,0.5040322580645161,0.504,99,132,0.75
Kyle O'Quinn,oquinky01,C,23,ORL,2014,69,1188.0,429,78,100,264,364,39,88,78,165,186,371,0.5013477088948787,0,3,0.0,186,368,0.5054347826086957,0.501,57,83,0.6867469879518072
Greg Oden,odengr01,C,26,MIA,2014,23,212.0,67,1,23,31,54,7,13,12,52,27,49,0.5510204081632653,0,0,0.0,27,49,0.5510204081632653,0.551,13,23,0.5652173913043478
Victor Oladipo,oladivi01,PG,21,ORL,2014,80,2487.0,1106,327,43,286,329,129,37,256,210,392,936,0.4188034188034188,74,226,0.3274336283185841,318,710,0.447887323943662,0.458,248,318,0.779874213836478
Kelly Olynyk,olynyke01,C,22,BOS,2014,70,1400.0,607,109,140,225,365,35,27,106,227,234,502,0.4661354581673306,40,114,0.3508771929824561,194,388,0.5,0.506,99,122,0.8114754098360656
Arinze Onuaku,onuakar01,PF,26,TOT,2014,5,30.0,3,3,2,6,8,0,0,1,3,1,5,0.2,0,0,0.0,1,5,0.2,0.2,1,2,0.5
Daniel Orton,ortonda01,C,23,PHI,2014,22,251.0,65,15,16,45,61,6,16,18,38,21,47,0.4468085106382978,0,0,0.0,21,47,0.4468085106382978,0.447,23,30,0.7666666666666667
Travis Outlaw,outlatr01,SF,29,SAC,2014,63,1065.0,343,48,36,132,168,20,19,26,94,130,326,0.3987730061349693,41,117,0.3504273504273504,89,209,0.4258373205741627,0.462,42,52,0.8076923076923077
Zaza Pachulia,pachuza01,C,29,MIL,2014,53,1325.0,408,136,141,192,333,45,14,92,124,149,349,0.4269340974212034,0,1,0.0,149,348,0.4281609195402299,0.427,110,130,0.8461538461538461
Jannero Pargo,pargoja01,PG,34,CHA,2014,29,242.0,136,52,1,19,20,14,1,26,17,52,118,0.4406779661016949,24,60,0.4,28,58,0.4827586206896552,0.542,8,11,0.7272727272727273
Tony Parker,parketo01,PG,31,SAS,2014,68,1997.0,1134,388,17,138,155,36,9,151,86,456,914,0.4989059080962801,25,67,0.373134328358209,431,847,0.5088547815820543,0.513,197,243,0.8106995884773662
Chandler Parsons,parsoch01,SF,25,HOU,2014,74,2783.0,1226,298,69,340,409,88,29,144,168,466,987,0.4721377912867274,130,351,0.3703703703703703,336,636,0.5283018867924528,0.538,164,221,0.7420814479638009
Patrick Patterson,pattepa01,PF,24,TOT,2014,65,1533.0,555,78,117,225,342,55,37,65,159,225,489,0.4601226993865031,55,151,0.3642384105960264,170,338,0.5029585798816568,0.516,50,71,0.704225352112676
Chris Paul,paulch01,PG,28,LAC,2014,62,2171.0,1185,663,38,230,268,154,4,145,157,406,870,0.4666666666666667,78,212,0.3679245283018867,328,658,0.4984802431610942,0.511,295,345,0.855072463768116
Nikola Peković,pekovni01,C,28,MIN,2014,54,1663.0,944,50,206,262,468,30,23,84,129,379,701,0.5406562054208274,0,0,0.0,379,701,0.5406562054208274,0.541,186,249,0.7469879518072289
Kendrick Perkins,perkike01,C,29,OKC,2014,62,1207.0,211,67,82,223,305,26,32,90,177,87,193,0.4507772020725388,0,1,0.0,87,192,0.453125,0.451,37,67,0.5522388059701493
Paul Pierce,piercpa01,SF,36,BRK,2014,75,2098.0,1010,178,26,322,348,86,31,153,190,321,712,0.4508426966292135,112,300,0.3733333333333333,209,412,0.5072815533980582,0.529,256,310,0.8258064516129032
Dexter Pittman,pittmde01,C,25,ATL,2014,2,3.0,0,0,3,0,3,0,0,0,0,0,1,0.0,0,0,0.0,0,1,0.0,0.0,0,2,0.0
Mason Plumlee,plumlma01,C,23,BRK,2014,70,1275.0,520,60,99,209,308,49,55,77,171,199,302,0.6589403973509934,0,3,0.0,199,299,0.6655518394648829,0.659,122,195,0.6256410256410256
Miles Plumlee,plumlmi01,C,25,PHO,2014,80,1964.0,646,43,198,428,626,50,90,111,185,286,553,0.5171790235081374,0,0,0.0,286,553,0.5171790235081374,0.517,74,132,0.5606060606060606
Quincy Pondexter,pondequ01,SG,25,MEM,2014,15,270.0,94,20,10,16,26,5,1,15,18,31,79,0.3924050632911392,11,34,0.3235294117647059,20,45,0.4444444444444444,0.462,21,26,0.8076923076923077
Otto Porter Jr.,porteot01,SF,20,WAS,2014,37,319.0,78,10,21,36,57,8,1,14,26,33,91,0.3626373626373626,4,21,0.1904761904761904,29,70,0.4142857142857143,0.385,8,12,0.6666666666666666
Josh Powell,poweljo01,PF,31,HOU,2014,1,19.0,4,0,0,5,5,0,1,1,1,2,6,0.3333333333333333,0,0,0.0,2,6,0.3333333333333333,0.333,0,0,0.0
Phil Pressey,pressph01,PG,22,BOS,2014,75,1132.0,213,241,20,85,105,68,5,87,97,78,253,0.308300395256917,28,106,0.2641509433962264,50,147,0.3401360544217687,0.364,29,45,0.6444444444444445
A.J. Price,priceaj01,SG,27,MIN,2014,28,99.0,44,13,1,9,10,1,0,7,5,19,46,0.4130434782608695,6,22,0.2727272727272727,13,24,0.5416666666666666,0.478,0,2,0.0
Ronnie Price,pricero01,SG,30,ORL,2014,31,377.0,74,66,8,35,43,25,2,26,50,28,92,0.3043478260869565,9,43,0.2093023255813953,19,49,0.3877551020408163,0.353,9,13,0.6923076923076923
Pablo Prigioni,prigipa01,PG,36,NYK,2014,66,1283.0,252,228,36,93,129,67,2,60,132,88,191,0.4607329842931937,65,140,0.4642857142857143,23,51,0.4509803921568627,0.631,11,12,0.9166666666666666
Tayshaun Prince,princta01,SF,33,MEM,2014,76,1948.0,454,119,32,202,234,39,19,41,63,200,492,0.4065040650406504,20,69,0.2898550724637681,180,423,0.425531914893617,0.427,34,60,0.5666666666666667
Miroslav Raduljica,radulmi01,C,26,MIL,2014,48,465.0,181,23,54,54,108,7,13,28,84,68,126,0.5396825396825397,0,0,0.0,68,126,0.5396825396825397,0.54,45,55,0.8181818181818182
Anthony Randolph,randoan01,PF,24,DEN,2014,43,527.0,206,32,20,102,122,26,19,39,64,68,176,0.3863636363636363,18,61,0.2950819672131147,50,115,0.4347826086956521,0.438,52,69,0.7536231884057971
Shavlik Randolph,randosh01,PF,30,PHO,2014,14,95.0,20,1,7,18,25,3,1,5,15,7,14,0.5,0,0,0.0,7,14,0.5,0.5,6,11,0.5454545454545454
Zach Randolph,randoza01,PF,32,MEM,2014,79,2705.0,1372,200,265,530,795,54,23,183,210,560,1198,0.4674457429048414,2,20,0.1,558,1178,0.4736842105263157,0.468,250,337,0.7418397626112759
J.J. Redick,redicjj01,SG,29,LAC,2014,35,987.0,532,78,9,65,74,28,3,42,65,181,398,0.4547738693467337,73,185,0.3945945945945946,108,213,0.5070422535211268,0.546,97,106,0.9150943396226416
Glen Rice Jr.,ricegl02,SG,23,WAS,2014,11,109.0,32,7,4,16,20,6,1,9,7,11,37,0.2972972972972973,5,17,0.2941176470588235,6,20,0.3,0.365,5,7,0.7142857142857143
Luke Ridnour,ridnolu01,PG,32,TOT,2014,61,1141.0,306,176,23,74,97,32,8,66,92,126,327,0.3853211009174312,37,108,0.3425925925925926,89,219,0.4063926940639269,0.442,17,26,0.6538461538461539
Austin Rivers,riverau01,PG,21,NOP,2014,69,1339.0,530,160,26,103,129,45,9,77,134,192,474,0.4050632911392405,36,99,0.3636363636363636,156,375,0.416,0.443,110,173,0.6358381502890174
Andre Roberson,roberan03,SG,22,OKC,2014,40,399.0,75,15,36,58,94,19,10,19,74,33,68,0.4852941176470588,2,13,0.1538461538461538,31,55,0.5636363636363636,0.5,7,10,0.7
Brian Roberts,roberbr01,PG,28,NOP,2014,72,1667.0,677,234,17,119,136,43,7,95,132,244,581,0.4199655765920826,64,178,0.3595505617977528,180,403,0.4466501240694789,0.475,125,133,0.9398496240601504
Nate Robinson,robinna01,PG,29,DEN,2014,44,866.0,457,112,21,60,81,36,4,58,92,164,383,0.4281984334203655,58,154,0.3766233766233766,106,229,0.462882096069869,0.504,71,85,0.8352941176470589
Thomas Robinson,robinth01,PF,22,POR,2014,70,873.0,339,34,105,202,307,23,20,57,131,141,293,0.4812286689419795,0,1,0.0,141,292,0.4828767123287671,0.481,57,101,0.5643564356435643
Rajon Rondo,rondora01,PG,27,BOS,2014,30,998.0,350,294,22,142,164,40,2,99,65,141,350,0.4028571428571428,26,90,0.2888888888888888,115,260,0.4423076923076923,0.44,42,67,0.6268656716417911
Derrick Rose,rosede01,PG,25,CHI,2014,10,311.0,159,43,9,23,32,5,1,34,15,58,164,0.3536585365853658,16,47,0.3404255319148936,42,117,0.358974358974359,0.402,27,32,0.84375
Terrence Ross,rosste01,SG,22,TOR,2014,81,2159.0,879,79,43,209,252,64,27,88,183,318,751,0.4234354194407457,161,408,0.3946078431372549,157,343,0.4577259475218659,0.531,82,98,0.8367346938775511
Ricky Rubio,rubiori01,PG,23,MIN,2014,82,2638.0,781,704,61,281,342,191,11,221,218,255,670,0.3805970149253731,44,133,0.3308270676691729,211,537,0.3929236499068901,0.413,227,283,0.8021201413427562
Brandon Rush,rushbr01,SG,28,UTA,2014,38,418.0,79,24,5,39,44,5,9,20,31,30,90,0.3333333333333333,16,47,0.3404255319148936,14,43,0.3255813953488372,0.422,3,5,0.6
Robert Sacre,sacrero01,C,24,LAL,2014,65,1089.0,350,51,82,172,254,24,47,44,134,143,300,0.4766666666666667,0,0,0.0,143,300,0.4766666666666667,0.477,64,94,0.6808510638297872
John Salmons,salmojo01,SG-SF,34,TOT,2014,78,1726.0,403,147,20,143,163,47,19,54,124,150,413,0.3631961259079903,63,163,0.3865030674846625,87,250,0.348,0.439,40,52,0.7692307692307693
Larry Sanders,sandela01,C,25,MIL,2014,23,584.0,178,19,60,105,165,18,40,26,74,76,162,0.4691358024691358,0,1,0.0,76,161,0.4720496894409938,0.469,26,55,0.4727272727272727
Dennis Schröder,schrode01,PG,20,ATL,2014,49,641.0,183,93,5,55,60,17,0,61,54,72,188,0.3829787234042553,10,42,0.238095238095238,62,146,0.4246575342465753,0.41,29,43,0.6744186046511628
Luis Scola,scolalu01,PF,33,IND,2014,82,1399.0,626,81,86,305,391,26,16,108,164,263,560,0.4696428571428571,1,7,0.1428571428571428,262,553,0.4737793851717902,0.471,99,136,0.7279411764705882
Mike Scott,scottmi01,PF,25,ATL,2014,80,1482.0,767,75,62,222,284,30,7,79,121,301,628,0.4792993630573248,62,200,0.31,239,428,0.5584112149532711,0.529,103,132,0.7803030303030303
Thabo Sefolosha,sefolth01,SG,29,OKC,2014,61,1584.0,383,94,50,170,220,79,17,55,90,141,340,0.4147058823529412,48,152,0.3157894736842105,93,188,0.4946808510638298,0.485,53,69,0.7681159420289855
Kevin Séraphin,serapke01,C,24,WAS,2014,53,578.0,249,17,53,75,128,3,26,41,103,111,220,0.5045454545454545,0,0,0.0,111,220,0.5045454545454545,0.505,27,31,0.8709677419354839
Ramon Sessions,sessira01,PG,27,TOT,2014,83,2214.0,1021,340,38,165,203,49,9,148,90,330,769,0.4291287386215864,35,124,0.282258064516129,295,645,0.4573643410852713,0.452,326,404,0.806930693069307
Mustafa Shakur,shakumu01,PG,29,OKC,2014,3,11.0,1,4,0,0,0,0,0,2,2,0,3,0.0,0,1,0.0,0,2,0.0,0.0,1,2,0.5
Tornike Shengelia,shengto01,SF,22,TOT,2014,26,154.0,29,14,4,12,16,3,1,12,18,13,28,0.4642857142857143,0,6,0.0,13,22,0.5909090909090909,0.464,3,8,0.375
Iman Shumpert,shumpim01,SG,23,NYK,2014,74,1962.0,495,129,81,227,308,92,13,79,209,183,484,0.378099173553719,76,228,0.3333333333333333,107,256,0.41796875,0.457,53,71,0.7464788732394366
Alexey Shved,shvedal01,SG,25,MIN,2014,63,664.0,250,68,21,60,81,26,16,48,36,76,237,0.3206751054852321,30,102,0.2941176470588235,46,135,0.3407407407407407,0.384,68,90,0.7555555555555555
Henry Sims,simshe01,C,23,TOT,2014,46,875.0,350,52,104,133,237,28,20,41,116,130,274,0.4744525547445255,0,1,0.0,130,273,0.4761904761904761,0.474,90,121,0.743801652892562
Kyle Singler,singlky01,SF,25,DET,2014,82,2337.0,784,75,116,187,303,61,38,79,211,269,602,0.446843853820598,94,246,0.3821138211382114,175,356,0.4915730337078651,0.525,152,184,0.8260869565217391
Chris Singleton,singlch01,SF,24,WAS,2014,25,250.0,75,6,18,37,55,9,3,17,25,25,67,0.373134328358209,7,19,0.3684210526315789,18,48,0.375,0.425,18,25,0.72
Peyton Siva,sivape01,SG,23,DET,2014,24,224.0,54,34,2,12,14,9,1,18,27,18,57,0.3157894736842105,7,25,0.28,11,32,0.34375,0.377,11,15,0.7333333333333333
Donald Sloan,sloando01,SG,26,IND,2014,48,392.0,110,50,4,40,44,10,1,22,19,44,117,0.376068376068376,10,42,0.238095238095238,34,75,0.4533333333333333,0.419,12,20,0.6
Chris Smith,smithch05,PG,26,NYK,2014,2,2.0,0,0,0,0,0,0,0,0,0,0,0,0.0,0,0,0.0,0,0,0.0,0.0,0,0,0.0
Greg Smith,smithgr02,C,23,HOU,2014,11,100.0,38,0,11,16,27,1,2,5,17,18,28,0.6428571428571429,0,0,0.0,18,28,0.6428571428571429,0.643,2,5,0.4
Ish Smith,smithis01,PG,25,PHO,2014,70,1006.0,261,179,31,98,129,49,13,65,66,119,281,0.4234875444839858,1,23,0.0434782608695652,118,258,0.4573643410852713,0.425,22,39,0.5641025641025641
J.R. Smith,smithjr01,SF,28,NYK,2014,74,2421.0,1071,219,35,261,296,65,20,108,196,396,955,0.4146596858638743,189,480,0.39375,207,475,0.4357894736842105,0.514,90,138,0.6521739130434783
Jason Smith,smithja02,PF,27,NOP,2014,31,830.0,301,29,51,130,181,11,29,28,100,131,282,0.4645390070921986,0,0,0.0,131,282,0.4645390070921986,0.465,39,50,0.78
Josh Smith,smithjo03,SF,28,DET,2014,77,2730.0,1264,252,102,418,520,105,110,199,197,517,1233,0.4193025141930251,70,265,0.2641509433962264,447,968,0.4617768595041322,0.448,160,301,0.53156146179402
Tony Snell,snellto01,SG,22,CHI,2014,77,1231.0,346,68,19,105,124,29,15,44,84,129,336,0.3839285714285714,57,178,0.3202247191011236,72,158,0.4556962025316455,0.469,31,41,0.7560975609756098
James Southerland,southja01,SF,23,TOT,2014,4,30.0,14,0,0,8,8,1,2,1,3,5,15,0.3333333333333333,3,6,0.5,2,9,0.2222222222222222,0.433,1,2,0.5
Marreese Speights,speigma01,C,26,GSW,2014,79,982.0,508,32,101,189,290,10,34,66,148,195,442,0.4411764705882353,8,31,0.2580645161290322,187,411,0.4549878345498783,0.45,110,134,0.8208955223880597
Tiago Splitter,splitti01,C,29,SAS,2014,59,1271.0,483,90,123,240,363,29,31,75,117,181,346,0.523121387283237,0,3,0.0,181,343,0.5276967930029155,0.523,121,173,0.6994219653179191
D.J. Stephens,stephdj01,SG,23,MIL,2014,3,15.0,7,0,1,4,5,0,0,0,0,3,7,0.4285714285714285,0,0,0.0,3,7,0.4285714285714285,0.429,1,1,1.0
Lance Stephenson,stephla01,SG,23,IND,2014,78,2752.0,1080,359,95,463,558,54,7,210,195,427,870,0.4908045977011494,86,244,0.3524590163934426,341,626,0.5447284345047924,0.54,140,197,0.7106598984771574
Greg Stiemsma,stiemgr01,C,28,NOP,2014,55,1007.0,159,36,72,154,226,35,57,44,169,70,122,0.5737704918032787,0,1,0.0,70,121,0.5785123966942148,0.574,19,32,0.59375
Julyan Stone,stoneju01,SG,25,TOR,2014,21,120.0,18,12,2,18,20,3,0,5,13,7,17,0.4117647058823529,2,8,0.25,5,9,0.5555555555555556,0.471,2,3,0.6666666666666666
Amar'e Stoudemire,stoudam01,C,31,NYK,2014,65,1466.0,772,34,112,208,320,23,37,91,159,311,558,0.557347670250896,0,0,0.0,311,558,0.557347670250896,0.557,150,203,0.7389162561576355
Rodney Stuckey,stuckro01,SG,27,DET,2014,73,1950.0,1012,152,39,130,169,54,10,125,131,372,853,0.4361078546307151,24,88,0.2727272727272727,348,765,0.4549019607843137,0.45,244,292,0.8356164383561644
Jared Sullinger,sullija01,PF,21,BOS,2014,74,2041.0,982,118,241,360,601,35,49,119,251,384,899,0.4271412680756396,56,208,0.2692307692307692,328,691,0.4746743849493487,0.458,158,203,0.7783251231527094
Jeff Taylor,tayloje03,SF,24,CHA,2014,26,629.0,208,22,15,45,60,13,5,25,62,82,218,0.3761467889908257,18,67,0.2686567164179104,64,151,0.423841059602649,0.417,26,47,0.5531914893617021
Tyshawn Taylor,tayloty01,PG,23,BRK,2014,23,270.0,89,36,3,12,15,12,1,31,29,31,91,0.3406593406593406,3,12,0.25,28,79,0.3544303797468354,0.357,24,30,0.8
Jeff Teague,teaguje01,PG,25,ATL,2014,79,2542.0,1304,528,34,174,208,89,17,232,158,456,1040,0.4384615384615384,74,225,0.3288888888888889,382,815,0.4687116564417178,0.474,318,376,0.8457446808510638
Marquis Teague,teaguma01,SG,20,TOT,2014,40,443.0,107,58,1,39,40,10,5,39,46,38,119,0.3193277310924369,5,18,0.2777777777777778,33,101,0.3267326732673267,0.34,26,35,0.7428571428571429
Mirza Teletović,teletmi01,SF,28,BRK,2014,72,1396.0,622,57,60,206,266,29,23,54,143,221,529,0.4177693761814744,136,349,0.3896848137535816,85,180,0.4722222222222222,0.546,44,62,0.7096774193548387
Garrett Temple,templga01,SG,27,WAS,2014,75,638.0,138,72,21,47,68,35,11,42,72,51,141,0.3617021276595745,6,29,0.2068965517241379,45,112,0.4017857142857143,0.383,30,43,0.6976744186046512
Jason Terry,terryja01,PG,36,BRK,2014,35,570.0,159,56,4,33,37,13,0,27,48,55,152,0.3618421052631579,39,103,0.3786407766990291,16,49,0.3265306122448979,0.49,10,15,0.6666666666666666
Hasheem Thabeet,thabeha01,C,26,OKC,2014,23,192.0,27,1,9,31,40,4,9,14,47,13,23,0.5652173913043478,0,0,0.0,13,23,0.5652173913043478,0.565,1,5,0.2
Adonis Thomas,thomaad01,SF,20,TOT,2014,6,37.0,14,3,0,3,3,0,0,1,6,6,14,0.4285714285714285,1,5,0.2,5,9,0.5555555555555556,0.464,1,1,1.0
Isaiah Thomas,thomais02,PG,24,SAC,2014,72,2497.0,1465,454,47,163,210,93,8,213,185,496,1096,0.4525547445255474,127,364,0.3489010989010989,369,732,0.5040983606557377,0.51,346,407,0.8501228501228502
Lance Thomas,thomala01,SF,25,NOP,2014,5,42.0,6,3,2,5,7,0,0,2,4,2,9,0.2222222222222222,0,0,0.0,2,9,0.2222222222222222,0.222,2,4,0.5
Malcolm Thomas,thomama01,PF,25,TOT,2014,8,63.0,15,2,5,16,21,0,3,9,5,7,16,0.4375,1,4,0.25,6,12,0.5,0.469,0,2,0.0
Hollis Thompson,thompho01,SF,22,PHI,2014,77,1742.0,461,73,73,174,247,53,12,60,144,171,372,0.4596774193548387,67,167,0.4011976047904191,104,205,0.5073170731707317,0.55,52,73,0.7123287671232876
Jason Thompson,thompja02,PF,27,SAC,2014,82,2007.0,586,53,153,374,527,32,56,95,251,251,496,0.5060483870967742,0,0,0.0,251,496,0.5060483870967742,0.506,84,145,0.5793103448275863
Klay Thompson,thompkl01,SG,23,GSW,2014,81,2868.0,1488,181,38,211,249,74,37,135,234,559,1259,0.4440031771247021,223,535,0.416822429906542,336,724,0.4640883977900552,0.533,147,185,0.7945945945945946
Tristan Thompson,thomptr01,PF,22,CLE,2014,82,2594.0,961,72,269,485,754,42,35,108,188,363,761,0.4770039421813403,0,1,0.0,363,760,0.4776315789473684,0.477,235,339,0.6932153392330384
Marcus Thornton,thornma01,SG,26,TOT,2014,72,1741.0,703,77,57,141,198,58,11,67,110,252,639,0.3943661971830985,109,316,0.3449367088607595,143,323,0.4427244582043343,0.48,90,112,0.8035714285714286
Jamaal Tinsley,tinslja01,PG,35,UTA,2014,8,110.0,9,23,2,9,11,2,0,9,10,4,20,0.2,1,15,0.0666666666666666,3,5,0.6,0.225,0,0,0.0
Anthony Tolliver,tollian01,PF,28,CHA,2014,64,1298.0,393,42,33,135,168,19,15,23,82,129,307,0.4201954397394137,102,247,0.4129554655870445,27,60,0.45,0.586,33,41,0.8048780487804879
P.J. Tucker,tuckepj01,SF,28,PHO,2014,81,2490.0,760,141,161,368,529,110,23,102,204,265,615,0.4308943089430894,74,191,0.387434554973822,191,424,0.4504716981132075,0.491,156,201,0.7761194029850746
Ronny Turiaf,turiaro01,C,31,MIN,2014,31,606.0,149,24,55,119,174,8,50,24,65,64,107,0.5981308411214953,0,0,0.0,64,107,0.5981308411214953,0.598,21,50,0.42
Hedo Türkoğlu,turkohe01,SF,34,LAC,2014,38,392.0,115,33,11,78,89,19,10,16,50,42,109,0.3853211009174312,22,50,0.44,20,59,0.3389830508474576,0.486,9,18,0.5
Evan Turner,turneev01,SF,25,TOT,2014,81,2457.0,1131,262,62,346,408,67,7,189,195,434,1021,0.4250734573947111,50,156,0.3205128205128205,384,865,0.4439306358381503,0.45,213,262,0.8129770992366412
Jeremy Tyler,tylerje01,C,22,NYK,2014,41,398.0,146,8,38,71,109,6,20,26,70,60,116,0.5172413793103449,0,0,0.0,60,116,0.5172413793103449,0.517,26,48,0.5416666666666666
Ekpe Udoh,udohek01,PF,26,MIL,2014,42,804.0,144,31,61,87,148,15,44,38,96,57,143,0.3986013986013986,0,0,0.0,57,143,0.3986013986013986,0.399,30,47,0.6382978723404256
Beno Udrih,udrihbe01,SG,31,TOT,2014,41,643.0,200,116,10,49,59,23,4,47,50,78,178,0.4382022471910112,19,42,0.4523809523809524,59,136,0.4338235294117647,0.492,25,30,0.8333333333333334
Jonas Valančiūnas,valanjo01,C,21,TOR,2014,81,2282.0,916,57,226,488,714,24,71,136,249,359,676,0.5310650887573964,0,1,0.0,359,675,0.5318518518518518,0.531,198,260,0.7615384615384615
Anderson Varejão,varejan01,C,31,CLE,2014,65,1800.0,546,140,187,442,629,69,39,72,164,227,459,0.494553376906318,0,7,0.0,227,452,0.5022123893805309,0.495,92,135,0.6814814814814815
Jarvis Varnado,varnaja01,PF,25,TOT,2014,24,339.0,99,13,19,44,63,10,29,10,62,36,60,0.6,0,0,0.0,36,60,0.6,0.6,27,52,0.5192307692307693
Greivis Vásquez,vasqugr01,PG,27,TOT,2014,79,1779.0,758,323,20,153,173,31,5,128,143,277,658,0.4209726443768997,109,289,0.3771626297577855,168,369,0.4552845528455284,0.504,95,108,0.8796296296296297
Jan Veselý,veselja01,PF,23,TOT,2014,54,776.0,197,21,81,110,191,53,35,36,121,89,173,0.5144508670520231,0,0,0.0,89,173,0.5144508670520231,0.514,19,56,0.3392857142857143
Charlie Villanueva,villach01,PF,29,DET,2014,20,180.0,92,6,6,28,34,4,5,7,16,35,92,0.3804347826086957,14,56,0.25,21,36,0.5833333333333334,0.457,8,14,0.5714285714285714
Nikola Vučević,vucevni01,C,23,ORL,2014,57,1812.0,811,104,185,441,626,60,47,112,169,353,696,0.507183908045977,0,0,0.0,353,696,0.507183908045977,0.507,105,137,0.7664233576642335
Sasha Vujačić,vujacsa01,SG,29,LAC,2014,2,10.0,5,0,0,3,3,1,0,3,1,2,5,0.4,1,2,0.5,1,3,0.3333333333333333,0.5,0,0,0.0
Dwyane Wade,wadedw01,SG,32,MIA,2014,54,1775.0,1028,252,60,181,241,79,29,161,106,415,761,0.545335085413929,9,32,0.28125,406,729,0.5569272976680384,0.551,189,258,0.7325581395348837
Dion Waiters,waitedi01,SG,22,CLE,2014,70,2072.0,1113,209,32,163,195,63,17,154,153,430,993,0.4330312185297079,92,250,0.368,338,743,0.4549125168236878,0.479,161,235,0.6851063829787234
Kemba Walker,walkeke02,PG,23,CHA,2014,73,2614.0,1289,447,39,267,306,86,32,169,128,449,1143,0.3928258967629046,109,327,0.3333333333333333,340,816,0.4166666666666667,0.441,282,337,0.8367952522255193
John Wall,walljo01,PG,23,WAS,2014,82,2980.0,1583,721,38,295,333,149,40,295,219,579,1337,0.4330590875093493,108,308,0.3506493506493506,471,1029,0.4577259475218659,0.473,317,394,0.8045685279187818
Gerald Wallace,wallage01,SF,31,BOS,2014,58,1416.0,298,143,36,176,212,73,14,97,79,116,230,0.5043478260869565,19,64,0.296875,97,166,0.5843373493975904,0.546,47,101,0.4653465346534653
Casper Ware,wareca01,PG,24,PHI,2014,9,116.0,48,10,0,9,9,8,0,5,11,18,42,0.4285714285714285,7,21,0.3333333333333333,11,21,0.5238095238095238,0.512,5,6,0.8333333333333334
C.J. Watson,watsocj01,PG,29,IND,2014,63,1193.0,414,107,19,82,101,60,8,60,66,146,334,0.437125748502994,53,145,0.3655172413793103,93,189,0.492063492063492,0.516,69,88,0.7840909090909091
Earl Watson,watsoea01,PG,34,POR,2014,24,161.0,12,28,5,10,15,5,1,17,33,3,11,0.2727272727272727,2,7,0.2857142857142857,1,4,0.25,0.364,4,4,1.0
Maalik Wayns,waynsma01,PG,22,LAC,2014,2,9.0,2,2,0,2,2,2,0,0,4,1,2,0.5,0,0,0.0,1,2,0.5,0.5,0,0,0.0
Martell Webster,webstma02,SF,27,WAS,2014,78,2157.0,759,97,38,184,222,41,15,58,150,254,587,0.4327086882453151,146,372,0.3924731182795699,108,215,0.5023255813953489,0.557,105,125,0.84
David West,westda01,PF,33,IND,2014,80,2472.0,1118,223,120,422,542,61,74,133,186,458,939,0.4877529286474973,4,15,0.2666666666666666,454,924,0.4913419913419913,0.49,198,251,0.7888446215139442
Russell Westbrook,westbru01,PG,25,OKC,2014,46,1412.0,1002,319,55,208,263,88,7,177,104,346,791,0.4374209860935524,68,214,0.3177570093457944,278,577,0.4818024263431542,0.48,242,293,0.825938566552901
D.J. White,whitedj01,PF,27,CHA,2014,2,10.0,0,0,0,2,2,1,0,0,1,0,1,0.0,0,0,0.0,0,1,0.0,0.0,0,0,0.0
Royce White,whitero03,PF,22,SAC,2014,3,9.0,0,0,0,0,0,0,0,0,2,0,1,0.0,0,0,0.0,0,1,0.0,0.0,0,0,0.0
Deron Williams,willide01,PG,29,BRK,2014,64,2059.0,915,392,15,153,168,93,13,143,148,322,716,0.4497206703910614,98,268,0.3656716417910448,224,448,0.5,0.518,173,216,0.8009259259259259
Derrick Williams,willide02,SF-PF,22,TOT,2014,78,1820.0,624,56,71,252,323,48,20,76,114,206,482,0.4273858921161825,26,99,0.2626262626262626,180,383,0.4699738903394256,0.454,186,259,0.7181467181467182
Elliot Williams,williel01,SG,24,PHI,2014,67,1157.0,404,72,30,100,130,35,3,68,126,140,337,0.4154302670623145,37,125,0.296,103,212,0.4858490566037736,0.47,87,119,0.7310924369747899
Lou Williams,willilo02,PG,27,ATL,2014,60,1445.0,625,210,10,114,124,45,4,92,65,197,493,0.3995943204868154,79,231,0.341991341991342,118,262,0.4503816793893129,0.48,152,179,0.8491620111731844
Marvin Williams,willima02,PF,27,UTA,2014,66,1674.0,603,78,82,252,334,54,31,53,151,231,526,0.4391634980988593,84,234,0.358974358974359,147,292,0.5034246575342466,0.519,57,73,0.7808219178082192
Mo Williams,willima01,PG,31,POR,2014,74,1834.0,721,321,42,111,153,55,10,149,197,280,672,0.4166666666666667,83,225,0.3688888888888889,197,447,0.4407158836689038,0.478,78,89,0.8764044943820225
Reggie Williams,willire02,SF,27,OKC,2014,3,17.0,11,1,0,0,0,1,0,2,1,5,9,0.5555555555555556,1,3,0.3333333333333333,4,6,0.6666666666666666,0.611,0,0,0.0
Shawne Williams,willish03,PF,27,LAL,2014,36,751.0,202,30,25,142,167,19,30,21,93,73,192,0.3802083333333333,42,129,0.3255813953488372,31,63,0.492063492063492,0.49,14,20,0.7
Jeff Withey,witheje01,C,23,NOP,2014,58,684.0,190,26,49,101,150,15,50,20,73,69,129,0.5348837209302325,0,1,0.0,69,128,0.5390625,0.535,52,73,0.7123287671232876
Nate Wolters,woltena01,PG,22,MIL,2014,58,1309.0,417,187,33,116,149,35,15,57,67,170,389,0.4370179948586118,18,62,0.2903225806451613,152,327,0.4648318042813456,0.46,59,90,0.6555555555555556
Metta World Peace,artesro01,SF,34,NYK,2014,29,388.0,139,17,18,41,59,24,8,19,44,56,141,0.3971631205673759,17,54,0.3148148148148148,39,87,0.4482758620689655,0.457,10,16,0.625
Brandan Wright,wrighbr03,C,26,DAL,2014,58,1077.0,525,31,102,142,244,32,55,35,94,224,331,0.676737160120846,0,0,0.0,224,331,0.676737160120846,0.677,77,106,0.7264150943396226
Chris Wright,wrighch01,SF,25,MIL,2014,8,126.0,48,5,10,10,20,7,5,5,17,21,35,0.6,0,1,0.0,21,34,0.6176470588235294,0.6,6,15,0.4
Dorell Wright,wrighdo01,SF,28,POR,2014,68,984.0,343,64,29,162,191,23,16,39,62,111,297,0.3737373737373737,69,202,0.3415841584158416,42,95,0.4421052631578947,0.49,52,69,0.7536231884057971
Tony Wroten,wroteto01,PG,20,PHI,2014,72,1765.0,939,217,69,159,228,78,16,204,151,345,808,0.4269801980198019,40,188,0.2127659574468085,305,620,0.4919354838709677,0.452,209,326,0.6411042944785276
Nick Young,youngni01,SG,28,LAL,2014,64,1810.0,1144,95,29,137,166,46,12,95,156,387,889,0.4353205849268841,135,350,0.3857142857142857,252,539,0.4675324675324675,0.511,235,285,0.8245614035087719
Thaddeus Young,youngth01,PF,25,PHI,2014,79,2718.0,1417,182,166,310,476,167,36,165,213,582,1283,0.4536243180046765,90,292,0.3082191780821918,492,991,0.496468213925328,0.489,163,229,0.7117903930131004
Cody Zeller,zelleco01,C,21,CHA,2014,82,1416.0,490,92,118,235,353,40,41,87,170,172,404,0.4257425742574257,0,1,0.0,172,403,0.4267990074441687,0.426,146,200,0.73
Tyler Zeller,zellety01,C,24,CLE,2014,70,1049.0,399,36,103,179,282,18,38,60,137,156,290,0.5379310344827586,0,1,0.0,156,289,0.5397923875432526,0.538,87,121,0.71900826446281
Quincy Acy,acyqu01,PF,24,NYK,2015,68,1287.0,398,68,79,222,301,27,22,60,147,152,331,0.459214501510574,18,60,0.3,134,271,0.4944649446494465,0.486,76,97,0.7835051546391752
Jordan Adams,adamsjo01,SG,20,MEM,2015,30,248.0,94,16,9,19,28,16,7,14,24,35,86,0.4069767441860465,10,25,0.4,25,61,0.4098360655737705,0.465,14,23,0.6086956521739131
Steven Adams,adamsst01,C,21,OKC,2015,70,1771.0,537,66,199,324,523,38,86,99,222,217,399,0.543859649122807,0,2,0.0,217,397,0.5465994962216625,0.544,103,205,0.5024390243902439
Jeff Adrien,adrieje01,PF,28,MIN,2015,17,215.0,60,15,23,54,77,4,9,9,30,19,44,0.4318181818181818,0,0,0.0,19,44,0.4318181818181818,0.432,22,38,0.5789473684210527
Arron Afflalo,afflaar01,SG,29,TOT,2015,78,2502.0,1035,129,27,220,247,41,7,116,167,375,884,0.4242081447963801,118,333,0.3543543543543543,257,551,0.4664246823956443,0.491,167,198,0.8434343434343434
Alexis Ajinça,ajincal01,C,26,NOP,2015,68,957.0,443,47,104,211,315,21,51,69,151,181,329,0.5501519756838906,0,0,0.0,181,329,0.5501519756838906,0.55,81,99,0.8181818181818182
Furkan Aldemir,aldemfu01,PF,23,PHI,2015,41,540.0,93,28,78,98,176,17,16,17,96,40,78,0.5128205128205128,0,5,0.0,40,73,0.547945205479452,0.513,13,27,0.4814814814814814
Cole Aldrich,aldrico01,C,26,NYK,2015,61,976.0,338,75,101,237,338,37,65,59,122,144,301,0.4784053156146179,0,0,0.0,144,301,0.4784053156146179,0.478,50,64,0.78125
LaMarcus Aldridge,aldrila01,PF,29,POR,2015,71,2512.0,1661,124,177,549,726,48,68,122,125,659,1415,0.4657243816254417,37,105,0.3523809523809524,622,1310,0.4748091603053435,0.479,306,362,0.8453038674033149
Lavoy Allen,allenla01,C,25,IND,2015,63,1070.0,315,73,123,200,323,15,42,40,102,141,299,0.471571906354515,0,0,0.0,141,299,0.471571906354515,0.472,33,47,0.7021276595744681
Tony Allen,allento01,SG,33,MEM,2015,63,1648.0,539,86,103,177,280,129,30,86,166,225,455,0.4945054945054945,10,29,0.3448275862068966,215,426,0.5046948356807511,0.505,79,126,0.626984126984127
Al-Farouq Aminu,aminual01,SF,24,DAL,2015,74,1366.0,412,59,114,228,342,70,62,55,137,147,357,0.4117647058823529,34,124,0.2741935483870967,113,233,0.4849785407725321,0.459,84,118,0.711864406779661
Lou Amundson,amundlo01,PF,32,TOT,2015,53,937.0,259,70,94,174,268,22,52,62,126,109,255,0.4274509803921568,0,1,0.0,109,254,0.4291338582677165,0.427,41,87,0.4712643678160919
Chris Andersen,anderch01,C,36,MIA,2015,60,1132.0,320,43,76,223,299,26,61,40,88,120,207,0.5797101449275363,4,13,0.3076923076923077,116,194,0.5979381443298969,0.589,76,114,0.6666666666666666
Alan Anderson,anderal01,SG,32,BRK,2015,74,1744.0,545,83,31,173,204,56,5,60,148,195,440,0.4431818181818182,73,210,0.3476190476190476,122,230,0.5304347826086957,0.526,82,101,0.8118811881188119
Kyle Anderson,anderky01,SF,21,SAS,2015,33,358.0,74,28,5,67,72,15,7,10,28,31,89,0.348314606741573,3,11,0.2727272727272727,28,78,0.358974358974359,0.365,9,14,0.6428571428571429
Ryan Anderson,anderry01,PF,26,NOP,2015,61,1675.0,833,55,108,187,295,33,20,62,113,291,729,0.3991769547325103,122,359,0.3398328690807799,169,370,0.4567567567567567,0.483,129,151,0.8543046357615894
Giannis Antetokounmpo,antetgi01,SG,20,MIL,2015,81,2541.0,1030,207,100,442,542,73,85,173,254,383,780,0.491025641025641,7,44,0.1590909090909091,376,736,0.5108695652173914,0.496,257,347,0.7406340057636888
Carmelo Anthony,anthoca01,SF,30,NYK,2015,40,1428.0,966,122,72,192,264,40,17,89,87,358,806,0.4441687344913151,61,179,0.3407821229050279,297,627,0.4736842105263157,0.482,189,237,0.7974683544303798
Joel Anthony,anthojo01,C,32,DET,2015,49,406.0,87,5,32,61,93,12,49,12,55,36,62,0.5806451612903226,0,0,0.0,36,62,0.5806451612903226,0.581,15,22,0.6818181818181818
Pero Antić,anticpe01,C,32,ATL,2015,63,1037.0,356,49,58,131,189,18,14,49,132,108,296,0.3648648648648648,52,173,0.3005780346820809,56,123,0.4552845528455284,0.453,88,123,0.7154471544715447
Trevor Ariza,arizatr01,SF,29,HOU,2015,82,2930.0,1048,209,77,382,459,152,17,141,186,366,910,0.4021978021978022,194,555,0.3495495495495495,172,355,0.4845070422535211,0.509,122,143,0.8531468531468531
Darrell Arthur,arthuda01,PF,26,DEN,2015,58,988.0,382,57,53,118,171,48,26,47,146,155,384,0.4036458333333333,26,110,0.2363636363636363,129,274,0.4708029197080292,0.438,46,59,0.7796610169491526
Ömer Aşık,asikom01,C,28,NOP,2015,76,1982.0,557,72,244,504,748,29,54,95,144,213,412,0.5169902912621359,0,0,0.0,213,412,0.5169902912621359,0.517,131,225,0.5822222222222222
D.J. Augustin,augusdj01,PG,27,TOT,2015,82,1964.0,777,353,20,141,161,49,3,145,93,258,647,0.3987635239567233,83,246,0.3373983739837398,175,401,0.4364089775561097,0.463,178,205,0.8682926829268293
Jeff Ayres,pendeje02,PF,27,SAS,2015,51,383.0,137,14,37,80,117,8,8,26,60,55,95,0.5789473684210527,0,0,0.0,55,95,0.5789473684210527,0.579,27,36,0.75
Luke Babbitt,babbilu01,SF,25,NOP,2015,63,830.0,256,24,12,99,111,17,11,26,63,92,192,0.4791666666666667,59,115,0.5130434782608696,33,77,0.4285714285714285,0.633,13,19,0.6842105263157895
Cameron Bairstow,bairsca01,PF,24,CHI,2015,18,64.0,10,1,6,2,8,2,1,3,8,3,14,0.2142857142857142,0,0,0.0,3,14,0.2142857142857142,0.214,4,5,0.8
Leandro Barbosa,barbole01,SG,32,GSW,2015,66,982.0,467,99,23,68,91,41,8,44,87,183,386,0.4740932642487047,43,112,0.3839285714285714,140,274,0.5109489051094891,0.53,58,74,0.7837837837837838
J.J. Barea,bareajo01,PG,30,DAL,2015,77,1362.0,580,263,23,111,134,33,1,70,104,225,536,0.4197761194029851,54,167,0.3233532934131736,171,369,0.4634146341463415,0.47,76,94,0.8085106382978723
Andrea Bargnani,bargnan01,C,29,NYK,2015,29,785.0,430,46,32,95,127,2,27,42,53,164,361,0.4542936288088642,15,41,0.3658536585365853,149,320,0.465625,0.475,87,107,0.8130841121495327
Harrison Barnes,barneha02,SF,22,GSW,2015,82,2318.0,827,116,117,336,453,61,19,71,146,316,656,0.4817073170731707,87,215,0.4046511627906977,229,441,0.5192743764172335,0.548,108,150,0.72
Matt Barnes,barnema02,SF,34,LAC,2015,76,2271.0,764,114,51,251,302,67,50,87,240,277,624,0.4439102564102564,136,376,0.3617021276595745,141,248,0.5685483870967742,0.553,74,95,0.7789473684210526
Earl Barron,barroea01,C,33,PHO,2015,16,143.0,32,5,14,14,28,4,2,5,26,12,39,0.3076923076923077,2,4,0.5,10,35,0.2857142857142857,0.333,6,12,0.5
Will Barton,bartowi01,SG,24,TOT,2015,58,983.0,397,81,26,136,162,48,19,61,70,150,353,0.4249291784702549,23,85,0.2705882352941176,127,268,0.4738805970149253,0.458,74,94,0.7872340425531915
Brandon Bass,bassbr01,PF,29,BOS,2015,82,1929.0,866,104,139,259,398,41,32,83,140,344,683,0.5036603221083455,9,32,0.28125,335,651,0.5145929339477726,0.51,169,214,0.7897196261682243
Nicolas Batum,batumni01,SF,26,POR,2015,71,2380.0,664,341,62,354,416,78,40,132,106,240,600,0.4,100,309,0.3236245954692556,140,291,0.4810996563573883,0.483,84,98,0.8571428571428571
Jerryd Bayless,bayleje01,PG,26,MIL,2015,77,1717.0,598,233,22,189,211,59,12,133,163,220,516,0.4263565891472868,37,120,0.3083333333333333,183,396,0.4621212121212121,0.462,121,137,0.8832116788321168
Aron Baynes,baynear01,C,28,SAS,2015,70,1122.0,461,35,109,209,318,16,22,65,162,185,327,0.5657492354740061,1,4,0.25,184,323,0.5696594427244582,0.567,90,104,0.8653846153846154
Kent Bazemore,bazemke01,SG,25,ATL,2015,75,1324.0,390,78,21,201,222,52,33,73,127,141,331,0.4259818731117825,48,132,0.3636363636363636,93,199,0.4673366834170854,0.498,60,100,0.6
Bradley Beal,bealbr01,SG,21,WAS,2015,63,2107.0,962,194,57,184,241,76,18,123,136,363,851,0.426556991774383,106,259,0.4092664092664093,257,592,0.4341216216216216,0.489,130,166,0.7831325301204819
Michael Beasley,beaslmi01,PF,26,MIA,2015,24,505.0,212,32,12,77,89,15,13,37,66,92,212,0.4339622641509434,8,34,0.2352941176470588,84,178,0.4719101123595505,0.453,20,26,0.7692307692307693
Marco Belinelli,belinma01,SG,28,SAS,2015,62,1388.0,568,94,26,131,157,31,3,61,85,199,470,0.4234042553191489,86,230,0.3739130434782609,113,240,0.4708333333333333,0.515,84,99,0.8484848484848485
Jerrelle Benimon,benimje01,PF,23,UTA,2015,2,3.0,0,0,1,2,3,0,0,1,0,0,0,0.0,0,0,0.0,0,0,0.0,0.0,0,0,0.0
Anthony Bennett,bennean01,PF,21,MIN,2015,57,894.0,298,48,52,164,216,27,16,36,87,125,297,0.4208754208754209,7,23,0.3043478260869565,118,274,0.4306569343065693,0.433,41,64,0.640625
Patrick Beverley,beverpa01,PG,26,HOU,2015,56,1727.0,568,192,67,170,237,59,23,83,182,204,532,0.3834586466165413,115,323,0.3560371517027864,89,209,0.4258373205741627,0.492,45,60,0.75
Sim Bhullar,bhullsi01,C,22,SAC,2015,3,3.0,2,1,0,1,1,0,1,0,0,1,2,0.5,0,0,0.0,1,2,0.5,0.5,0,0,0.0
Bismack Biyombo,biyombi01,C,22,CHO,2015,64,1243.0,304,16,159,248,407,18,99,52,140,101,186,0.543010752688172,0,0,0.0,101,186,0.543010752688172,0.543,102,175,0.5828571428571429
Tarik Black,blackta01,C,23,TOT,2015,63,1196.0,379,42,142,226,368,19,24,48,158,157,273,0.575091575091575,0,1,0.0,157,272,0.5772058823529411,0.575,65,118,0.5508474576271186
DeJuan Blair,blairde01,PF,25,WAS,2015,29,180.0,56,3,16,40,56,7,1,13,41,26,57,0.4561403508771929,0,0,0.0,26,57,0.4561403508771929,0.456,4,6,0.6666666666666666
Steve Blake,blakest01,PG,34,POR,2015,81,1529.0,350,288,16,121,137,41,5,104,118,122,327,0.3730886850152905,77,219,0.3515981735159817,45,108,0.4166666666666667,0.491,29,41,0.7073170731707317
Eric Bledsoe,bledser01,PG,25,PHO,2015,81,2800.0,1377,493,72,351,423,127,45,274,189,468,1046,0.4474187380497132,88,272,0.3235294117647059,380,774,0.4909560723514212,0.489,353,441,0.800453514739229
Vander Blue,blueva01,SG,22,LAL,2015,2,74.0,22,8,2,7,9,3,0,6,4,9,30,0.3,2,10,0.2,7,20,0.35,0.333,2,5,0.4
Bojan Bogdanović,bogdabo02,SF,25,BRK,2015,78,1854.0,700,68,50,163,213,34,9,78,104,261,576,0.453125,91,256,0.35546875,170,320,0.53125,0.532,87,106,0.8207547169811321
Andrew Bogut,bogutan01,C,30,GSW,2015,67,1583.0,422,180,141,402,543,39,113,106,188,200,355,0.5633802816901409,0,0,0.0,200,355,0.5633802816901409,0.563,22,42,0.5238095238095238
Matt Bonner,bonnema01,PF,34,SAS,2015,72,935.0,264,47,29,86,115,10,12,11,65,94,230,0.408695652173913,46,126,0.365079365079365,48,104,0.4615384615384615,0.509,30,37,0.8108108108108109
Trevor Booker,booketr01,PF,27,UTA,2015,79,1564.0,567,83,139,258,397,43,41,88,144,226,464,0.4870689655172414,29,84,0.3452380952380952,197,380,0.5184210526315789,0.518,86,148,0.581081081081081
Carlos Boozer,boozeca01,PF,33,LAL,2015,71,1692.0,836,95,111,371,482,41,12,92,184,371,743,0.4993270524899058,0,0,0.0,371,743,0.4993270524899058,0.499,94,150,0.6266666666666667
Chris Bosh,boshch01,C,30,MIA,2015,44,1556.0,928,95,46,264,310,41,25,95,69,343,745,0.4604026845637584,63,168,0.375,280,577,0.4852686308492201,0.503,179,232,0.771551724137931
Avery Bradley,bradlav01,SG,24,BOS,2015,77,2428.0,1071,135,46,195,241,82,15,109,177,434,1012,0.4288537549407115,124,352,0.3522727272727273,310,660,0.4696969696969697,0.49,79,100,0.79
Elton Brand,brandel01,C,35,ATL,2015,36,486.0,96,22,28,72,100,17,25,18,54,42,95,0.4421052631578947,0,1,0.0,42,94,0.4468085106382978,0.442,12,23,0.5217391304347826
Corey Brewer,breweco01,SF,28,TOT,2015,80,2087.0,917,173,80,217,297,114,19,131,173,343,805,0.4260869565217391,63,235,0.2680851063829787,280,570,0.4912280701754385,0.465,168,226,0.7433628318584071
Aaron Brooks,brookaa01,PG,30,CHI,2015,82,1885.0,954,261,32,134,166,54,15,157,189,344,817,0.4210526315789473,121,313,0.3865814696485623,223,504,0.4424603174603174,0.495,145,174,0.8333333333333334
Jabari Brown,brownja01,SG,22,LAL,2015,19,568.0,227,40,3,33,36,12,2,32,33,70,170,0.4117647058823529,23,62,0.3709677419354839,47,108,0.4351851851851852,0.479,64,85,0.7529411764705882
Lorenzo Brown,brownlo01,PG,24,MIN,2015,29,549.0,122,90,14,56,70,28,6,30,49,52,122,0.4262295081967213,6,28,0.2142857142857142,46,94,0.4893617021276595,0.451,12,19,0.631578947368421
Markel Brown,brownma02,SG,23,BRK,2015,47,781.0,216,39,16,91,107,31,12,27,57,76,210,0.3619047619047619,17,64,0.265625,59,146,0.4041095890410959,0.402,47,57,0.8245614035087719
Shannon Brown,brownsh01,SG,29,MIA,2015,5,89.0,20,3,0,1,1,4,0,4,8,7,19,0.3684210526315789,3,7,0.4285714285714285,4,12,0.3333333333333333,0.447,3,4,0.75
Kobe Bryant,bryanko01,SG,36,LAL,2015,35,1207.0,782,197,26,173,199,47,7,128,65,266,713,0.3730715287517531,54,184,0.2934782608695652,212,529,0.4007561436672968,0.411,196,241,0.8132780082987552
Chase Budinger,budinch01,SF,26,MIN,2015,67,1286.0,457,64,33,165,198,44,10,49,72,169,390,0.4333333333333333,52,143,0.3636363636363636,117,247,0.4736842105263157,0.5,67,81,0.8271604938271605
Reggie Bullock,bullore01,SF,23,TOT,2015,36,338.0,69,8,1,49,50,10,4,8,19,24,70,0.3428571428571428,15,46,0.3260869565217391,9,24,0.375,0.45,6,9,0.6666666666666666
Trey Burke,burketr01,PG,22,UTA,2015,76,2288.0,973,328,31,173,204,65,15,124,119,370,1005,0.3681592039800995,124,390,0.3179487179487179,246,615,0.4,0.43,109,145,0.7517241379310344
Alec Burks,burksal01,SG,23,UTA,2015,27,899.0,374,82,19,95,114,17,5,52,64,121,300,0.4033333333333333,26,68,0.3823529411764705,95,232,0.4094827586206896,0.447,106,129,0.8217054263565892
Caron Butler,butleca01,SF,34,DET,2015,78,1623.0,460,79,21,175,196,43,4,49,120,161,396,0.4065656565656566,83,219,0.3789954337899543,78,177,0.4406779661016949,0.511,55,61,0.9016393442622952
Jimmy Butler,butleji01,SG,25,CHI,2015,65,2513.0,1301,212,114,265,379,114,36,93,108,421,912,0.4616228070175439,73,193,0.3782383419689119,348,719,0.4840055632823365,0.502,386,463,0.8336933045356372
Rasual Butler,butlera01,SF,35,WAS,2015,75,1505.0,580,63,27,170,197,29,22,48,98,218,517,0.4216634429400386,91,235,0.3872340425531915,127,282,0.450354609929078,0.51,53,67,0.7910447761194029
Dwight Buycks,buyckdw01,PG,25,LAL,2015,6,123.0,52,14,2,10,12,3,0,12,3,18,40,0.45,7,11,0.6363636363636364,11,29,0.3793103448275862,0.538,9,10,0.9
Will Bynum,bynumwi01,SG,32,WAS,2015,7,67.0,22,18,2,4,6,1,1,8,9,10,31,0.3225806451612903,0,9,0.0,10,22,0.4545454545454545,0.323,2,4,0.5
Bruno Caboclo,cabocbr01,SF,19,TOR,2015,8,23.0,10,0,1,1,2,0,1,4,3,4,12,0.3333333333333333,2,3,0.6666666666666666,2,9,0.2222222222222222,0.417,0,0,0.0
Nick Calathes,calatni01,SG,25,MEM,2015,58,838.0,243,146,19,87,106,63,5,61,100,104,247,0.4210526315789473,11,43,0.2558139534883721,93,204,0.4558823529411764,0.443,24,45,0.5333333333333333
José Calderón,caldejo01,PG,33,NYK,2015,42,1270.0,382,198,19,105,124,31,0,75,76,147,354,0.4152542372881356,59,142,0.4154929577464789,88,212,0.4150943396226415,0.499,29,32,0.90625
Kentavious Caldwell-Pope,caldwke01,SG,21,DET,2015,82,2587.0,1043,109,46,209,255,93,18,94,161,390,972,0.4012345679012346,153,444,0.3445945945945945,237,528,0.4488636363636363,0.48,110,158,0.6962025316455697
Isaiah Canaan,canaais01,PG,23,TOT,2015,47,938.0,432,98,18,69,87,29,3,62,83,146,378,0.3862433862433862,91,246,0.3699186991869919,55,132,0.4166666666666667,0.507,49,60,0.8166666666666667
Clint Capela,capelca01,C,20,HOU,2015,12,90.0,32,2,10,26,36,1,9,5,14,14,29,0.4827586206896552,0,0,0.0,14,29,0.4827586206896552,0.483,4,23,0.1739130434782608
DeMarre Carroll,carrode01,SF,28,ATL,2015,70,2189.0,883,118,99,273,372,94,17,75,154,318,653,0.4869831546707504,120,304,0.3947368421052631,198,349,0.5673352435530086,0.579,127,181,0.7016574585635359
Vince Carter,cartevi01,SG,38,MEM,2015,66,1091.0,384,79,27,106,133,43,14,43,102,135,406,0.3325123152709359,69,232,0.2974137931034483,66,174,0.3793103448275862,0.417,45,57,0.7894736842105263
Michael Carter-Williams,cartemi01,PG,23,TOT,2015,66,2149.0,966,442,64,289,353,111,30,253,167,364,919,0.3960826985854189,36,153,0.2352941176470588,328,766,0.4281984334203655,0.416,202,291,0.6941580756013745
Omri Casspi,casspom01,SF,26,SAC,2015,67,1416.0,593,102,54,206,260,31,9,88,107,209,427,0.4894613583138173,35,87,0.4022988505747126,174,340,0.5117647058823529,0.53,140,191,0.7329842931937173
Mario Chalmers,chalmma01,PG,28,MIA,2015,80,2368.0,813,307,24,182,206,122,10,173,251,267,663,0.4027149321266968,73,248,0.2943548387096774,194,415,0.4674698795180723,0.458,206,266,0.7744360902255639
Tyson Chandler,chandty01,C,32,DAL,2015,75,2286.0,771,84,294,570,864,42,91,105,169,293,440,0.6659090909090909,0,0,0.0,293,440,0.6659090909090909,0.666,185,257,0.7198443579766537
Wilson Chandler,chandwi01,SF,27,DEN,2015,78,2471.0,1085,134,96,379,475,58,29,110,231,418,975,0.4287179487179487,139,406,0.3423645320197044,279,569,0.4903339191564148,0.5,110,142,0.7746478873239436
Will Cherry,cherrwi01,PG,23,CLE,2015,8,69.0,15,8,1,4,5,6,1,4,10,5,19,0.2631578947368421,2,9,0.2222222222222222,3,10,0.3,0.316,3,6,0.5
Patrick Christopher,chrispa01,SG,26,UTA,2015,4,29.0,6,0,2,4,6,1,0,1,6,3,12,0.25,0,4,0.0,3,8,0.375,0.25,0,0,0.0
Earl Clark,clarkea01,PF,27,BRK,2015,10,93.0,27,3,1,22,23,3,4,6,12,11,30,0.3666666666666666,4,14,0.2857142857142857,7,16,0.4375,0.433,1,4,0.25
Ian Clark,clarkia01,SG,23,TOT,2015,30,192.0,57,12,4,12,16,9,3,9,20,19,55,0.3454545454545454,10,30,0.3333333333333333,9,25,0.36,0.436,9,9,1.0
Jordan Clarkson,clarkjo01,PG,22,LAL,2015,59,1476.0,703,206,56,135,191,51,12,96,109,267,596,0.447986577181208,38,121,0.3140495867768595,229,475,0.4821052631578947,0.48,131,158,0.8291139240506329
Victor Claver,clavevi01,SF,26,POR,2015,10,76.0,24,1,3,17,20,1,1,4,12,9,20,0.45,6,11,0.5454545454545454,3,9,0.3333333333333333,0.6,0,0,0.0
Norris Cole,coleno01,PG,26,TOT,2015,75,1831.0,573,255,13,146,159,57,15,99,124,230,558,0.4121863799283154,55,176,0.3125,175,382,0.4581151832460733,0.461,58,81,0.7160493827160493
Darren Collison,collida01,PG,27,SAC,2015,45,1565.0,725,252,19,124,143,67,14,112,95,260,550,0.4727272727272727,60,161,0.3726708074534161,200,389,0.5141388174807198,0.527,145,184,0.7880434782608695
Nick Collison,collini01,PF,34,OKC,2015,66,1101.0,273,90,90,160,250,35,25,45,156,106,253,0.4189723320158103,16,60,0.2666666666666666,90,193,0.466321243523316,0.451,45,65,0.6923076923076923
Mike Conley,conlemi01,PG,27,MEM,2015,70,2225.0,1107,375,29,180,209,89,14,156,139,393,882,0.445578231292517,107,277,0.3862815884476534,286,605,0.4727272727272727,0.506,214,249,0.8594377510040161
Jack Cooley,cooleja01,C,23,UTA,2015,16,87.0,27,1,10,15,25,6,3,3,23,9,22,0.4090909090909091,0,0,0.0,9,22,0.4090909090909091,0.409,9,21,0.4285714285714285
Chris Copeland,copelch01,SF,30,IND,2015,50,828.0,309,51,23,88,111,11,11,59,78,112,310,0.3612903225806451,52,167,0.311377245508982,60,143,0.4195804195804196,0.445,33,45,0.7333333333333333
Bryce Cotton,cottobr01,PG,22,UTA,2015,15,159.0,80,15,3,15,18,4,0,12,6,29,69,0.4202898550724637,7,20,0.35,22,49,0.4489795918367347,0.471,15,18,0.8333333333333334
DeMarcus Cousins,couside01,C,24,SAC,2015,59,2013.0,1421,210,185,562,747,90,103,254,241,498,1066,0.4671669793621013,2,8,0.25,496,1058,0.4688090737240075,0.468,423,541,0.7818853974121996
Robert Covington,covinro01,SF,24,PHI,2015,70,1956.0,943,105,65,251,316,97,31,128,189,299,756,0.3955026455026455,167,446,0.3744394618834081,132,310,0.4258064516129032,0.506,178,217,0.8202764976958525
Allen Crabbe,crabbal01,SG,22,POR,2015,51,683.0,168,39,7,66,73,19,15,15,74,63,153,0.4117647058823529,30,85,0.3529411764705882,33,68,0.4852941176470588,0.51,12,16,0.75
Jamal Crawford,crawfja01,SG,34,LAC,2015,64,1703.0,1010,158,18,106,124,59,14,92,108,332,839,0.3957091775923719,119,364,0.3269230769230769,213,475,0.4484210526315789,0.467,227,252,0.9007936507936508
Jae Crowder,crowdja01,SF,24,TOT,2015,82,1647.0,628,94,72,221,293,72,25,49,137,229,545,0.4201834862385321,61,208,0.2932692307692308,168,337,0.4985163204747774,0.476,109,141,0.7730496453900709
Dante Cunningham,cunnida01,PF,27,NOP,2015,66,1652.0,340,50,70,186,256,46,37,35,101,155,339,0.4572271386430678,1,10,0.1,154,329,0.4680851063829787,0.459,29,47,0.6170212765957447
Jared Cunningham,cunnija01,SG,23,LAC,2015,19,89.0,35,10,1,8,9,3,0,7,12,12,33,0.3636363636363636,4,13,0.3076923076923077,8,20,0.4,0.424,7,13,0.5384615384615384
Seth Curry,curryse01,PG,24,PHO,2015,2,8.0,0,1,0,2,2,0,0,0,2,0,3,0.0,0,1,0.0,0,2,0.0,0.0,0,0,0.0
Stephen Curry,curryst01,PG,26,GSW,2015,80,2613.0,1900,619,56,285,341,163,16,249,158,653,1341,0.4869500372856077,286,646,0.4427244582043343,367,695,0.5280575539568345,0.594,308,337,0.913946587537092
Samuel Dalembert,dalemsa01,C,33,NYK,2015,32,544.0,128,29,53,115,168,14,41,39,70,57,130,0.4384615384615384,0,0,0.0,57,130,0.4384615384615384,0.438,14,20,0.7
Troy Daniels,danietr01,SG,23,TOT,2015,47,397.0,176,22,8,25,33,6,1,20,40,61,165,0.3696969696969697,43,118,0.3644067796610169,18,47,0.3829787234042553,0.5,11,13,0.8461538461538461
Gigi Datome,datomlu01,SF,27,TOT,2015,21,209.0,105,9,3,26,29,2,7,9,15,43,89,0.4831460674157303,18,40,0.45,25,49,0.5102040816326531,0.584,1,1,1.0
Brandon Davies,daviebr01,PF,23,TOT,2015,27,423.0,142,30,38,45,83,18,7,29,59,55,137,0.4014598540145985,8,34,0.2352941176470588,47,103,0.4563106796116505,0.431,24,37,0.6486486486486487
Anthony Davis,davisan02,PF,21,NOP,2015,68,2455.0,1656,149,173,523,696,100,200,95,141,642,1199,0.5354462051709759,1,12,0.0833333333333333,641,1187,0.540016849199663,0.536,371,461,0.8047722342733189
Ed Davis,davised01,PF,25,LAL,2015,79,1840.0,656,94,230,370,600,49,98,58,202,282,469,0.6012793176972282,0,0,0.0,282,469,0.6012793176972282,0.601,92,189,0.4867724867724867
Glen Davis,davisgl01,PF,29,LAC,2015,74,904.0,294,39,43,126,169,41,21,39,132,117,255,0.4588235294117647,0,4,0.0,117,251,0.4661354581673306,0.459,60,95,0.631578947368421
Andre Dawkins,dawkian01,SG,23,MIA,2015,4,22.0,3,1,0,2,2,0,0,1,3,1,6,0.1666666666666666,1,6,0.1666666666666666,0,0,0.0,0.25,0,0,0.0
Austin Daye,dayeau01,SF,26,TOT,2015,34,344.0,129,17,10,65,75,12,5,23,39,50,141,0.3546099290780142,24,71,0.3380281690140845,26,70,0.3714285714285714,0.44,5,6,0.8333333333333334
Dewayne Dedmon,dedmode01,C,25,ORL,2015,59,845.0,216,9,118,177,295,16,50,51,141,91,162,0.5617283950617284,0,1,0.0,91,161,0.5652173913043478,0.562,34,64,0.53125
Matthew Dellavedova,dellama01,SG,24,CLE,2015,67,1380.0,319,204,37,89,126,24,2,61,152,111,307,0.3615635179153094,68,167,0.4071856287425149,43,140,0.3071428571428571,0.472,29,38,0.7631578947368421
Luol Deng,denglu01,SF,29,MIA,2015,72,2421.0,1007,139,103,273,376,65,22,108,109,369,787,0.4688691232528589,78,220,0.3545454545454545,291,567,0.5132275132275133,0.518,191,251,0.7609561752988048
DeMar DeRozan,derozde01,SG,25,TOR,2015,60,2100.0,1204,210,41,236,277,73,11,137,122,409,990,0.4131313131313131,25,88,0.2840909090909091,384,902,0.425720620842572,0.426,361,434,0.8317972350230415
Boris Diaw,diawbo01,PF,32,SAS,2015,81,1984.0,708,233,78,270,348,36,23,126,148,291,632,0.4604430379746835,54,169,0.3195266272189349,237,463,0.5118790496760259,0.503,72,93,0.7741935483870968
Gorgui Dieng,dienggo01,C,25,MIN,2015,73,2193.0,710,146,223,386,609,71,126,126,188,259,512,0.505859375,1,6,0.1666666666666666,258,506,0.5098814229249012,0.507,191,244,0.7827868852459017
Spencer Dinwiddie,dinwisp01,PG,21,DET,2015,34,455.0,145,104,4,44,48,19,6,33,53,51,169,0.301775147928994,12,65,0.1846153846153846,39,104,0.375,0.337,31,34,0.9117647058823528
Joey Dorsey,dorsejo01,PF,31,HOU,2015,69,854.0,184,25,103,176,279,40,25,41,157,80,145,0.5517241379310345,0,1,0.0,80,144,0.5555555555555556,0.552,24,83,0.2891566265060241
Toney Douglas,douglto01,SG,28,NOP,2015,12,177.0,51,24,2,20,22,11,4,10,20,19,51,0.3725490196078431,5,18,0.2777777777777778,14,33,0.4242424242424242,0.422,8,13,0.6153846153846154
Chris Douglas-Roberts,douglch01,SG,28,LAC,2015,12,103.0,19,4,1,11,12,1,0,0,14,5,21,0.238095238095238,1,7,0.1428571428571428,4,14,0.2857142857142857,0.262,8,8,1.0
Goran Dragić,dragigo01,SG-PG,28,TOT,2015,78,2640.0,1275,350,81,193,274,78,15,173,195,502,1002,0.500998003992016,90,259,0.3474903474903475,412,743,0.5545087483176312,0.546,181,234,0.7735042735042735
Zoran Dragić,dragizo01,SG,25,TOT,2015,16,75.0,28,5,5,3,8,2,0,5,6,11,30,0.3666666666666666,3,14,0.2142857142857142,8,16,0.5,0.417,3,5,0.6
Larry Drew II,drewla02,PG,24,PHI,2015,12,219.0,46,45,1,14,15,6,0,25,13,20,58,0.3448275862068966,4,26,0.1538461538461538,16,32,0.5,0.379,2,3,0.6666666666666666
Andre Drummond,drumman01,C,21,DET,2015,82,2502.0,1130,55,437,667,1104,73,153,120,285,494,961,0.514047866805411,0,2,0.0,494,959,0.5151199165797706,0.514,142,365,0.3890410958904109
Jared Dudley,dudleja01,SG,29,MIL,2015,72,1717.0,518,130,45,175,220,72,11,62,113,198,423,0.4680851063829787,74,192,0.3854166666666667,124,231,0.5367965367965368,0.556,48,67,0.7164179104477612
Tim Duncan,duncati01,C,38,SAS,2015,77,2227.0,1070,230,170,534,704,63,151,131,165,419,819,0.5115995115995116,2,7,0.2857142857142857,417,812,0.5135467980295566,0.513,230,311,0.7395498392282959
Mike Dunleavy,dunlemi02,SF,34,CHI,2015,63,1838.0,595,114,28,220,248,39,21,60,123,209,481,0.4345114345114345,107,263,0.4068441064638783,102,218,0.4678899082568807,0.546,70,87,0.8045977011494253
Kevin Durant,duranke01,SF,26,OKC,2015,27,913.0,686,110,16,162,178,24,25,74,40,238,467,0.5096359743040685,64,159,0.4025157232704403,174,308,0.564935064935065,0.578,146,171,0.8538011695906432
Cleanthony Early,earlycl01,SF,23,NYK,2015,39,647.0,210,36,22,75,97,24,12,40,57,76,214,0.3551401869158878,22,84,0.2619047619047619,54,130,0.4153846153846154,0.407,36,48,0.75
Wayne Ellington,ellinwa01,SG,27,LAL,2015,65,1675.0,650,105,31,179,210,33,2,50,77,254,617,0.4116693679092382,90,243,0.3703703703703703,164,374,0.4385026737967914,0.485,52,64,0.8125
Monta Ellis,ellismo01,SG,29,DAL,2015,80,2699.0,1513,329,34,156,190,148,25,198,197,602,1354,0.4446085672082718,81,284,0.2852112676056338,521,1070,0.4869158878504673,0.475,228,303,0.7524752475247525
James Ennis III,ennisja01,SF,24,MIA,2015,62,1051.0,312,48,51,125,176,25,17,39,89,101,247,0.4089068825910931,31,95,0.3263157894736842,70,152,0.4605263157894737,0.472,79,94,0.8404255319148937
Tyler Ennis,ennisty01,PG,20,TOT,2015,33,411.0,121,73,7,28,35,18,5,42,36,52,144,0.3611111111111111,12,43,0.2790697674418604,40,101,0.396039603960396,0.403,5,7,0.7142857142857143
Jeremy Evans,evansje01,SF,27,UTA,2015,38,266.0,90,13,26,45,71,11,12,5,29,32,58,0.5517241379310345,2,5,0.4,30,53,0.5660377358490566,0.569,24,29,0.8275862068965517
Reggie Evans,evansre01,PF,34,SAC,2015,47,764.0,176,32,97,202,299,22,5,45,91,58,137,0.4233576642335766,0,2,0.0,58,135,0.4296296296296296,0.423,60,97,0.6185567010309279
Tyreke Evans,evansty01,SG,25,NOP,2015,79,2690.0,1313,521,82,334,416,100,37,246,198,521,1165,0.4472103004291845,69,227,0.3039647577092511,452,938,0.4818763326226012,0.477,202,291,0.6941580756013745
Dante Exum,exumda01,PG,19,UTA,2015,82,1817.0,393,198,27,104,131,41,14,118,147,145,416,0.3485576923076923,83,264,0.3143939393939394,62,152,0.4078947368421052,0.448,20,32,0.625
Festus Ezeli,ezelife01,C,25,GSW,2015,46,504.0,201,9,60,95,155,7,42,32,77,76,139,0.5467625899280576,0,0,0.0,76,139,0.5467625899280576,0.547,49,78,0.6282051282051282
Kenneth Faried,farieke01,PF,25,DEN,2015,75,2086.0,946,89,242,426,668,62,57,118,211,373,736,0.5067934782608695,1,8,0.125,372,728,0.510989010989011,0.507,199,288,0.6909722222222222
Jordan Farmar,farmajo01,PG,28,LAC,2015,36,529.0,167,67,8,34,42,20,5,32,52,61,158,0.3860759493670886,35,97,0.3608247422680412,26,61,0.4262295081967213,0.497,10,11,0.9090909090909092
Derrick Favors,favorde01,PF,23,UTA,2015,74,2280.0,1187,112,196,411,607,60,123,121,210,482,918,0.5250544662309368,1,6,0.1666666666666666,481,912,0.5274122807017544,0.526,222,332,0.6686746987951807
Raymond Felton,feltora01,PG,30,DAL,2015,29,281.0,108,41,2,24,26,11,4,18,17,43,106,0.4056603773584906,10,34,0.2941176470588235,33,72,0.4583333333333333,0.453,12,15,0.8
Landry Fields,fieldla01,SF,26,TOR,2015,26,216.0,46,15,10,16,26,11,0,8,9,20,41,0.4878048780487805,1,2,0.5,19,39,0.4871794871794871,0.5,5,6,0.8333333333333334
Evan Fournier,fournev01,SG,22,ORL,2015,58,1661.0,698,120,28,125,153,40,2,82,116,253,575,0.44,85,225,0.3777777777777777,168,350,0.48,0.514,107,147,0.7278911564625851
Randy Foye,foyera01,SG,31,DEN,2015,50,1087.0,435,119,9,76,85,34,11,60,97,148,402,0.3681592039800995,94,263,0.3574144486692015,54,139,0.3884892086330935,0.485,45,55,0.8181818181818182
Jamaal Franklin,frankja01,SG,23,DEN,2015,3,13.0,3,3,1,1,2,0,1,3,4,1,2,0.5,1,2,0.5,0,0,0.0,0.75,0,0,0.0
Tim Frazier,fraziti01,PG,24,TOT,2015,11,239.0,57,60,6,22,28,8,0,25,26,21,61,0.3442622950819672,5,17,0.2941176470588235,16,44,0.3636363636363636,0.385,10,21,0.4761904761904761
Jimmer Fredette,fredeji01,PG,25,NOP,2015,50,509.0,178,58,8,32,40,15,2,33,43,63,166,0.3795180722891566,9,48,0.1875,54,118,0.4576271186440678,0.407,43,45,0.9555555555555556
Enes Freedom,kanteen01,C,22,TOT,2015,75,2135.0,1163,55,277,394,671,36,29,145,189,482,928,0.5193965517241379,16,45,0.3555555555555555,466,883,0.5277463193657984,0.528,183,234,0.782051282051282
Joel Freeland,freeljo01,C,27,POR,2015,48,617.0,169,16,62,129,191,9,23,23,93,74,151,0.4900662251655629,0,0,0.0,74,151,0.4900662251655629,0.49,21,25,0.84
Channing Frye,fryech01,PF,31,ORL,2015,75,1870.0,549,94,27,266,293,47,39,78,191,191,487,0.3921971252566735,136,346,0.3930635838150289,55,141,0.3900709219858156,0.532,31,35,0.8857142857142857
Danilo Gallinari,gallida01,SF,26,DEN,2015,59,1426.0,734,83,31,187,218,47,20,57,94,228,568,0.4014084507042254,107,301,0.3554817275747508,121,267,0.4531835205992509,0.496,171,191,0.8952879581151832
Langston Galloway,gallola01,PG,23,NYK,2015,45,1457.0,533,150,37,153,190,52,12,61,129,204,511,0.3992172211350293,62,176,0.3522727272727273,142,335,0.4238805970149253,0.46,63,78,0.8076923076923077
Francisco García,garcifr01,SF,33,HOU,2015,14,200.0,45,15,3,14,17,9,5,10,20,17,63,0.2698412698412698,10,45,0.2222222222222222,7,18,0.3888888888888889,0.349,1,4,0.25
Kevin Garnett,garneke01,PF,38,TOT,2015,47,952.0,323,77,48,263,311,46,17,46,109,143,306,0.4673202614379085,1,7,0.1428571428571428,142,299,0.4749163879598662,0.469,36,45,0.8
Marc Gasol,gasolma01,C,30,MEM,2015,81,2687.0,1413,307,115,515,630,70,131,176,208,530,1072,0.4944029850746269,3,17,0.1764705882352941,527,1055,0.4995260663507109,0.496,350,440,0.7954545454545454
Pau Gasol,gasolpa01,PF,34,CHI,2015,78,2681.0,1446,210,220,699,919,25,147,158,147,570,1153,0.4943625325238508,12,26,0.4615384615384615,558,1127,0.4951197870452529,0.5,294,366,0.8032786885245902
Rudy Gay,gayru01,SF,28,SAC,2015,68,2408.0,1432,250,98,301,399,71,41,183,157,508,1116,0.4551971326164875,79,220,0.359090909090909,429,896,0.4787946428571428,0.491,337,393,0.8575063613231552
Alonzo Gee,geeal01,SF,27,TOT,2015,54,662.0,241,25,37,57,94,35,7,33,58,87,186,0.4677419354838709,13,35,0.3714285714285714,74,151,0.4900662251655629,0.503,54,77,0.7012987012987013
Paul George,georgpa01,SF,24,IND,2015,6,91.0,53,6,4,18,22,5,1,12,11,18,49,0.3673469387755102,9,22,0.4090909090909091,9,27,0.3333333333333333,0.459,8,11,0.7272727272727273
Taj Gibson,gibsota01,PF,29,CHI,2015,62,1692.0,640,71,162,234,396,36,75,77,162,254,506,0.5019762845849802,0,0,0.0,254,506,0.5019762845849802,0.502,132,184,0.717391304347826
Manu Ginóbili,ginobma01,SG,37,SAS,2015,70,1587.0,738,293,28,183,211,67,20,154,138,251,589,0.4261460101867572,89,258,0.3449612403100775,162,331,0.4894259818731117,0.502,147,204,0.7205882352941176
Rudy Gobert,goberru01,C,22,UTA,2015,82,2158.0,686,109,265,510,775,64,189,111,175,258,427,0.6042154566744731,0,2,0.0,258,425,0.6070588235294118,0.604,170,273,0.6227106227106227
Drew Gooden,goodedr01,PF,33,WAS,2015,51,864.0,277,49,72,151,223,21,9,28,91,110,276,0.3985507246376811,23,59,0.3898305084745763,87,217,0.4009216589861751,0.44,34,44,0.7727272727272727
Archie Goodwin,goodwar01,SG,20,PHO,2015,41,535.0,231,44,27,47,74,18,9,48,55,79,201,0.3930348258706467,12,41,0.2926829268292683,67,160,0.41875,0.423,61,83,0.7349397590361446
Aaron Gordon,gordoaa01,PF,19,ORL,2015,47,797.0,243,33,46,123,169,21,22,38,83,93,208,0.4471153846153846,13,48,0.2708333333333333,80,160,0.5,0.478,44,61,0.7213114754098361
Ben Gordon,gordobe01,SG,31,ORL,2015,56,790.0,349,50,6,57,63,14,1,55,60,129,295,0.4372881355932203,35,97,0.3608247422680412,94,198,0.4747474747474747,0.497,56,67,0.835820895522388
Drew Gordon,gordodr01,PF,24,PHI,2015,9,71.0,17,2,7,11,18,1,0,8,7,8,19,0.4210526315789473,0,3,0.0,8,16,0.5,0.421,1,2,0.5
Eric Gordon,gordoer01,SG,26,NOP,2015,61,2018.0,818,229,28,131,159,50,14,122,145,285,694,0.4106628242074928,141,315,0.4476190476190476,144,379,0.3799472295514511,0.512,107,133,0.8045112781954887
Marcin Gortat,gortama01,C,30,WAS,2015,82,2453.0,1001,97,180,537,717,49,110,100,191,439,775,0.5664516129032258,0,3,0.0,439,772,0.5686528497409327,0.566,123,175,0.7028571428571428
Danny Granger,grangda01,SF,31,MIA,2015,30,613.0,188,17,20,60,80,13,6,24,67,65,162,0.4012345679012346,30,84,0.3571428571428571,35,78,0.4487179487179487,0.494,28,37,0.7567567567567568
Jerami Grant,grantje01,SF,20,PHI,2015,65,1377.0,411,79,49,149,198,40,68,85,144,124,352,0.3522727272727273,49,156,0.3141025641025641,75,196,0.3826530612244898,0.422,114,193,0.5906735751295337
Danny Green,greenda02,SG,27,SAS,2015,81,2312.0,946,158,54,289,343,101,87,93,163,322,738,0.4363143631436314,191,457,0.4179431072210066,131,281,0.4661921708185053,0.566,111,127,0.8740157480314961
Draymond Green,greendr01,PF,24,GSW,2015,79,2490.0,921,291,114,533,647,123,99,133,253,339,765,0.4431372549019607,111,329,0.3373860182370821,228,436,0.5229357798165137,0.516,132,200,0.66
Erick Green,greener01,PG,23,DEN,2015,43,410.0,146,39,7,24,31,12,0,14,26,61,162,0.3765432098765432,14,47,0.2978723404255319,47,115,0.408695652173913,0.42,10,12,0.8333333333333334
Gerald Green,greenge01,SG,29,PHO,2015,74,1446.0,884,91,33,153,186,42,12,104,145,324,778,0.416452442159383,137,387,0.3540051679586563,187,391,0.4782608695652174,0.504,99,120,0.825
JaMychal Green,greenja01,PF,24,TOT,2015,24,164.0,62,4,19,26,45,5,5,14,25,27,47,0.574468085106383,0,6,0.0,27,41,0.6585365853658537,0.574,8,10,0.8
Jeff Green,greenje02,SF,28,TOT,2015,78,2454.0,1168,134,64,264,328,53,34,108,147,416,967,0.4301964839710445,97,292,0.3321917808219178,319,675,0.4725925925925926,0.48,239,287,0.8327526132404182
Willie Green,greenwi01,SG,33,ORL,2015,52,951.0,306,68,14,65,79,26,5,48,81,118,306,0.3856209150326797,42,121,0.3471074380165289,76,185,0.4108108108108108,0.454,28,34,0.8235294117647058
Blake Griffin,griffbl01,PF,25,LAC,2015,67,2356.0,1469,354,126,382,508,63,35,152,196,574,1144,0.5017482517482518,10,25,0.4,564,1119,0.5040214477211796,0.506,311,427,0.7283372365339579
Jorge Gutiérrez,gutiejo01,PG,26,TOT,2015,20,175.0,53,22,5,20,25,6,0,12,25,22,41,0.5365853658536586,0,3,0.0,22,38,0.5789473684210527,0.537,9,13,0.6923076923076923
P.J. Hairston,hairspj02,SG,22,CHO,2015,45,687.0,254,21,22,70,92,21,13,22,61,87,269,0.3234200743494423,49,163,0.3006134969325153,38,106,0.3584905660377358,0.414,31,36,0.8611111111111112
Jordan Hamilton,hamiljo02,SF,24,LAC,2015,14,122.0,38,7,2,14,16,2,0,4,14,14,35,0.4,10,21,0.4761904761904761,4,14,0.2857142857142857,0.543,0,0,0.0
Justin Hamilton,hamilju01,C,24,TOT,2015,41,712.0,219,36,57,77,134,27,30,26,70,85,178,0.4775280898876404,10,31,0.3225806451612903,75,147,0.5102040816326531,0.506,39,47,0.8297872340425532
Tyler Hansbrough,hansbty01,PF,29,TOR,2015,74,1058.0,270,21,106,159,265,30,15,20,141,86,165,0.5212121212121212,1,7,0.1428571428571428,85,158,0.5379746835443038,0.524,97,139,0.697841726618705
Tim Hardaway Jr.,hardati02,SG,22,NYK,2015,70,1681.0,804,127,12,144,156,20,14,82,119,279,717,0.3891213389121339,121,354,0.3418079096045198,158,363,0.4352617079889807,0.474,125,156,0.8012820512820513
James Harden,hardeja01,SG,25,HOU,2015,81,2981.0,2217,565,75,384,459,154,60,321,208,647,1470,0.4401360544217687,208,555,0.3747747747747748,439,915,0.4797814207650273,0.511,715,824,0.8677184466019418
Maurice Harkless,harklma01,SF,21,ORL,2015,45,674.0,158,25,38,68,106,32,9,27,66,63,158,0.3987341772151899,10,56,0.1785714285714285,53,102,0.5196078431372549,0.43,22,41,0.5365853658536586
Devin Harris,harride01,PG,31,DAL,2015,76,1685.0,665,237,13,122,135,78,14,85,147,219,524,0.4179389312977099,95,266,0.3571428571428571,124,258,0.4806201550387597,0.509,132,162,0.8148148148148148
Gary Harris,harriga01,SG,20,DEN,2015,55,719.0,188,29,21,43,64,39,7,38,71,66,217,0.304147465437788,21,103,0.203883495145631,45,114,0.3947368421052631,0.353,35,47,0.7446808510638298
Joe Harris,harrijo01,SG,23,CLE,2015,51,493.0,136,26,7,34,41,7,2,27,62,48,120,0.4,31,84,0.369047619047619,17,36,0.4722222222222222,0.529,9,15,0.6
Tobias Harris,harrito02,SF,22,ORL,2015,68,2369.0,1164,124,73,357,430,69,36,115,134,442,949,0.4657534246575342,87,239,0.3640167364016736,355,710,0.5,0.512,193,245,0.7877551020408163
Udonis Haslem,hasleud01,PF,34,MIA,2015,62,995.0,261,46,71,187,258,21,13,41,113,107,239,0.4476987447698745,2,10,0.2,105,229,0.4585152838427948,0.452,45,64,0.703125
Spencer Hawes,hawessp01,PF,26,LAC,2015,73,1274.0,425,88,30,228,258,24,53,61,173,163,415,0.3927710843373494,55,176,0.3125,108,239,0.4518828451882845,0.459,44,68,0.6470588235294118
Chuck Hayes,hayesch01,C,31,TOR,2015,29,255.0,50,20,18,33,51,10,4,8,37,22,46,0.4782608695652174,0,0,0.0,22,46,0.4782608695652174,0.478,6,11,0.5454545454545454
Gordon Hayward,haywago01,SF,24,UTA,2015,76,2618.0,1463,313,54,319,373,108,30,206,131,484,1087,0.4452621895124195,120,330,0.3636363636363636,364,757,0.4808454425363276,0.5,375,462,0.8116883116883117
Brendan Haywood,haywobr01,C,35,CLE,2015,22,119.0,35,2,6,23,29,2,10,10,17,14,30,0.4666666666666667,0,0,0.0,14,30,0.4666666666666667,0.467,7,13,0.5384615384615384
Gerald Henderson,hendege02,SG,27,CHO,2015,80,2315.0,969,206,36,237,273,51,22,110,135,370,847,0.4368358913813459,45,136,0.3308823529411764,325,711,0.4571026722925457,0.463,184,217,0.847926267281106
Xavier Henry,henryxa01,SF,23,LAL,2015,9,86.0,20,3,2,2,4,3,0,3,6,3,13,0.2307692307692307,0,0,0.0,3,13,0.2307692307692307,0.231,14,24,0.5833333333333334
John Henson,hensojo01,C,24,MIL,2015,67,1228.0,470,59,124,188,312,28,135,87,152,196,346,0.5664739884393064,0,0,0.0,196,346,0.5664739884393064,0.566,78,137,0.5693430656934306
Roy Hibbert,hibbero01,C,28,IND,2015,76,1926.0,802,84,156,384,540,18,125,107,216,317,710,0.4464788732394366,0,2,0.0,317,708,0.4477401129943503,0.446,168,204,0.8235294117647058
J.J. Hickson,hicksjj01,C,26,DEN,2015,73,1411.0,552,57,150,302,452,36,35,96,136,218,459,0.4749455337690632,0,2,0.0,218,457,0.4770240700218818,0.475,116,201,0.5771144278606966
Nenê,hilarne01,PF,32,WAS,2015,67,1693.0,737,123,84,261,345,66,22,124,180,307,601,0.5108153078202995,1,5,0.2,306,596,0.5134228187919463,0.512,122,202,0.6039603960396039
George Hill,hillge01,PG,28,IND,2015,43,1267.0,692,220,25,154,179,44,14,69,111,255,535,0.4766355140186916,69,193,0.3575129533678756,186,342,0.543859649122807,0.541,113,143,0.7902097902097902
Jordan Hill,hilljo01,C,27,LAL,2015,70,1874.0,841,103,174,382,556,34,52,106,164,357,777,0.4594594594594595,3,11,0.2727272727272727,354,766,0.4621409921671018,0.461,124,168,0.7380952380952381
Solomon Hill,hillso01,SF,23,IND,2015,82,2381.0,729,184,70,244,314,66,18,115,177,251,634,0.3958990536277602,68,208,0.3269230769230769,183,426,0.4295774647887324,0.45,159,193,0.8238341968911918
Kirk Hinrich,hinriki01,SG,34,CHI,2015,66,1610.0,377,148,20,101,121,46,14,73,144,142,381,0.3727034120734908,58,168,0.3452380952380952,84,213,0.3943661971830985,0.449,35,50,0.7
Jrue Holiday,holidjr01,PG,24,NOP,2015,40,1303.0,592,274,32,103,135,63,23,91,110,238,534,0.445692883895131,51,135,0.3777777777777777,187,399,0.4686716791979949,0.493,65,76,0.8552631578947368
Justin Holiday,holidju01,SG,25,GSW,2015,59,657.0,254,48,12,61,73,40,12,29,54,91,235,0.3872340425531915,35,109,0.3211009174311927,56,126,0.4444444444444444,0.462,37,45,0.8222222222222222
Ryan Hollins,holliry01,C,30,SAC,2015,46,441.0,137,14,36,67,103,6,19,25,65,53,82,0.6463414634146342,0,0,0.0,53,82,0.6463414634146342,0.646,31,54,0.5740740740740741
Rodney Hood,hoodro01,SG,22,UTA,2015,50,1064.0,433,83,9,108,117,30,12,45,119,155,374,0.4144385026737968,62,170,0.3647058823529411,93,204,0.4558823529411764,0.497,61,80,0.7625
Al Horford,horfoal01,C,28,ATL,2015,76,2318.0,1156,244,131,413,544,68,98,100,121,519,965,0.5378238341968912,11,36,0.3055555555555556,508,929,0.5468245425188375,0.544,107,141,0.7588652482269503
Dwight Howard,howardw01,C,29,HOU,2015,41,1223.0,646,50,110,321,431,28,53,115,137,251,423,0.5933806146572104,1,2,0.5,250,421,0.5938242280285035,0.595,143,271,0.5276752767527675
Lester Hudson,hudsole01,SG,30,LAC,2015,5,56.0,18,5,1,7,8,6,1,3,4,6,14,0.4285714285714285,3,6,0.5,3,8,0.375,0.536,3,4,0.75
Robbie Hummel,hummero01,SF,25,MIN,2015,45,742.0,198,27,31,103,134,16,9,18,86,79,172,0.4593023255813953,16,51,0.3137254901960784,63,121,0.5206611570247934,0.506,24,29,0.8275862068965517
Kris Humphries,humphkr01,PF,29,WAS,2015,64,1345.0,509,57,118,298,416,34,25,46,130,211,446,0.4730941704035874,0,7,0.0,211,439,0.4806378132118451,0.473,87,117,0.7435897435897436
Serge Ibaka,ibakase01,PF,25,OKC,2015,64,2116.0,917,55,135,364,499,30,155,97,194,374,786,0.4758269720101781,77,205,0.375609756097561,297,581,0.5111876075731497,0.525,92,110,0.8363636363636363
Andre Iguodala,iguodan01,SF,31,GSW,2015,77,2069.0,604,228,44,213,257,89,25,88,100,231,496,0.4657258064516129,74,212,0.3490566037735849,157,284,0.5528169014084507,0.54,68,114,0.5964912280701754
Ersan İlyasova,ilyaser01,PF,27,MIL,2015,58,1319.0,669,56,80,197,277,36,19,45,149,263,557,0.4721723518850987,74,190,0.3894736842105263,189,367,0.5149863760217984,0.539,69,107,0.6448598130841121
Joe Ingles,inglejo01,SF,27,UTA,2015,79,1673.0,396,182,22,153,175,72,10,98,124,147,354,0.4152542372881356,72,202,0.3564356435643564,75,152,0.4934210526315789,0.517,30,40,0.75
Kyrie Irving,irvinky01,PG,22,CLE,2015,75,2730.0,1628,389,55,182,237,114,20,186,146,578,1235,0.4680161943319838,157,378,0.4153439153439153,421,857,0.4912485414235706,0.532,315,365,0.863013698630137
Jarrett Jack,jackja01,PG,31,BRK,2015,80,2241.0,957,373,19,226,245,75,13,191,143,359,817,0.4394124847001224,39,146,0.2671232876712329,320,671,0.4769001490312965,0.463,200,227,0.8810572687224669
Reggie Jackson,jacksre01,PG,24,TOT,2015,77,2268.0,1117,462,56,271,327,62,9,186,167,432,996,0.4337349397590361,72,241,0.2987551867219917,360,755,0.4768211920529801,0.47,181,218,0.8302752293577982
Bernard James,jamesbe01,C,29,DAL,2015,16,158.0,44,4,18,21,39,2,15,6,17,12,27,0.4444444444444444,0,0,0.0,12,27,0.4444444444444444,0.444,20,23,0.8695652173913043
LeBron James,jamesle01,SF,30,CLE,2015,69,2493.0,1743,511,51,365,416,109,49,272,135,624,1279,0.4878811571540266,120,339,0.3539823008849557,504,940,0.5361702127659574,0.535,375,528,0.7102272727272727
Al Jefferson,jeffeal01,C,30,CHO,2015,65,1992.0,1082,113,99,449,548,47,84,68,139,486,1010,0.4811881188118811,2,5,0.4,484,1005,0.481592039800995,0.482,108,165,0.6545454545454545
Cory Jefferson,jeffeco01,PF,24,BRK,2015,50,531.0,183,16,47,98,145,10,21,20,61,75,167,0.4491017964071856,2,15,0.1333333333333333,73,152,0.4802631578947368,0.455,31,54,0.5740740740740741
Richard Jefferson,jefferi01,SF,34,DAL,2015,74,1244.0,432,61,25,158,183,32,11,52,115,144,324,0.4444444444444444,66,155,0.4258064516129032,78,169,0.4615384615384615,0.546,78,114,0.6842105263157895
John Jenkins,jenkijo01,SG,23,ATL,2015,24,297.0,135,13,2,37,39,10,0,8,15,49,99,0.494949494949495,21,52,0.4038461538461538,28,47,0.5957446808510638,0.601,16,19,0.8421052631578947
Brandon Jennings,jennibr01,PG,25,DET,2015,41,1173.0,632,272,21,83,104,44,4,90,64,218,543,0.4014732965009208,76,211,0.3601895734597156,142,332,0.4277108433734939,0.471,120,143,0.8391608391608392
Jonas Jerebko,jerebjo01,PF,27,TOT,2015,75,1230.0,448,71,93,189,282,46,18,44,135,169,379,0.445910290237467,54,140,0.3857142857142857,115,239,0.4811715481171548,0.517,56,66,0.8484848484848485
Grant Jerrett,jerregr01,PF,21,TOT,2015,8,51.0,16,3,2,7,9,2,2,3,11,7,26,0.2692307692307692,1,15,0.0666666666666666,6,11,0.5454545454545454,0.288,1,1,1.0
Amir Johnson,johnsam01,PF,27,TOR,2015,75,1979.0,694,117,159,297,456,44,59,110,225,298,519,0.5741811175337187,19,46,0.4130434782608695,279,473,0.5898520084566596,0.592,79,129,0.6124031007751938
Chris Johnson,johnsch04,SF,24,TOT,2015,29,526.0,166,15,8,47,55,26,7,15,44,62,154,0.4025974025974026,28,95,0.2947368421052631,34,59,0.576271186440678,0.494,14,16,0.875
James Johnson,johnsja01,PF,27,TOR,2015,70,1370.0,554,95,61,196,257,54,70,79,155,238,404,0.5891089108910891,11,51,0.2156862745098039,227,353,0.6430594900849859,0.603,67,102,0.6568627450980392
Joe Johnson,johnsjo02,SG,33,BRK,2015,80,2791.0,1154,292,53,331,384,59,14,137,120,446,1025,0.4351219512195122,121,337,0.3590504451038576,325,688,0.4723837209302325,0.494,141,176,0.8011363636363636
Nick Johnson,johnsni01,SG,22,HOU,2015,28,262.0,74,11,13,26,39,7,3,19,34,26,75,0.3466666666666667,5,21,0.238095238095238,21,54,0.3888888888888889,0.38,17,25,0.68
Tyler Johnson,johnsty01,SG,22,MIA,2015,32,603.0,190,42,14,67,81,33,9,30,42,70,167,0.4191616766467065,18,48,0.375,52,119,0.4369747899159664,0.473,32,47,0.6808510638297872
Wesley Johnson,johnswe01,SF,27,LAL,2015,76,2245.0,753,124,67,252,319,59,45,87,162,286,691,0.4138929088277858,91,259,0.3513513513513513,195,432,0.4513888888888889,0.48,90,112,0.8035714285714286
Dahntay Jones,jonesda02,SF,34,LAC,2015,33,123.0,21,2,1,10,11,3,0,1,23,6,21,0.2857142857142857,0,4,0.0,6,17,0.3529411764705882,0.286,9,11,0.8181818181818182
James Jones,jonesja02,SF,34,CLE,2015,57,669.0,250,24,9,53,62,13,8,13,67,74,201,0.3681592039800995,63,175,0.36,11,26,0.4230769230769231,0.525,39,46,0.8478260869565217
Perry Jones,jonespe01,SF,23,OKC,2015,43,631.0,184,18,6,70,76,17,8,24,50,73,184,0.3967391304347826,14,60,0.2333333333333333,59,124,0.4758064516129032,0.435,24,37,0.6486486486486487
Terrence Jones,joneste01,PF,23,HOU,2015,33,889.0,386,36,78,142,220,18,59,37,78,158,299,0.5284280936454849,13,37,0.3513513513513513,145,262,0.5534351145038168,0.55,57,94,0.6063829787234043
DeAndre Jordan,jordade01,C,26,LAC,2015,82,2820.0,946,61,397,829,1226,81,183,109,245,379,534,0.7097378277153558,1,4,0.25,378,530,0.7132075471698113,0.711,187,471,0.3970276008492569
Jerome Jordan,jordaje01,C,28,BRK,2015,44,383.0,138,13,52,53,105,8,15,22,58,50,94,0.5319148936170213,0,0,0.0,50,94,0.5319148936170213,0.532,38,44,0.8636363636363636
Cory Joseph,josepco01,PG,23,SAS,2015,79,1444.0,535,188,44,148,192,46,17,67,105,207,411,0.5036496350364964,16,44,0.3636363636363636,191,367,0.5204359673024523,0.523,105,143,0.7342657342657343
Chris Kaman,kamanch01,C,32,POR,2015,74,1398.0,638,65,149,335,484,18,54,108,140,283,549,0.5154826958105647,0,0,0.0,283,549,0.5154826958105647,0.515,72,102,0.7058823529411765
Sergey Karasev,karasse01,SG,21,BRK,2015,33,555.0,153,46,22,44,66,23,1,24,45,54,134,0.4029850746268656,16,54,0.2962962962962963,38,80,0.475,0.463,29,38,0.7631578947368421
Ryan Kelly,kellyry01,PF,23,LAL,2015,52,1233.0,332,92,13,133,146,30,24,37,118,104,309,0.3365695792880259,45,134,0.3358208955223881,59,175,0.3371428571428571,0.409,79,95,0.8315789473684211
Michael Kidd-Gilchrist,kiddgmi01,SF,21,CHO,2015,55,1587.0,598,77,109,307,416,30,38,63,115,224,482,0.4647302904564315,0,0,0.0,224,482,0.4647302904564315,0.465,150,214,0.7009345794392523
Sean Kilpatrick,kilpase01,SG,25,MIN,2015,4,72.0,22,4,1,5,6,3,0,2,3,7,20,0.35,4,13,0.3076923076923077,3,7,0.4285714285714285,0.45,4,4,1.0
Andrei Kirilenko,kirilan01,SF,33,BRK,2015,7,36.0,3,1,2,6,8,1,0,1,1,0,5,0.0,0,0,0.0,0,5,0.0,0.0,3,4,0.75
Alex Kirk,kirkal01,C,23,CLE,2015,5,14.0,4,1,1,0,1,0,0,0,1,1,4,0.25,0,0,0.0,1,4,0.25,0.25,2,2,1.0
Brandon Knight,knighbr03,PG-SG,23,TOT,2015,63,2035.0,1070,330,28,216,244,90,10,189,114,375,888,0.4222972972972973,125,321,0.3894080996884735,250,567,0.4409171075837742,0.493,195,223,0.874439461883408
Kyle Korver,korveky01,SG,33,ATL,2015,75,2418.0,911,196,15,289,304,52,42,107,140,292,600,0.4866666666666667,221,449,0.4922048997772829,71,151,0.4701986754966887,0.671,106,118,0.8983050847457628
Kosta Koufos,koufoko01,C,25,MEM,2015,81,1348.0,419,37,121,305,426,29,63,69,148,182,358,0.5083798882681564,0,0,0.0,182,358,0.5083798882681564,0.508,55,85,0.6470588235294118
Ognjen Kuzmić,kuzmiog01,C,24,GSW,2015,16,72.0,20,6,7,10,17,2,1,5,13,8,12,0.6666666666666666,0,0,0.0,8,12,0.6666666666666666,0.667,4,4,1.0
Jeremy Lamb,lambje01,SG,22,OKC,2015,47,633.0,295,44,8,99,107,21,6,27,52,104,250,0.416,38,111,0.3423423423423423,66,139,0.4748201438848921,0.492,49,55,0.8909090909090909
Carl Landry,landrca01,PF,31,SAC,2015,70,1192.0,503,26,99,169,268,15,17,54,132,190,369,0.5149051490514905,0,0,0.0,190,369,0.5149051490514905,0.515,123,150,0.82
Shane Larkin,larkish01,PG,22,NYK,2015,76,1865.0,470,226,29,147,176,93,9,83,150,187,432,0.4328703703703703,35,116,0.3017241379310345,152,316,0.4810126582278481,0.473,61,78,0.782051282051282
Joffrey Lauvergne,lauvejo01,C,23,DEN,2015,24,268.0,93,13,27,50,77,8,10,22,43,36,89,0.4044943820224719,3,16,0.1875,33,73,0.4520547945205479,0.421,18,28,0.6428571428571429
Zach LaVine,lavinza01,PG,19,MIN,2015,77,1902.0,778,276,27,187,214,54,10,193,158,286,677,0.4224519940915805,57,167,0.3413173652694611,229,510,0.4490196078431372,0.465,149,177,0.8418079096045198
Ty Lawson,lawsoty01,PG,27,DEN,2015,75,2665.0,1143,720,42,192,234,92,9,185,128,404,926,0.4362850971922246,70,205,0.3414634146341463,334,721,0.463245492371706,0.474,265,363,0.7300275482093664
Ricky Ledo,ledori01,SG,22,TOT,2015,17,244.0,90,19,16,20,36,6,1,26,21,32,96,0.3333333333333333,10,27,0.3703703703703703,22,69,0.3188405797101449,0.385,16,22,0.7272727272727273
Courtney Lee,leeco01,SG,29,MEM,2015,77,2354.0,777,151,21,157,178,75,12,78,129,288,643,0.447900466562986,90,224,0.4017857142857143,198,419,0.4725536992840095,0.518,111,129,0.8604651162790697
David Lee,leeda02,PF,31,GSW,2015,49,904.0,388,85,81,176,257,31,26,49,83,160,313,0.5111821086261981,0,2,0.0,160,311,0.5144694533762058,0.511,68,104,0.6538461538461539
Malcolm Lee,leema01,SG,24,PHI,2015,1,2.0,0,0,0,0,0,0,0,0,0,0,1,0.0,0,0,0.0,0,1,0.0,0.0,0,0,0.0
Alex Len,lenal01,C,21,PHO,2015,69,1518.0,432,32,142,312,454,34,105,74,213,179,353,0.5070821529745042,1,3,0.3333333333333333,178,350,0.5085714285714286,0.508,73,104,0.7019230769230769
Kawhi Leonard,leonaka01,SF,23,SAS,2015,64,2033.0,1057,161,85,376,461,148,48,97,128,394,822,0.4793187347931874,67,192,0.3489583333333333,327,630,0.5190476190476191,0.52,202,252,0.8015873015873016
Meyers Leonard,leoname01,C,22,POR,2015,55,847.0,327,32,46,204,250,10,14,39,113,125,245,0.5102040816326531,47,112,0.4196428571428571,78,133,0.5864661654135338,0.606,30,32,0.9375
Jon Leuer,leuerjo01,PF,25,MEM,2015,63,824.0,286,46,50,157,207,17,9,35,86,121,273,0.4432234432234432,7,29,0.2413793103448276,114,244,0.4672131147540984,0.456,37,59,0.6271186440677966
Damian Lillard,lillada01,PG,24,POR,2015,82,2925.0,1720,507,49,329,378,97,21,222,164,590,1360,0.4338235294117647,196,572,0.3426573426573426,394,788,0.5,0.506,344,398,0.864321608040201
Jeremy Lin,linje01,PG,26,LAL,2015,74,1907.0,832,339,26,170,196,82,32,166,189,277,654,0.4235474006116208,65,176,0.3693181818181818,212,478,0.4435146443514644,0.473,213,268,0.7947761194029851
Shaun Livingston,livinsh01,PG,29,GSW,2015,78,1468.0,461,259,43,140,183,49,20,102,110,198,396,0.5,0,2,0.0,198,394,0.5025380710659898,0.5,65,91,0.7142857142857143
Brook Lopez,lopezbr01,C,26,BRK,2015,72,2100.0,1236,50,214,321,535,43,126,104,206,506,987,0.5126646403242148,1,10,0.1,505,977,0.5168884339815762,0.513,223,274,0.8138686131386861
Robin Lopez,lopezro01,C,26,POR,2015,59,1638.0,566,55,190,204,394,16,84,73,122,234,437,0.5354691075514875,0,1,0.0,234,436,0.536697247706422,0.535,98,127,0.7716535433070866
Kevin Love,loveke01,PF,26,CLE,2015,75,2532.0,1228,168,142,589,731,51,39,122,140,413,952,0.4338235294117647,144,392,0.3673469387755102,269,560,0.4803571428571428,0.509,258,321,0.8037383177570093
Kyle Lowry,lowryky01,PG,28,TOR,2015,70,2414.0,1244,473,54,274,328,109,13,173,212,430,1043,0.4122722914669223,132,391,0.3375959079283887,298,652,0.4570552147239264,0.476,252,312,0.8076923076923077
Kalin Lucas,lucaska01,PG,25,MEM,2015,1,6.0,0,0,0,0,0,1,0,0,1,0,1,0.0,0,0,0.0,0,1,0.0,0.0,0,0,0.0
John Lucas III,lucasjo02,PG,32,DET,2015,21,272.0,98,60,4,12,16,8,0,16,18,42,104,0.4038461538461538,9,29,0.3103448275862069,33,75,0.44,0.447,5,5,1.0
Shelvin Mack,macksh01,PG,24,ATL,2015,55,833.0,299,155,8,71,79,30,2,49,32,117,292,0.4006849315068493,40,127,0.3149606299212598,77,165,0.4666666666666667,0.469,25,31,0.8064516129032258
Ian Mahinmi,mahinia01,C,28,IND,2015,61,1146.0,265,33,105,251,356,30,46,59,172,117,212,0.5518867924528302,0,0,0.0,117,212,0.5518867924528302,0.552,31,102,0.3039215686274509
Devyn Marble,marblde01,SG,22,ORL,2015,16,208.0,37,17,5,26,31,9,2,9,14,14,44,0.3181818181818182,4,22,0.1818181818181818,10,22,0.4545454545454545,0.364,5,16,0.3125
Shawn Marion,mariosh01,SF,36,CLE,2015,57,1101.0,276,51,64,138,202,27,27,33,58,119,267,0.445692883895131,12,46,0.2608695652173913,107,221,0.4841628959276018,0.468,26,34,0.7647058823529411
Kendall Marshall,marshke01,PG,23,MIL,2015,28,417.0,118,86,2,26,28,21,0,35,26,46,101,0.4554455445544554,18,46,0.391304347826087,28,55,0.509090909090909,0.545,8,9,0.8888888888888888
Cartier Martin,martica01,SF,30,DET,2015,23,198.0,36,11,0,20,20,3,1,5,20,15,53,0.2830188679245283,6,33,0.1818181818181818,9,20,0.45,0.34,0,0,0.0
Kenyon Martin,martike01,PF,37,MIL,2015,11,104.0,20,5,6,13,19,5,6,3,13,9,22,0.4090909090909091,0,0,0.0,9,22,0.4090909090909091,0.409,2,2,1.0
Kevin Martin,martike02,SG,31,MIN,2015,39,1302.0,779,89,19,123,142,33,1,76,76,267,625,0.4272,75,191,0.3926701570680628,192,434,0.4423963133640553,0.487,170,193,0.8808290155440415
Wesley Matthews,matthwe02,SG,28,POR,2015,60,2024.0,956,139,38,184,222,77,10,81,132,337,752,0.4481382978723404,173,445,0.3887640449438202,164,307,0.5342019543973942,0.563,109,145,0.7517241379310344
Jason Maxiell,maxieja01,PF,31,CHO,2015,61,878.0,203,19,86,117,203,18,44,29,96,81,192,0.421875,0,0,0.0,81,192,0.421875,0.422,41,71,0.5774647887323944
O.J. Mayo,mayooj01,SG,27,MIL,2015,71,1697.0,806,197,30,157,187,57,18,128,165,296,701,0.4222539229671897,99,277,0.3574007220216607,197,424,0.4646226415094339,0.493,115,139,0.8273381294964028
Luc Mbah a Moute,mbahalu01,PF,28,PHI,2015,67,1916.0,660,106,82,246,328,81,21,99,104,251,636,0.3946540880503145,62,202,0.3069306930693069,189,434,0.4354838709677419,0.443,96,163,0.588957055214724
James Michael McAdoo,mcadoja01,PF,22,GSW,2015,15,137.0,62,2,15,22,37,5,9,6,21,24,44,0.5454545454545454,0,0,0.0,24,44,0.5454545454545454,0.545,14,25,0.56
Ray McCallum,mccalra01,PG,23,SAC,2015,68,1436.0,503,188,52,128,180,45,11,85,92,206,470,0.4382978723404255,34,111,0.3063063063063063,172,359,0.479108635097493,0.474,57,84,0.6785714285714286
CJ McCollum,mccolcj01,SG,23,POR,2015,62,973.0,424,64,14,77,91,43,8,48,81,159,365,0.4356164383561643,55,139,0.39568345323741,104,226,0.4601769911504424,0.511,51,73,0.6986301369863014
K.J. McDaniels,mcdankj01,SG,21,TOT,2015,62,1352.0,487,72,65,135,200,44,70,105,126,172,434,0.3963133640552995,43,150,0.2866666666666667,129,284,0.454225352112676,0.446,100,133,0.7518796992481203
Doug McDermott,mcderdo01,SF,23,CHI,2015,36,321.0,109,6,6,37,43,4,1,17,29,43,107,0.4018691588785046,13,41,0.3170731707317073,30,66,0.4545454545454545,0.463,10,15,0.6666666666666666
Mitch McGary,mcgarmi01,PF,22,OKC,2015,32,485.0,201,14,53,112,165,16,16,31,72,88,165,0.5333333333333333,0,2,0.0,88,163,0.5398773006134969,0.533,25,40,0.625
JaVale McGee,mcgeeja01,C,27,TOT,2015,23,256.0,106,3,18,43,61,2,20,18,30,42,79,0.5316455696202531,0,0,0.0,42,79,0.5316455696202531,0.532,22,33,0.6666666666666666
Ben McLemore,mclembe01,SG,21,SAC,2015,82,2670.0,996,140,31,210,241,77,19,138,219,363,831,0.4368231046931408,140,391,0.3580562659846547,223,440,0.5068181818181818,0.521,130,160,0.8125
Jerel McNeal,mcneaje01,PG,27,PHO,2015,6,36.0,9,2,0,3,3,3,1,5,5,3,11,0.2727272727272727,1,2,0.5,2,9,0.2222222222222222,0.318,2,2,1.0
Josh McRoberts,mcrobjo01,PF,27,MIA,2015,17,296.0,72,33,7,38,45,12,3,22,41,28,53,0.5283018867924528,8,19,0.4210526315789473,20,34,0.5882352941176471,0.604,8,13,0.6153846153846154
Jodie Meeks,meeksjo01,SG,27,DET,2015,60,1462.0,663,79,12,92,104,59,6,57,76,222,534,0.4157303370786517,74,212,0.3490566037735849,148,322,0.4596273291925465,0.485,145,160,0.90625
Gal Mekel,mekelga01,PG,26,NOP,2015,4,43.0,6,13,0,1,1,2,0,2,1,3,20,0.15,0,3,0.0,3,17,0.1764705882352941,0.15,0,0,0.0
Khris Middleton,middlkh01,SF,23,MIL,2015,79,2378.0,1055,182,48,299,347,122,11,113,183,406,869,0.4672036823935558,109,268,0.4067164179104477,297,601,0.4941763727121464,0.53,134,156,0.8589743589743589
C.J. Miles,milescj01,SG,27,IND,2015,70,1841.0,942,75,18,196,214,60,26,73,132,329,827,0.3978234582829504,154,446,0.3452914798206278,175,381,0.4593175853018372,0.491,130,161,0.8074534161490683
Andre Miller,millean02,PG,38,TOT,2015,81,1253.0,355,284,37,116,153,32,6,104,103,145,290,0.5,7,34,0.2058823529411764,138,256,0.5390625,0.512,58,77,0.7532467532467533
Darius Miller,milleda01,SF,24,NOP,2015,5,43.0,2,2,0,1,1,1,0,1,8,1,7,0.1428571428571428,0,1,0.0,1,6,0.1666666666666666,0.143,0,0,0.0
Mike Miller,millemi01,SF,34,CLE,2015,52,701.0,109,46,4,87,91,14,4,23,74,37,114,0.3245614035087719,32,98,0.3265306122448979,5,16,0.3125,0.465,3,4,0.75
Quincy Miller,millequ01,PF,22,TOT,2015,10,119.0,29,8,4,16,20,7,5,5,9,9,38,0.2368421052631578,3,18,0.1666666666666666,6,20,0.3,0.276,8,11,0.7272727272727273
Patty Mills,millspa02,PG,26,SAS,2015,51,801.0,351,87,21,54,75,28,2,35,58,128,336,0.3809523809523809,62,182,0.3406593406593406,66,154,0.4285714285714285,0.473,33,40,0.825
Elijah Millsap,millsel01,SG,27,UTA,2015,47,924.0,248,58,28,122,150,56,16,67,124,81,238,0.3403361344537815,28,90,0.3111111111111111,53,148,0.3581081081081081,0.399,58,86,0.6744186046511628
Paul Millsap,millspa01,PF,29,ATL,2015,73,2390.0,1218,223,139,431,570,130,69,166,201,443,930,0.4763440860215053,77,216,0.3564814814814814,366,714,0.5126050420168067,0.518,255,337,0.7566765578635015
Nikola Mirotić,mirotni01,PF,23,CHI,2015,82,1654.0,833,97,63,341,404,54,54,89,172,253,624,0.4054487179487179,99,313,0.31629392971246,154,311,0.495176848874598,0.485,228,284,0.8028169014084507
Nazr Mohammed,mohamna01,C,37,CHI,2015,23,128.0,27,3,11,27,38,4,5,7,16,13,30,0.4333333333333333,0,0,0.0,13,30,0.4333333333333333,0.433,1,3,0.3333333333333333
Greg Monroe,monrogr01,PF,24,DET,2015,69,2137.0,1098,142,229,475,704,78,34,149,148,423,853,0.4958968347010551,0,0,0.0,423,853,0.4958968347010551,0.496,252,336,0.75
E'Twaun Moore,mooreet01,SG,25,CHI,2015,56,504.0,149,33,12,34,46,20,6,14,45,62,139,0.4460431654676259,13,38,0.3421052631578947,49,101,0.4851485148514851,0.493,12,20,0.6
Eric Moreland,moreler01,PF,23,SAC,2015,3,2.0,2,0,0,1,1,0,0,0,1,1,1,1.0,0,0,0.0,1,1,1.0,1.0,0,0,0.0
Darius Morris,morrida01,PG,24,BRK,2015,38,299.0,83,48,7,20,27,9,0,21,20,36,106,0.3396226415094339,7,33,0.2121212121212121,29,73,0.3972602739726027,0.373,4,9,0.4444444444444444
Marcus Morris,morrima03,PF,25,PHO,2015,81,2045.0,845,133,73,312,385,63,16,73,188,331,763,0.4338138925294889,112,313,0.3578274760383386,219,450,0.4866666666666667,0.507,71,113,0.6283185840707964
Markieff Morris,morrima02,PF,25,PHO,2015,82,2581.0,1258,192,110,396,506,101,39,170,245,512,1100,0.4654545454545454,57,179,0.3184357541899441,455,921,0.494028230184582,0.491,177,232,0.7629310344827587
Anthony Morrow,morroan01,SG,29,OKC,2015,74,1806.0,790,60,40,155,195,54,11,38,135,285,615,0.4634146341463415,141,325,0.4338461538461538,144,290,0.496551724137931,0.578,79,89,0.8876404494382022
Donatas Motiejūnas,motiedo01,PF,24,HOU,2015,71,2037.0,855,130,137,284,421,56,34,123,203,353,700,0.5042857142857143,49,133,0.3684210526315789,304,567,0.5361552028218695,0.539,100,166,0.6024096385542169
Timofey Mozgov,mozgoti01,C,28,TOT,2015,81,2045.0,785,55,203,388,591,33,97,116,227,314,566,0.5547703180212014,2,6,0.3333333333333333,312,560,0.5571428571428572,0.557,155,216,0.7175925925925926
Shabazz Muhammad,muhamsh01,SG,22,MIN,2015,38,866.0,512,44,63,91,154,18,7,35,49,194,397,0.4886649874055415,20,51,0.392156862745098,174,346,0.5028901734104047,0.514,104,145,0.7172413793103448
Toure' Murry,murryto01,SG-PG,25,TOT,2015,5,18.0,6,1,1,0,1,1,0,4,2,2,5,0.4,0,0,0.0,2,5,0.4,0.4,2,2,1.0
Mike Muscala,muscami01,PF,23,ATL,2015,40,502.0,197,25,52,67,119,16,19,21,52,83,151,0.5496688741721855,9,22,0.4090909090909091,74,129,0.5736434108527132,0.579,22,25,0.88
Shabazz Napier,napiesh01,PG,23,MIA,2015,51,1012.0,261,130,17,96,113,40,4,81,76,87,228,0.3815789473684211,43,118,0.3644067796610169,44,110,0.4,0.476,44,56,0.7857142857142857
Gary Neal,nealga01,SG,30,TOT,2015,54,1193.0,543,100,14,115,129,23,1,65,88,188,503,0.3737574552683896,50,164,0.3048780487804878,138,339,0.4070796460176991,0.423,117,135,0.8666666666666667
Jameer Nelson,nelsoja01,PG,32,TOT,2015,63,1407.0,523,253,33,113,146,47,6,109,136,205,504,0.4067460317460317,89,258,0.3449612403100775,116,246,0.4715447154471545,0.495,24,36,0.6666666666666666
Andrew Nicholson,nichoan01,PF,25,ORL,2015,40,492.0,194,22,17,65,82,6,12,24,51,83,190,0.4368421052631579,13,41,0.3170731707317073,70,149,0.4697986577181208,0.471,15,25,0.6
Joakim Noah,noahjo01,C,29,CHI,2015,67,2049.0,485,312,219,427,646,48,74,123,203,190,427,0.4449648711943794,0,2,0.0,190,425,0.4470588235294118,0.445,105,174,0.603448275862069
Nerlens Noel,noelne01,C,20,PHI,2015,75,2311.0,744,128,185,426,611,133,142,146,208,302,653,0.4624808575803981,0,0,0.0,302,653,0.4624808575803981,0.462,140,230,0.6086956521739131
Lucas Nogueira,noguelu01,C,22,TOR,2015,6,23.0,6,1,2,9,11,2,0,2,6,2,8,0.25,0,0,0.0,2,8,0.25,0.25,2,4,0.5
Steve Novak,novakst01,SF-PF,31,TOT,2015,35,197.0,63,11,2,20,22,0,2,5,23,22,56,0.3928571428571428,19,48,0.3958333333333333,3,8,0.375,0.563,0,2,0.0
Dirk Nowitzki,nowitdi01,PF,36,DAL,2015,77,2282.0,1333,143,44,413,457,39,33,82,160,487,1062,0.4585687382297552,104,274,0.3795620437956204,383,788,0.4860406091370558,0.508,255,289,0.8823529411764706
Jusuf Nurkić,nurkiju01,C,20,DEN,2015,62,1103.0,426,50,125,257,382,52,68,86,207,171,383,0.4464751958224543,0,2,0.0,171,381,0.4488188976377952,0.446,84,132,0.6363636363636364
Johnny O'Bryant,obryajo01,PF,21,MIL,2015,34,368.0,100,17,26,38,64,5,4,25,44,44,120,0.3666666666666666,0,0,0.0,44,120,0.3666666666666666,0.367,12,27,0.4444444444444444
Kyle O'Quinn,oquinky01,PF,24,ORL,2015,51,824.0,294,59,46,153,199,31,39,55,110,119,242,0.4917355371900826,12,43,0.2790697674418604,107,199,0.5376884422110553,0.517,44,57,0.7719298245614035
Victor Oladipo,oladivi01,SG,22,ORL,2015,72,2573.0,1292,295,51,251,302,120,19,204,187,473,1086,0.4355432780847145,84,248,0.3387096774193548,389,838,0.4642004773269689,0.474,262,320,0.81875
Kelly Olynyk,olynyke01,C,23,BOS,2015,64,1423.0,656,109,92,211,303,64,39,98,213,251,528,0.4753787878787879,61,175,0.3485714285714286,190,353,0.5382436260623229,0.533,93,136,0.6838235294117647
Arinze Onuaku,onuakar01,C,27,MIN,2015,6,68.0,27,4,7,14,21,1,3,2,6,12,14,0.8571428571428571,0,0,0.0,12,14,0.8571428571428571,0.857,3,8,0.375
Zaza Pachulia,pachuza01,C,30,MIL,2015,73,1730.0,606,178,197,303,500,80,21,133,170,240,529,0.4536862003780718,0,3,0.0,240,526,0.4562737642585551,0.454,126,160,0.7875
Kostas Papanikolaou,papanko01,SF,24,HOU,2015,43,795.0,182,85,39,79,118,29,13,55,71,69,197,0.350253807106599,31,106,0.2924528301886792,38,91,0.4175824175824176,0.429,13,18,0.7222222222222222
Jannero Pargo,pargoja01,PG,35,CHO,2015,9,73.0,41,8,0,3,3,0,0,3,8,15,35,0.4285714285714285,9,22,0.4090909090909091,6,13,0.4615384615384615,0.557,2,2,1.0
Jabari Parker,parkeja01,PF,19,MIL,2015,25,738.0,308,42,50,88,138,31,5,47,42,129,263,0.4904942965779467,4,16,0.25,125,247,0.5060728744939271,0.498,46,66,0.696969696969697
Tony Parker,parketo01,PG,32,SAS,2015,68,1953.0,976,335,15,114,129,44,2,146,108,404,832,0.4855769230769231,38,89,0.4269662921348314,366,743,0.4925975773889636,0.508,130,166,0.7831325301204819
Chandler Parsons,parsoch01,SF,26,DAL,2015,66,2186.0,1037,161,64,259,323,69,19,96,140,383,829,0.4620024125452352,132,347,0.3804034582132565,251,482,0.520746887966805,0.542,139,193,0.7202072538860104
Patrick Patterson,pattepa01,PF,25,TOR,2015,81,2156.0,648,155,127,306,433,60,44,54,149,240,535,0.4485981308411215,105,283,0.3710247349823322,135,252,0.5357142857142857,0.547,63,80,0.7875
Chris Paul,paulch01,PG,29,LAC,2015,82,2857.0,1564,838,52,324,376,156,15,190,203,568,1170,0.4854700854700854,139,349,0.3982808022922636,429,821,0.5225334957369062,0.545,289,321,0.9003115264797508
Adreian Payne,paynead01,PF,23,TOT,2015,32,739.0,213,30,48,114,162,19,9,44,88,91,220,0.4136363636363636,1,9,0.1111111111111111,90,211,0.4265402843601896,0.416,30,46,0.6521739130434783
Elfrid Payton,paytoel01,PG,20,ORL,2015,82,2489.0,731,533,107,242,349,142,20,203,193,301,708,0.4251412429378531,11,42,0.2619047619047619,290,666,0.4354354354354354,0.433,118,214,0.5514018691588785
Nikola Peković,pekovni01,C,29,MIN,2015,31,815.0,386,27,89,145,234,19,12,42,59,139,328,0.423780487804878,0,0,0.0,139,328,0.423780487804878,0.424,108,129,0.8372093023255814
Kendrick Perkins,perkike01,C,30,TOT,2015,68,1148.0,246,51,91,229,320,16,42,95,162,102,227,0.4493392070484581,0,1,0.0,102,226,0.4513274336283185,0.449,42,83,0.5060240963855421
Paul Pierce,piercpa01,SF,37,WAS,2015,73,1914.0,868,144,45,249,294,46,24,92,160,293,656,0.4466463414634146,118,303,0.3894389438943894,175,353,0.4957507082152974,0.537,164,210,0.780952380952381
Mason Plumlee,plumlma01,C,24,BRK,2015,82,1743.0,717,74,175,337,512,65,63,106,207,280,489,0.5725971370143149,0,3,0.0,280,486,0.5761316872427984,0.573,157,317,0.4952681388012618
Miles Plumlee,plumlmi01,C,26,TOT,2015,73,1194.0,294,34,112,208,320,41,66,51,111,136,254,0.5354330708661418,0,0,0.0,136,254,0.5354330708661418,0.535,22,46,0.4782608695652174
Quincy Pondexter,pondequ01,SF-SG,26,TOT,2015,75,1793.0,538,94,53,142,195,19,24,51,150,188,447,0.4205816554809843,91,244,0.3729508196721312,97,203,0.4778325123152709,0.522,71,96,0.7395833333333334
Otto Porter Jr.,porteot01,SF,21,WAS,2015,74,1432.0,445,65,70,151,221,44,30,52,97,176,391,0.4501278772378516,35,104,0.3365384615384615,141,287,0.4912891986062718,0.495,58,79,0.7341772151898734
Dwight Powell,poweldw01,PF,23,TOT,2015,29,236.0,90,9,18,32,50,9,6,11,40,31,67,0.4626865671641791,3,11,0.2727272727272727,28,56,0.5,0.485,25,33,0.7575757575757576
Phil Pressey,pressph01,PG,23,BOS,2015,50,600.0,177,117,13,67,80,30,6,41,54,64,174,0.367816091954023,16,65,0.2461538461538461,48,109,0.4403669724770642,0.414,33,49,0.673469387755102
A.J. Price,priceaj01,PG,28,TOT,2015,26,324.0,133,46,6,26,32,7,0,14,15,51,137,0.3722627737226277,15,57,0.2631578947368421,36,80,0.45,0.427,16,24,0.6666666666666666
Ronnie Price,pricero01,PG,31,LAL,2015,43,982.0,221,165,19,50,69,67,4,52,118,77,223,0.3452914798206278,31,109,0.2844036697247706,46,114,0.4035087719298245,0.415,36,45,0.8
Pablo Prigioni,prigipa01,PG,37,TOT,2015,67,1197.0,274,171,30,89,119,79,1,62,88,91,228,0.3991228070175439,57,166,0.3433734939759036,34,62,0.5483870967741935,0.524,35,41,0.8536585365853658
Tayshaun Prince,princta01,SF,34,TOT,2015,58,1397.0,434,93,52,158,210,29,16,35,55,177,402,0.4402985074626865,31,67,0.4626865671641791,146,335,0.435820895522388,0.479,49,65,0.7538461538461538
Miroslav Raduljica,radulmi01,C,27,MIN,2015,5,23.0,8,0,2,3,5,1,0,2,8,3,8,0.375,0,0,0.0,3,8,0.375,0.375,2,2,1.0
Julius Randle,randlju01,PF,20,LAL,2015,1,14.0,2,0,0,0,0,0,0,1,1,1,3,0.3333333333333333,0,0,0.0,1,3,0.3333333333333333,0.333,0,2,0.0
Shavlik Randolph,randosh01,PF,31,TOT,2015,21,126.0,24,4,16,22,38,5,3,3,16,9,35,0.2571428571428571,0,5,0.0,9,30,0.3,0.257,6,12,0.5
Zach Randolph,randoza01,PF,33,MEM,2015,71,2304.0,1143,153,225,522,747,69,14,156,175,454,932,0.4871244635193133,7,20,0.35,447,912,0.4901315789473684,0.491,228,298,0.7651006711409396
J.J. Redick,redicjj01,SG,30,LAC,2015,78,2409.0,1277,137,22,145,167,39,8,95,134,447,938,0.476545842217484,200,458,0.4366812227074236,247,480,0.5145833333333333,0.583,183,203,0.9014778325123152
Glen Rice Jr.,ricegl02,SG,24,WAS,2015,5,43.0,11,2,2,2,4,0,0,2,11,3,15,0.2,1,7,0.1428571428571428,2,8,0.25,0.233,4,6,0.6666666666666666
Jason Richardson,richaja01,SG,34,PHI,2015,19,416.0,172,38,13,53,66,13,3,16,28,62,178,0.348314606741573,31,96,0.3229166666666667,31,82,0.3780487804878049,0.435,17,22,0.7727272727272727
Luke Ridnour,ridnolu01,PG,33,ORL,2015,47,683.0,188,96,8,60,68,20,4,38,67,75,176,0.4261363636363636,20,63,0.3174603174603174,55,113,0.4867256637168141,0.483,18,21,0.8571428571428571
Austin Rivers,riverau01,PG-SG,22,TOT,2015,76,1563.0,530,155,27,125,152,48,14,65,146,203,496,0.4092741935483871,39,131,0.2977099236641221,164,365,0.4493150684931506,0.449,85,126,0.6746031746031746
Andre Roberson,roberan03,SG,23,OKC,2015,67,1286.0,228,70,60,195,255,53,29,46,141,92,201,0.4577114427860697,21,85,0.2470588235294117,71,116,0.6120689655172413,0.51,23,48,0.4791666666666667
Brian Roberts,roberbr01,PG,29,CHO,2015,72,1330.0,480,162,13,96,109,33,6,57,75,176,452,0.3893805309734513,62,193,0.3212435233160621,114,259,0.4401544401544401,0.458,66,74,0.8918918918918919
Glenn Robinson III,robingl02,SG-SF,21,TOT,2015,35,261.0,73,11,15,24,39,6,1,11,15,26,67,0.3880597014925373,5,19,0.2631578947368421,21,48,0.4375,0.425,16,24,0.6666666666666666
Nate Robinson,robinna01,PG,30,TOT,2015,42,591.0,238,97,17,33,50,20,3,30,76,88,255,0.3450980392156862,31,112,0.2767857142857143,57,143,0.3986013986013986,0.406,31,46,0.6739130434782609
Thomas Robinson,robinth01,PF,23,TOT,2015,54,798.0,308,33,95,208,303,32,20,59,104,126,260,0.4846153846153846,0,2,0.0,126,258,0.4883720930232558,0.485,56,106,0.5283018867924528
Rajon Rondo,rondora01,PG,28,TOT,2015,68,2018.0,608,538,73,300,373,91,7,210,153,275,645,0.4263565891472868,27,86,0.313953488372093,248,559,0.443649373881932,0.447,31,78,0.3974358974358974
Derrick Rose,rosede01,PG,26,CHI,2015,51,1530.0,904,251,35,126,161,36,16,161,63,338,835,0.4047904191616766,76,271,0.2804428044280442,262,564,0.4645390070921986,0.45,152,187,0.8128342245989305
Terrence Ross,rosste01,SF,23,TOR,2015,82,2092.0,807,86,32,194,226,53,25,69,136,309,753,0.4103585657370518,145,390,0.3717948717948718,164,363,0.4517906336088154,0.507,44,56,0.7857142857142857
Ricky Rubio,rubiori01,PG,24,MIN,2015,22,692.0,226,193,19,106,125,38,1,64,59,78,219,0.3561643835616438,13,51,0.2549019607843137,65,168,0.3869047619047619,0.386,57,71,0.8028169014084507
Damjan Rudež,rudezda01,SF,28,IND,2015,68,1047.0,323,53,8,39,47,16,5,47,79,119,263,0.4524714828897338,69,170,0.4058823529411764,50,93,0.5376344086021505,0.584,16,23,0.6956521739130435
Brandon Rush,rushbr01,SG,29,GSW,2015,33,271.0,30,12,4,37,41,5,12,11,27,11,54,0.2037037037037037,3,27,0.1111111111111111,8,27,0.2962962962962963,0.231,5,11,0.4545454545454545
Robert Sacre,sacrero01,C,25,LAL,2015,67,1133.0,307,55,89,144,233,28,43,36,121,126,306,0.4117647058823529,0,1,0.0,126,305,0.4131147540983607,0.412,55,82,0.6707317073170732
John Salmons,salmojo01,SF,35,NOP,2015,21,270.0,42,13,4,17,21,9,4,5,25,16,48,0.3333333333333333,8,26,0.3076923076923077,8,22,0.3636363636363636,0.417,2,4,0.5
JaKarr Sampson,sampsja02,SF,21,PHI,2015,74,1131.0,386,77,35,128,163,38,26,76,135,146,346,0.4219653179190751,31,127,0.2440944881889764,115,219,0.5251141552511416,0.467,63,94,0.6702127659574468
Larry Sanders,sandela01,C,26,MIL,2015,27,586.0,196,23,67,99,166,26,39,28,104,86,172,0.5,0,0,0.0,86,172,0.5,0.5,24,48,0.5
Dennis Schröder,schrode01,PG,21,ATL,2015,77,1516.0,768,317,29,135,164,49,4,150,127,284,665,0.4270676691729323,52,148,0.3513513513513513,232,517,0.448742746615087,0.466,148,179,0.8268156424581006
Luis Scola,scolalu01,PF,34,IND,2015,81,1659.0,763,105,138,388,526,47,18,94,192,300,642,0.4672897196261682,5,20,0.25,295,622,0.4742765273311897,0.471,158,226,0.6991150442477876
Mike Scott,scottmi01,PF,26,ATL,2015,68,1123.0,529,75,45,154,199,25,3,39,83,201,453,0.4437086092715231,66,192,0.34375,135,261,0.5172413793103449,0.517,61,77,0.7922077922077922
Thabo Sefolosha,sefolth01,SF,30,ATL,2015,52,976.0,278,75,53,170,223,53,21,38,67,104,249,0.4176706827309236,25,78,0.3205128205128205,79,171,0.4619883040935672,0.468,45,58,0.7758620689655172
Kevin Séraphin,serapke01,C,25,WAS,2015,79,1235.0,520,59,87,201,288,10,59,98,197,231,450,0.5133333333333333,0,2,0.0,231,448,0.515625,0.513,58,82,0.7073170731707317
Ramon Sessions,sessira01,PG,28,TOT,2015,64,1188.0,402,182,23,121,144,29,0,86,73,125,334,0.374251497005988,19,60,0.3166666666666666,106,274,0.3868613138686131,0.403,133,173,0.7687861271676301
Iman Shumpert,shumpim01,SG,24,TOT,2015,62,1545.0,496,135,55,169,224,81,16,91,138,193,471,0.4097664543524416,67,196,0.3418367346938775,126,275,0.4581818181818182,0.481,43,64,0.671875
Alexey Shved,shvedal01,SG,26,TOT,2015,42,767.0,434,106,23,76,99,30,6,48,48,133,335,0.3970149253731343,47,139,0.3381294964028777,86,196,0.4387755102040816,0.467,121,150,0.8066666666666666
Henry Sims,simshe01,C,24,PHI,2015,73,1399.0,586,79,121,238,359,39,30,99,135,238,502,0.4741035856573705,4,22,0.1818181818181818,234,480,0.4875,0.478,106,137,0.7737226277372263
Kyle Singler,singlky01,SF,26,TOT,2015,80,1743.0,480,85,33,161,194,47,21,55,153,172,446,0.3856502242152466,96,241,0.3983402489626556,76,205,0.3707317073170731,0.493,40,52,0.7692307692307693
Donald Sloan,sloando01,PG,27,IND,2015,53,1107.0,391,190,12,131,143,23,0,65,47,145,355,0.4084507042253521,41,131,0.3129770992366412,104,224,0.4642857142857143,0.466,60,77,0.7792207792207793
Marcus Smart,smartma01,PG,20,BOS,2015,67,1808.0,523,208,61,161,222,99,18,90,176,175,477,0.3668763102725367,91,272,0.3345588235294117,84,205,0.4097560975609756,0.462,82,127,0.6456692913385826
Greg Smith,smithgr02,PF,24,DAL,2015,42,363.0,80,9,26,53,79,7,11,11,53,30,49,0.6122448979591837,0,0,0.0,30,49,0.6122448979591837,0.612,20,39,0.5128205128205128
Ish Smith,smithis01,PG,26,TOT,2015,55,832.0,338,180,15,85,100,36,6,78,50,143,367,0.3896457765667575,18,60,0.3,125,307,0.4071661237785016,0.414,34,57,0.5964912280701754
J.R. Smith,smithjr01,SG,29,TOT,2015,70,2080.0,847,195,30,188,218,82,22,97,163,315,755,0.4172185430463576,163,426,0.3826291079812207,152,329,0.4620060790273556,0.525,54,72,0.75
Jason Smith,smithja02,C,28,NYK,2015,82,1785.0,656,140,98,226,324,32,44,104,205,257,592,0.4341216216216216,15,42,0.3571428571428571,242,550,0.44,0.447,127,153,0.8300653594771242
Josh Smith,smithjo03,PF,29,TOT,2015,83,2300.0,1027,277,152,378,530,87,116,206,228,414,987,0.4194528875379939,72,228,0.3157894736842105,342,759,0.4505928853754941,0.456,127,255,0.4980392156862745
Russ Smith,smithru01,PG,23,TOT,2015,12,65.0,30,8,1,5,6,3,0,12,13,8,25,0.32,2,11,0.1818181818181818,6,14,0.4285714285714285,0.36,12,13,0.9230769230769232
Tony Snell,snellto01,SF,23,CHI,2015,72,1412.0,435,62,31,145,176,32,11,48,86,159,371,0.4285714285714285,73,197,0.3705583756345177,86,174,0.4942528735632184,0.527,44,55,0.8
Marreese Speights,speigma01,C,27,GSW,2015,76,1207.0,791,72,109,216,325,20,34,82,189,318,646,0.4922600619195046,5,18,0.2777777777777778,313,628,0.4984076433121019,0.496,150,178,0.8426966292134831
Tiago Splitter,splitti01,C,30,SAS,2015,52,1030.0,428,78,91,161,252,35,37,60,103,169,303,0.5577557755775577,0,0,0.0,169,303,0.5577557755775577,0.558,90,120,0.75
Nik Stauskas,stausni01,SG,21,SAC,2015,73,1127.0,319,67,11,77,88,20,17,40,92,108,296,0.3648648648648648,48,149,0.3221476510067114,60,147,0.4081632653061224,0.446,55,64,0.859375
Lance Stephenson,stephla01,SG,24,CHO,2015,61,1573.0,501,240,39,238,277,38,8,128,134,207,550,0.3763636363636363,18,105,0.1714285714285714,189,445,0.4247191011235955,0.393,69,110,0.6272727272727273
Greg Stiemsma,stiemgr01,C,29,TOR,2015,17,66.0,14,3,9,6,15,2,0,7,15,6,8,0.75,0,0,0.0,6,8,0.75,0.75,2,4,0.5
David Stockton,stockda01,PG,23,SAC,2015,3,33.0,8,9,0,2,2,2,0,4,1,2,6,0.3333333333333333,1,2,0.5,1,4,0.25,0.417,3,6,0.5
Jarnell Stokes,stokeja01,PF,21,MEM,2015,19,126.0,57,4,16,18,34,5,5,7,25,21,37,0.5675675675675675,0,0,0.0,21,37,0.5675675675675675,0.568,15,28,0.5357142857142857
Amar'e Stoudemire,stoudam01,PF,32,TOT,2015,59,1245.0,680,45,110,219,329,29,38,78,161,273,490,0.5571428571428572,0,4,0.0,273,486,0.5617283950617284,0.557,134,186,0.7204301075268817
Rodney Stuckey,stuckro01,PG,28,IND,2015,71,1874.0,896,219,36,212,248,56,10,118,131,332,754,0.4403183023872679,55,141,0.3900709219858156,277,613,0.4518760195758564,0.477,177,216,0.8194444444444444
Jared Sullinger,sullija01,PF,22,BOS,2015,58,1566.0,770,134,147,294,441,44,42,78,153,311,708,0.4392655367231638,52,184,0.2826086956521739,259,524,0.4942748091603053,0.476,96,129,0.7441860465116279
Jeff Taylor,tayloje03,SF,25,CHO,2015,29,430.0,127,22,14,39,53,12,1,19,36,45,114,0.3947368421052631,11,36,0.3055555555555556,34,78,0.4358974358974359,0.443,26,41,0.6341463414634146
Jeff Teague,teaguje01,PG,26,ATL,2015,73,2228.0,1162,513,30,154,184,125,31,205,139,408,887,0.4599774520856821,71,207,0.3429951690821256,337,680,0.4955882352941176,0.5,275,319,0.8620689655172413
Mirza Teletović,teletmi01,PF,29,BRK,2015,40,892.0,339,46,27,167,194,14,16,53,74,122,319,0.3824451410658307,62,193,0.3212435233160621,60,126,0.4761904761904761,0.48,33,46,0.717391304347826
Sebastian Telfair,telfase01,PG,29,OKC,2015,16,327.0,134,45,2,28,30,10,0,18,29,46,125,0.368,18,60,0.3,28,65,0.4307692307692308,0.44,24,34,0.7058823529411765
Garrett Temple,templga01,SG,28,WAS,2015,52,735.0,204,56,24,66,90,42,9,34,76,68,170,0.4,33,88,0.375,35,82,0.4268292682926829,0.497,35,48,0.7291666666666666
Jason Terry,terryja01,SG,37,HOU,2015,77,1641.0,541,147,15,106,121,66,19,74,116,188,446,0.42152466367713,126,323,0.3900928792569659,62,123,0.5040650406504065,0.563,39,48,0.8125
Isaiah Thomas,thomais02,PG,25,TOT,2015,67,1726.0,1101,284,33,120,153,57,5,143,150,335,797,0.4203262233375157,129,346,0.3728323699421965,206,451,0.4567627494456763,0.501,302,348,0.867816091954023
Lance Thomas,thomala01,PF-SF,26,TOT,2015,62,1490.0,443,69,65,130,195,37,8,74,101,182,442,0.4117647058823529,7,22,0.3181818181818182,175,420,0.4166666666666667,0.42,72,99,0.7272727272727273
Malcolm Thomas,thomama01,PF,26,PHI,2015,17,194.0,45,7,16,40,56,3,1,13,17,18,40,0.45,0,7,0.0,18,33,0.5454545454545454,0.45,9,13,0.6923076923076923
Tyrus Thomas,thomaty01,PF,28,MEM,2015,2,7.0,4,1,0,0,0,0,0,0,0,1,1,1.0,0,0,0.0,1,1,1.0,1.0,2,2,1.0
Hollis Thompson,thompho01,SG,23,PHI,2015,71,1776.0,626,85,53,145,198,57,26,66,141,224,543,0.4125230202578269,115,287,0.4006968641114982,109,256,0.42578125,0.518,63,89,0.7078651685393258
Jason Thompson,thompja02,PF,28,SAC,2015,81,1991.0,491,85,139,391,530,33,57,84,239,201,428,0.4696261682242991,0,1,0.0,201,427,0.4707259953161593,0.47,89,143,0.6223776223776224
Klay Thompson,thompkl01,SG,24,GSW,2015,77,2455.0,1668,222,27,220,247,87,60,149,122,602,1299,0.4634334103156274,239,545,0.4385321100917431,363,754,0.4814323607427055,0.555,225,256,0.87890625
Tristan Thompson,thomptr01,PF,23,CLE,2015,82,2194.0,693,39,274,383,657,34,61,83,189,267,488,0.5471311475409836,0,0,0.0,267,488,0.5471311475409836,0.547,159,248,0.6411290322580645
Marcus Thornton,thornma01,SG,27,TOT,2015,48,721.0,380,36,23,63,86,27,7,27,38,140,345,0.4057971014492754,54,143,0.3776223776223776,86,202,0.4257425742574257,0.484,46,56,0.8214285714285714
Anthony Tolliver,tollian01,PF,29,TOT,2015,76,1432.0,482,59,51,185,236,24,16,51,137,161,393,0.4096692111959287,106,290,0.3655172413793103,55,103,0.5339805825242718,0.545,54,69,0.782608695652174
P.J. Tucker,tuckepj01,SF,29,PHO,2015,78,2383.0,713,122,114,388,502,107,23,96,179,261,596,0.4379194630872483,87,252,0.3452380952380952,174,344,0.5058139534883721,0.511,104,143,0.7272727272727273
Ronny Turiaf,turiaro01,C,32,MIN,2015,2,19.0,0,2,0,1,1,0,0,0,0,0,0,0.0,0,0,0.0,0,0,0.0,0.0,0,0,0.0
Hedo Türkoğlu,turkohe01,SF,35,LAC,2015,62,705.0,232,37,5,94,99,19,7,29,66,83,188,0.4414893617021276,60,139,0.4316546762589928,23,49,0.4693877551020408,0.601,6,11,0.5454545454545454
Evan Turner,turneev01,SG,26,BOS,2015,82,2260.0,779,449,40,377,417,83,19,198,180,320,746,0.4289544235924933,33,119,0.2773109243697479,287,627,0.4577352472089314,0.451,106,141,0.75177304964539
Ekpe Udoh,udohek01,PF,27,LAC,2015,33,128.0,29,8,7,19,26,8,7,7,20,11,24,0.4583333333333333,0,0,0.0,11,24,0.4583333333333333,0.458,7,9,0.7777777777777778
Beno Udrih,udrihbe01,PG,32,MEM,2015,79,1494.0,605,220,20,123,143,46,8,89,88,246,505,0.4871287128712871,26,97,0.268041237113402,220,408,0.5392156862745098,0.513,87,102,0.8529411764705882
Jonas Valančiūnas,valanjo01,C,22,TOR,2015,80,2096.0,963,39,215,478,693,33,95,109,222,373,652,0.5720858895705522,0,1,0.0,373,651,0.5729646697388633,0.572,217,276,0.7862318840579711
Anderson Varejão,varejan01,C,32,CLE,2015,26,636.0,255,35,57,113,170,19,16,35,58,111,200,0.555,0,2,0.0,111,198,0.5606060606060606,0.555,33,45,0.7333333333333333
Greivis Vásquez,vasqugr01,PG,28,TOR,2015,82,1991.0,775,302,22,194,216,46,10,119,177,296,725,0.4082758620689655,133,351,0.3789173789173789,163,374,0.4358288770053476,0.5,50,66,0.7575757575757576
Charlie Villanueva,villach01,PF,30,DAL,2015,64,678.0,403,19,30,119,149,15,22,28,64,150,362,0.4143646408839779,83,221,0.3755656108597285,67,141,0.475177304964539,0.529,20,35,0.5714285714285714
Noah Vonleh,vonleno01,PF,19,CHO,2015,25,259.0,83,4,28,58,86,4,9,11,20,30,76,0.3947368421052631,5,13,0.3846153846153846,25,63,0.3968253968253968,0.428,18,26,0.6923076923076923
Nikola Vučević,vucevni01,C,24,ORL,2015,74,2529.0,1428,147,238,572,810,54,54,148,220,631,1206,0.5232172470978441,2,6,0.3333333333333333,629,1200,0.5241666666666667,0.524,164,218,0.7522935779816514
Dwyane Wade,wadedw01,SG,33,MIA,2015,62,1971.0,1331,299,58,161,219,73,21,209,105,509,1084,0.4695571955719557,29,102,0.284313725490196,480,982,0.4887983706720977,0.483,284,370,0.7675675675675676
Dion Waiters,waitedi01,SG,23,TOT,2015,80,2208.0,940,163,41,151,192,90,21,113,155,375,946,0.3964059196617336,73,246,0.2967479674796748,302,700,0.4314285714285714,0.435,117,172,0.6802325581395349
Henry Walker,walkebi01,SF,27,MIA,2015,24,628.0,175,29,7,75,82,24,9,24,76,58,168,0.3452380952380952,45,132,0.3409090909090909,13,36,0.3611111111111111,0.479,14,18,0.7777777777777778
Kemba Walker,walkeke02,PG,24,CHO,2015,62,2119.0,1075,318,35,185,220,89,31,100,92,378,981,0.3853211009174312,85,280,0.3035714285714285,293,701,0.4179743223965763,0.429,234,283,0.8268551236749117
John Wall,walljo01,PG,24,WAS,2015,79,2837.0,1387,792,36,330,366,138,45,304,180,519,1166,0.4451114922813036,65,217,0.2995391705069124,454,949,0.4783983140147523,0.473,284,362,0.7845303867403315
Gerald Wallace,wallage01,SF,32,BOS,2015,32,286.0,35,11,17,40,57,15,4,18,19,14,34,0.4117647058823529,1,3,0.3333333333333333,13,31,0.4193548387096774,0.426,6,15,0.4
T.J. Warren,warretj01,SF,21,PHO,2015,40,614.0,245,25,41,44,85,18,9,27,51,113,214,0.5280373831775701,5,21,0.238095238095238,108,193,0.5595854922279793,0.54,14,19,0.7368421052631579
C.J. Watson,watsocj01,PG,30,IND,2015,57,1422.0,570,208,18,145,163,57,9,100,107,181,417,0.434052757793765,70,175,0.4,111,242,0.4586776859504132,0.518,138,167,0.8263473053892215
David Wear,wearda01,PF,24,SAC,2015,2,7.0,0,1,2,0,2,0,0,0,1,0,2,0.0,0,1,0.0,0,1,0.0,0.0,0,0,0.0
Travis Wear,weartr01,SF,24,NYK,2015,51,672.0,199,40,31,75,106,15,11,35,55,84,209,0.4019138755980861,11,30,0.3666666666666666,73,179,0.4078212290502793,0.428,20,26,0.7692307692307693
Martell Webster,webstma02,SF,28,WAS,2015,32,352.0,106,17,10,36,46,7,1,22,24,24,91,0.2637362637362637,10,43,0.2325581395348837,14,48,0.2916666666666667,0.319,48,64,0.75
David West,westda01,PF,34,IND,2015,66,1895.0,769,223,108,341,449,48,48,120,160,323,686,0.4708454810495627,4,20,0.2,319,666,0.4789789789789789,0.474,119,161,0.7391304347826086
Russell Westbrook,westbru01,PG,26,OKC,2015,67,2302.0,1886,574,124,364,488,140,14,293,184,627,1471,0.4262406526172672,86,288,0.2986111111111111,541,1183,0.4573119188503803,0.455,546,654,0.8348623853211009
Hassan Whiteside,whiteha01,C,25,MIA,2015,48,1142.0,564,6,145,337,482,27,123,58,129,243,387,0.627906976744186,0,0,0.0,243,387,0.627906976744186,0.628,78,156,0.5
Shayne Whittington,whittsh01,PF,23,IND,2015,20,108.0,57,6,10,19,29,5,2,5,18,19,42,0.4523809523809524,1,6,0.1666666666666666,18,36,0.5,0.464,18,23,0.782608695652174
Andrew Wiggins,wiggian01,SF,19,MIN,2015,82,2969.0,1387,170,134,240,374,86,50,177,190,497,1137,0.4371152154793316,39,126,0.3095238095238095,458,1011,0.4530168150346192,0.454,354,466,0.759656652360515
C.J. Wilcox,wilcocj01,SG,24,LAC,2015,21,101.0,41,8,1,6,7,3,1,10,7,16,38,0.4210526315789473,7,19,0.3684210526315789,9,19,0.4736842105263157,0.513,2,2,1.0
Deron Williams,willide01,PG,30,BRK,2015,68,2114.0,884,448,29,208,237,64,17,154,157,298,771,0.3865110246433204,87,237,0.3670886075949367,211,534,0.3951310861423221,0.443,201,241,0.8340248962655602
Derrick Williams,willide02,PF,23,SAC,2015,74,1462.0,617,50,41,161,202,34,4,56,67,217,485,0.4474226804123711,49,156,0.3141025641025641,168,329,0.5106382978723404,0.498,134,196,0.6836734693877551
Elliot Williams,williel01,SG,25,TOT,2015,13,119.0,37,12,0,8,8,4,0,4,12,14,37,0.3783783783783784,8,18,0.4444444444444444,6,19,0.3157894736842105,0.486,1,4,0.25
Lou Williams,willilo02,SG,28,TOR,2015,80,2016.0,1242,164,24,127,151,88,10,101,103,375,928,0.4040948275862069,152,447,0.3400447427293065,223,481,0.4636174636174636,0.486,340,395,0.8607594936708861
Marvin Williams,willima02,PF,28,CHO,2015,78,2035.0,577,100,58,328,386,69,36,60,146,210,495,0.4242424242424242,95,265,0.3584905660377358,115,230,0.5,0.52,62,87,0.7126436781609196
Mo Williams,willima01,PG,32,TOT,2015,68,1980.0,964,424,22,152,174,46,14,172,162,341,860,0.3965116279069767,119,348,0.3419540229885057,222,512,0.43359375,0.466,163,187,0.8716577540106952
Reggie Williams,willire02,SF,28,SAS,2015,20,105.0,37,10,5,12,17,1,0,2,12,15,39,0.3846153846153846,3,19,0.1578947368421052,12,20,0.6,0.423,4,4,1.0
Shawne Williams,willish03,SF,28,TOT,2015,63,1087.0,341,44,36,130,166,25,21,30,135,121,300,0.4033333333333333,64,178,0.3595505617977528,57,122,0.4672131147540984,0.51,35,40,0.875
Jeff Withey,witheje01,C,24,NOP,2015,37,259.0,98,11,23,41,64,4,18,12,26,32,64,0.5,0,0,0.0,32,64,0.5,0.5,34,50,0.68
Nate Wolters,woltena01,PG,23,TOT,2015,21,247.0,42,21,8,26,34,8,2,13,18,20,57,0.3508771929824561,0,7,0.0,20,50,0.4,0.351,2,6,0.3333333333333333
Brandan Wright,wrighbr03,PF,27,TOT,2015,75,1449.0,544,41,128,193,321,50,94,34,102,233,363,0.6418732782369146,0,3,0.0,233,360,0.6472222222222223,0.642,78,112,0.6964285714285714
Dorell Wright,wrighdo01,SF,29,POR,2015,48,592.0,219,41,14,97,111,20,11,18,55,72,190,0.3789473684210526,41,108,0.3796296296296296,31,82,0.3780487804878049,0.487,34,42,0.8095238095238095
Tony Wroten,wroteto01,PG,21,PHI,2015,30,895.0,507,157,22,64,86,48,8,113,72,175,434,0.4032258064516129,37,142,0.2605633802816901,138,292,0.4726027397260274,0.446,120,180,0.6666666666666666
James Young,youngja01,SG,19,BOS,2015,31,332.0,105,13,9,33,42,8,2,5,22,36,102,0.3529411764705882,17,66,0.2575757575757575,19,36,0.5277777777777778,0.436,16,29,0.5517241379310345
Nick Young,youngni01,SG,29,LAL,2015,42,1000.0,563,41,17,79,96,23,11,44,83,174,476,0.3655462184873949,83,225,0.3688888888888889,91,251,0.3625498007968127,0.453,132,148,0.8918918918918919
Thaddeus Young,youngth01,PF,26,TOT,2015,76,2434.0,1071,173,127,284,411,124,25,117,171,451,968,0.4659090909090909,38,115,0.3304347826086956,413,853,0.4841735052754982,0.486,131,200,0.655
Cody Zeller,zelleco01,C,22,CHO,2015,62,1487.0,472,100,97,265,362,34,49,62,156,172,373,0.4611260053619302,1,1,1.0,171,372,0.4596774193548387,0.462,127,164,0.774390243902439
Tyler Zeller,zellety01,C,25,BOS,2015,82,1731.0,833,113,146,319,465,18,52,76,205,340,619,0.5492730210016155,0,0,0.0,340,619,0.5492730210016155,0.549,153,186,0.8225806451612904
Quincy Acy,acyqu01,PF,25,SAC,2016,59,876.0,307,27,65,123,188,29,24,27,103,119,214,0.5560747663551402,19,49,0.3877551020408163,100,165,0.6060606060606061,0.6,50,68,0.7352941176470589
Jordan Adams,adamsjo01,SG,21,MEM,2016,2,15.0,7,3,0,2,2,3,0,2,2,2,6,0.3333333333333333,0,1,0.0,2,5,0.4,0.333,3,5,0.6
Steven Adams,adamsst01,C,22,OKC,2016,80,2014.0,636,62,219,314,533,42,89,84,223,261,426,0.6126760563380281,0,0,0.0,261,426,0.6126760563380281,0.613,114,196,0.5816326530612245
Arron Afflalo,afflaar01,SG,30,NYK,2016,71,2371.0,909,144,23,243,266,25,10,82,142,354,799,0.4430538172715895,91,238,0.3823529411764705,263,561,0.4688057040998217,0.5,110,131,0.8396946564885496
Alexis Ajinça,ajincal01,C,27,NOP,2016,59,861.0,352,31,75,194,269,19,36,54,134,150,315,0.4761904761904761,0,1,0.0,150,314,0.4777070063694267,0.476,52,62,0.8387096774193549
Cole Aldrich,aldrico01,C,27,LAC,2016,60,800.0,328,50,86,202,288,47,68,64,139,134,225,0.5955555555555555,0,0,0.0,134,225,0.5955555555555555,0.596,60,84,0.7142857142857143
LaMarcus Aldridge,aldrila01,PF,30,SAS,2016,74,2261.0,1331,110,176,456,632,38,81,99,151,536,1045,0.5129186602870813,0,16,0.0,536,1029,0.5208940719144801,0.513,259,302,0.8576158940397351
Cliff Alexander,alexacl01,PF,20,POR,2016,8,36.0,10,0,2,4,6,1,2,1,1,5,10,0.5,0,0,0.0,5,10,0.5,0.5,0,0,0.0
Lavoy Allen,allenla01,PF,26,IND,2016,79,1599.0,428,76,162,262,424,26,42,69,147,191,370,0.5162162162162162,0,0,0.0,191,370,0.5162162162162162,0.516,46,73,0.6301369863013698
Tony Allen,allento01,SG,34,MEM,2016,64,1620.0,535,70,104,192,296,110,18,78,175,215,469,0.4584221748400853,15,42,0.3571428571428571,200,427,0.468384074941452,0.474,90,138,0.6521739130434783
Al-Farouq Aminu,aminual01,SF,25,POR,2016,82,2341.0,839,138,98,401,499,72,53,120,171,299,719,0.4158553546592489,126,349,0.3610315186246418,173,370,0.4675675675675675,0.503,115,156,0.7371794871794872
Lou Amundson,amundlo01,PF,33,NYK,2016,29,204.0,52,12,23,26,49,6,7,15,44,19,53,0.3584905660377358,0,0,0.0,19,53,0.3584905660377358,0.358,14,27,0.5185185185185185
Chris Andersen,anderch01,C,37,TOT,2016,27,402.0,105,12,36,62,98,15,13,9,29,38,72,0.5277777777777778,4,14,0.2857142857142857,34,58,0.5862068965517241,0.556,25,36,0.6944444444444444
Alan Anderson,anderal01,SG,33,WAS,2016,13,192.0,65,14,1,26,27,4,1,2,25,21,59,0.3559322033898305,12,37,0.3243243243243243,9,22,0.4090909090909091,0.458,11,15,0.7333333333333333
James Anderson,anderja01,SG,26,SAC,2016,51,721.0,179,41,13,73,86,21,14,42,54,67,178,0.3764044943820224,23,86,0.2674418604651162,44,92,0.4782608695652174,0.441,22,29,0.7586206896551724
Justin Anderson,anderju01,SF,22,DAL,2016,55,647.0,208,29,18,114,132,19,25,24,45,71,175,0.4057142857142857,22,83,0.2650602409638554,49,92,0.532608695652174,0.469,44,55,0.8
Kyle Anderson,anderky01,SF,22,SAS,2016,78,1245.0,350,123,25,219,244,60,29,59,97,138,295,0.4677966101694915,12,37,0.3243243243243243,126,258,0.4883720930232558,0.488,62,83,0.7469879518072289
Ryan Anderson,anderry01,PF,27,NOP,2016,66,2008.0,1124,73,131,265,396,38,25,90,109,397,929,0.4273412271259418,131,358,0.3659217877094972,266,571,0.4658493870402802,0.498,199,228,0.8728070175438597
Giannis Antetokounmpo,antetgi01,PG,21,MIL,2016,80,2823.0,1350,345,113,499,612,94,113,208,258,513,1013,0.506416584402764,28,109,0.2568807339449541,485,904,0.536504424778761,0.52,296,409,0.7237163814180929
Thanasis Antetokounmpo,antetth01,SF,23,NYK,2016,2,6.0,6,0,0,1,1,0,0,0,2,3,4,0.75,0,1,0.0,3,3,1.0,0.75,0,0,0.0
Carmelo Anthony,anthoca01,SF,31,NYK,2016,72,2530.0,1573,299,98,458,556,62,38,176,180,567,1307,0.4338179035960214,105,310,0.3387096774193548,462,997,0.4633901705115346,0.474,334,403,0.8287841191066998
Joel Anthony,anthojo01,C,33,DET,2016,19,96.0,18,1,8,13,21,2,12,2,15,6,10,0.6,0,0,0.0,6,10,0.6,0.6,6,8,0.75
Keith Appling,applike01,PG,23,ORL,2016,5,27.0,6,1,0,1,1,1,0,3,5,2,8,0.25,0,3,0.0,2,5,0.4,0.25,2,2,1.0
Trevor Ariza,arizatr01,SF,30,HOU,2016,81,2859.0,1025,188,67,299,366,160,26,113,177,357,859,0.4155995343422584,185,499,0.3707414829659318,172,360,0.4777777777777778,0.523,126,161,0.782608695652174
Darrell Arthur,arthuda01,PF,27,DEN,2016,70,1516.0,527,96,86,207,293,53,48,66,185,221,489,0.4519427402862985,45,117,0.3846153846153846,176,372,0.4731182795698925,0.498,40,53,0.7547169811320755
Ömer Aşık,asikom01,C,29,NOP,2016,68,1178.0,269,26,120,294,414,21,23,60,124,104,195,0.5333333333333333,0,0,0.0,104,195,0.5333333333333333,0.533,61,112,0.5446428571428571
D.J. Augustin,augusdj01,PG,28,TOT,2016,62,1178.0,467,198,8,87,95,38,4,84,85,148,350,0.4228571428571429,68,168,0.4047619047619047,80,182,0.4395604395604395,0.52,103,128,0.8046875
Jeff Ayres,pendeje02,C,28,LAC,2016,17,107.0,30,5,4,18,22,0,3,6,18,12,23,0.5217391304347826,0,1,0.0,12,22,0.5454545454545454,0.522,6,6,1.0
Luke Babbitt,babbilu01,SF,26,NOP,2016,47,845.0,327,53,25,123,148,11,7,23,90,122,289,0.4221453287197231,44,109,0.4036697247706422,78,180,0.4333333333333333,0.498,39,50,0.78
Cameron Bairstow,bairsca01,C,25,CHI,2016,18,103.0,34,6,4,24,28,2,3,4,19,13,40,0.325,1,5,0.2,12,35,0.3428571428571428,0.338,7,8,0.875
Leandro Barbosa,barbole01,SG,33,GSW,2016,68,1079.0,433,82,28,89,117,44,10,53,107,171,370,0.4621621621621621,39,110,0.3545454545454545,132,260,0.5076923076923077,0.515,52,62,0.8387096774193549
J.J. Barea,bareajo01,PG,31,DAL,2016,74,1667.0,808,302,26,126,152,26,2,113,110,317,711,0.4458509142053445,100,260,0.3846153846153846,217,451,0.4811529933481153,0.516,74,96,0.7708333333333334
Andrea Bargnani,bargnan01,C,30,BRK,2016,46,634.0,304,18,28,69,97,4,9,26,61,127,279,0.4551971326164875,3,16,0.1875,124,263,0.4714828897338403,0.461,47,57,0.8245614035087719
Harrison Barnes,barneha02,SF,23,GSW,2016,66,2042.0,774,117,77,248,325,41,10,57,136,295,633,0.4660347551342812,82,214,0.3831775700934579,213,419,0.5083532219570406,0.531,102,134,0.7611940298507462
Matt Barnes,barnema02,SF,35,MEM,2016,76,2190.0,758,163,84,336,420,78,57,121,234,264,693,0.3809523809523809,119,370,0.3216216216216216,145,323,0.4489164086687306,0.467,111,138,0.8043478260869565
Will Barton,bartowi01,SG,25,DEN,2016,82,2353.0,1178,203,59,417,476,71,39,139,147,425,983,0.4323499491353001,112,325,0.3446153846153846,313,658,0.4756838905775076,0.489,216,268,0.8059701492537313
Brandon Bass,bassbr01,PF,30,LAL,2016,66,1342.0,473,74,104,181,285,33,55,42,125,174,317,0.5488958990536278,0,2,0.0,174,315,0.5523809523809524,0.549,125,148,0.8445945945945946
Nicolas Batum,batumni01,SF,27,CHO,2016,70,2448.0,1046,403,55,373,428,65,43,205,114,372,873,0.4261168384879725,139,399,0.3483709273182957,233,474,0.4915611814345991,0.506,163,192,0.8489583333333334
Jerryd Bayless,bayleje01,SG,27,MIL,2016,52,1505.0,541,163,21,120,141,47,11,73,111,185,437,0.4233409610983982,101,231,0.4372294372294372,84,206,0.4077669902912621,0.539,70,90,0.7777777777777778
Aron Baynes,baynear01,C,29,DET,2016,81,1233.0,514,51,140,244,384,21,52,67,151,194,384,0.5052083333333334,0,2,0.0,194,382,0.5078534031413613,0.505,126,165,0.7636363636363637
Kent Bazemore,bazemke01,SF,26,ATL,2016,75,2083.0,872,171,28,351,379,98,38,138,176,320,725,0.4413793103448276,109,305,0.3573770491803278,211,420,0.5023809523809524,0.517,123,151,0.8145695364238411
Bradley Beal,bealbr01,SG,22,WAS,2016,55,1708.0,958,162,41,147,188,54,11,112,117,359,799,0.4493116395494368,105,271,0.3874538745387454,254,528,0.4810606060606061,0.515,135,176,0.7670454545454546
Michael Beasley,beaslmi01,PF,27,HOU,2016,20,363.0,255,16,29,69,98,11,9,24,39,107,205,0.5219512195121951,3,9,0.3333333333333333,104,196,0.5306122448979592,0.529,38,49,0.7755102040816326
Marco Belinelli,belinma01,SG,29,SAC,2016,68,1672.0,696,127,10,107,117,37,2,80,91,245,635,0.3858267716535433,91,297,0.3063973063973064,154,338,0.4556213017751479,0.457,115,138,0.8333333333333334
Anthony Bennett,bennean01,PF,22,TOR,2016,19,84.0,28,0,6,17,23,5,0,4,8,8,27,0.2962962962962963,3,14,0.2142857142857142,5,13,0.3846153846153846,0.352,9,10,0.9
Patrick Beverley,beverpa01,PG,27,HOU,2016,71,2041.0,700,239,73,177,250,94,26,91,234,258,594,0.4343434343434343,124,310,0.4,134,284,0.4718309859154929,0.539,60,88,0.6818181818181818
Bismack Biyombo,biyombi01,C,23,TOR,2016,82,1808.0,454,29,182,473,655,19,133,71,225,156,288,0.5416666666666666,0,1,0.0,156,287,0.5435540069686411,0.542,142,226,0.6283185840707964
Nemanja Bjelica,bjeline01,PF,27,MIN,2016,60,1075.0,308,83,49,161,210,26,21,47,154,110,235,0.4680851063829787,48,125,0.384,62,110,0.5636363636363636,0.57,40,55,0.7272727272727273
Tarik Black,blackta01,C,24,LAL,2016,39,496.0,133,16,44,113,157,14,18,22,78,57,104,0.5480769230769231,0,0,0.0,57,104,0.5480769230769231,0.548,19,45,0.4222222222222222
DeJuan Blair,blairde01,C,26,WAS,2016,29,218.0,61,11,20,37,57,8,2,15,53,28,68,0.4117647058823529,0,1,0.0,28,67,0.417910447761194,0.412,5,13,0.3846153846153846
Steve Blake,blakest01,PG,35,DET,2016,58,986.0,254,200,9,80,89,24,5,81,70,93,240,0.3875,52,151,0.3443708609271523,41,89,0.4606741573033708,0.496,16,20,0.8
Eric Bledsoe,bledser01,PG,26,PHO,2016,31,1059.0,632,190,18,107,125,63,19,110,75,223,492,0.4532520325203252,48,129,0.3720930232558139,175,363,0.4820936639118457,0.502,138,172,0.8023255813953488
Bojan Bogdanović,bogdabo02,SF,26,BRK,2016,79,2115.0,887,99,36,219,255,29,5,115,119,324,749,0.4325767690253672,129,338,0.3816568047337278,195,411,0.4744525547445255,0.519,110,132,0.8333333333333334
Andrew Bogut,bogutan01,C,31,GSW,2016,70,1451.0,375,162,121,371,492,33,114,83,221,175,279,0.6272401433691757,1,1,1.0,174,278,0.6258992805755396,0.629,24,50,0.48
Matt Bonner,bonnema01,C,35,SAS,2016,30,206.0,76,9,3,24,27,6,1,3,16,29,57,0.5087719298245614,15,34,0.4411764705882353,14,23,0.6086956521739131,0.64,3,4,0.75
Devin Booker,bookede01,SG,19,PHO,2016,76,2108.0,1048,200,27,160,187,44,20,160,225,367,867,0.4232987312572088,99,289,0.3425605536332179,268,578,0.4636678200692041,0.48,215,256,0.83984375
Trevor Booker,booketr01,PF,28,UTA,2016,79,1632.0,463,84,166,286,452,59,41,81,169,190,388,0.4896907216494845,12,41,0.2926829268292683,178,347,0.5129682997118156,0.505,71,106,0.6698113207547169
Chris Bosh,boshch01,PF,31,MIA,2016,53,1778.0,1010,128,48,342,390,36,34,78,101,358,767,0.4667535853976532,81,222,0.3648648648648648,277,545,0.5082568807339449,0.52,213,268,0.7947761194029851
Avery Bradley,bradlav01,SG,25,BOS,2016,76,2536.0,1155,158,48,172,220,117,19,109,164,456,1019,0.4474975466143278,147,407,0.3611793611793611,309,612,0.5049019607843137,0.52,96,123,0.7804878048780488
Elton Brand,brandel01,C,36,PHI,2016,17,225.0,70,18,9,54,63,9,8,11,32,31,72,0.4305555555555556,0,1,0.0,31,71,0.4366197183098591,0.431,8,9,0.8888888888888888
Corey Brewer,breweco01,SF,29,HOU,2016,82,1669.0,590,109,42,157,199,84,19,78,168,212,552,0.3840579710144927,61,224,0.2723214285714285,151,328,0.4603658536585366,0.439,105,140,0.75
Aaron Brooks,brookaa01,PG,31,CHI,2016,69,1108.0,491,180,21,80,101,30,10,82,132,188,469,0.4008528784648187,66,185,0.3567567567567568,122,284,0.4295774647887324,0.471,49,64,0.765625
Anthony Brown,brownan02,SF,23,LAL,2016,29,599.0,115,19,9,61,70,14,5,15,34,39,126,0.3095238095238095,20,70,0.2857142857142857,19,56,0.3392857142857143,0.389,17,20,0.85
Lorenzo Brown,brownlo01,PG,25,PHO,2016,8,61.0,20,11,0,7,7,3,1,9,4,8,25,0.32,1,8,0.125,7,17,0.4117647058823529,0.34,3,4,0.75
Markel Brown,brownma02,SG,24,BRK,2016,62,982.0,363,91,23,99,122,38,15,54,94,127,322,0.3944099378881988,38,121,0.3140495867768595,89,201,0.4427860696517413,0.453,71,94,0.7553191489361702
Kobe Bryant,bryanko01,SF,37,LAL,2016,66,1863.0,1161,184,41,206,247,62,13,129,115,398,1113,0.35759209344115,133,467,0.284796573875803,265,646,0.4102167182662539,0.417,232,281,0.8256227758007118
Chase Budinger,budinch01,SF,27,TOT,2016,66,929.0,271,64,43,107,150,32,10,44,62,104,239,0.4351464435146444,24,86,0.2790697674418604,80,153,0.5228758169934641,0.485,39,56,0.6964285714285714
Reggie Bullock,bullore01,SF,24,DET,2016,37,429.0,122,27,14,54,68,10,2,8,29,43,98,0.4387755102040816,22,53,0.4150943396226415,21,45,0.4666666666666667,0.551,14,15,0.9333333333333332
Trey Burke,burketr01,PG,23,UTA,2016,64,1366.0,679,148,18,94,112,35,6,80,86,262,634,0.4132492113564668,88,256,0.34375,174,378,0.4603174603174603,0.483,67,82,0.8170731707317073
Alec Burks,burksal01,SG,24,UTA,2016,31,797.0,412,63,16,93,109,18,4,51,71,137,334,0.4101796407185629,32,79,0.4050632911392405,105,255,0.4117647058823529,0.458,106,141,0.75177304964539
Caron Butler,butleca01,SF,35,SAC,2016,17,176.0,63,10,5,17,22,9,1,3,19,25,59,0.423728813559322,3,18,0.1666666666666666,22,41,0.5365853658536586,0.449,10,12,0.8333333333333334
Jimmy Butler,butleji01,SG,26,CHI,2016,67,2474.0,1399,321,79,279,358,110,43,132,124,470,1035,0.4541062801932367,64,205,0.3121951219512195,406,830,0.4891566265060241,0.485,395,475,0.8315789473684211
Rasual Butler,butlera01,SF,36,SAS,2016,46,432.0,124,24,3,53,56,13,23,8,11,49,104,0.4711538461538461,15,49,0.3061224489795918,34,55,0.6181818181818182,0.543,11,16,0.6875
Bruno Caboclo,cabocbr01,SF,20,TOR,2016,6,43.0,3,1,1,1,2,2,1,4,2,1,12,0.0833333333333333,1,7,0.1428571428571428,0,5,0.0,0.125,0,0,0.0
José Calderón,caldejo01,PG,34,NYK,2016,72,2024.0,544,298,22,207,229,63,7,87,135,209,455,0.4593406593406593,84,203,0.4137931034482758,125,252,0.496031746031746,0.552,42,48,0.875
Kentavious Caldwell-Pope,caldwke01,SG,22,DET,2016,76,2789.0,1105,138,70,212,282,110,17,105,167,403,960,0.4197916666666667,114,369,0.3089430894308943,289,591,0.4890016920473773,0.479,185,228,0.8114035087719298
Isaiah Canaan,canaais01,SG,24,PHI,2016,77,1966.0,846,137,20,154,174,56,12,91,133,260,722,0.3601108033240997,176,485,0.3628865979381443,84,237,0.3544303797468354,0.482,150,180,0.8333333333333334
Clint Capela,capelca01,C,21,HOU,2016,77,1471.0,542,47,194,300,494,59,92,60,190,231,397,0.5818639798488665,0,1,0.0,231,396,0.5833333333333334,0.582,80,211,0.3791469194312796
DeMarre Carroll,carrode01,SF,29,TOR,2016,26,786.0,286,27,31,91,122,44,6,28,63,105,270,0.3888888888888889,46,118,0.3898305084745763,59,152,0.3881578947368421,0.474,30,50,0.6
Vince Carter,cartevi01,SG,39,MEM,2016,60,1005.0,395,56,31,115,146,38,16,35,101,133,343,0.3877551020408163,59,169,0.3491124260355029,74,174,0.425287356321839,0.474,70,84,0.8333333333333334
Michael Carter-Williams,cartemi01,PG,24,MIL,2016,54,1649.0,623,281,48,228,276,80,41,153,162,251,555,0.4522522522522522,15,55,0.2727272727272727,236,500,0.472,0.466,106,162,0.654320987654321
Omri Casspi,casspom01,PF,27,SAC,2016,69,1880.0,813,95,58,352,410,56,17,94,154,299,622,0.4807073954983923,112,274,0.4087591240875912,187,348,0.5373563218390804,0.571,103,159,0.6477987421383647
Willie Cauley-Stein,caulewi01,C,22,SAC,2016,66,1412.0,463,37,134,218,352,48,66,46,146,191,339,0.5634218289085545,0,2,0.0,191,337,0.5667655786350149,0.563,81,125,0.648
Mario Chalmers,chalmma01,PG,29,TOT,2016,61,1373.0,628,230,24,133,157,88,13,110,181,182,444,0.4099099099099099,46,149,0.3087248322147651,136,295,0.4610169491525424,0.462,218,262,0.8320610687022901
Tyson Chandler,chandty01,C,33,PHO,2016,66,1618.0,472,64,175,401,576,36,44,93,145,183,314,0.5828025477707006,0,1,0.0,183,313,0.5846645367412141,0.583,106,171,0.6198830409356725
Rakeem Christmas,chrisra01,PF,24,IND,2016,1,6.0,4,0,1,0,1,0,0,0,1,2,2,1.0,0,0,0.0,2,2,1.0,1.0,0,0,0.0
Ian Clark,clarkia01,SG,24,GSW,2016,66,578.0,236,64,13,55,68,17,13,43,58,89,202,0.4405940594059406,30,84,0.3571428571428571,59,118,0.5,0.515,28,34,0.8235294117647058
Coty Clarke,clarkco01,SF,23,BOS,2016,3,6.0,6,0,0,1,1,0,0,1,0,2,4,0.5,2,2,1.0,0,2,0.0,0.75,0,0,0.0
Jordan Clarkson,clarkjo01,SG,23,LAL,2016,79,2552.0,1225,192,93,220,313,88,7,135,168,475,1098,0.4326047358834244,111,320,0.346875,364,778,0.467866323907455,0.483,164,204,0.803921568627451
Norris Cole,coleno01,PG,27,NOP,2016,45,1198.0,477,167,10,141,151,37,5,75,102,196,484,0.4049586776859504,33,102,0.3235294117647059,163,382,0.4267015706806282,0.439,52,65,0.8
Darren Collison,collida01,PG,28,SAC,2016,74,2219.0,1035,318,28,141,169,76,4,130,142,377,776,0.4858247422680412,87,217,0.4009216589861751,290,559,0.518783542039356,0.542,194,226,0.8584070796460177
Nick Collison,collini01,PF,35,OKC,2016,59,699.0,123,52,68,103,171,15,16,50,107,50,109,0.4587155963302752,0,2,0.0,50,107,0.4672897196261682,0.459,23,33,0.696969696969697
Mike Conley,conlemi01,PG,28,MEM,2016,56,1761.0,857,342,26,138,164,67,16,84,100,294,696,0.4224137931034483,78,215,0.3627906976744186,216,481,0.4490644490644491,0.478,191,229,0.834061135371179
Pat Connaughton,connapa01,SG,23,POR,2016,34,143.0,36,10,11,21,32,2,0,10,6,13,49,0.2653061224489796,5,21,0.238095238095238,8,28,0.2857142857142857,0.316,5,5,1.0
Chris Copeland,copelch01,PF,31,MIL,2016,24,156.0,50,11,1,9,10,2,0,6,17,17,51,0.3333333333333333,10,36,0.2777777777777778,7,15,0.4666666666666667,0.431,6,7,0.8571428571428571
Bryce Cotton,cottobr01,PG,23,TOT,2016,8,39.0,8,3,0,0,0,3,0,5,2,4,10,0.4,0,3,0.0,4,7,0.5714285714285714,0.4,0,0,0.0
DeMarcus Cousins,couside01,C,25,SAC,2016,65,2246.0,1748,214,158,589,747,101,92,249,236,601,1332,0.4512012012012012,70,210,0.3333333333333333,531,1122,0.4732620320855615,0.477,476,663,0.717948717948718
Robert Covington,covinro01,SF,25,PHI,2016,67,1903.0,858,97,65,354,419,105,40,143,232,274,712,0.3848314606741573,170,482,0.3526970954356846,104,230,0.4521739130434782,0.504,140,177,0.7909604519774012
Allen Crabbe,crabbal01,SG,23,POR,2016,81,2105.0,832,99,27,189,216,63,16,64,192,311,678,0.4587020648967551,112,285,0.3929824561403509,199,393,0.5063613231552163,0.541,98,113,0.8672566371681416
Jamal Crawford,crawfja01,SG,35,LAC,2016,79,2126.0,1120,183,20,125,145,52,12,113,122,379,939,0.4036208732694356,117,344,0.3401162790697674,262,595,0.4403361344537815,0.466,245,271,0.904059040590406
Jae Crowder,crowdja01,SF,25,BOS,2016,73,2308.0,1038,135,70,303,373,126,35,83,198,360,813,0.4428044280442804,122,363,0.3360881542699724,238,450,0.5288888888888889,0.518,196,239,0.8200836820083682
Dante Cunningham,cunnida01,SF,28,NOP,2016,80,1971.0,484,77,57,179,236,42,33,41,173,186,412,0.4514563106796116,55,174,0.3160919540229885,131,238,0.5504201680672269,0.518,57,82,0.6951219512195121
Jared Cunningham,cunnija01,SG,24,TOT,2016,44,410.0,120,20,3,35,38,14,2,21,41,36,105,0.3428571428571428,12,39,0.3076923076923077,24,66,0.3636363636363636,0.4,36,55,0.6545454545454545
Seth Curry,curryse01,PG,25,SAC,2016,44,692.0,299,67,9,51,60,22,3,36,41,102,224,0.4553571428571428,50,111,0.4504504504504504,52,113,0.4601769911504424,0.567,45,54,0.8333333333333334
Stephen Curry,curryst01,PG,27,GSW,2016,79,2700.0,2375,527,68,362,430,169,15,262,161,805,1598,0.5037546933667084,402,886,0.45372460496614,403,712,0.5660112359550562,0.63,363,400,0.9075
Troy Daniels,danietr01,SG,24,CHO,2016,43,476.0,242,21,7,50,57,11,3,24,40,89,187,0.4759358288770053,59,122,0.4836065573770491,30,65,0.4615384615384615,0.634,5,9,0.5555555555555556
Anthony Davis,davisan02,C,22,NOP,2016,61,2164.0,1481,116,130,497,627,78,125,121,148,560,1136,0.4929577464788732,35,108,0.324074074074074,525,1028,0.5107003891050583,0.508,326,430,0.7581395348837209
Ed Davis,davised01,PF,26,POR,2016,81,1684.0,526,88,224,375,599,57,72,64,202,206,337,0.6112759643916914,0,0,0.0,206,337,0.6112759643916914,0.611,114,204,0.5588235294117647
Branden Dawson,dawsobr01,PF,22,LAC,2016,6,29.0,5,0,2,2,4,0,1,0,2,2,5,0.4,0,0,0.0,2,5,0.4,0.4,1,1,1.0
Dewayne Dedmon,dedmode01,C,26,ORL,2016,58,705.0,255,13,67,161,228,22,46,32,109,99,177,0.559322033898305,0,0,0.0,99,177,0.559322033898305,0.559,57,76,0.75
Bryce Dejean-Jones,dejeabr01,SG,23,NOP,2016,14,279.0,79,15,8,40,48,10,2,11,17,28,69,0.4057971014492754,12,32,0.375,16,37,0.4324324324324324,0.493,11,21,0.5238095238095238
Sam Dekker,dekkesa01,PF,21,HOU,2016,3,6.0,0,0,0,1,1,1,0,0,0,0,0,0.0,0,0,0.0,0,0,0.0,0.0,0,0,0.0
Matthew Dellavedova,dellama01,PG,25,CLE,2016,76,1867.0,569,337,33,129,162,44,9,116,178,207,511,0.4050880626223092,98,239,0.4100418410041841,109,272,0.4007352941176471,0.501,57,66,0.8636363636363636
Luol Deng,denglu01,PF,30,MIA,2016,74,2394.0,911,140,108,335,443,74,29,81,122,339,745,0.4550335570469798,88,256,0.34375,251,489,0.5132924335378323,0.514,145,192,0.7552083333333334
DeMar DeRozan,derozde01,SG,26,TOR,2016,78,2804.0,1830,315,64,285,349,81,21,175,167,614,1377,0.4458968772694263,47,139,0.3381294964028777,567,1238,0.4579967689822294,0.463,555,653,0.8499234303215927
Boris Diaw,diawbo01,PF,33,SAS,2016,76,1386.0,485,176,58,175,233,26,21,97,102,202,383,0.5274151436031331,25,69,0.3623188405797101,177,314,0.5636942675159236,0.56,56,76,0.7368421052631579
Gorgui Dieng,dienggo01,C,26,MIN,2016,82,2220.0,827,143,157,428,585,94,96,140,219,308,579,0.531951640759931,6,20,0.3,302,559,0.5402504472271914,0.537,205,248,0.8266129032258065
Spencer Dinwiddie,dinwisp01,PG,22,DET,2016,12,159.0,58,22,4,13,17,3,0,7,20,19,54,0.3518518518518518,1,10,0.1,18,44,0.4090909090909091,0.361,19,33,0.5757575757575758
Toney Douglas,douglto01,PG,29,NOP,2016,61,1262.0,531,157,25,118,143,70,5,64,131,183,445,0.4112359550561797,81,203,0.3990147783251231,102,242,0.4214876033057851,0.502,84,99,0.8484848484848485
Goran Dragić,dragigo01,PG,29,MIA,2016,72,2363.0,1018,419,54,223,277,71,17,185,188,417,875,0.4765714285714286,64,205,0.3121951219512195,353,670,0.5268656716417911,0.513,120,165,0.7272727272727273
Andre Drummond,drumman01,C,22,DET,2016,81,2666.0,1314,67,395,803,1198,119,112,155,245,552,1060,0.5207547169811321,2,6,0.3333333333333333,550,1054,0.5218216318785579,0.522,208,586,0.3549488054607508
Jared Dudley,dudleja01,PF,30,WAS,2016,81,2098.0,638,170,54,232,286,75,18,80,190,233,487,0.4784394250513347,100,238,0.4201680672268907,133,249,0.5341365461847389,0.581,72,98,0.7346938775510204
Duje Dukan,dukandu01,SF,24,SAC,2016,1,24.0,6,1,2,2,4,1,0,0,2,2,10,0.2,2,5,0.4,0,5,0.0,0.3,0,0,0.0
Tim Duncan,duncati01,C,39,SAS,2016,61,1536.0,522,163,115,332,447,47,78,90,125,215,441,0.4875283446712018,0,2,0.0,215,439,0.489749430523918,0.488,92,131,0.7022900763358778
Mike Dunleavy,dunlemi02,SF,35,CHI,2016,31,703.0,222,39,8,75,83,14,10,26,66,77,188,0.4095744680851064,39,99,0.3939393939393939,38,89,0.4269662921348314,0.513,29,37,0.7837837837837838
Kevin Durant,duranke01,SF,27,OKC,2016,72,2578.0,2029,361,45,544,589,69,85,250,137,698,1381,0.5054308472121651,186,481,0.3866943866943867,512,900,0.5688888888888889,0.573,447,498,0.8975903614457831
Cleanthony Early,earlycl01,SF,24,NYK,2016,17,154.0,31,6,4,22,26,2,3,9,16,12,40,0.3,4,15,0.2666666666666666,8,25,0.32,0.35,3,4,0.75
Jarell Eddie,eddieja01,SF,24,WAS,2016,26,147.0,63,5,2,21,23,5,1,1,5,20,65,0.3076923076923077,15,47,0.3191489361702128,5,18,0.2777777777777778,0.423,8,8,1.0
Wayne Ellington,ellinwa01,SG,28,BRK,2016,76,1615.0,586,83,20,154,174,48,5,45,82,218,561,0.3885918003565062,96,268,0.3582089552238806,122,293,0.4163822525597269,0.474,54,63,0.8571428571428571
Monta Ellis,ellismo01,SG,30,IND,2016,81,2734.0,1121,383,42,229,271,150,37,203,174,436,1021,0.4270323212536728,87,282,0.3085106382978723,349,739,0.4722598105548038,0.47,162,206,0.7864077669902912
James Ennis III,ennisja01,SF,25,TOT,2016,22,329.0,159,21,21,21,42,16,5,19,28,54,113,0.4778761061946903,26,58,0.4482758620689655,28,55,0.509090909090909,0.593,25,34,0.7352941176470589
Tyler Ennis,ennisty01,PG,21,MIL,2016,46,654.0,206,95,13,62,75,25,1,46,64,84,187,0.4491978609625668,13,39,0.3333333333333333,71,148,0.4797297297297297,0.484,25,34,0.7352941176470589
Jeremy Evans,evansje01,SF,28,DAL,2016,30,251.0,71,2,11,43,54,6,9,7,19,26,48,0.5416666666666666,4,16,0.25,22,32,0.6875,0.583,15,21,0.7142857142857143
Tyreke Evans,evansty01,SG,26,NOP,2016,25,765.0,379,164,20,109,129,32,8,73,66,136,314,0.4331210191082802,33,85,0.388235294117647,103,229,0.4497816593886463,0.486,74,93,0.7956989247311828
Festus Ezeli,ezelife01,C,26,GSW,2016,46,770.0,320,32,91,166,257,18,50,38,94,125,228,0.5482456140350878,0,0,0.0,125,228,0.5482456140350878,0.548,70,132,0.5303030303030303
Kenneth Faried,farieke01,PF,26,DEN,2016,67,1694.0,835,79,235,346,581,32,60,91,169,349,626,0.5575079872204473,1,2,0.5,348,624,0.5576923076923077,0.558,136,222,0.6126126126126126
Jordan Farmar,farmajo01,PG,29,MEM,2016,12,291.0,110,37,4,21,25,15,2,18,22,42,100,0.42,16,45,0.3555555555555555,26,55,0.4727272727272727,0.5,10,10,1.0
Derrick Favors,favorde01,PF,24,UTA,2016,62,1983.0,1016,94,169,334,503,74,91,104,150,418,811,0.5154130702836005,0,4,0.0,418,807,0.5179677819083024,0.515,180,254,0.7086614173228346
Cristiano Felício,feliccr01,C,23,CHI,2016,31,321.0,105,26,30,72,102,6,13,13,31,40,72,0.5555555555555556,0,4,0.0,40,68,0.5882352941176471,0.556,25,35,0.7142857142857143
Raymond Felton,feltora01,PG,31,DAL,2016,80,2192.0,763,284,36,222,258,68,15,121,141,277,682,0.4061583577712609,60,213,0.2816901408450704,217,469,0.4626865671641791,0.45,149,176,0.8465909090909091
Evan Fournier,fournev01,SF,23,ORL,2016,79,2566.0,1213,213,33,192,225,96,2,133,214,429,929,0.4617868675995694,156,390,0.4,273,539,0.5064935064935064,0.546,199,238,0.8361344537815126
Randy Foye,foyera01,SG,32,TOT,2016,81,1642.0,474,161,24,132,156,39,29,86,131,169,482,0.3506224066390041,75,250,0.3,94,232,0.4051724137931034,0.428,61,74,0.8243243243243243
Tim Frazier,fraziti01,PG,25,TOT,2016,51,741.0,261,162,26,84,110,33,2,65,73,96,229,0.4192139737991266,16,48,0.3333333333333333,80,181,0.4419889502762431,0.454,53,74,0.7162162162162162
Jimmer Fredette,fredeji01,SG,26,TOT,2016,6,18.0,9,1,0,0,0,1,0,2,2,2,5,0.4,1,2,0.5,1,3,0.3333333333333333,0.5,4,5,0.8
Enes Freedom,kanteen01,C,23,OKC,2016,82,1721.0,1038,33,249,415,664,26,33,115,166,414,719,0.5757997218358831,10,21,0.4761904761904761,404,698,0.5787965616045845,0.583,200,251,0.796812749003984
Channing Frye,fryech01,PF-C,32,TOT,2016,70,1200.0,425,71,35,199,234,29,28,43,127,152,347,0.4380403458213256,91,235,0.3872340425531915,61,112,0.5446428571428571,0.569,30,35,0.8571428571428571
Danilo Gallinari,gallida01,SF,27,DEN,2016,53,1839.0,1036,135,52,229,281,42,19,77,87,287,700,0.41,87,239,0.3640167364016736,200,461,0.4338394793926247,0.472,375,432,0.8680555555555556
Langston Galloway,gallola01,PG,24,NYK,2016,82,2033.0,625,207,43,245,288,77,22,61,177,231,588,0.3928571428571428,77,224,0.34375,154,364,0.4230769230769231,0.458,86,114,0.7543859649122807
Kevin Garnett,garneke01,PF,39,MIN,2016,38,556.0,122,62,15,135,150,28,10,16,70,54,115,0.4695652173913043,0,1,0.0,54,114,0.4736842105263157,0.47,14,21,0.6666666666666666
Marc Gasol,gasolma01,C,31,MEM,2016,52,1791.0,861,196,58,304,362,50,70,118,141,328,707,0.4639321074964639,2,3,0.6666666666666666,326,704,0.4630681818181818,0.465,203,245,0.8285714285714286
Pau Gasol,gasolpa01,C,35,CHI,2016,72,2291.0,1187,294,155,638,793,42,146,164,148,467,995,0.4693467336683417,24,69,0.3478260869565217,443,926,0.478401727861771,0.481,229,289,0.7923875432525952
Rudy Gay,gayru01,SF,29,SAC,2016,70,2379.0,1204,120,103,353,456,100,51,139,184,466,1007,0.4627606752730884,74,215,0.3441860465116279,392,792,0.494949494949495,0.5,198,254,0.7795275590551181
Alonzo Gee,geeal01,SF,28,NOP,2016,73,1632.0,325,72,60,185,245,63,13,55,169,132,255,0.5176470588235295,17,60,0.2833333333333333,115,195,0.5897435897435898,0.551,44,66,0.6666666666666666
Paul George,georgpa01,SF,25,IND,2016,81,2819.0,1874,329,79,484,563,152,29,265,230,605,1449,0.4175293305728088,210,566,0.3710247349823322,395,883,0.4473386183465458,0.49,454,528,0.8598484848484849
Taj Gibson,gibsota01,PF,30,CHI,2016,73,1936.0,627,106,206,298,504,47,77,78,180,263,500,0.526,0,3,0.0,263,497,0.5291750503018109,0.526,101,146,0.6917808219178082
Manu Ginóbili,ginobma01,SG,38,SAS,2016,58,1134.0,555,177,26,120,146,66,11,99,99,197,435,0.4528735632183908,70,179,0.3910614525139664,127,256,0.49609375,0.533,91,112,0.8125
Rudy Gobert,goberru01,C,23,UTA,2016,61,1932.0,557,91,208,460,668,45,135,114,163,198,354,0.559322033898305,0,0,0.0,198,354,0.559322033898305,0.559,161,283,0.568904593639576
Drew Gooden,goodedr01,PF,34,WAS,2016,30,305.0,82,13,28,57,85,8,11,13,40,33,103,0.3203883495145631,7,41,0.1707317073170731,26,62,0.4193548387096774,0.354,9,14,0.6428571428571429
Archie Goodwin,goodwar01,PG,21,PHO,2016,57,1114.0,505,118,27,115,142,27,13,100,84,176,422,0.4170616113744075,23,99,0.2323232323232323,153,323,0.4736842105263157,0.444,130,193,0.6735751295336787
Aaron Gordon,gordoaa01,PF,20,ORL,2016,78,1863.0,719,128,154,353,507,59,55,66,153,274,579,0.4732297063903281,42,142,0.2957746478873239,232,437,0.5308924485125858,0.509,129,193,0.6683937823834197
Eric Gordon,gordoer01,SG,27,NOP,2016,45,1481.0,686,121,10,89,99,43,14,73,98,231,552,0.4184782608695652,113,294,0.3843537414965986,118,258,0.4573643410852713,0.521,111,125,0.888
Marcin Gortat,gortama01,C,31,WAS,2016,75,2256.0,1012,106,222,519,741,47,96,121,193,433,764,0.5667539267015707,0,1,0.0,433,763,0.5674967234600262,0.567,146,207,0.7053140096618358
Andrew Goudelock,goudean01,PG,27,HOU,2016,8,50.0,22,4,1,1,2,6,2,7,4,9,20,0.45,1,9,0.1111111111111111,8,11,0.7272727272727273,0.475,3,4,0.75
Jerami Grant,grantje01,PF,21,PHI,2016,77,2066.0,749,135,99,262,361,54,127,110,215,251,599,0.4190317195325542,35,146,0.2397260273972602,216,453,0.4768211920529801,0.448,212,322,0.6583850931677019
Jerian Grant,grantje02,PG,23,NYK,2016,76,1265.0,426,177,23,120,143,50,10,87,97,154,391,0.3938618925831202,22,100,0.22,132,291,0.4536082474226804,0.422,96,123,0.7804878048780488
Danny Green,greenda02,SG,28,SAS,2016,79,2062.0,572,141,48,255,303,79,64,75,141,211,561,0.3761140819964349,116,349,0.332378223495702,95,212,0.4481132075471698,0.48,34,46,0.7391304347826086
Draymond Green,greendr01,PF,25,GSW,2016,81,2808.0,1131,598,134,635,769,119,113,259,240,401,819,0.4896214896214896,100,258,0.3875968992248062,301,561,0.5365418894830659,0.551,229,329,0.6960486322188449
Erick Green,greener01,PG,24,TOT,2016,9,42.0,13,3,3,3,6,1,0,0,4,5,13,0.3846153846153846,1,5,0.2,4,8,0.5,0.423,2,2,1.0
Gerald Green,greenge01,SG,30,MIA,2016,69,1557.0,616,56,25,138,163,38,19,46,123,230,587,0.3918228279386712,84,260,0.3230769230769231,146,327,0.4464831804281345,0.463,72,92,0.782608695652174
JaMychal Green,greenja01,PF,25,MEM,2016,78,1446.0,578,67,139,234,373,46,33,83,189,230,495,0.4646464646464646,15,45,0.3333333333333333,215,450,0.4777777777777778,0.48,103,137,0.7518248175182481
Jeff Green,greenje02,SF,29,TOT,2016,80,2253.0,939,138,74,258,332,58,40,93,164,354,824,0.4296116504854368,67,213,0.3145539906103286,287,611,0.469721767594108,0.47,164,220,0.7454545454545455
Blake Griffin,griffbl01,PF,26,LAC,2016,35,1170.0,749,170,51,243,294,28,17,83,95,301,603,0.4991708126036484,6,18,0.3333333333333333,295,585,0.5042735042735043,0.504,141,194,0.7268041237113402
Jorge Gutiérrez,gutiejo01,PG,27,CHO,2016,12,63.0,22,17,0,7,7,3,0,6,3,6,11,0.5454545454545454,0,2,0.0,6,9,0.6666666666666666,0.545,10,11,0.9090909090909092
P.J. Hairston,hairspj02,SF,23,TOT,2016,66,1313.0,410,38,25,149,174,32,11,41,137,145,408,0.3553921568627451,70,241,0.2904564315352697,75,167,0.4491017964071856,0.441,50,64,0.78125
Jordan Hamilton,hamiljo02,SF,25,NOP,2016,11,304.0,125,25,12,50,62,8,3,17,24,49,116,0.4224137931034483,13,45,0.2888888888888888,36,71,0.5070422535211268,0.478,14,21,0.6666666666666666
Tyler Hansbrough,hansbty01,PF,30,CHO,2016,44,343.0,104,8,40,49,89,12,7,12,55,32,71,0.4507042253521127,2,3,0.6666666666666666,30,68,0.4411764705882353,0.465,38,65,0.5846153846153846
Tim Hardaway Jr.,hardati02,SG,23,ATL,2016,51,864.0,326,51,7,79,86,21,7,23,48,114,265,0.430188679245283,48,142,0.3380281690140845,66,123,0.5365853658536586,0.521,50,56,0.8928571428571429
James Harden,hardeja01,SG,26,HOU,2016,82,3125.0,2376,612,63,438,501,139,51,374,229,710,1617,0.4390847247990105,236,657,0.3592085235920852,474,960,0.49375,0.512,720,837,0.8602150537634409
Maurice Harkless,harklma01,SF,22,POR,2016,78,1457.0,498,67,101,179,280,49,35,62,124,195,411,0.4744525547445255,39,140,0.2785714285714286,156,271,0.5756457564575646,0.522,69,111,0.6216216216216216
Justin Harper,harpeju01,PF,26,DET,2016,5,35.0,13,0,0,1,1,1,0,2,3,4,10,0.4,4,9,0.4444444444444444,0,1,0.0,0.6,1,2,0.5
Montrezl Harrell,harremo01,PF,22,HOU,2016,39,379.0,140,17,25,40,65,11,11,17,48,58,90,0.6444444444444445,0,1,0.0,58,89,0.651685393258427,0.644,24,46,0.5217391304347826
Devin Harris,harride01,PG,32,DAL,2016,64,1280.0,487,118,18,120,138,60,13,66,124,167,374,0.446524064171123,52,158,0.3291139240506329,115,216,0.5324074074074074,0.516,101,140,0.7214285714285714
Gary Harris,harriga01,SG,21,DEN,2016,76,2439.0,932,147,54,166,220,97,18,98,143,359,765,0.469281045751634,105,297,0.3535353535353535,254,468,0.5427350427350427,0.538,109,133,0.8195488721804511
Joe Harris,harrijo01,SG,24,CLE,2016,5,15.0,3,2,0,3,3,0,0,1,1,1,4,0.25,1,4,0.25,0,0,0.0,0.375,0,0,0.0
Tobias Harris,harrito02,PF,23,TOT,2016,76,2513.0,1116,169,96,414,510,65,40,108,153,417,889,0.4690663667041619,80,239,0.3347280334728033,337,650,0.5184615384615384,0.514,202,243,0.831275720164609
Aaron Harrison,harriaa01,SG,21,CHO,2016,21,93.0,18,2,4,11,15,6,0,4,10,5,19,0.2631578947368421,3,10,0.3,2,9,0.2222222222222222,0.342,5,12,0.4166666666666667
Udonis Haslem,hasleud01,PF,35,MIA,2016,37,260.0,59,14,10,65,75,5,2,5,25,23,61,0.3770491803278688,1,9,0.1111111111111111,22,52,0.4230769230769231,0.385,12,16,0.75
Spencer Hawes,hawessp01,PF,27,CHO,2016,57,1035.0,340,109,51,193,244,22,27,58,111,124,306,0.4052287581699346,38,102,0.3725490196078431,86,204,0.4215686274509804,0.467,54,65,0.8307692307692308
Chuck Hayes,hayesch01,C,32,HOU,2016,2,24.0,4,2,0,8,8,0,0,3,6,1,2,0.5,0,0,0.0,1,2,0.5,0.5,2,2,1.0
Gordon Hayward,haywago01,SF,25,UTA,2016,80,2893.0,1578,296,61,336,397,95,27,202,183,521,1202,0.4334442595673877,143,410,0.348780487804878,378,792,0.4772727272727273,0.493,393,477,0.8238993710691824
Gerald Henderson,hendege02,SG,28,POR,2016,72,1431.0,624,75,30,181,211,39,19,68,87,232,529,0.4385633270321361,48,136,0.3529411764705882,184,393,0.4681933842239186,0.484,112,146,0.7671232876712328
John Henson,hensojo01,C,25,MIL,2016,57,960.0,397,54,87,134,221,18,109,64,131,164,291,0.563573883161512,0,1,0.0,164,290,0.5655172413793104,0.564,69,117,0.5897435897435898
Mario Hezonja,hezonma01,SF,20,ORL,2016,79,1413.0,478,109,28,148,176,39,17,97,124,181,418,0.4330143540669856,67,192,0.3489583333333333,114,226,0.504424778761062,0.513,49,54,0.9074074074074074
Roy Hibbert,hibbero01,C,29,LAL,2016,81,1878.0,481,95,132,266,398,32,110,76,252,182,411,0.4428223844282238,0,2,0.0,182,409,0.4449877750611247,0.443,117,145,0.8068965517241379
J.J. Hickson,hicksjj01,C,27,TOT,2016,35,436.0,206,23,39,93,132,15,14,25,47,80,155,0.5161290322580645,0,1,0.0,80,154,0.5194805194805194,0.516,46,103,0.4466019417475728
Nenê,hilarne01,PF,33,WAS,2016,57,1094.0,525,97,52,207,259,54,26,76,156,209,384,0.5442708333333334,0,3,0.0,209,381,0.5485564304461942,0.544,107,185,0.5783783783783784
George Hill,hillge01,PG,29,IND,2016,74,2524.0,894,259,58,240,298,83,17,101,149,326,739,0.4411366711772665,128,314,0.4076433121019108,198,425,0.4658823529411764,0.528,114,150,0.76
Jordan Hill,hilljo01,C,28,IND,2016,73,1513.0,645,87,156,295,451,36,37,92,155,278,549,0.5063752276867031,0,1,0.0,278,548,0.5072992700729927,0.506,89,125,0.712
Solomon Hill,hillso01,SF,24,IND,2016,59,866.0,246,57,39,127,166,37,11,33,68,93,208,0.4471153846153846,24,74,0.3243243243243243,69,134,0.5149253731343284,0.505,36,42,0.8571428571428571
Darrun Hilliard,hillida01,SG,22,DET,2016,38,383.0,152,27,5,40,45,9,1,19,28,52,131,0.3969465648854962,19,50,0.38,33,81,0.4074074074074074,0.469,29,40,0.725
Kirk Hinrich,hinriki01,PG,35,TOT,2016,46,631.0,137,73,8,62,70,15,2,30,64,49,129,0.3798449612403101,24,62,0.3870967741935484,25,67,0.373134328358209,0.473,15,16,0.9375
Jrue Holiday,holidjr01,PG,25,NOP,2016,65,1831.0,1089,391,27,168,195,88,22,167,148,410,935,0.4385026737967914,87,259,0.3359073359073359,323,676,0.4778106508875739,0.485,182,216,0.8425925925925926
Justin Holiday,holidju01,SG,26,TOT,2016,53,773.0,239,56,12,78,90,32,19,39,61,88,228,0.3859649122807017,36,105,0.3428571428571428,52,123,0.4227642276422764,0.465,27,37,0.7297297297297297
Ryan Hollins,holliry01,C,31,TOT,2016,37,460.0,124,10,47,51,98,6,21,24,62,49,79,0.620253164556962,0,0,0.0,49,79,0.620253164556962,0.62,26,42,0.6190476190476191
Rondae Hollis-Jefferson,holliro01,SF,21,BRK,2016,29,615.0,167,43,39,115,154,39,16,26,61,63,138,0.4565217391304347,4,14,0.2857142857142857,59,124,0.4758064516129032,0.471,37,52,0.7115384615384616
Richaun Holmes,holmeri01,PF,22,PHI,2016,51,702.0,287,33,62,73,135,19,40,32,92,114,222,0.5135135135135135,8,44,0.1818181818181818,106,178,0.5955056179775281,0.532,51,74,0.6891891891891891
Rodney Hood,hoodro01,SG,23,UTA,2016,79,2541.0,1149,213,38,229,267,73,16,125,202,408,972,0.419753086419753,161,449,0.3585746102449889,247,523,0.4722753346080306,0.503,172,200,0.86
Al Horford,horfoal01,C,29,ATL,2016,82,2631.0,1249,263,148,448,596,68,121,107,163,529,1048,0.5047709923664122,88,256,0.34375,441,792,0.5568181818181818,0.547,103,129,0.7984496124031008
Dwight Howard,howardw01,C,30,HOU,2016,71,2280.0,976,98,238,597,835,69,113,166,219,372,600,0.62,0,6,0.0,372,594,0.6262626262626263,0.62,232,474,0.4894514767932489
Marcelo Huertas,huertma01,PG,32,LAL,2016,53,869.0,237,182,18,72,90,26,7,80,76,97,230,0.4217391304347826,16,61,0.2622950819672131,81,169,0.4792899408284023,0.457,27,29,0.9310344827586208
Josh Huestis,huestjo01,PF,24,OKC,2016,5,55.0,14,0,2,8,10,1,2,3,3,5,12,0.4166666666666667,4,6,0.6666666666666666,1,6,0.1666666666666666,0.583,0,4,0.0
Kris Humphries,humphkr01,PF,30,TOT,2016,53,835.0,343,36,57,161,218,16,23,38,94,121,295,0.4101694915254237,34,108,0.3148148148148148,87,187,0.46524064171123,0.468,67,84,0.7976190476190477
R.J. Hunter,hunterj01,SG,22,BOS,2016,36,315.0,97,13,2,35,37,14,4,11,29,36,98,0.3673469387755102,19,63,0.3015873015873015,17,35,0.4857142857142857,0.464,6,7,0.8571428571428571
Serge Ibaka,ibakase01,PF,26,OKC,2016,78,2500.0,983,66,141,392,533,38,148,108,211,416,869,0.478711162255466,60,184,0.3260869565217391,356,685,0.5197080291970803,0.513,91,121,0.7520661157024794
Andre Iguodala,iguodan01,SF,32,GSW,2016,65,1732.0,457,219,52,211,263,73,19,79,102,176,368,0.4782608695652174,54,154,0.3506493506493506,122,214,0.5700934579439252,0.552,51,83,0.6144578313253012
Ersan İlyasova,ilyaser01,PF,28,TOT,2016,74,1881.0,767,67,144,259,403,52,33,71,171,280,661,0.4236006051437216,96,259,0.3706563706563706,184,402,0.4577114427860697,0.496,111,154,0.7207792207792207
Joe Ingles,inglejo01,SF,28,UTA,2016,81,1241.0,342,96,19,132,151,55,4,65,98,124,291,0.4261168384879725,81,210,0.3857142857142857,43,81,0.5308641975308642,0.565,13,18,0.7222222222222222
Damien Inglis,inglida01,SF,20,MIL,2016,20,156.0,36,10,2,29,31,6,3,11,11,13,37,0.3513513513513513,3,13,0.2307692307692307,10,24,0.4166666666666667,0.392,7,8,0.875
Kyrie Irving,irvinky01,PG,23,CLE,2016,53,1667.0,1041,249,44,113,157,56,18,124,107,394,879,0.4482366325369738,84,262,0.3206106870229007,310,617,0.5024311183144247,0.496,169,191,0.8848167539267016
Jarrett Jack,jackja01,PG,32,BRK,2016,32,1027.0,411,236,9,127,136,34,7,94,77,140,358,0.3910614525139664,31,102,0.3039215686274509,109,256,0.42578125,0.434,100,112,0.8928571428571429
Reggie Jackson,jacksre01,PG,25,DET,2016,79,2424.0,1489,492,58,195,253,59,11,223,187,540,1244,0.4340836012861736,118,334,0.3532934131736527,422,910,0.4637362637362637,0.482,291,337,0.8635014836795252
LeBron James,jamesle01,SF,31,CLE,2016,76,2709.0,1920,514,111,454,565,104,49,249,143,737,1416,0.5204802259887006,87,282,0.3085106382978723,650,1134,0.5731922398589065,0.551,359,491,0.7311608961303462
Al Jefferson,jeffeal01,C,31,CHO,2016,47,1096.0,562,70,57,244,301,30,41,34,117,245,505,0.4851485148514851,0,0,0.0,245,505,0.4851485148514851,0.485,72,111,0.6486486486486487
Cory Jefferson,jeffeco01,PF,25,PHO,2016,8,50.0,22,0,6,10,16,0,1,0,8,9,22,0.4090909090909091,0,1,0.0,9,21,0.4285714285714285,0.409,4,6,0.6666666666666666
Richard Jefferson,jefferi01,SF,35,CLE,2016,74,1326.0,410,59,15,113,128,33,14,43,129,143,312,0.4583333333333333,66,173,0.3815028901734104,77,139,0.5539568345323741,0.564,58,87,0.6666666666666666
John Jenkins,jenkijo01,SG,24,TOT,2016,43,480.0,178,35,8,49,57,8,1,27,22,71,160,0.44375,16,51,0.3137254901960784,55,109,0.5045871559633027,0.494,20,24,0.8333333333333334
Brandon Jennings,jennibr01,PG,26,TOT,2016,48,868.0,332,170,16,80,96,29,7,57,57,112,304,0.3684210526315789,51,155,0.3290322580645161,61,149,0.4093959731543624,0.452,57,78,0.7307692307692307
Jonas Jerebko,jerebjo01,PF,28,BOS,2016,78,1176.0,340,62,77,211,288,20,24,52,137,118,286,0.4125874125874126,43,108,0.3981481481481481,75,178,0.4213483146067415,0.488,61,78,0.782051282051282
Amir Johnson,johnsam01,PF,28,BOS,2016,79,1800.0,577,138,178,327,505,52,83,94,214,249,426,0.5845070422535211,10,43,0.2325581395348837,239,383,0.6240208877284595,0.596,69,121,0.5702479338842975
Chris Johnson,johnsch04,SF,25,UTA,2016,70,857.0,205,45,27,105,132,32,20,40,100,72,194,0.3711340206185567,27,99,0.2727272727272727,45,95,0.4736842105263157,0.441,34,42,0.8095238095238095
James Johnson,johnsja01,PF,28,TOR,2016,57,926.0,287,67,28,98,126,29,33,54,84,114,240,0.475,20,66,0.303030303030303,94,174,0.5402298850574713,0.517,39,68,0.5735294117647058
Joe Johnson,johnsjo02,SF,34,TOT,2016,81,2703.0,992,318,49,243,292,61,4,159,146,377,859,0.4388824214202561,120,313,0.3833865814696485,257,546,0.4706959706959707,0.509,118,142,0.8309859154929577
Orlando Johnson,johnsor01,SG,26,TOT,2016,7,101.0,26,2,4,11,15,3,3,4,9,9,34,0.2647058823529412,2,10,0.2,7,24,0.2916666666666667,0.294,6,8,0.75
Stanley Johnson,johnsst04,SF,19,DET,2016,73,1687.0,593,118,58,248,306,55,12,114,178,225,600,0.375,63,205,0.3073170731707317,162,395,0.410126582278481,0.428,80,102,0.7843137254901961
Tyler Johnson,johnsty01,SG,23,MIA,2016,36,863.0,314,79,28,81,109,24,14,47,66,118,243,0.48559670781893,27,71,0.380281690140845,91,172,0.5290697674418605,0.541,51,64,0.796875
Wesley Johnson,johnswe01,SF,28,LAC,2016,80,1666.0,549,49,37,211,248,89,56,54,173,208,515,0.403883495145631,103,309,0.3333333333333333,105,206,0.5097087378640777,0.504,30,46,0.6521739130434783
Nikola Jokić,jokicni01,C,20,DEN,2016,80,1733.0,796,189,181,379,560,79,50,104,208,307,600,0.5116666666666667,28,84,0.3333333333333333,279,516,0.5406976744186046,0.535,154,190,0.8105263157894737
Dahntay Jones,jonesda02,SF,35,CLE,2016,1,42.0,13,2,1,4,5,1,2,0,6,6,14,0.4285714285714285,1,2,0.5,5,12,0.4166666666666667,0.464,0,0,0.0
James Jones,jonesja02,SF,35,CLE,2016,48,463.0,178,14,8,42,50,11,10,13,50,58,142,0.4084507042253521,41,104,0.3942307692307692,17,38,0.4473684210526316,0.553,21,26,0.8076923076923077
Terrence Jones,joneste01,PF,24,HOU,2016,50,1044.0,434,41,62,149,211,23,39,49,86,166,367,0.4523160762942779,25,79,0.3164556962025316,141,288,0.4895833333333333,0.486,77,116,0.6637931034482759
Tyus Jones,jonesty01,PG,19,MIN,2016,37,573.0,156,108,7,40,47,31,3,33,33,56,156,0.358974358974359,16,53,0.3018867924528302,40,103,0.3883495145631068,0.41,28,39,0.717948717948718
DeAndre Jordan,jordade01,C,27,LAC,2016,77,2598.0,980,90,267,792,1059,51,177,107,207,357,508,0.702755905511811,0,1,0.0,357,507,0.7041420118343196,0.703,266,619,0.4297253634894992
Cory Joseph,josepco01,SG,24,TOR,2016,80,2046.0,677,250,39,171,210,63,20,102,131,257,585,0.4393162393162393,30,110,0.2727272727272727,227,475,0.4778947368421052,0.465,133,174,0.764367816091954
Chris Kaman,kamanch01,C,33,POR,2016,16,112.0,44,11,7,17,24,1,1,8,15,20,43,0.4651162790697674,1,4,0.25,19,39,0.4871794871794871,0.477,3,3,1.0
Frank Kaminsky,kaminfr01,C,22,CHO,2016,81,1708.0,606,98,69,266,335,38,43,58,126,215,525,0.4095238095238095,68,202,0.3366336633663366,147,323,0.4551083591331269,0.474,108,148,0.7297297297297297
Sergey Karasev,karasse01,SF,22,BRK,2016,40,399.0,97,35,8,50,58,6,2,22,27,30,74,0.4054054054054054,11,37,0.2972972972972973,19,37,0.5135135135135135,0.48,26,28,0.9285714285714286
Sasha Kaun,kaunsa01,C,30,CLE,2016,25,95.0,23,3,12,14,26,4,5,7,11,9,17,0.5294117647058824,0,0,0.0,9,17,0.5294117647058824,0.529,5,11,0.4545454545454545
Ryan Kelly,kellyry01,PF,24,LAL,2016,36,470.0,152,20,21,100,121,13,10,18,39,55,149,0.3691275167785235,5,37,0.1351351351351351,50,112,0.4464285714285714,0.386,37,54,0.6851851851851852
Michael Kidd-Gilchrist,kiddgmi01,SF,22,CHO,2016,7,205.0,89,9,12,33,45,3,3,8,9,33,61,0.5409836065573771,3,7,0.4285714285714285,30,54,0.5555555555555556,0.566,20,29,0.6896551724137931
Sean Kilpatrick,kilpase01,SG,26,TOT,2016,31,616.0,345,29,12,44,56,12,2,31,37,123,270,0.4555555555555555,39,114,0.3421052631578947,84,156,0.5384615384615384,0.528,60,67,0.8955223880597015
Brandon Knight,knighbr03,SG,24,PHO,2016,52,1870.0,1018,263,36,166,202,61,20,177,124,371,895,0.4145251396648045,120,351,0.3418803418803419,251,544,0.4613970588235294,0.482,156,183,0.8524590163934426
Kyle Korver,korveky01,SG,34,ATL,2016,80,2401.0,739,164,14,246,260,60,35,98,161,268,616,0.435064935064935,158,397,0.3979848866498741,110,219,0.502283105022831,0.563,45,54,0.8333333333333334
Kosta Koufos,koufoko01,C,26,SAC,2016,78,1482.0,529,33,169,254,423,40,70,48,185,236,444,0.5315315315315315,0,0,0.0,236,444,0.5315315315315315,0.532,57,104,0.5480769230769231
Jeremy Lamb,lambje01,SG,23,CHO,2016,66,1227.0,580,77,44,208,252,42,30,50,105,230,510,0.4509803921568627,56,181,0.3093922651933701,174,329,0.5288753799392097,0.506,64,88,0.7272727272727273
Carl Landry,landrca01,PF,32,PHI,2016,36,569.0,351,32,49,97,146,12,9,22,69,139,250,0.556,6,13,0.4615384615384615,133,237,0.5611814345991561,0.568,67,91,0.7362637362637363
Shane Larkin,larkish01,PG,23,BRK,2016,78,1751.0,566,342,28,152,180,95,12,146,121,222,502,0.4422310756972111,39,108,0.3611111111111111,183,394,0.4644670050761421,0.481,83,107,0.7757009345794392
Joffrey Lauvergne,lauvejo01,C,24,DEN,2016,59,1041.0,465,56,77,213,290,13,15,54,115,195,380,0.5131578947368421,13,53,0.2452830188679245,182,327,0.5565749235474006,0.53,62,69,0.8985507246376812
Zach LaVine,lavinza01,SG,20,MIN,2016,82,2294.0,1150,251,27,201,228,69,17,155,193,433,959,0.451511991657977,123,316,0.3892405063291139,310,643,0.4821150855365474,0.516,161,203,0.7931034482758621
Ty Lawson,lawsoty01,PG,28,TOT,2016,66,1411.0,373,237,26,94,120,53,7,95,87,139,354,0.3926553672316384,36,108,0.3333333333333333,103,246,0.4186991869918699,0.444,59,86,0.686046511627907
Courtney Lee,leeco01,SG,30,TOT,2016,79,2334.0,761,136,29,176,205,85,28,72,134,290,639,0.4538341158059468,82,217,0.3778801843317972,208,422,0.4928909952606635,0.518,99,118,0.8389830508474576
David Lee,leeda02,PF,32,TOT,2016,55,903.0,427,84,101,204,305,22,28,66,114,178,335,0.5313432835820896,0,1,0.0,178,334,0.5329341317365269,0.531,71,93,0.7634408602150538
Alex Len,lenal01,C,22,PHO,2016,78,1821.0,703,97,178,416,594,38,62,145,230,264,624,0.4230769230769231,1,7,0.1428571428571428,263,617,0.426256077795786,0.424,174,239,0.7280334728033473
Kawhi Leonard,leonaka01,SF,24,SAS,2016,72,2380.0,1523,186,95,398,493,128,71,105,133,551,1090,0.5055045871559632,129,291,0.4432989690721649,422,799,0.5281602002503129,0.565,292,334,0.874251497005988
Meyers Leonard,leoname01,PF,23,POR,2016,61,1333.0,511,92,51,263,314,8,18,77,183,195,435,0.4482758620689655,86,228,0.3771929824561403,109,207,0.5265700483091788,0.547,35,46,0.7608695652173914
Jon Leuer,leuerjo01,PF,26,PHO,2016,67,1255.0,567,72,76,297,373,38,30,75,125,224,466,0.4806866952789699,42,110,0.3818181818181818,182,356,0.5112359550561798,0.526,77,101,0.7623762376237624
Damian Lillard,lillada01,PG,25,POR,2016,75,2676.0,1879,512,45,257,302,65,28,242,165,618,1474,0.4192672998643147,229,610,0.3754098360655737,389,864,0.4502314814814814,0.497,414,464,0.8922413793103449
Jeremy Lin,linje01,SG,27,CHO,2016,78,2048.0,914,235,42,211,253,58,42,150,165,300,728,0.412087912087912,76,226,0.336283185840708,224,502,0.446215139442231,0.464,238,292,0.815068493150685
Shaun Livingston,livinsh01,PG,30,GSW,2016,78,1520.0,488,237,42,127,169,57,27,78,140,203,379,0.5356200527704486,2,12,0.1666666666666666,201,367,0.547683923705722,0.538,80,93,0.8602150537634409
Kevon Looney,looneke01,PF,19,GSW,2016,5,21.0,9,0,4,6,10,0,0,1,2,4,7,0.5714285714285714,1,2,0.5,3,5,0.6,0.643,0,0,0.0
Brook Lopez,lopezbr01,C,27,BRK,2016,73,2457.0,1501,147,204,369,573,58,124,175,215,591,1157,0.5108038029386344,2,14,0.1428571428571428,589,1143,0.5153105861767279,0.512,317,403,0.7866004962779156
Robin Lopez,lopezro01,C,27,NYK,2016,82,2219.0,842,114,268,334,602,16,129,133,182,357,662,0.5392749244712991,0,1,0.0,357,661,0.540090771558245,0.539,128,161,0.7950310559006211
Kevin Love,loveke01,PF,27,CLE,2016,77,2424.0,1234,186,149,613,762,58,41,142,159,409,977,0.4186284544524053,158,439,0.3599088838268792,251,538,0.466542750929368,0.499,258,314,0.821656050955414
Kyle Lowry,lowryky01,PG,29,TOR,2016,77,2851.0,1634,494,55,310,365,158,34,225,211,512,1198,0.4273789649415693,212,547,0.3875685557586837,300,651,0.4608294930875576,0.516,398,491,0.8105906313645621
Trey Lyles,lylestr01,PF,20,UTA,2016,80,1382.0,488,59,59,240,299,26,18,65,114,191,436,0.4380733944954128,49,128,0.3828125,142,308,0.461038961038961,0.494,57,82,0.6951219512195121
Shelvin Mack,macksh01,PG,25,TOT,2016,52,1058.0,448,187,13,115,128,34,3,95,72,182,415,0.4385542168674698,39,125,0.312,143,290,0.493103448275862,0.486,45,61,0.7377049180327869
Ian Mahinmi,mahinia01,C,29,IND,2016,71,1816.0,660,104,138,369,507,65,75,100,220,264,448,0.5892857142857143,0,0,0.0,264,448,0.5892857142857143,0.589,132,225,0.5866666666666667
Devyn Marble,marblde01,SG,23,ORL,2016,28,249.0,60,12,6,32,38,13,1,7,25,21,71,0.2957746478873239,8,32,0.25,13,39,0.3333333333333333,0.352,10,24,0.4166666666666667
Boban Marjanović,marjabo01,C,27,SAS,2016,54,508.0,297,21,73,121,194,12,23,29,54,105,174,0.603448275862069,0,0,0.0,105,174,0.603448275862069,0.603,87,114,0.7631578947368421
Kendall Marshall,marshke01,PG,24,PHI,2016,30,400.0,111,73,2,26,28,16,2,43,30,43,118,0.3644067796610169,16,49,0.3265306122448979,27,69,0.391304347826087,0.432,9,13,0.6923076923076923
Jarell Martin,martija01,PF,21,MEM,2016,27,380.0,153,15,39,47,86,8,7,19,58,54,116,0.4655172413793103,0,2,0.0,54,114,0.4736842105263157,0.466,45,62,0.7258064516129032
Kevin Martin,martike02,SG,32,TOT,2016,55,1095.0,514,58,14,96,110,26,3,54,83,156,419,0.3723150357995227,49,136,0.3602941176470588,107,283,0.3780918727915194,0.431,153,172,0.8895348837209303
Wesley Matthews,matthwe02,SF,29,DAL,2016,78,2644.0,977,151,27,211,238,78,17,78,179,331,854,0.3875878220140515,189,525,0.36,142,329,0.4316109422492401,0.498,126,146,0.863013698630137
O.J. Mayo,mayooj01,SG,28,MIL,2016,41,1090.0,321,118,13,92,105,48,8,72,126,119,321,0.3707165109034268,52,162,0.3209876543209876,67,159,0.4213836477987421,0.452,31,40,0.775
Luc Mbah a Moute,mbahalu01,PF,29,LAC,2016,75,1274.0,231,30,60,111,171,44,19,34,100,94,207,0.4541062801932367,13,40,0.325,81,167,0.4850299401197604,0.486,30,57,0.5263157894736842
James Michael McAdoo,mcadoja01,PF,23,GSW,2016,41,262.0,117,17,30,28,58,10,8,16,39,45,84,0.5357142857142857,1,2,0.5,44,82,0.5365853658536586,0.542,26,49,0.5306122448979592
Ray McCallum,mccalra01,PG,24,TOT,2016,41,475.0,137,60,8,39,47,12,7,24,29,55,146,0.3767123287671233,15,42,0.3571428571428571,40,104,0.3846153846153846,0.428,12,15,0.8
CJ McCollum,mccolcj01,SG,24,POR,2016,80,2780.0,1666,341,47,212,259,97,23,196,187,641,1431,0.4479385045422781,197,472,0.4173728813559322,444,959,0.4629822732012513,0.517,187,226,0.827433628318584
T.J. McConnell,mccontj01,PG,23,PHI,2016,81,1606.0,493,367,43,207,250,95,10,140,114,218,464,0.4698275862068966,31,89,0.348314606741573,187,375,0.4986666666666666,0.503,26,41,0.6341463414634146
Chris McCullough,mcculch01,PF,20,BRK,2016,24,362.0,112,9,25,43,68,28,12,15,39,44,109,0.4036697247706422,13,34,0.3823529411764705,31,75,0.4133333333333333,0.463,11,23,0.4782608695652174
K.J. McDaniels,mcdankj01,SF,22,HOU,2016,37,235.0,89,10,16,26,42,7,6,17,30,29,72,0.4027777777777778,7,25,0.28,22,47,0.4680851063829787,0.451,24,30,0.8
Doug McDermott,mcderdo01,SF,24,CHI,2016,81,1861.0,764,59,37,158,195,14,6,53,127,291,644,0.4518633540372671,110,259,0.4247104247104247,181,385,0.4701298701298701,0.537,72,84,0.8571428571428571
Mitch McGary,mcgarmi01,PF,23,OKC,2016,20,72.0,26,3,4,14,18,1,2,7,10,11,23,0.4782608695652174,0,4,0.0,11,19,0.5789473684210527,0.478,4,10,0.4
JaVale McGee,mcgeeja01,C,28,DAL,2016,34,370.0,172,3,53,80,133,5,26,21,49,77,134,0.5746268656716418,0,1,0.0,77,133,0.5789473684210527,0.575,18,36,0.5
Ben McLemore,mclembe01,SG,22,SAC,2016,68,1443.0,531,79,34,114,148,52,10,99,140,195,455,0.4285714285714285,67,185,0.3621621621621622,128,270,0.4740740740740741,0.502,74,103,0.7184466019417476
Jordan McRae,mcraejo01,PG,24,TOT,2016,22,195.0,99,25,4,16,20,3,1,15,17,34,78,0.4358974358974359,10,22,0.4545454545454545,24,56,0.4285714285714285,0.5,21,28,0.75
Josh McRoberts,mcrobjo01,PF,28,MIA,2016,42,595.0,150,81,22,83,105,18,7,30,68,55,148,0.3716216216216216,12,49,0.2448979591836734,43,99,0.4343434343434343,0.412,28,40,0.7
Jodie Meeks,meeksjo01,SG,28,DET,2016,3,43.0,22,3,1,4,5,0,0,1,2,7,20,0.35,4,9,0.4444444444444444,3,11,0.2727272727272727,0.45,4,4,1.0
Salah Mejri,mejrisa01,C,29,DAL,2016,34,397.0,125,10,41,82,123,8,36,23,54,49,78,0.6282051282051282,0,1,0.0,49,77,0.6363636363636364,0.628,27,46,0.5869565217391305
Jordan Mickey,mickejo01,PF,21,BOS,2016,16,57.0,21,1,6,7,13,0,11,1,5,8,22,0.3636363636363636,0,0,0.0,8,22,0.3636363636363636,0.364,5,10,0.5
Khris Middleton,middlkh01,SG,24,MIL,2016,79,2852.0,1434,331,44,258,302,131,19,180,204,507,1142,0.4439579684763572,143,361,0.3961218836565097,364,781,0.4660691421254802,0.507,277,312,0.8878205128205128
C.J. Miles,milescj01,SF,28,IND,2016,64,1464.0,753,63,25,150,175,53,29,70,142,259,634,0.4085173501577287,142,387,0.3669250645994832,117,247,0.4736842105263157,0.521,93,124,0.75
Andre Miller,millean02,PG,39,TOT,2016,39,461.0,144,87,12,39,51,16,0,37,46,59,106,0.5566037735849056,2,8,0.25,57,98,0.5816326530612245,0.566,24,32,0.75
Mike Miller,millemi01,SF,35,DEN,2016,47,373.0,63,40,6,47,53,13,4,17,53,22,62,0.3548387096774194,19,52,0.3653846153846153,3,10,0.3,0.508,0,0,0.0
Patty Mills,millspa02,PG,27,SAS,2016,81,1662.0,690,226,27,131,158,59,6,76,102,260,612,0.4248366013071895,123,320,0.384375,137,292,0.4691780821917808,0.525,47,58,0.8103448275862069
Elijah Millsap,millsel01,SG,28,UTA,2016,20,173.0,36,19,6,29,35,7,3,9,33,11,39,0.282051282051282,1,12,0.0833333333333333,10,27,0.3703703703703703,0.295,13,18,0.7222222222222222
Paul Millsap,millspa01,PF,30,ATL,2016,81,2647.0,1385,265,198,534,732,147,139,191,237,501,1066,0.4699812382739212,74,232,0.3189655172413793,427,834,0.511990407673861,0.505,309,408,0.7573529411764706
Nikola Mirotić,mirotni01,PF,24,CHI,2016,66,1646.0,777,100,58,304,362,58,46,102,151,248,609,0.4072249589490969,135,346,0.3901734104046243,113,263,0.4296577946768061,0.518,146,181,0.8066298342541437
Nazr Mohammed,mohamna01,C,38,OKC,2016,5,19.0,8,0,1,3,4,0,0,3,4,3,5,0.6,0,0,0.0,3,5,0.6,0.6,2,2,1.0
Greg Monroe,monrogr01,C,25,MIL,2016,79,2314.0,1210,178,218,478,696,72,67,129,163,491,941,0.5217853347502657,0,1,0.0,491,940,0.5223404255319148,0.522,228,308,0.7402597402597403
Luis Montero,montelu01,SG,22,POR,2016,12,42.0,14,1,0,4,4,0,0,4,1,5,19,0.2631578947368421,1,9,0.1111111111111111,4,10,0.4,0.289,3,4,0.75
E'Twaun Moore,mooreet01,SG,26,CHI,2016,59,1263.0,443,99,19,114,133,37,18,53,103,187,389,0.480719794344473,47,104,0.4519230769230769,140,285,0.4912280701754385,0.541,22,35,0.6285714285714286
Eric Moreland,moreler01,PF,24,SAC,2016,8,48.0,8,1,3,8,11,0,4,3,4,3,6,0.5,0,0,0.0,3,6,0.5,0.5,2,4,0.5
Marcus Morris,morrima03,SF,26,DET,2016,80,2856.0,1131,201,91,313,404,67,23,140,170,410,945,0.4338624338624338,108,298,0.3624161073825503,302,647,0.4667697063369397,0.491,203,271,0.7490774907749077
Markieff Morris,morrima02,PF,26,TOT,2016,64,1629.0,765,124,73,279,352,58,34,135,184,305,718,0.4247910863509749,47,155,0.3032258064516129,258,563,0.458259325044405,0.458,108,147,0.7346938775510204
Anthony Morrow,morroan01,SG,30,OKC,2016,68,926.0,380,24,10,52,62,22,5,17,64,136,333,0.4084084084084084,79,204,0.3872549019607843,57,129,0.4418604651162791,0.527,29,39,0.7435897435897436
Donatas Motiejūnas,motiedo01,PF,25,HOU,2016,37,547.0,230,41,37,72,109,17,5,44,69,90,205,0.4390243902439024,16,57,0.2807017543859649,74,148,0.5,0.478,34,53,0.6415094339622641
Timofey Mozgov,mozgoti01,C,29,CLE,2016,76,1326.0,475,33,110,227,337,22,57,71,159,203,359,0.5654596100278552,1,7,0.1428571428571428,202,352,0.5738636363636364,0.567,68,95,0.7157894736842105
Emmanuel Mudiay,mudiaem01,PG,19,DEN,2016,68,2068.0,872,372,32,200,232,65,35,217,141,329,905,0.3635359116022099,74,232,0.3189655172413793,255,673,0.3789004457652303,0.404,140,209,0.6698564593301436
Shabazz Muhammad,muhamsh01,SF,23,MIN,2016,82,1682.0,863,52,100,167,267,24,7,70,94,317,681,0.4654919236417034,44,152,0.2894736842105263,273,529,0.5160680529300568,0.498,185,242,0.7644628099173554
Xavier Munford,munfoxa02,SG,23,MEM,2016,14,244.0,80,22,3,28,31,13,3,15,25,32,77,0.4155844155844156,9,23,0.391304347826087,23,54,0.4259259259259259,0.474,7,14,0.5
Mike Muscala,muscami01,C,24,ATL,2016,60,565.0,195,34,38,79,117,13,27,27,72,76,152,0.5,12,39,0.3076923076923077,64,113,0.5663716814159292,0.539,31,39,0.7948717948717948
Larry Nance Jr.,nancela02,PF,23,LAL,2016,63,1266.0,349,44,101,211,312,54,23,41,124,158,300,0.5266666666666666,1,10,0.1,157,290,0.5413793103448276,0.528,32,47,0.6808510638297872
Shabazz Napier,napiesh01,PG,24,ORL,2016,55,600.0,203,97,9,46,55,23,1,46,38,68,201,0.3383084577114428,34,104,0.3269230769230769,34,97,0.3505154639175257,0.423,33,45,0.7333333333333333
Gary Neal,nealga01,SG,31,WAS,2016,40,807.0,390,47,11,72,83,20,1,29,55,151,325,0.4646153846153846,41,100,0.41,110,225,0.4888888888888889,0.528,47,55,0.8545454545454545
Jameer Nelson,nelsoja01,PG,33,DEN,2016,39,1036.0,299,190,19,96,115,25,5,66,100,113,307,0.3680781758957654,43,144,0.2986111111111111,70,163,0.4294478527607362,0.438,30,35,0.8571428571428571
Raul Neto,netora01,PG,23,UTA,2016,81,1499.0,476,174,17,103,120,62,2,109,122,180,418,0.430622009569378,64,162,0.3950617283950617,116,256,0.453125,0.507,52,70,0.7428571428571429
Andrew Nicholson,nichoan01,PF,26,ORL,2016,56,823.0,384,25,34,167,201,10,22,41,69,146,310,0.4709677419354838,41,114,0.3596491228070175,105,196,0.5357142857142857,0.537,51,65,0.7846153846153846
Joakim Noah,noahjo01,C,30,CHI,2016,29,635.0,124,110,87,168,255,18,29,52,77,51,133,0.3834586466165413,0,1,0.0,51,132,0.3863636363636363,0.383,22,45,0.4888888888888889
Nerlens Noel,noelne01,C,21,PHI,2016,67,1965.0,747,122,154,388,542,118,100,158,192,306,587,0.5212947189097104,1,2,0.5,305,585,0.5213675213675214,0.522,134,227,0.5903083700440529
Lucas Nogueira,noguelu01,C,23,TOR,2016,29,225.0,65,7,18,28,46,12,12,11,29,28,44,0.6363636363636364,1,3,0.3333333333333333,27,41,0.6585365853658537,0.648,8,15,0.5333333333333333
Steve Novak,novakst01,PF,32,TOT,2016,10,44.0,24,0,0,5,5,0,0,1,3,8,18,0.4444444444444444,7,15,0.4666666666666667,1,3,0.3333333333333333,0.639,1,1,1.0
Dirk Nowitzki,nowitdi01,PF,37,DAL,2016,75,2364.0,1372,132,52,437,489,52,52,84,161,498,1112,0.447841726618705,126,342,0.3684210526315789,372,770,0.4831168831168831,0.504,250,280,0.8928571428571429
Jusuf Nurkić,nurkiju01,C,21,DEN,2016,32,547.0,263,40,65,110,175,24,44,55,91,101,242,0.4173553719008264,0,3,0.0,101,239,0.4225941422594142,0.417,61,99,0.6161616161616161
J.J. O'Brien,obriejj01,SF,23,UTA,2016,2,6.0,0,0,0,1,1,1,0,0,1,0,1,0.0,0,0,0.0,0,1,0.0,0.0,0,0,0.0
Johnny O'Bryant,obryajo01,PF,22,MIL,2016,66,857.0,200,32,65,111,176,18,8,31,100,86,209,0.4114832535885167,1,1,1.0,85,208,0.4086538461538461,0.414,27,40,0.675
Kyle O'Quinn,oquinky01,PF,25,NYK,2016,65,764.0,309,72,76,174,250,20,49,61,107,129,271,0.4760147601476014,5,22,0.2272727272727272,124,249,0.4979919678714859,0.485,46,60,0.7666666666666667
Jahlil Okafor,okafoja01,C,20,PHI,2016,53,1591.0,928,65,122,251,373,22,61,124,140,397,781,0.5083226632522407,1,6,0.1666666666666666,396,775,0.5109677419354839,0.509,133,194,0.6855670103092784
Victor Oladipo,oladivi01,SG,23,ORL,2016,72,2379.0,1153,282,48,297,345,116,54,153,174,425,970,0.4381443298969072,98,282,0.3475177304964539,327,688,0.4752906976744186,0.489,205,247,0.8299595141700404
Kelly Olynyk,olynyke01,C,24,BOS,2016,69,1395.0,687,105,72,209,281,52,33,74,163,253,556,0.4550359712230216,85,210,0.4047619047619047,168,346,0.4855491329479768,0.531,96,128,0.75
Kelly Oubre Jr.,oubreke01,SF,20,WAS,2016,63,671.0,236,13,25,108,133,22,7,34,100,90,211,0.4265402843601896,25,79,0.3164556962025316,65,132,0.4924242424242424,0.486,31,49,0.6326530612244898
Zaza Pachulia,pachuza01,C,31,DAL,2016,76,2004.0,650,128,249,469,718,64,22,119,181,219,470,0.4659574468085106,0,3,0.0,219,467,0.4689507494646681,0.466,212,276,0.7681159420289855
Kostas Papanikolaou,papanko01,SF,25,DEN,2016,26,294.0,67,16,8,32,40,13,5,21,24,24,66,0.3636363636363636,10,32,0.3125,14,34,0.4117647058823529,0.439,9,14,0.6428571428571429
Jabari Parker,parkeja01,PF,20,MIL,2016,76,2408.0,1070,130,123,272,395,69,29,116,154,443,899,0.492769744160178,9,35,0.2571428571428571,434,864,0.5023148148148148,0.498,175,228,0.7675438596491229
Tony Parker,parketo01,PG,33,SAS,2016,72,1980.0,857,379,17,159,176,54,11,131,114,350,710,0.4929577464788732,27,65,0.4153846153846154,323,645,0.5007751937984496,0.512,130,171,0.7602339181286549
Chandler Parsons,parsoch01,SF,27,DAL,2016,61,1799.0,837,169,29,256,285,46,21,95,114,320,651,0.4915514592933948,104,251,0.4143426294820717,216,400,0.54,0.571,93,136,0.6838235294117647
Lamar Patterson,pattela01,SG,24,ATL,2016,35,395.0,84,39,4,46,50,9,2,23,45,28,80,0.35,12,49,0.2448979591836734,16,31,0.5161290322580645,0.425,16,22,0.7272727272727273
Patrick Patterson,pattepa01,PF,26,TOR,2016,79,2020.0,543,94,77,265,342,53,32,65,128,204,493,0.4137931034482758,106,293,0.3617747440273037,98,200,0.49,0.521,29,34,0.8529411764705882
Chris Paul,paulch01,PG,30,LAC,2016,74,2420.0,1446,738,39,271,310,152,13,194,185,515,1114,0.4622980251346499,122,329,0.3708206686930091,393,785,0.5006369426751592,0.517,294,328,0.8963414634146342
Adreian Payne,paynead01,PF,24,MIN,2016,52,486.0,132,29,20,91,111,16,11,36,77,53,145,0.3655172413793103,9,32,0.28125,44,113,0.3893805309734513,0.397,17,26,0.6538461538461539
Cameron Payne,payneca01,PG,21,OKC,2016,57,698.0,283,108,9,76,85,36,6,44,80,114,278,0.4100719424460431,36,111,0.3243243243243243,78,167,0.467065868263473,0.475,19,24,0.7916666666666666
Elfrid Payton,paytoel01,PG,21,ORL,2016,73,2145.0,778,468,77,184,261,89,20,177,159,318,730,0.4356164383561643,30,92,0.3260869565217391,288,638,0.45141065830721,0.456,112,190,0.5894736842105263
Nikola Peković,pekovni01,C,30,MIN,2016,12,156.0,54,11,7,14,21,1,0,9,22,19,50,0.38,0,0,0.0,19,50,0.38,0.38,16,20,0.8
Kendrick Perkins,perkike01,C,31,NOP,2016,37,542.0,91,31,25,103,128,11,11,41,64,40,75,0.5333333333333333,0,0,0.0,40,75,0.5333333333333333,0.533,11,25,0.44
Paul Pierce,piercpa01,SF,38,LAC,2016,68,1231.0,417,71,12,174,186,33,17,58,129,144,397,0.36272040302267,75,242,0.3099173553719008,69,155,0.4451612903225806,0.457,54,66,0.8181818181818182
Tibor Pleiß,pleisti01,C,26,UTA,2016,12,82.0,24,2,6,9,15,1,2,8,19,11,25,0.44,0,2,0.0,11,23,0.4782608695652174,0.44,2,2,1.0
Mason Plumlee,plumlma01,C,25,POR,2016,82,2084.0,749,226,201,427,628,68,85,154,253,267,517,0.5164410058027079,0,4,0.0,267,513,0.52046783625731,0.516,215,335,0.6417910447761194
Miles Plumlee,plumlmi01,C,27,MIL,2016,61,870.0,314,16,94,138,232,21,50,40,73,140,233,0.6008583690987125,0,0,0.0,140,233,0.6008583690987125,0.601,34,59,0.576271186440678
Otto Porter Jr.,porteot01,SF,22,WAS,2016,75,2276.0,871,120,97,294,391,105,32,70,163,339,717,0.4728033472803347,98,267,0.3670411985018726,241,450,0.5355555555555556,0.541,95,126,0.753968253968254
Bobby Portis,portibo01,PF,20,CHI,2016,62,1102.0,436,52,123,214,337,25,22,54,100,186,436,0.4266055045871559,16,52,0.3076923076923077,170,384,0.4427083333333333,0.445,48,66,0.7272727272727273
Kristaps Porziņģis,porzikr01,PF,20,NYK,2016,72,2047.0,1028,94,132,394,526,53,134,121,205,373,886,0.4209932279909706,81,243,0.3333333333333333,292,643,0.4541213063763608,0.467,201,240,0.8375
Dwight Powell,poweldw01,PF,24,DAL,2016,69,992.0,399,44,84,189,273,36,24,40,118,146,296,0.4932432432432432,2,16,0.125,144,280,0.5142857142857142,0.497,105,142,0.7394366197183099
Norman Powell,powelno01,SG,22,TOR,2016,49,725.0,273,47,16,95,111,29,10,32,59,97,229,0.4235807860262008,36,89,0.4044943820224719,61,140,0.4357142857142857,0.502,43,53,0.8113207547169812
Phil Pressey,pressph01,PG,24,TOT,2016,23,283.0,77,75,3,28,31,18,4,33,28,30,78,0.3846153846153846,4,18,0.2222222222222222,26,60,0.4333333333333333,0.41,13,25,0.52
Ronnie Price,pricero01,PG,32,PHO,2016,62,1211.0,331,147,25,74,99,74,13,70,161,116,302,0.3841059602649007,68,196,0.3469387755102041,48,106,0.4528301886792453,0.497,31,41,0.7560975609756098
Pablo Prigioni,prigipa01,PG,38,LAC,2016,59,823.0,145,130,38,76,114,53,1,49,82,55,147,0.3741496598639456,28,95,0.2947368421052631,27,52,0.5192307692307693,0.469,7,8,0.875
Tayshaun Prince,princta01,SF,35,MIN,2016,77,1462.0,221,73,32,115,147,36,13,27,62,102,229,0.445414847161572,4,23,0.1739130434782608,98,206,0.4757281553398058,0.454,13,19,0.6842105263157895
Julius Randle,randlju01,PF,21,LAL,2016,81,2286.0,919,144,172,657,829,53,29,149,242,358,835,0.4287425149700599,10,36,0.2777777777777778,348,799,0.4355444305381727,0.435,193,270,0.7148148148148148
Zach Randolph,randoza01,PF,34,MEM,2016,68,2016.0,1040,142,179,350,529,43,13,105,146,431,907,0.4751929437706725,6,26,0.2307692307692307,425,881,0.4824063564131668,0.479,172,216,0.7962962962962963
J.J. Redick,redicjj01,SG,31,LAC,2016,75,2097.0,1226,106,10,129,139,42,5,78,135,422,880,0.4795454545454545,200,421,0.4750593824228028,222,459,0.4836601307189542,0.593,182,205,0.8878048780487805
Willie Reed,reedwi02,C,25,BRK,2016,39,426.0,182,10,49,73,122,6,30,16,47,76,133,0.5714285714285714,0,0,0.0,76,133,0.5714285714285714,0.571,30,55,0.5454545454545454
Josh Richardson,richajo01,SG,22,MIA,2016,52,1107.0,341,73,21,86,107,36,25,35,107,123,272,0.4522058823529412,53,115,0.4608695652173913,70,157,0.445859872611465,0.55,42,63,0.6666666666666666
Austin Rivers,riverau01,SG,23,LAC,2016,67,1464.0,593,99,22,108,130,48,9,61,137,226,516,0.437984496124031,62,185,0.3351351351351351,164,331,0.4954682779456193,0.498,79,116,0.6810344827586207
Andre Roberson,roberan03,SG,24,OKC,2016,70,1553.0,337,47,79,172,251,53,42,35,133,136,274,0.4963503649635036,32,103,0.3106796116504854,104,171,0.6081871345029239,0.555,33,54,0.6111111111111112
Brian Roberts,roberbr01,PG,30,TOT,2016,51,470.0,205,54,6,35,41,10,2,23,35,74,165,0.4484848484848485,15,42,0.3571428571428571,59,123,0.4796747967479675,0.494,42,47,0.8936170212765957
Glenn Robinson III,robingl02,SF,22,IND,2016,45,508.0,171,26,12,56,68,17,9,18,21,65,151,0.4304635761589404,14,37,0.3783783783783784,51,114,0.4473684210526316,0.477,27,39,0.6923076923076923
Nate Robinson,robinna01,PG,31,NOP,2016,2,23.0,0,4,0,0,0,1,0,0,5,0,1,0.0,0,1,0.0,0,0,0.0,0.0,0,0,0.0
Thomas Robinson,robinth01,PF,24,BRK,2016,71,917.0,307,46,136,223,359,39,36,69,111,130,291,0.4467353951890034,0,1,0.0,130,290,0.4482758620689655,0.447,47,109,0.4311926605504587
Rajon Rondo,rondora01,PG,29,SAC,2016,72,2537.0,859,839,77,358,435,141,10,278,175,355,782,0.4539641943734015,62,170,0.3647058823529411,293,612,0.4787581699346405,0.494,87,150,0.58
Derrick Rose,rosede01,PG,27,CHI,2016,66,2097.0,1080,311,46,179,225,44,14,175,84,447,1048,0.4265267175572519,44,150,0.2933333333333333,403,898,0.4487750556792873,0.448,142,179,0.7932960893854749
Terrence Ross,rosste01,SF,24,TOR,2016,73,1747.0,720,56,21,164,185,54,25,46,120,270,626,0.4313099041533546,131,339,0.3864306784660767,139,287,0.4843205574912892,0.536,49,62,0.7903225806451613
Terry Rozier,roziete01,PG,21,BOS,2016,39,311.0,72,37,24,39,63,6,1,19,23,29,106,0.2735849056603773,6,27,0.2222222222222222,23,79,0.2911392405063291,0.302,8,10,0.8
Ricky Rubio,rubiori01,PG,25,MIN,2016,76,2323.0,766,658,40,286,326,162,10,193,201,219,586,0.3737201365187713,62,190,0.3263157894736842,157,396,0.3964646464646464,0.427,266,314,0.8471337579617835
Damjan Rudež,rudezda01,SF,29,MIN,2016,33,277.0,75,11,5,15,20,3,1,13,33,25,62,0.4032258064516129,17,50,0.34,8,12,0.6666666666666666,0.54,8,8,1.0
Brandon Rush,rushbr01,SG,30,GSW,2016,72,1055.0,305,57,21,160,181,20,23,33,57,111,260,0.4269230769230769,65,157,0.4140127388535032,46,103,0.4466019417475728,0.552,18,28,0.6428571428571429
D'Angelo Russell,russeda01,PG,19,LAL,2016,80,2259.0,1054,266,47,227,274,93,13,196,142,392,956,0.4100418410041841,130,370,0.3513513513513513,262,586,0.447098976109215,0.478,140,190,0.7368421052631579
Robert Sacre,sacrero01,C,26,LAL,2016,25,320.0,87,14,32,40,72,4,10,12,43,31,75,0.4133333333333333,0,0,0.0,31,75,0.4133333333333333,0.413,25,38,0.6578947368421053
JaKarr Sampson,sampsja02,SF,22,TOT,2016,73,1160.0,374,46,46,144,190,23,33,70,142,140,317,0.4416403785488959,14,63,0.2222222222222222,126,254,0.4960629921259842,0.464,80,122,0.6557377049180327
Dennis Schröder,schrode01,PG,22,ATL,2016,80,1621.0,879,349,25,179,204,70,9,183,138,329,781,0.4212548015364917,77,239,0.3221757322175732,252,542,0.4649446494464944,0.471,144,182,0.7912087912087912
Luis Scola,scolalu01,PF,35,TOR,2016,76,1636.0,664,66,84,276,360,46,27,68,178,269,598,0.4498327759197324,65,161,0.4037267080745341,204,437,0.4668192219679634,0.504,61,84,0.7261904761904762
Mike Scott,scottmi01,PF,27,ATL,2016,75,1146.0,464,78,53,153,206,25,17,42,102,176,376,0.4680851063829787,62,158,0.3924050632911392,114,218,0.5229357798165137,0.551,50,63,0.7936507936507936
Thabo Sefolosha,sefolth01,SF,31,ATL,2016,75,1758.0,480,107,52,282,334,85,37,68,109,188,372,0.5053763440860215,42,124,0.3387096774193548,146,248,0.5887096774193549,0.562,62,99,0.6262626262626263
Kevin Séraphin,serapke01,C,26,NYK,2016,48,526.0,187,47,31,95,126,8,36,43,67,84,205,0.4097560975609756,0,2,0.0,84,203,0.4137931034482758,0.41,19,23,0.8260869565217391
Ramon Sessions,sessira01,PG,29,WAS,2016,82,1667.0,810,239,25,178,203,46,5,115,102,280,592,0.4729729729729729,36,111,0.3243243243243243,244,481,0.5072765072765073,0.503,214,283,0.7561837455830389
Iman Shumpert,shumpim01,SG,25,CLE,2016,54,1316.0,311,92,32,171,203,54,19,57,119,114,305,0.3737704918032787,43,146,0.2945205479452055,71,159,0.4465408805031446,0.444,40,51,0.7843137254901961
Jonathon Simmons,simmojo02,SG,26,SAS,2016,55,813.0,331,58,16,80,96,24,5,53,103,122,242,0.5041322314049587,18,47,0.3829787234042553,104,195,0.5333333333333333,0.541,69,92,0.75
Henry Sims,simshe01,C,25,BRK,2016,14,263.0,91,9,21,51,72,9,14,12,37,33,77,0.4285714285714285,0,0,0.0,33,77,0.4285714285714285,0.429,25,30,0.8333333333333334
Kyle Singler,singlky01,SF,27,OKC,2016,68,977.0,231,24,50,91,141,30,9,32,120,86,221,0.3891402714932127,30,97,0.3092783505154639,56,124,0.4516129032258064,0.457,29,44,0.6590909090909091
Donald Sloan,sloando01,PG,28,BRK,2016,61,1318.0,424,268,17,156,173,32,4,80,73,154,350,0.44,38,99,0.3838383838383838,116,251,0.4621513944223107,0.494,78,104,0.75
Marcus Smart,smartma01,PG,21,BOS,2016,61,1667.0,558,185,76,179,255,91,18,80,183,184,529,0.3478260869565217,61,241,0.2531120331950207,123,288,0.4270833333333333,0.405,129,166,0.7771084337349398
Greg Smith,smithgr02,PF,25,MIN,2016,18,192.0,43,6,12,30,42,4,1,7,28,18,32,0.5625,0,0,0.0,18,32,0.5625,0.563,7,17,0.4117647058823529
Ish Smith,smithis01,PG,27,TOT,2016,77,2239.0,972,502,43,262,305,88,24,175,133,397,967,0.4105480868665977,56,170,0.3294117647058823,341,797,0.4278544542032622,0.44,122,176,0.6931818181818182
J.R. Smith,smithjr01,SG,30,CLE,2016,77,2362.0,955,130,43,174,217,81,21,59,204,353,850,0.4152941176470588,204,510,0.4,149,340,0.438235294117647,0.535,45,71,0.6338028169014085
Jason Smith,smithja02,C,29,ORL,2016,76,1181.0,546,62,53,166,219,33,65,57,163,244,503,0.4850894632206759,4,16,0.25,240,487,0.4928131416837782,0.489,54,67,0.8059701492537313
Josh Smith,smithjo03,PF,30,TOT,2016,55,880.0,332,90,51,141,192,34,47,77,118,127,349,0.3638968481375358,41,143,0.2867132867132867,86,206,0.4174757281553398,0.423,37,67,0.5522388059701493
Russ Smith,smithru01,PG,24,MEM,2016,15,66.0,23,11,1,8,9,5,1,7,5,7,22,0.3181818181818182,1,5,0.2,6,17,0.3529411764705882,0.341,8,13,0.6153846153846154
Tony Snell,snellto01,SF,24,CHI,2016,64,1301.0,338,63,19,180,199,16,17,52,100,126,339,0.3716814159292035,56,155,0.3612903225806451,70,184,0.3804347826086957,0.454,30,33,0.9090909090909092
Marreese Speights,speigma01,C,28,GSW,2016,72,832.0,512,61,77,162,239,19,34,66,117,197,456,0.4320175438596491,24,62,0.3870967741935484,173,394,0.4390862944162436,0.458,94,114,0.8245614035087719
Tiago Splitter,splitti01,C,31,ATL,2016,36,579.0,201,30,45,75,120,20,12,24,71,81,155,0.5225806451612903,0,2,0.0,81,153,0.5294117647058824,0.523,39,48,0.8125
Nik Stauskas,stausni01,SG,22,PHI,2016,73,1809.0,617,138,23,160,183,44,20,94,115,210,545,0.3853211009174312,106,325,0.3261538461538461,104,220,0.4727272727272727,0.483,91,118,0.7711864406779662
Lance Stephenson,stephla01,SF,25,TOT,2016,69,1372.0,573,133,40,183,223,43,9,94,135,228,474,0.4810126582278481,30,78,0.3846153846153846,198,396,0.5,0.513,87,111,0.7837837837837838
Alex Stepheson,stephal01,PF,28,TOT,2016,8,73.0,22,2,19,9,28,1,5,0,12,9,27,0.3333333333333333,0,0,0.0,9,27,0.3333333333333333,0.333,4,12,0.3333333333333333
Jarnell Stokes,stokeja01,C,22,TOT,2016,7,18.0,7,1,1,3,4,1,0,0,1,3,5,0.6,0,0,0.0,3,5,0.6,0.6,1,2,0.5
Amar'e Stoudemire,stoudam01,C,33,MIA,2016,52,762.0,300,27,65,157,222,18,41,47,92,125,221,0.5656108597285068,0,0,0.0,125,221,0.5656108597285068,0.566,50,67,0.746268656716418
Rodney Stuckey,stuckro01,PG,29,IND,2016,58,1275.0,517,142,19,137,156,43,8,76,77,183,443,0.4130925507900677,20,83,0.2409638554216867,163,360,0.4527777777777778,0.436,131,158,0.8291139240506329
Jared Sullinger,sullija01,PF,23,BOS,2016,81,1915.0,834,187,194,479,673,75,47,102,209,351,806,0.4354838709677419,29,103,0.2815533980582524,322,703,0.4580369843527738,0.453,103,161,0.639751552795031
Edy Tavares,tavarwa01,C,23,ATL,2016,11,73.0,25,3,7,14,21,1,6,5,8,11,19,0.5789473684210527,0,0,0.0,11,19,0.5789473684210527,0.579,3,8,0.375
Jeff Teague,teaguje01,PG,27,ATL,2016,79,2255.0,1239,470,33,181,214,97,24,218,167,434,988,0.4392712550607287,110,275,0.4,324,713,0.4544179523141655,0.495,261,312,0.8365384615384616
Mirza Teletović,teletmi01,PF,30,PHO,2016,79,1686.0,965,89,55,247,302,32,21,84,159,332,777,0.4272844272844273,181,460,0.3934782608695652,151,317,0.4763406940063091,0.544,120,155,0.7741935483870968
Garrett Temple,templga01,SF,29,WAS,2016,80,1951.0,582,140,36,176,212,69,18,64,195,201,505,0.398019801980198,89,258,0.3449612403100775,112,247,0.4534412955465587,0.486,91,125,0.728
Jason Terry,terryja01,SG,38,HOU,2016,72,1258.0,422,103,14,65,79,47,9,49,91,151,376,0.4015957446808511,93,261,0.3563218390804598,58,115,0.5043478260869565,0.525,27,33,0.8181818181818182
Isaiah Thomas,thomais02,PG,26,BOS,2016,82,2644.0,1823,509,46,197,243,91,9,220,167,591,1382,0.4276410998552822,167,465,0.3591397849462365,424,917,0.4623773173391494,0.488,474,544,0.8713235294117647
Lance Thomas,thomala01,PF,27,NYK,2016,59,1313.0,484,53,34,97,131,22,7,57,109,169,382,0.4424083769633508,44,109,0.4036697247706422,125,273,0.4578754578754578,0.5,102,119,0.8571428571428571
Hollis Thompson,thompho01,SG,24,PHI,2016,77,2154.0,758,99,54,218,272,36,24,76,187,270,680,0.3970588235294117,149,392,0.3801020408163265,121,288,0.4201388888888889,0.507,69,96,0.71875
Jason Thompson,thompja02,C,29,TOT,2016,47,471.0,147,29,32,102,134,12,20,15,80,52,108,0.4814814814814814,5,15,0.3333333333333333,47,93,0.5053763440860215,0.505,38,54,0.7037037037037037
Klay Thompson,thompkl01,SG,25,GSW,2016,80,2666.0,1771,166,35,271,306,60,49,138,152,651,1386,0.4696969696969697,276,650,0.4246153846153846,375,736,0.5095108695652174,0.569,193,221,0.8733031674208145
Tristan Thompson,thomptr01,PF,24,CLE,2016,82,2269.0,643,62,268,470,738,38,51,61,202,247,420,0.5880952380952381,0,0,0.0,247,420,0.5880952380952381,0.588,149,242,0.6157024793388429
Marcus Thornton,thornma01,SG,28,TOT,2016,61,1109.0,590,85,38,112,150,47,4,51,90,216,542,0.3985239852398524,91,270,0.337037037037037,125,272,0.4595588235294117,0.482,67,79,0.8481012658227848
Anthony Tolliver,tollian01,PF,30,DET,2016,72,1341.0,383,52,39,190,229,26,16,28,86,128,332,0.3855421686746988,98,272,0.3602941176470588,30,60,0.5,0.533,29,47,0.6170212765957447
Axel Toupane,toupaax01,SF,23,DEN,2016,21,305.0,76,15,8,23,31,7,6,6,40,25,70,0.3571428571428571,13,40,0.325,12,30,0.4,0.45,13,17,0.7647058823529411
Karl-Anthony Towns,townska01,C,20,MIN,2016,82,2627.0,1503,161,229,629,858,58,138,183,245,625,1153,0.5420641803989592,30,88,0.3409090909090909,595,1065,0.5586854460093896,0.555,223,275,0.8109090909090909
P.J. Tucker,tuckepj01,SF,30,PHO,2016,82,2540.0,652,177,165,347,512,106,20,111,202,239,582,0.4106529209621993,68,206,0.3300970873786408,171,376,0.4547872340425531,0.469,106,142,0.7464788732394366
Evan Turner,turneev01,SG,27,BOS,2016,81,2271.0,854,359,50,347,397,80,28,169,139,343,753,0.4555112881806109,20,83,0.2409638554216867,323,670,0.4820895522388059,0.469,148,179,0.8268156424581006
Myles Turner,turnemy01,C,19,IND,2016,60,1367.0,619,41,68,264,332,25,86,67,158,264,530,0.4981132075471698,3,14,0.2142857142857142,261,516,0.5058139534883721,0.501,88,121,0.7272727272727273
Beno Udrih,udrihbe01,PG,33,TOT,2016,44,707.0,205,116,8,64,72,14,1,53,51,86,198,0.4343434343434343,15,44,0.3409090909090909,71,154,0.461038961038961,0.472,18,20,0.9
Jonas Valančiūnas,valanjo01,C,23,TOR,2016,60,1557.0,768,42,184,363,547,25,80,85,158,303,536,0.5652985074626866,0,0,0.0,303,536,0.5652985074626866,0.565,162,213,0.7605633802816901
Anderson Varejão,varejan01,C,33,TOT,2016,53,496.0,138,35,37,104,141,16,10,22,70,53,124,0.4274193548387097,0,1,0.0,53,123,0.4308943089430894,0.427,32,50,0.64
Greivis Vásquez,vasqugr01,PG,29,MIL,2016,23,460.0,130,91,5,42,47,10,0,40,42,45,138,0.3260869565217391,18,73,0.2465753424657534,27,65,0.4153846153846154,0.391,22,26,0.8461538461538461
Rashad Vaughn,vaughra01,SG,19,MIL,2016,70,1001.0,217,39,11,77,88,29,16,28,73,81,266,0.3045112781954887,43,147,0.2925170068027211,38,119,0.3193277310924369,0.385,12,15,0.8
Charlie Villanueva,villach01,PF,31,DAL,2016,62,665.0,319,24,24,128,152,18,15,31,71,125,327,0.382262996941896,47,172,0.2732558139534883,78,155,0.5032258064516129,0.454,22,24,0.9166666666666666
Noah Vonleh,vonleno01,PF,20,POR,2016,78,1174.0,283,30,91,214,305,27,26,50,152,117,278,0.420863309352518,11,46,0.2391304347826087,106,232,0.4568965517241379,0.441,38,51,0.7450980392156863
Nikola Vučević,vucevni01,C,25,ORL,2016,65,2037.0,1181,179,174,402,576,53,70,123,173,533,1046,0.5095602294455067,2,9,0.2222222222222222,531,1037,0.5120540019286403,0.511,113,150,0.7533333333333333
Sasha Vujačić,vujacsa01,SG,31,NYK,2016,61,908.0,296,84,26,123,149,34,5,44,83,106,277,0.3826714801444043,52,143,0.3636363636363636,54,134,0.4029850746268656,0.477,32,39,0.8205128205128205
Dwyane Wade,wadedw01,SG,34,MIA,2016,74,2258.0,1409,344,82,220,302,79,42,203,116,540,1183,0.4564666103127641,7,44,0.1590909090909091,533,1139,0.4679543459174715,0.459,322,406,0.7931034482758621
Dion Waiters,waitedi01,SG,24,OKC,2016,78,2152.0,762,154,36,166,202,81,15,120,143,282,706,0.3994334277620396,86,240,0.3583333333333333,196,466,0.4206008583690987,0.46,112,157,0.7133757961783439
Kemba Walker,walkeke02,PG,25,CHO,2016,81,2885.0,1689,421,56,301,357,126,39,171,111,568,1331,0.4267468069120961,182,490,0.3714285714285714,386,841,0.4589774078478002,0.495,371,438,0.8470319634703196
John Wall,walljo01,PG,25,WAS,2016,77,2784.0,1531,789,42,337,379,145,59,318,159,572,1349,0.4240177909562639,115,328,0.3506097560975609,457,1021,0.4476003917727718,0.467,272,344,0.7906976744186046
T.J. Warren,warretj01,SF,22,PHO,2016,47,1070.0,515,44,57,90,147,37,16,32,94,221,441,0.5011337868480725,28,70,0.4,193,371,0.5202156334231806,0.533,45,64,0.703125
C.J. Watson,watsocj01,PG,31,ORL,2016,33,656.0,142,88,10,56,66,19,5,25,49,47,137,0.3430656934306569,14,48,0.2916666666666667,33,89,0.3707865168539326,0.394,34,39,0.8717948717948718
Briante Weber,weberbr01,PG,23,TOT,2016,7,169.0,31,21,8,17,25,9,3,9,12,14,39,0.358974358974359,0,5,0.0,14,34,0.4117647058823529,0.359,3,4,0.75
Sonny Weems,weemsso01,SG-SF,29,TOT,2016,43,499.0,107,49,7,46,53,10,1,41,47,42,110,0.3818181818181818,15,41,0.3658536585365853,27,69,0.391304347826087,0.45,8,15,0.5333333333333333
David West,westda01,PF,35,SAS,2016,78,1404.0,554,143,72,237,309,44,55,68,142,244,448,0.5446428571428571,3,7,0.4285714285714285,241,441,0.546485260770975,0.548,63,80,0.7875
Russell Westbrook,westbru01,PG,27,OKC,2016,80,2750.0,1878,834,145,481,626,163,20,342,200,656,1444,0.4542936288088642,101,341,0.2961876832844575,555,1103,0.5031731640979148,0.489,465,573,0.8115183246073299
Hassan Whiteside,whiteha01,C,26,MIA,2016,73,2125.0,1040,30,238,627,865,44,269,137,201,413,682,0.6055718475073314,0,0,0.0,413,682,0.6055718475073314,0.606,214,329,0.6504559270516718
Shayne Whittington,whittsh01,PF,24,IND,2016,7,41.0,11,3,5,7,12,1,1,5,7,5,11,0.4545454545454545,0,2,0.0,5,9,0.5555555555555556,0.455,1,2,0.5
Andrew Wiggins,wiggian01,SF,20,MIN,2016,81,2845.0,1675,164,105,186,291,78,46,182,165,594,1294,0.4590417310664605,57,190,0.3,537,1104,0.4864130434782608,0.481,430,565,0.7610619469026548
C.J. Wilcox,wilcocj01,SG,25,LAC,2016,23,167.0,70,10,1,11,12,10,2,2,15,26,66,0.3939393939393939,9,23,0.391304347826087,17,43,0.3953488372093023,0.462,9,12,0.75
Alan Williams,willial03,PF,23,PHO,2016,10,68.0,29,5,14,24,38,4,5,6,15,10,24,0.4166666666666667,0,0,0.0,10,24,0.4166666666666667,0.417,9,14,0.6428571428571429
Deron Williams,willide01,PG,31,DAL,2016,65,2106.0,918,378,19,171,190,61,14,150,155,321,775,0.4141935483870967,97,282,0.3439716312056737,224,493,0.4543610547667343,0.477,179,206,0.8689320388349514
Derrick Williams,willide02,SF,24,NYK,2016,80,1435.0,746,75,47,249,296,29,9,61,69,254,565,0.4495575221238938,44,150,0.2933333333333333,210,415,0.5060240963855421,0.488,194,256,0.7578125
Elliot Williams,williel01,PG,26,MEM,2016,5,45.0,8,4,1,3,4,0,0,1,2,2,10,0.2,1,4,0.25,1,6,0.1666666666666666,0.25,3,4,0.75
Lou Williams,willilo02,SG,29,LAL,2016,67,1907.0,1028,167,31,138,169,62,19,107,107,283,693,0.4083694083694084,110,320,0.34375,173,373,0.4638069705093833,0.488,352,424,0.8301886792452831
Marvin Williams,willima02,PF,29,CHO,2016,81,2338.0,948,110,127,394,521,58,77,62,133,338,747,0.4524765729585007,152,378,0.4021164021164021,186,369,0.5040650406504065,0.554,120,144,0.8333333333333334
Mo Williams,willima01,PG,33,CLE,2016,41,748.0,338,98,6,66,72,14,5,57,60,132,302,0.4370860927152318,36,102,0.3529411764705882,96,200,0.48,0.497,38,42,0.9047619047619048
Justise Winslow,winslju01,SF,19,MIA,2016,78,2232.0,502,117,81,322,403,68,26,95,184,195,462,0.422077922077922,32,116,0.2758620689655172,163,346,0.4710982658959537,0.457,80,117,0.6837606837606838
Jeff Withey,witheje01,C,25,UTA,2016,51,658.0,217,20,56,117,173,21,53,28,75,87,162,0.5370370370370371,0,2,0.0,87,160,0.54375,0.537,43,59,0.7288135593220338
Christian Wood,woodch01,PF,20,PHI,2016,17,145.0,61,3,13,25,38,5,7,2,11,22,53,0.4150943396226415,4,11,0.3636363636363636,18,42,0.4285714285714285,0.453,13,21,0.6190476190476191
Metta World Peace,artesro01,SF,36,LAL,2016,35,590.0,176,27,19,70,89,22,11,15,67,55,177,0.3107344632768362,26,84,0.3095238095238095,29,93,0.3118279569892473,0.384,40,57,0.7017543859649122
Brandan Wright,wrighbr03,PF,28,MEM,2016,12,212.0,83,6,14,29,43,5,15,10,21,35,52,0.6730769230769231,0,0,0.0,35,52,0.6730769230769231,0.673,13,24,0.5416666666666666
Delon Wright,wrighde01,PG,23,TOR,2016,27,229.0,103,31,8,29,37,8,3,16,7,36,80,0.45,5,13,0.3846153846153846,31,67,0.4626865671641791,0.481,26,35,0.7428571428571429
Tony Wroten,wroteto01,PG,22,PHI,2016,8,144.0,67,20,2,19,21,3,0,29,11,22,65,0.3384615384615385,3,17,0.1764705882352941,19,48,0.3958333333333333,0.362,20,37,0.5405405405405406
James Young,youngja01,SG,20,BOS,2016,29,199.0,29,9,4,22,26,6,1,5,17,11,36,0.3055555555555556,6,26,0.2307692307692307,5,10,0.5,0.389,1,4,0.25
Joe Young,youngjo01,PG,23,IND,2016,41,384.0,154,65,6,44,50,15,0,33,30,62,169,0.3668639053254438,10,46,0.217391304347826,52,123,0.4227642276422764,0.396,20,25,0.8
Nick Young,youngni01,SG,30,LAL,2016,54,1033.0,392,34,14,83,97,23,7,30,50,126,372,0.3387096774193548,77,237,0.3248945147679324,49,135,0.362962962962963,0.442,63,76,0.8289473684210527
Thaddeus Young,youngth01,PF,27,BRK,2016,73,2407.0,1102,136,176,484,660,112,37,136,182,495,963,0.514018691588785,7,30,0.2333333333333333,488,933,0.5230439442658092,0.518,105,163,0.6441717791411042
Cody Zeller,zelleco01,C,23,CHO,2016,73,1774.0,638,71,138,317,455,57,63,68,204,231,437,0.528604118993135,1,10,0.1,230,427,0.5386416861826698,0.53,175,232,0.7543103448275862
Tyler Zeller,zellety01,C,26,BOS,2016,60,710.0,364,29,62,116,178,10,22,46,97,138,290,0.4758620689655172,0,0,0.0,138,290,0.4758620689655172,0.476,88,108,0.8148148148148148
Álex Abrines,abrinal01,SG,23,OKC,2017,68,1055.0,406,40,18,68,86,37,8,33,114,134,341,0.3929618768328445,94,247,0.3805668016194332,40,94,0.425531914893617,0.531,44,49,0.8979591836734694
Quincy Acy,acyqu01,PF,26,TOT,2017,38,558.0,222,18,20,95,115,14,15,21,67,70,170,0.4117647058823529,37,90,0.4111111111111111,33,80,0.4125,0.521,45,60,0.75
Steven Adams,adamsst01,C,23,OKC,2017,80,2389.0,905,86,281,332,613,89,78,146,195,374,655,0.5709923664122137,0,1,0.0,374,654,0.5718654434250765,0.571,157,257,0.6108949416342413
Arron Afflalo,afflaar01,SG,31,SAC,2017,61,1580.0,515,78,9,116,125,21,6,42,104,185,420,0.4404761904761904,62,151,0.4105960264900662,123,269,0.4572490706319702,0.514,83,93,0.8924731182795699
Alexis Ajinça,ajincal01,C,28,NOP,2017,39,584.0,207,12,46,131,177,20,22,31,77,89,178,0.5,0,4,0.0,89,174,0.5114942528735632,0.5,29,40,0.725
Cole Aldrich,aldrico01,C,28,MIN,2017,62,531.0,105,25,51,107,158,25,23,17,85,45,86,0.5232558139534884,0,0,0.0,45,86,0.5232558139534884,0.523,15,22,0.6818181818181818
LaMarcus Aldridge,aldrila01,PF,31,SAS,2017,72,2335.0,1243,139,172,351,523,46,88,98,158,500,1049,0.4766444232602478,23,56,0.4107142857142857,477,993,0.4803625377643504,0.488,220,271,0.8118081180811808
Lavoy Allen,allenla01,PF,27,IND,2017,61,871.0,177,57,105,114,219,18,24,29,78,77,168,0.4583333333333333,0,1,0.0,77,167,0.4610778443113772,0.458,23,33,0.696969696969697
Tony Allen,allento01,SG,35,MEM,2017,71,1914.0,643,98,166,225,391,115,29,100,178,274,595,0.4605042016806722,15,54,0.2777777777777778,259,541,0.4787430683918669,0.473,80,130,0.6153846153846154
Al-Farouq Aminu,aminual01,PF,26,POR,2017,61,1773.0,532,99,77,374,451,60,44,94,102,183,466,0.3927038626609442,70,212,0.330188679245283,113,254,0.4448818897637795,0.468,96,136,0.7058823529411765
Chris Andersen,anderch01,C,38,CLE,2017,12,114.0,28,5,9,22,31,5,7,5,20,9,22,0.4090909090909091,0,3,0.0,9,19,0.4736842105263157,0.409,10,14,0.7142857142857143
Alan Anderson,anderal01,SF,34,LAC,2017,30,308.0,86,11,3,21,24,3,0,7,35,30,80,0.375,14,44,0.3181818181818182,16,36,0.4444444444444444,0.463,12,16,0.75
Justin Anderson,anderju01,SF,23,TOT,2017,75,1228.0,532,66,69,176,245,41,23,66,109,186,439,0.4236902050113895,58,194,0.2989690721649484,128,245,0.5224489795918368,0.49,102,129,0.7906976744186046
Kyle Anderson,anderky01,SF,23,SAS,2017,72,1020.0,246,91,33,175,208,51,26,39,63,93,209,0.4449760765550239,15,40,0.375,78,169,0.4615384615384615,0.481,45,57,0.7894736842105263
Ryan Anderson,anderry01,PF,28,HOU,2017,72,2116.0,979,68,112,218,330,31,14,55,142,323,773,0.4178525226390686,204,506,0.4031620553359684,119,267,0.445692883895131,0.55,129,150,0.86
Giannis Antetokounmpo,antetgi01,SF,22,MIL,2017,80,2845.0,1832,434,142,558,700,131,151,234,246,656,1259,0.5210484511517077,49,180,0.2722222222222222,607,1079,0.5625579240037072,0.541,471,612,0.7696078431372549
Carmelo Anthony,anthoca01,SF,32,NYK,2017,74,2538.0,1659,213,62,376,438,60,34,153,198,602,1389,0.4334053275737941,151,421,0.3586698337292161,451,968,0.4659090909090909,0.488,304,365,0.8328767123287671
Joel Anthony,anthojo01,C,34,SAS,2017,19,122.0,25,3,8,23,31,2,6,4,11,10,16,0.625,0,0,0.0,10,16,0.625,0.625,5,8,0.625
Trevor Ariza,arizatr01,SF,31,HOU,2017,80,2773.0,936,175,54,404,458,147,20,73,133,326,798,0.4085213032581453,191,555,0.3441441441441441,135,243,0.5555555555555556,0.528,93,126,0.7380952380952381
Darrell Arthur,arthuda01,PF,28,DEN,2017,41,639.0,262,42,25,87,112,19,21,36,76,95,215,0.4418604651162791,53,117,0.452991452991453,42,98,0.4285714285714285,0.565,19,22,0.8636363636363636
Ömer Aşık,asikom01,C,30,NOP,2017,31,482.0,85,15,48,115,163,5,10,14,51,31,65,0.4769230769230769,0,0,0.0,31,65,0.4769230769230769,0.477,23,39,0.5897435897435898
D.J. Augustin,augusdj01,PG,29,ORL,2017,78,1538.0,616,209,15,102,117,31,1,90,101,195,517,0.3771760154738878,95,274,0.3467153284671533,100,243,0.411522633744856,0.469,131,161,0.8136645962732919
Luke Babbitt,babbilu01,SF,27,MIA,2017,68,1065.0,324,36,12,129,141,20,11,25,118,113,281,0.4021352313167259,87,210,0.4142857142857143,26,71,0.3661971830985915,0.557,11,15,0.7333333333333333
Ron Baker,bakerro01,SG,23,NYK,2017,52,857.0,215,107,12,86,98,34,8,56,74,82,217,0.3778801843317972,23,86,0.2674418604651162,59,131,0.4503816793893129,0.431,28,43,0.6511627906976745
Wade Baldwin,baldwwa01,PG,20,MEM,2017,33,405.0,106,61,11,35,46,18,7,39,40,36,115,0.3130434782608696,3,22,0.1363636363636363,33,93,0.3548387096774194,0.326,31,37,0.8378378378378378
Leandro Barbosa,barbole01,SG,34,PHO,2017,67,963.0,419,81,15,89,104,31,8,48,82,172,392,0.4387755102040816,35,98,0.3571428571428571,137,294,0.4659863945578231,0.483,40,45,0.8888888888888888
J.J. Barea,bareajo01,PG,32,DAL,2017,35,771.0,381,193,9,75,84,14,1,63,30,142,343,0.4139941690962099,53,148,0.3581081081081081,89,195,0.4564102564102564,0.491,44,51,0.8627450980392157
Harrison Barnes,barneha02,PF,24,DAL,2017,79,2803.0,1518,116,93,301,394,65,15,102,128,599,1280,0.46796875,78,222,0.3513513513513513,521,1058,0.4924385633270321,0.498,242,281,0.8612099644128114
Matt Barnes,barnema02,SF,36,TOT,2017,74,1777.0,527,195,70,314,384,48,26,107,185,185,473,0.3911205073995771,87,263,0.3307984790874524,98,210,0.4666666666666667,0.483,70,89,0.7865168539325843
Will Barton,bartowi01,SG,26,DEN,2017,60,1705.0,820,206,58,201,259,48,28,97,110,295,666,0.4429429429429429,87,235,0.3702127659574468,208,431,0.482598607888631,0.508,143,190,0.7526315789473684
Brandon Bass,bassbr01,PF,31,LAC,2017,52,577.0,292,21,43,86,129,14,11,29,45,107,186,0.5752688172043011,1,3,0.3333333333333333,106,183,0.5792349726775956,0.578,77,88,0.875
Nicolas Batum,batumni01,SG,28,CHO,2017,77,2617.0,1164,456,46,435,481,86,29,194,109,393,975,0.403076923076923,135,405,0.3333333333333333,258,570,0.4526315789473684,0.472,243,284,0.8556338028169014
Jerryd Bayless,bayleje01,PG,28,PHI,2017,3,71.0,33,13,3,9,12,0,0,9,4,11,32,0.34375,2,5,0.4,9,27,0.3333333333333333,0.375,9,10,0.9
Aron Baynes,baynear01,C,30,DET,2017,75,1163.0,365,32,111,222,333,17,39,50,166,143,279,0.5125448028673835,0,0,0.0,143,279,0.5125448028673835,0.513,79,94,0.8404255319148937
Kent Bazemore,bazemke01,SF,27,ATL,2017,73,1963.0,801,177,45,186,231,91,52,125,165,295,721,0.4091539528432732,92,266,0.3458646616541353,203,455,0.4461538461538462,0.473,119,168,0.7083333333333334
Bradley Beal,bealbr01,SG,23,WAS,2017,77,2684.0,1779,267,53,187,240,83,21,156,169,637,1322,0.4818456883509833,223,552,0.4039855072463768,414,770,0.5376623376623376,0.566,282,342,0.8245614035087719
Malik Beasley,beaslma01,SG,20,DEN,2017,22,165.0,83,11,5,12,17,7,0,8,10,33,73,0.4520547945205479,9,28,0.3214285714285714,24,45,0.5333333333333333,0.514,8,10,0.8
Michael Beasley,beaslmi01,PF,28,MIL,2017,56,935.0,528,53,40,153,193,27,27,66,92,216,406,0.5320197044334976,18,43,0.4186046511627907,198,363,0.5454545454545454,0.554,78,105,0.7428571428571429
Marco Belinelli,belinma01,SG,30,CHO,2017,74,1778.0,780,147,14,164,178,44,9,70,90,264,615,0.4292682926829268,102,283,0.3604240282685512,162,332,0.4879518072289157,0.512,150,168,0.8928571428571429
DeAndre' Bembry,bembrde01,SF,22,ATL,2017,38,371.0,101,28,14,45,59,8,5,16,21,47,98,0.4795918367346938,1,18,0.0555555555555555,46,80,0.575,0.485,6,16,0.375
Dragan Bender,bendedr01,PF,19,PHO,2017,43,574.0,146,23,23,80,103,10,22,32,74,57,161,0.3540372670807453,28,101,0.2772277227722772,29,60,0.4833333333333333,0.441,4,11,0.3636363636363636
Anthony Bennett,bennean01,PF,23,BRK,2017,23,264.0,115,12,25,53,78,5,3,12,18,38,92,0.4130434782608695,13,48,0.2708333333333333,25,44,0.5681818181818182,0.484,26,36,0.7222222222222222
Ben Bentil,bentibe01,PF,21,DAL,2017,3,10.0,0,0,0,2,2,0,0,1,1,0,3,0.0,0,1,0.0,0,2,0.0,0.0,0,0,0.0
Dāvis Bertāns,bertada01,PF,24,SAS,2017,67,808.0,303,46,22,76,98,20,28,32,75,103,234,0.4401709401709401,69,173,0.3988439306358382,34,61,0.5573770491803278,0.588,28,34,0.8235294117647058
Patrick Beverley,beverpa01,SG,28,HOU,2017,67,2058.0,639,281,95,298,393,99,25,100,222,228,543,0.4198895027624309,110,288,0.3819444444444444,118,255,0.4627450980392157,0.521,73,95,0.7684210526315789
Bismack Biyombo,biyombi01,C,24,ORL,2017,81,1793.0,483,74,157,410,567,25,91,95,202,179,339,0.528023598820059,0,0,0.0,179,339,0.528023598820059,0.528,125,234,0.5341880341880342
Nemanja Bjelica,bjeline01,PF,28,MIN,2017,65,1190.0,403,79,57,187,244,40,20,59,154,151,356,0.4241573033707865,56,177,0.3163841807909605,95,179,0.5307262569832403,0.503,45,61,0.7377049180327869
Tarik Black,blackta01,C,25,LAL,2017,67,1091.0,383,39,144,199,343,29,44,58,173,150,294,0.5102040816326531,1,2,0.5,149,292,0.5102739726027398,0.512,82,109,0.7522935779816514
Eric Bledsoe,bledser01,PG,27,PHO,2017,66,2176.0,1390,418,52,268,320,91,31,224,164,449,1034,0.4342359767891682,104,310,0.3354838709677419,345,724,0.4765193370165745,0.485,388,458,0.8471615720524017
Bojan Bogdanović,bogdabo02,SF,27,TOT,2017,81,2083.0,1113,111,37,240,277,34,7,131,146,376,845,0.4449704142011834,144,392,0.3673469387755102,232,453,0.5121412803532008,0.53,217,243,0.8930041152263375
Andrew Bogut,bogutan01,C,32,TOT,2017,27,583.0,79,49,56,162,218,13,25,43,86,38,81,0.4691358024691358,0,1,0.0,38,80,0.475,0.469,3,11,0.2727272727272727
Joel Bolomboy,bolomjo01,PF,23,UTA,2017,12,53.0,22,2,4,13,17,1,2,2,1,9,16,0.5625,1,4,0.25,8,12,0.6666666666666666,0.594,3,6,0.5
Devin Booker,bookede01,SG,20,PHO,2017,78,2730.0,1726,268,46,203,249,72,21,241,242,606,1431,0.4234800838574423,147,405,0.362962962962963,459,1026,0.4473684210526316,0.475,367,441,0.8321995464852607
Trevor Booker,booketr01,PF,29,BRK,2017,71,1754.0,709,138,143,428,571,75,28,127,152,305,591,0.5160744500846024,25,78,0.3205128205128205,280,513,0.5458089668615984,0.537,74,110,0.6727272727272727
Avery Bradley,bradlav01,SG,26,BOS,2017,55,1835.0,894,122,65,269,334,68,11,88,141,359,775,0.4632258064516129,108,277,0.3898916967509025,251,498,0.5040160642570282,0.533,68,93,0.7311827956989247
Corey Brewer,breweco01,SF,30,TOT,2017,82,1281.0,371,97,32,134,166,61,20,55,133,147,348,0.4224137931034483,27,118,0.2288135593220339,120,230,0.5217391304347826,0.461,50,68,0.7352941176470589
Malcolm Brogdon,brogdma01,SG,24,MIL,2017,75,1982.0,767,317,47,166,213,84,12,113,140,290,635,0.4566929133858268,78,193,0.4041450777202072,212,442,0.4796380090497738,0.518,109,126,0.8650793650793651
Aaron Brooks,brookaa01,PG,32,IND,2017,65,894.0,322,125,18,51,69,25,9,66,93,121,300,0.4033333333333333,48,128,0.375,73,172,0.4244186046511627,0.483,32,40,0.8
Anthony Brown,brownan02,SF,24,TOT,2017,11,159.0,43,8,8,25,33,5,1,6,15,18,50,0.36,7,27,0.2592592592592592,11,23,0.4782608695652174,0.43,0,0,0.0
Bobby Brown,brownbo02,PG,32,HOU,2017,25,123.0,62,14,0,6,6,1,0,5,5,23,60,0.3833333333333333,14,35,0.4,9,25,0.36,0.5,2,2,1.0
Jaylen Brown,brownja02,SF,20,BOS,2017,78,1341.0,515,64,45,175,220,35,18,68,142,192,423,0.4539007092198581,46,135,0.3407407407407407,146,288,0.5069444444444444,0.508,85,124,0.6854838709677419
Nicolás Brussino,brussni01,SG,23,DAL,2017,54,521.0,150,47,26,69,95,17,8,26,43,52,141,0.3687943262411347,29,95,0.3052631578947368,23,46,0.5,0.472,17,22,0.7727272727272727
Reggie Bullock,bullore01,SF,25,DET,2017,31,467.0,141,29,13,51,64,18,3,10,22,54,128,0.421875,28,73,0.3835616438356164,26,55,0.4727272727272727,0.531,5,7,0.7142857142857143
Trey Burke,burketr01,PG,24,WAS,2017,57,703.0,285,100,7,40,47,11,5,48,54,116,255,0.4549019607843137,31,70,0.4428571428571428,85,185,0.4594594594594595,0.516,22,29,0.7586206896551724
Alec Burks,burksal01,SG,25,UTA,2017,42,653.0,283,30,17,103,120,18,5,35,50,99,248,0.3991935483870967,25,76,0.3289473684210526,74,172,0.4302325581395348,0.45,60,78,0.7692307692307693
Jimmy Butler,butleji01,SF,27,CHI,2017,76,2809.0,1816,417,129,341,470,143,32,159,112,570,1252,0.4552715654952076,91,248,0.3669354838709677,479,1004,0.4770916334661355,0.492,585,676,0.8653846153846154
Bruno Caboclo,cabocbr01,SF,21,TOR,2017,9,40.0,14,4,5,5,10,2,1,2,4,6,16,0.375,2,6,0.3333333333333333,4,10,0.4,0.438,0,0,0.0
José Calderón,caldejo01,PG,35,TOT,2017,41,539.0,141,88,15,59,74,11,1,41,36,55,134,0.4104477611940298,20,64,0.3125,35,70,0.5,0.485,11,12,0.9166666666666666
Kentavious Caldwell-Pope,caldwke01,SG,23,DET,2017,76,2529.0,1047,193,55,193,248,89,12,86,118,370,928,0.3987068965517241,153,437,0.3501144164759725,217,491,0.4419551934826884,0.481,154,185,0.8324324324324325
Isaiah Canaan,canaais01,SG,25,CHI,2017,39,592.0,181,37,6,44,50,22,1,21,35,63,173,0.3641618497109826,25,94,0.2659574468085106,38,79,0.4810126582278481,0.436,30,33,0.9090909090909092
Clint Capela,capelca01,C,22,HOU,2017,65,1551.0,818,63,178,348,526,34,79,87,179,362,563,0.6429840142095915,0,0,0.0,362,563,0.6429840142095915,0.643,94,177,0.5310734463276836
DeMarre Carroll,carrode01,SF,30,TOR,2017,72,1882.0,638,74,63,212,275,81,27,54,143,220,550,0.4,109,320,0.340625,111,230,0.4826086956521739,0.499,89,117,0.7606837606837606
Vince Carter,cartevi01,SF,40,MEM,2017,73,1799.0,586,133,36,191,227,60,36,50,163,193,490,0.3938775510204081,112,296,0.3783783783783784,81,194,0.4175257731958763,0.508,88,115,0.7652173913043478
Michael Carter-Williams,cartemi01,PG,25,CHI,2017,45,846.0,297,113,24,129,153,38,23,66,102,112,306,0.3660130718954248,15,64,0.234375,97,242,0.4008264462809917,0.391,58,77,0.7532467532467533
Omri Casspi,casspom01,PF,28,TOT,2017,36,643.0,186,37,27,85,112,23,3,29,50,77,164,0.4695121951219512,15,43,0.3488372093023256,62,121,0.512396694214876,0.515,17,29,0.5862068965517241
Willie Cauley-Stein,caulewi01,C,23,SAC,2017,75,1421.0,611,80,85,254,339,53,44,69,147,255,481,0.5301455301455301,0,2,0.0,255,479,0.5323590814196242,0.53,101,151,0.6688741721854304
Tyson Chandler,chandty01,C,34,PHO,2017,47,1298.0,397,30,153,386,539,33,24,65,126,153,228,0.6710526315789473,0,0,0.0,153,228,0.6710526315789473,0.671,91,124,0.7338709677419355
Wilson Chandler,chandwi01,SF,29,DEN,2017,71,2197.0,1117,141,103,357,460,51,30,114,172,433,939,0.4611288604898828,110,326,0.3374233128834356,323,613,0.5269168026101142,0.52,141,194,0.7268041237113402
Marquese Chriss,chrisma01,PF,19,PHO,2017,82,1743.0,753,60,96,252,348,67,70,108,263,284,632,0.4493670886075949,72,224,0.3214285714285714,212,408,0.5196078431372549,0.506,113,181,0.6243093922651933
Rakeem Christmas,chrisra01,PF,25,IND,2017,29,219.0,59,4,26,30,56,3,6,8,37,19,43,0.4418604651162791,0,0,0.0,19,43,0.4418604651162791,0.442,21,29,0.7241379310344828
Semaj Christon,chrisse01,PG,24,OKC,2017,64,973.0,183,130,19,68,87,28,7,43,79,77,223,0.3452914798206278,12,63,0.1904761904761904,65,160,0.40625,0.372,17,31,0.5483870967741935
Ian Clark,clarkia01,SG,25,GSW,2017,77,1137.0,527,90,22,99,121,39,8,55,77,211,433,0.48729792147806,61,163,0.3742331288343558,150,270,0.5555555555555556,0.558,44,58,0.7586206896551724
Jordan Clarkson,clarkjo01,SG,24,LAL,2017,82,2397.0,1205,213,49,197,246,88,8,164,150,477,1071,0.4453781512605042,117,356,0.3286516853932584,360,715,0.5034965034965035,0.5,134,168,0.7976190476190477
Norris Cole,coleno01,PG,28,OKC,2017,13,125.0,43,14,0,11,11,8,0,7,18,16,52,0.3076923076923077,3,13,0.2307692307692307,13,39,0.3333333333333333,0.337,8,10,0.8
Darren Collison,collida01,PG,29,SAC,2017,68,2063.0,900,312,23,129,152,67,9,114,119,340,714,0.4761904761904761,73,175,0.4171428571428571,267,539,0.4953617810760667,0.527,147,171,0.8596491228070176
Nick Collison,collini01,PF,36,OKC,2017,20,128.0,33,12,9,22,31,2,2,4,17,14,23,0.6086956521739131,0,1,0.0,14,22,0.6363636363636364,0.609,5,8,0.625
Mike Conley,conlemi01,PG,29,MEM,2017,69,2292.0,1415,433,31,210,241,92,19,156,126,464,1009,0.4598612487611496,171,419,0.4081145584725537,293,590,0.4966101694915254,0.545,316,368,0.8586956521739131
Pat Connaughton,connapa01,SG,24,POR,2017,39,316.0,98,28,10,42,52,6,2,17,23,37,72,0.5138888888888888,17,33,0.5151515151515151,20,39,0.5128205128205128,0.632,7,9,0.7777777777777778
Quinn Cook,cookqu01,PG,23,TOT,2017,14,188.0,79,26,1,6,7,4,0,13,13,33,66,0.5,11,26,0.4230769230769231,22,40,0.55,0.583,2,5,0.4
DeMarcus Cousins,couside01,C,26,TOT,2017,72,2465.0,1942,332,152,642,794,100,93,269,278,647,1432,0.4518156424581006,131,363,0.3608815426997245,516,1069,0.4826941066417212,0.498,517,670,0.7716417910447761
Robert Covington,covinro01,SF,26,PHI,2017,67,2119.0,864,102,92,344,436,127,69,131,203,292,732,0.3989071038251366,137,412,0.3325242718446602,155,320,0.484375,0.492,143,174,0.8218390804597702
Allen Crabbe,crabbal01,SG,24,POR,2017,79,2254.0,845,94,19,207,226,54,20,62,171,303,647,0.4683153013910355,134,302,0.4437086092715231,169,345,0.4898550724637681,0.572,105,124,0.8467741935483871
Jamal Crawford,crawfja01,SG,36,LAC,2017,82,2157.0,1008,214,17,112,129,61,14,134,115,359,870,0.4126436781609195,116,322,0.3602484472049689,243,548,0.4434306569343065,0.479,174,203,0.8571428571428571
Jordan Crawford,crawfjo02,SG,28,NOP,2017,19,442.0,267,57,4,30,34,11,2,25,30,105,218,0.481651376146789,37,95,0.3894736842105263,68,123,0.5528455284552846,0.567,20,26,0.7692307692307693
Jae Crowder,crowdja01,SF,26,BOS,2017,72,2335.0,999,155,48,367,415,73,23,80,161,333,720,0.4625,157,394,0.398477157360406,176,326,0.5398773006134969,0.572,176,217,0.8110599078341014
Dante Cunningham,cunnida01,PF,29,NOP,2017,66,1649.0,435,37,56,221,277,39,28,28,100,174,359,0.4846796657381615,71,181,0.3922651933701657,103,178,0.5786516853932584,0.584,16,27,0.5925925925925926
Seth Curry,curryse01,PG,26,DAL,2017,70,2029.0,898,189,25,154,179,79,7,92,126,338,703,0.4807965860597439,137,322,0.4254658385093168,201,381,0.5275590551181102,0.578,85,100,0.85
Stephen Curry,curryst01,PG,28,GSW,2017,79,2638.0,1999,524,61,292,353,142,17,239,183,675,1443,0.4677754677754678,324,789,0.4106463878326996,351,654,0.536697247706422,0.58,325,362,0.8977900552486188
Troy Daniels,danietr01,SG,25,MEM,2017,67,1183.0,551,46,22,78,100,20,4,45,90,185,495,0.3737373737373737,138,355,0.3887323943661971,47,140,0.3357142857142857,0.513,43,54,0.7962962962962963
Anthony Davis,davisan02,C,23,NOP,2017,75,2708.0,2099,157,172,712,884,94,167,181,168,770,1526,0.5045871559633027,40,134,0.2985074626865671,730,1392,0.5244252873563219,0.518,519,647,0.8021638330757341
Deyonta Davis,davisde01,C,20,MEM,2017,36,238.0,58,2,20,40,60,3,17,8,40,24,47,0.5106382978723404,0,0,0.0,24,47,0.5106382978723404,0.511,10,18,0.5555555555555556
Ed Davis,davised01,PF,27,POR,2017,46,789.0,200,26,96,148,244,15,22,37,137,75,142,0.528169014084507,0,0,0.0,75,142,0.528169014084507,0.528,50,81,0.6172839506172839
Dewayne Dedmon,dedmode01,C,27,SAS,2017,76,1330.0,387,44,129,367,496,37,61,61,180,161,259,0.6216216216216216,0,0,0.0,161,259,0.6216216216216216,0.622,65,93,0.6989247311827957
Sam Dekker,dekkesa01,PF,22,HOU,2017,77,1419.0,504,76,94,190,284,38,21,41,83,203,429,0.4731934731934732,60,187,0.320855614973262,143,242,0.5909090909090909,0.543,38,68,0.5588235294117647
Malcolm Delaney,delanma01,PG,27,ATL,2017,73,1248.0,391,193,10,113,123,39,1,95,112,145,388,0.3737113402061855,26,110,0.2363636363636363,119,278,0.4280575539568345,0.407,75,93,0.8064516129032258
Matthew Dellavedova,dellama01,PG,26,MIL,2017,76,1986.0,577,357,24,123,147,53,0,133,153,208,534,0.3895131086142322,79,215,0.3674418604651163,129,319,0.4043887147335423,0.463,82,96,0.8541666666666666
Luol Deng,denglu01,SF,31,LAL,2017,56,1486.0,425,74,63,232,295,48,20,43,61,164,424,0.3867924528301887,51,165,0.3090909090909091,113,259,0.4362934362934363,0.447,46,63,0.7301587301587301
DeMar DeRozan,derozde01,SG,27,TOR,2017,74,2620.0,2020,290,70,316,386,78,13,180,134,721,1545,0.4666666666666667,33,124,0.2661290322580645,688,1421,0.4841660802251935,0.477,545,647,0.8423493044822257
Cheick Diallo,diallch01,PF,20,NOP,2017,17,199.0,87,4,23,50,73,4,7,7,17,36,76,0.4736842105263157,0,0,0.0,36,76,0.4736842105263157,0.474,15,21,0.7142857142857143
Boris Diaw,diawbo01,PF,34,UTA,2017,73,1283.0,338,170,46,112,158,18,9,87,83,146,327,0.4464831804281345,20,81,0.2469135802469135,126,246,0.5121951219512195,0.477,26,35,0.7428571428571429
Gorgui Dieng,dienggo01,PF,27,MIN,2017,82,2653.0,816,158,188,459,647,88,95,107,254,332,661,0.5022692889561271,16,43,0.3720930232558139,316,618,0.511326860841424,0.514,136,167,0.8143712574850299
Spencer Dinwiddie,dinwisp01,PG,23,BRK,2017,59,1334.0,432,185,27,137,164,44,23,66,119,134,302,0.4437086092715231,38,101,0.3762376237623762,96,201,0.4776119402985074,0.507,126,159,0.7924528301886793
Toney Douglas,douglto01,PG,30,MEM,2017,24,394.0,117,56,13,48,61,18,5,21,50,43,117,0.3675213675213675,7,42,0.1666666666666666,36,75,0.48,0.397,24,29,0.8275862068965517
Goran Dragić,dragigo01,PG,30,MIA,2017,73,2459.0,1483,423,62,217,279,89,13,212,199,534,1124,0.4750889679715303,117,289,0.4048442906574394,417,835,0.4994011976047904,0.527,298,377,0.7904509283819628
Andre Drummond,drumman01,C,23,DET,2017,81,2409.0,1105,90,345,770,1115,124,89,152,237,483,911,0.5301866081229418,2,7,0.2857142857142857,481,904,0.5320796460176991,0.531,137,355,0.3859154929577464
Jared Dudley,dudleja01,PF,31,PHO,2017,64,1362.0,434,121,31,194,225,42,16,73,154,157,346,0.453757225433526,77,203,0.3793103448275862,80,143,0.5594405594405595,0.565,43,65,0.6615384615384615
Mike Dunleavy,dunlemi02,SF,36,TOT,2017,53,841.0,275,50,18,97,115,15,7,28,67,93,220,0.4227272727272727,53,134,0.3955223880597014,40,86,0.4651162790697674,0.543,36,45,0.8
Kris Dunn,dunnkr01,PG,22,MIN,2017,78,1333.0,293,188,24,142,166,78,36,89,178,118,313,0.3769968051118211,21,73,0.2876712328767123,97,240,0.4041666666666667,0.411,36,59,0.6101694915254238
Kevin Durant,duranke01,PF,28,GSW,2017,62,2070.0,1555,300,39,474,513,66,99,138,117,551,1026,0.5370370370370371,117,312,0.375,434,714,0.6078431372549019,0.594,336,384,0.875
Jarell Eddie,eddieja01,SF,25,PHO,2017,5,62.0,24,0,1,6,7,1,0,1,1,6,19,0.3157894736842105,4,16,0.25,2,3,0.6666666666666666,0.421,8,9,0.8888888888888888
Henry Ellenson,ellenhe01,PF,20,DET,2017,19,146.0,60,7,8,33,41,1,1,14,6,23,64,0.359375,10,35,0.2857142857142857,13,29,0.4482758620689655,0.438,4,8,0.5
Wayne Ellington,ellinwa01,SG,29,MIA,2017,62,1500.0,648,70,18,114,132,35,4,30,70,231,555,0.4162162162162162,149,394,0.3781725888324873,82,161,0.5093167701863354,0.55,37,43,0.8604651162790697
Monta Ellis,ellismo01,SG,31,IND,2017,74,1998.0,630,236,19,185,204,78,27,135,149,247,557,0.4434470377019748,43,135,0.3185185185185185,204,422,0.4834123222748815,0.482,93,128,0.7265625
Joel Embiid,embiijo01,C,22,PHI,2017,31,786.0,627,66,61,182,243,27,76,117,112,200,429,0.4662004662004662,36,98,0.3673469387755102,164,331,0.4954682779456193,0.508,191,244,0.7827868852459017
James Ennis III,ennisja01,SF,26,MEM,2017,64,1501.0,429,64,69,190,259,46,19,59,165,146,321,0.454828660436137,51,137,0.3722627737226277,95,184,0.5163043478260869,0.534,86,110,0.7818181818181819
Tyler Ennis,ennisty01,PG,22,TOT,2017,53,588.0,228,86,9,36,45,25,2,45,58,90,208,0.4326923076923077,27,70,0.3857142857142857,63,138,0.4565217391304347,0.498,21,25,0.84
Tyreke Evans,evansty01,SF,27,TOT,2017,40,788.0,411,124,13,124,137,35,9,61,60,150,370,0.4054054054054054,42,118,0.3559322033898305,108,252,0.4285714285714285,0.462,69,92,0.75
Dante Exum,exumda01,PG,21,UTA,2017,66,1228.0,412,111,30,102,132,21,12,80,146,155,363,0.4269972451790633,44,149,0.2953020134228188,111,214,0.5186915887850467,0.488,58,73,0.7945205479452054
Kenneth Faried,farieke01,PF,27,DEN,2017,61,1296.0,587,55,183,279,462,43,40,59,124,228,416,0.5480769230769231,0,6,0.0,228,410,0.5560975609756098,0.548,131,189,0.6931216931216931
Jordan Farmar,farmajo01,PG,30,SAC,2017,2,35.0,12,9,1,2,3,2,0,3,1,4,12,0.3333333333333333,4,9,0.4444444444444444,0,3,0.0,0.5,0,0,0.0
Derrick Favors,favorde01,PF,25,UTA,2017,50,1186.0,476,56,92,213,305,45,40,60,103,203,417,0.486810551558753,3,10,0.3,200,407,0.4914004914004914,0.49,67,109,0.6146788990825688
Kay Felder,feldeka01,PG,21,CLE,2017,42,386.0,166,58,3,38,41,18,7,30,38,62,158,0.3924050632911392,7,22,0.3181818181818182,55,136,0.4044117647058823,0.415,35,49,0.7142857142857143
Cristiano Felício,feliccr01,C,24,CHI,2017,66,1040.0,316,40,124,187,311,25,17,33,110,128,221,0.579185520361991,0,0,0.0,128,221,0.579185520361991,0.579,60,93,0.6451612903225806
Raymond Felton,feltora01,PG,32,LAC,2017,80,1700.0,538,191,33,185,218,66,22,83,125,221,514,0.4299610894941634,46,144,0.3194444444444444,175,370,0.4729729729729729,0.475,50,64,0.78125
Yogi Ferrell,ferreyo01,PG,23,TOT,2017,46,1197.0,462,172,20,91,111,42,9,70,90,160,394,0.4060913705583756,68,176,0.3863636363636363,92,218,0.4220183486238532,0.492,74,89,0.8314606741573034
Dorian Finney-Smith,finnedo01,PF,23,DAL,2017,81,1642.0,350,67,55,167,222,52,25,45,125,124,333,0.3723723723723723,56,191,0.2931937172774869,68,142,0.4788732394366197,0.456,46,61,0.7540983606557377
Bryn Forbes,forbebr01,SG,23,SAS,2017,36,285.0,94,23,2,21,23,1,0,11,20,36,99,0.3636363636363636,17,53,0.320754716981132,19,46,0.4130434782608695,0.449,5,6,0.8333333333333334
Evan Fournier,fournev01,SG,24,ORL,2017,68,2234.0,1167,202,44,165,209,66,4,141,180,408,930,0.4387096774193548,128,360,0.3555555555555555,280,570,0.4912280701754385,0.508,223,277,0.8050541516245487
Randy Foye,foyera01,SG,33,BRK,2017,69,1284.0,357,135,9,146,155,35,9,80,99,118,325,0.3630769230769231,67,203,0.3300492610837438,51,122,0.4180327868852459,0.466,54,63,0.8571428571428571
Tim Frazier,fraziti01,PG,26,NOP,2017,65,1525.0,464,335,34,139,173,56,6,101,133,163,404,0.4034653465346535,40,128,0.3125,123,276,0.4456521739130434,0.453,98,129,0.7596899224806202
Enes Freedom,kanteen01,C,24,OKC,2017,72,1533.0,1033,67,195,287,482,32,38,123,154,402,737,0.5454545454545454,5,38,0.131578947368421,397,699,0.5679542203147353,0.549,224,285,0.7859649122807018
Channing Frye,fryech01,C,33,CLE,2017,74,1398.0,676,45,37,253,290,33,37,53,138,238,520,0.4576923076923077,137,335,0.408955223880597,101,185,0.5459459459459459,0.589,63,74,0.8513513513513513
Danilo Gallinari,gallida01,SF,28,DEN,2017,63,2134.0,1145,135,39,286,325,40,15,82,93,335,750,0.4466666666666666,126,324,0.3888888888888889,209,426,0.4906103286384976,0.531,349,387,0.9018087855297158
Langston Galloway,gallola01,PG,25,TOT,2017,74,1495.0,585,93,27,129,156,46,6,46,96,207,545,0.3798165137614679,120,308,0.3896103896103896,87,237,0.3670886075949367,0.49,51,64,0.796875
Patricio Garino,garinpa01,SG,23,ORL,2017,5,43.0,0,0,1,6,7,0,0,3,4,0,7,0.0,0,5,0.0,0,2,0.0,0.0,0,0,0.0
Marc Gasol,gasolma01,C,32,MEM,2017,74,2531.0,1446,338,60,404,464,67,99,166,171,532,1160,0.4586206896551724,104,268,0.3880597014925373,428,892,0.4798206278026906,0.503,278,332,0.8373493975903614
Pau Gasol,gasolpa01,C,36,SAS,2017,64,1627.0,792,150,107,394,501,24,70,81,110,303,604,0.5016556291390728,56,104,0.5384615384615384,247,500,0.494,0.548,130,184,0.7065217391304348
Rudy Gay,gayru01,SF,30,SAC,2017,30,1013.0,562,83,35,155,190,44,26,74,79,201,442,0.4547511312217194,42,113,0.3716814159292035,159,329,0.4832826747720364,0.502,118,138,0.855072463768116
Michael Gbinije,gbinimi01,SG,24,DET,2017,9,32.0,4,2,2,1,3,0,0,0,2,1,10,0.1,0,4,0.0,1,6,0.1666666666666666,0.1,2,2,1.0
Alonzo Gee,geeal01,SF,29,DEN,2017,13,89.0,11,6,4,11,15,5,1,4,14,3,14,0.2142857142857142,0,3,0.0,3,11,0.2727272727272727,0.214,5,9,0.5555555555555556
Paul George,georgpa01,SF,26,IND,2017,75,2689.0,1775,251,58,434,492,119,27,220,206,622,1348,0.4614243323442136,195,496,0.3931451612903225,427,852,0.5011737089201878,0.534,336,374,0.8983957219251337
Marcus Georges-Hunt,georgma01,SG,22,ORL,2017,5,48.0,14,3,1,8,9,1,0,2,5,2,7,0.2857142857142857,1,2,0.5,1,5,0.2,0.357,9,10,0.9
Jonathan Gibson,gibsojo01,PG,29,DAL,2017,17,231.0,106,26,1,21,22,8,0,21,21,35,95,0.3684210526315789,15,45,0.3333333333333333,20,50,0.4,0.447,21,29,0.7241379310344828
Taj Gibson,gibsota01,PF,31,TOT,2017,78,1989.0,846,73,158,327,485,41,65,105,163,365,709,0.5148095909732017,3,13,0.2307692307692307,362,696,0.5201149425287356,0.517,113,158,0.7151898734177216
Manu Ginóbili,ginobma01,SG,39,SAS,2017,69,1291.0,517,183,28,129,157,82,16,96,119,171,439,0.3895216400911162,89,227,0.3920704845814978,82,212,0.3867924528301887,0.491,86,107,0.8037383177570093
Rudy Gobert,goberru01,C,24,UTA,2017,81,2744.0,1137,97,314,721,1035,49,214,147,246,413,625,0.6608,0,1,0.0,413,624,0.6618589743589743,0.661,311,476,0.6533613445378151
Archie Goodwin,goodwar01,SG,22,TOT,2017,15,214.0,110,24,7,21,28,4,5,14,8,36,66,0.5454545454545454,5,15,0.3333333333333333,31,51,0.6078431372549019,0.583,33,42,0.7857142857142857
Aaron Gordon,gordoaa01,SF,21,ORL,2017,80,2298.0,1019,150,116,289,405,65,40,89,172,393,865,0.4543352601156069,77,267,0.2883895131086142,316,598,0.5284280936454849,0.499,156,217,0.7188940092165899
Eric Gordon,gordoer01,SG,28,HOU,2017,75,2323.0,1217,188,29,172,201,48,41,121,150,412,1016,0.405511811023622,246,661,0.3721633888048411,166,355,0.4676056338028169,0.527,147,175,0.84
Marcin Gortat,gortama01,C,32,WAS,2017,82,2556.0,883,121,238,611,849,40,61,119,213,390,674,0.5786350148367952,0,2,0.0,390,672,0.5803571428571429,0.579,103,159,0.6477987421383647
Treveon Graham,grahatr01,SG,23,CHO,2017,27,189.0,57,6,5,17,22,6,1,3,18,19,40,0.475,9,15,0.6,10,25,0.4,0.588,10,15,0.6666666666666666
Jerami Grant,grantje01,PF,22,TOT,2017,80,1531.0,437,46,38,167,205,33,79,44,149,152,328,0.4634146341463415,43,116,0.3706896551724138,109,212,0.5141509433962265,0.529,90,147,0.6122448979591837
Jerian Grant,grantje02,PG,24,CHI,2017,63,1028.0,370,121,17,94,111,47,8,44,93,128,301,0.4252491694352159,49,134,0.3656716417910448,79,167,0.4730538922155688,0.507,65,73,0.8904109589041096
Danny Green,greenda02,SG,29,SAS,2017,68,1807.0,497,124,31,193,224,70,57,76,120,176,449,0.3919821826280623,118,311,0.3794212218649517,58,138,0.4202898550724637,0.523,27,32,0.84375
Draymond Green,greendr01,PF,26,GSW,2017,76,2471.0,776,533,98,501,599,154,106,184,217,272,650,0.4184615384615384,81,263,0.3079847908745247,191,387,0.4935400516795866,0.481,151,213,0.7089201877934272
Gerald Green,greenge01,SF,31,BOS,2017,47,538.0,262,33,16,68,84,9,7,25,48,95,232,0.4094827586206896,39,111,0.3513513513513513,56,121,0.4628099173553719,0.494,33,41,0.8048780487804879
JaMychal Green,greenja01,PF,26,MEM,2017,77,2101.0,689,84,167,377,544,47,34,94,248,250,500,0.5,55,145,0.3793103448275862,195,355,0.5492957746478874,0.555,134,167,0.8023952095808383
Jeff Green,greenje02,PF,30,ORL,2017,69,1534.0,638,81,39,175,214,37,13,75,103,220,558,0.3942652329749104,53,193,0.2746113989637305,167,365,0.4575342465753425,0.442,145,168,0.8630952380952381
Blake Griffin,griffbl01,PF,27,LAC,2017,61,2076.0,1316,300,112,385,497,57,22,142,157,479,971,0.4933058702368692,38,113,0.336283185840708,441,858,0.513986013986014,0.513,320,421,0.7600950118764845
Justin Hamilton,hamilju01,C,26,BRK,2017,64,1177.0,442,55,71,191,262,29,43,43,91,174,379,0.4591029023746701,55,180,0.3055555555555556,119,199,0.5979899497487438,0.532,39,52,0.75
A.J. Hammons,hammoaj01,C,24,DAL,2017,22,163.0,48,4,8,28,36,1,13,10,21,17,42,0.4047619047619047,5,10,0.5,12,32,0.375,0.464,9,20,0.45
Tim Hardaway Jr.,hardati02,SG,24,ATL,2017,79,2154.0,1143,182,35,189,224,55,15,106,103,415,912,0.4550438596491228,149,417,0.3573141486810551,266,495,0.5373737373737374,0.537,164,214,0.7663551401869159
James Harden,hardeja01,PG,27,HOU,2017,81,2947.0,2356,907,95,564,659,121,38,464,215,674,1533,0.4396607958251793,262,756,0.3465608465608465,412,777,0.5302445302445302,0.525,746,881,0.8467650397275823
Maurice Harkless,harklma01,SF,23,POR,2017,77,2223.0,773,88,125,216,341,85,70,86,214,314,624,0.5032051282051282,68,194,0.3505154639175257,246,430,0.5720930232558139,0.558,77,124,0.6209677419354839
Justin Harper,harpeju01,PF,27,PHI,2017,3,31.0,12,2,2,3,5,0,0,4,2,5,12,0.4166666666666667,2,7,0.2857142857142857,3,5,0.6,0.5,0,0,0.0
Montrezl Harrell,harremo01,C,23,HOU,2017,58,1064.0,527,64,81,138,219,20,42,44,126,225,345,0.6521739130434783,1,7,0.1428571428571428,224,338,0.6627218934911243,0.654,76,121,0.628099173553719
Devin Harris,harride01,PG,33,DAL,2017,65,1087.0,437,136,11,116,127,43,7,57,101,136,341,0.3988269794721407,58,177,0.327683615819209,78,164,0.4756097560975609,0.484,107,129,0.8294573643410853
Gary Harris,harriga01,SG,22,DEN,2017,57,1782.0,851,164,48,130,178,71,8,76,92,320,637,0.5023547880690737,107,255,0.4196078431372549,213,382,0.5575916230366492,0.586,104,134,0.7761194029850746
Joe Harris,harrijo01,SG,25,BRK,2017,52,1138.0,428,54,16,131,147,30,8,55,121,154,362,0.425414364640884,85,221,0.3846153846153846,69,141,0.4893617021276595,0.543,35,49,0.7142857142857143
Manny Harris,harrima01,SG,27,DAL,2017,4,25.0,8,2,3,6,9,0,0,2,1,3,15,0.2,0,2,0.0,3,13,0.2307692307692307,0.2,2,4,0.5
Tobias Harris,harrito02,PF,24,DET,2017,82,2567.0,1321,142,63,353,416,60,39,96,133,511,1063,0.4807149576669802,109,314,0.3471337579617834,402,749,0.5367156208277704,0.532,190,226,0.8407079646017699
Aaron Harrison,harriaa01,SG,22,CHO,2017,5,17.0,1,3,0,3,3,0,0,0,2,0,4,0.0,0,2,0.0,0,2,0.0,0.0,1,2,0.5
Andrew Harrison,harrian01,PG,22,MEM,2017,72,1474.0,425,198,23,113,136,53,21,85,194,117,360,0.325,43,156,0.2756410256410256,74,204,0.3627450980392157,0.385,148,194,0.7628865979381443
Udonis Haslem,hasleud01,C,36,MIA,2017,16,130.0,31,6,8,28,36,6,1,8,22,11,23,0.4782608695652174,0,3,0.0,11,20,0.55,0.478,9,15,0.6
Spencer Hawes,hawessp01,PF,28,TOT,2017,54,797.0,337,81,38,153,191,15,30,49,77,134,277,0.483754512635379,25,81,0.3086419753086419,109,196,0.5561224489795918,0.529,44,52,0.8461538461538461
Gordon Hayward,haywago01,SF,26,UTA,2017,73,2516.0,1601,252,49,345,394,73,20,140,117,545,1156,0.4714532871972318,149,374,0.3983957219251337,396,782,0.5063938618925832,0.536,362,429,0.8438228438228438
Gerald Henderson,hendege02,SG,29,PHI,2017,72,1667.0,662,112,34,151,185,40,15,62,129,234,553,0.4231464737793852,61,173,0.3526011560693641,173,380,0.4552631578947368,0.478,133,165,0.806060606060606
John Henson,hensojo01,C,26,MIL,2017,58,1123.0,392,57,92,203,295,29,78,52,151,159,309,0.5145631067961165,0,1,0.0,159,308,0.5162337662337663,0.515,74,107,0.6915887850467289
Juancho Hernangómez,hernaju01,PF,21,DEN,2017,62,842.0,305,29,43,144,187,30,12,31,62,101,224,0.4508928571428571,46,113,0.4070796460176991,55,111,0.4954954954954955,0.554,57,76,0.75
Willy Hernangómez,hernawi01,C,22,NYK,2017,72,1324.0,587,96,170,332,502,41,36,100,150,246,465,0.5290322580645161,4,15,0.2666666666666666,242,450,0.5377777777777778,0.533,91,125,0.728
Mario Hezonja,hezonma01,SF,21,ORL,2017,65,960.0,317,62,20,126,146,30,15,58,74,117,330,0.3545454545454545,43,144,0.2986111111111111,74,186,0.3978494623655914,0.42,40,50,0.8
Roy Hibbert,hibbero01,C,30,TOT,2017,48,682.0,221,21,54,98,152,8,46,32,100,80,147,0.54421768707483,0,0,0.0,80,147,0.54421768707483,0.544,61,75,0.8133333333333334
Buddy Hield,hieldbu01,SG,24,TOT,2017,82,1888.0,866,121,35,234,269,38,9,101,115,327,767,0.4263363754889178,148,379,0.3905013192612137,179,388,0.461340206185567,0.523,64,76,0.8421052631578947
Nenê,hilarne01,C,34,HOU,2017,67,1198.0,609,65,95,187,282,56,39,73,163,245,397,0.6171284634760705,3,9,0.3333333333333333,242,388,0.6237113402061856,0.621,116,197,0.5888324873096447
George Hill,hillge01,PG,30,UTA,2017,49,1544.0,829,204,23,144,167,50,11,85,114,289,606,0.4768976897689769,94,233,0.4034334763948498,195,373,0.5227882037533512,0.554,157,196,0.8010204081632653
Jordan Hill,hilljo01,C,29,MIN,2017,7,47.0,12,0,8,6,14,1,0,4,9,5,13,0.3846153846153846,0,0,0.0,5,13,0.3846153846153846,0.385,2,2,1.0
Solomon Hill,hillso01,SF,25,NOP,2017,80,2374.0,563,141,51,256,307,72,32,82,182,183,478,0.3828451882845188,94,270,0.3481481481481481,89,208,0.4278846153846153,0.481,103,128,0.8046875
Darrun Hilliard,hillida01,SG,23,DET,2017,39,381.0,127,33,2,31,33,11,2,28,39,47,126,0.373015873015873,12,46,0.2608695652173913,35,80,0.4375,0.421,21,28,0.75
Jrue Holiday,holidjr01,PG,26,NOP,2017,67,2190.0,1029,488,46,218,264,100,44,194,133,405,893,0.4535274356103023,100,281,0.3558718861209964,305,612,0.4983660130718954,0.51,119,168,0.7083333333333334
Justin Holiday,holidju01,SG,27,NYK,2017,82,1639.0,629,102,27,198,225,65,31,66,109,233,538,0.433085501858736,97,273,0.3553113553113553,136,265,0.5132075471698113,0.523,66,80,0.825
Rondae Hollis-Jefferson,holliro01,SF,22,BRK,2017,78,1761.0,675,154,96,356,452,82,44,116,177,235,542,0.4335793357933579,15,67,0.2238805970149253,220,475,0.4631578947368421,0.447,190,253,0.7509881422924901
Richaun Holmes,holmeri01,C,23,PHI,2017,57,1193.0,559,58,94,217,311,42,55,55,136,230,412,0.558252427184466,27,77,0.3506493506493506,203,335,0.6059701492537314,0.591,72,103,0.6990291262135923
Rodney Hood,hoodro01,SG,24,UTA,2017,59,1593.0,748,96,16,186,202,38,11,65,132,272,666,0.4084084084084084,114,307,0.3713355048859935,158,359,0.4401114206128134,0.494,90,115,0.782608695652174
Al Horford,horfoal01,C,30,BOS,2017,68,2193.0,952,337,95,370,465,52,86,115,138,379,801,0.4731585518102372,86,242,0.3553719008264462,293,559,0.5241502683363148,0.527,108,135,0.8
Danuel House Jr.,houseda01,SG,23,WAS,2017,1,1.0,0,0,0,1,1,0,0,0,0,0,0,0.0,0,0,0.0,0,0,0.0,0.0,0,0,0.0
Dwight Howard,howardw01,C,31,ATL,2017,74,2199.0,1002,104,296,644,940,64,92,170,203,388,613,0.632952691680261,0,2,0.0,388,611,0.6350245499181669,0.633,226,424,0.5330188679245284
Marcelo Huertas,huertma01,PG,33,LAL,2017,23,237.0,63,52,2,22,24,10,2,19,16,25,68,0.3676470588235294,4,19,0.2105263157894736,21,49,0.4285714285714285,0.397,9,17,0.5294117647058824
Josh Huestis,huestjo01,PF,25,OKC,2017,2,31.0,14,3,4,5,9,0,3,0,0,6,11,0.5454545454545454,2,4,0.5,4,7,0.5714285714285714,0.636,0,1,0.0
Kris Humphries,humphkr01,PF,31,ATL,2017,56,689.0,257,29,60,146,206,15,21,28,69,87,214,0.4065420560747663,19,54,0.3518518518518518,68,160,0.425,0.451,64,82,0.7804878048780488
R.J. Hunter,hunterj01,SG,23,CHI,2017,3,9.0,0,0,0,1,1,0,0,0,0,0,1,0.0,0,1,0.0,0,0,0.0,0.0,0,0,0.0
Serge Ibaka,ibakase01,PF,27,TOT,2017,79,2422.0,1173,75,129,409,538,41,124,105,215,471,982,0.4796334012219959,124,317,0.3911671924290221,347,665,0.5218045112781955,0.543,107,125,0.856
Andre Iguodala,iguodan01,SF,33,GSW,2017,76,1998.0,574,261,51,253,304,76,39,58,97,219,415,0.5277108433734939,64,177,0.3615819209039548,155,238,0.6512605042016807,0.605,72,102,0.7058823529411765
Ersan İlyasova,ilyaser01,PF,29,TOT,2017,82,2142.0,1071,141,115,366,481,58,23,116,211,384,890,0.4314606741573034,142,402,0.3532338308457711,242,488,0.4959016393442623,0.511,161,207,0.7777777777777778
Joe Ingles,inglejo01,SF,29,UTA,2017,82,1972.0,581,225,23,238,261,96,8,107,163,204,451,0.4523281596452328,123,279,0.4408602150537634,81,172,0.4709302325581395,0.589,50,68,0.7352941176470589
Brandon Ingram,ingrabr01,SF,19,LAL,2017,79,2279.0,740,166,60,256,316,50,36,116,158,276,686,0.4023323615160349,55,187,0.2941176470588235,221,499,0.4428857715430861,0.442,133,214,0.6214953271028038
Kyrie Irving,irvinky01,PG,24,CLE,2017,72,2525.0,1816,418,52,178,230,83,24,180,157,671,1420,0.4725352112676056,177,441,0.4013605442176871,494,979,0.5045965270684372,0.535,297,328,0.9054878048780488
Jarrett Jack,jackja01,PG,33,NOP,2017,2,33.0,6,5,0,0,0,2,0,3,4,2,3,0.6666666666666666,0,1,0.0,2,2,1.0,0.667,2,2,1.0
Demetrius Jackson,jacksde01,PG,22,BOS,2017,5,17.0,10,3,2,2,4,0,0,0,0,3,4,0.75,1,1,1.0,2,3,0.6666666666666666,0.875,3,6,0.5
Pierre Jackson,jackspi01,PG,25,DAL,2017,8,84.0,35,19,1,8,9,2,0,3,5,13,39,0.3333333333333333,3,11,0.2727272727272727,10,28,0.3571428571428571,0.372,6,7,0.8571428571428571
Reggie Jackson,jacksre01,PG,26,DET,2017,52,1424.0,752,270,21,93,114,35,5,114,129,284,677,0.4194977843426883,66,184,0.358695652173913,218,493,0.4421906693711968,0.468,118,136,0.8676470588235294
LeBron James,jamesle01,SF,32,CLE,2017,74,2794.0,1954,646,97,542,639,92,44,303,134,736,1344,0.5476190476190477,124,342,0.3625730994152046,612,1002,0.6107784431137725,0.594,358,531,0.6741996233521658
Al Jefferson,jeffeal01,C,32,IND,2017,66,931.0,535,57,75,203,278,19,16,33,125,235,471,0.4989384288747346,0,1,0.0,235,470,0.5,0.499,65,85,0.7647058823529411
Richard Jefferson,jefferi01,SF,36,CLE,2017,79,1614.0,448,78,28,175,203,26,10,52,153,153,343,0.446064139941691,62,186,0.3333333333333333,91,157,0.5796178343949044,0.536,80,108,0.7407407407407407
John Jenkins,jenkijo01,SG,25,PHO,2017,4,13.0,7,1,0,1,1,0,0,0,0,2,5,0.4,1,2,0.5,1,3,0.3333333333333333,0.5,2,2,1.0
Brandon Jennings,jennibr01,PG,27,TOT,2017,81,1802.0,577,395,29,167,196,70,4,128,116,192,535,0.3588785046728971,79,252,0.3134920634920635,113,283,0.3992932862190813,0.433,114,152,0.75
Jonas Jerebko,jerebjo01,PF,29,BOS,2017,78,1232.0,299,71,59,213,272,25,17,39,122,114,262,0.4351145038167939,45,130,0.3461538461538461,69,132,0.5227272727272727,0.521,26,37,0.7027027027027027
Amir Johnson,johnsam01,PF,29,BOS,2017,80,1608.0,520,140,118,248,366,51,62,77,211,213,370,0.5756756756756757,27,66,0.4090909090909091,186,304,0.6118421052631579,0.612,67,100,0.67
Brice Johnson,johnsbr02,PF,22,LAC,2017,3,9.0,4,1,1,2,3,2,1,1,0,2,7,0.2857142857142857,0,0,0.0,2,7,0.2857142857142857,0.286,0,0,0.0
James Johnson,johnsja01,PF,29,MIA,2017,76,2085.0,975,276,66,310,376,76,86,171,197,368,769,0.4785435630689206,87,256,0.33984375,281,513,0.5477582846003899,0.535,152,215,0.7069767441860465
Joe Johnson,johnsjo02,SF,35,UTA,2017,78,1843.0,715,144,33,210,243,36,18,69,93,273,626,0.4361022364217252,106,258,0.4108527131782946,167,368,0.453804347826087,0.521,63,77,0.8181818181818182
Stanley Johnson,johnsst04,SF,20,DET,2017,77,1371.0,339,105,36,153,189,56,24,71,121,129,365,0.3534246575342465,45,154,0.2922077922077922,84,211,0.3981042654028436,0.415,36,53,0.6792452830188679
Tyler Johnson,johnsty01,PG,24,MIA,2017,73,2178.0,1002,233,50,243,293,84,44,90,176,357,824,0.433252427184466,93,250,0.372,264,574,0.4599303135888501,0.49,195,254,0.7677165354330708
Wesley Johnson,johnswe01,SF,29,LAC,2017,68,810.0,186,23,26,155,181,29,30,18,83,73,200,0.365,29,118,0.2457627118644068,44,82,0.5365853658536586,0.438,11,17,0.6470588235294118
Nikola Jokić,jokicni01,C,21,DEN,2017,73,2038.0,1221,359,212,506,718,61,55,171,214,494,854,0.5784543325526932,45,139,0.3237410071942446,449,715,0.627972027972028,0.605,188,228,0.8245614035087719
Dahntay Jones,jonesda02,SF,36,CLE,2017,1,12.0,9,1,1,1,2,0,0,1,1,3,8,0.375,0,2,0.0,3,6,0.5,0.375,3,4,0.75
Damian Jones,jonesda03,C,21,GSW,2017,10,85.0,19,0,9,14,23,1,4,6,15,8,16,0.5,0,0,0.0,8,16,0.5,0.5,3,10,0.3
Derrick Jones Jr.,jonesde02,SF,19,PHO,2017,32,545.0,168,12,39,40,79,14,13,13,63,68,121,0.5619834710743802,3,11,0.2727272727272727,65,110,0.5909090909090909,0.574,29,41,0.7073170731707317
James Jones,jonesja02,SF,36,CLE,2017,48,381.0,132,14,3,34,37,6,10,10,37,44,92,0.4782608695652174,31,66,0.4696969696969697,13,26,0.5,0.647,13,20,0.65
Terrence Jones,joneste01,PF,25,TOT,2017,54,1270.0,584,59,65,241,306,40,54,48,67,231,492,0.4695121951219512,19,75,0.2533333333333333,212,417,0.5083932853717026,0.489,103,170,0.6058823529411764
Tyus Jones,jonesty01,PG,20,MIN,2017,60,774.0,209,156,10,57,67,48,5,38,50,75,181,0.4143646408839779,26,73,0.3561643835616438,49,108,0.4537037037037037,0.486,33,43,0.7674418604651163
DeAndre Jordan,jordade01,C,28,LAC,2017,81,2570.0,1029,96,298,816,1114,51,134,115,212,412,577,0.7140381282495667,0,2,0.0,412,575,0.7165217391304348,0.714,205,425,0.4823529411764706
Cory Joseph,josepco01,PG,25,TOR,2017,80,2003.0,740,265,51,184,235,66,13,108,140,299,661,0.4523449319213313,48,135,0.3555555555555555,251,526,0.4771863117870722,0.489,94,122,0.7704918032786885
Frank Kaminsky,kaminfr01,C,23,CHO,2017,75,1954.0,874,162,57,279,336,46,34,76,139,320,802,0.399002493765586,116,354,0.327683615819209,204,448,0.4553571428571428,0.471,118,156,0.7564102564102564
Ryan Kelly,kellyry01,PF,25,ATL,2017,16,110.0,25,8,1,17,18,4,5,4,5,8,28,0.2857142857142857,4,10,0.4,4,18,0.2222222222222222,0.357,5,6,0.8333333333333334
Michael Kidd-Gilchrist,kiddgmi01,SF,23,CHO,2017,81,2349.0,743,114,156,409,565,81,77,56,187,295,618,0.4773462783171521,1,9,0.1111111111111111,294,609,0.4827586206896552,0.478,152,194,0.7835051546391752
Sean Kilpatrick,kilpase01,SG,27,BRK,2017,70,1754.0,919,157,22,258,280,45,6,135,118,305,735,0.4149659863945578,105,308,0.3409090909090909,200,427,0.468384074941452,0.486,204,242,0.8429752066115702
Brandon Knight,knighbr03,SG,25,PHO,2017,54,1140.0,595,130,25,93,118,27,5,88,87,209,525,0.3980952380952381,45,139,0.3237410071942446,164,386,0.4248704663212435,0.441,132,154,0.8571428571428571
Kyle Korver,korveky01,SG,35,TOT,2017,67,1753.0,678,110,7,179,186,34,21,69,107,239,515,0.4640776699029126,162,359,0.4512534818941504,77,156,0.4935897435897436,0.621,38,42,0.9047619047619048
Kosta Koufos,koufoko01,C,27,SAC,2017,71,1419.0,470,47,118,285,403,36,48,61,172,216,392,0.5510204081632653,0,1,0.0,216,391,0.5524296675191815,0.551,38,62,0.6129032258064516
Mindaugas Kuzminskas,kuzmimi01,SF,27,NYK,2017,68,1016.0,425,69,47,79,126,29,11,51,79,158,369,0.4281842818428184,54,168,0.3214285714285714,104,201,0.5174129353233831,0.501,55,68,0.8088235294117647
Skal Labissière,labissk01,PF,20,SAC,2017,33,612.0,289,27,51,111,162,16,13,37,64,117,218,0.536697247706422,3,8,0.375,114,210,0.5428571428571428,0.544,52,74,0.7027027027027027
Jeremy Lamb,lambje01,SG,24,CHO,2017,62,1143.0,603,75,30,234,264,27,23,40,98,226,491,0.460285132382892,41,146,0.2808219178082192,185,345,0.5362318840579711,0.502,110,129,0.8527131782945736
Nicolás Laprovíttola,laproni01,PG,27,SAS,2017,18,174.0,59,28,1,9,10,4,1,19,19,20,47,0.425531914893617,10,27,0.3703703703703703,10,20,0.5,0.532,9,9,1.0
Joffrey Lauvergne,lauvejo01,PF-C,25,TOT,2017,70,980.0,375,70,72,179,251,25,6,56,83,148,336,0.4404761904761904,33,98,0.336734693877551,115,238,0.4831932773109244,0.49,46,73,0.6301369863013698
Zach LaVine,lavinza01,SG,21,MIN,2017,47,1749.0,889,139,19,141,160,41,10,85,104,326,710,0.4591549295774648,120,310,0.3870967741935484,206,400,0.515,0.544,117,140,0.8357142857142857
Ty Lawson,lawsoty01,PG,29,SAC,2017,69,1732.0,681,334,44,135,179,74,6,129,119,237,522,0.4540229885057471,34,118,0.288135593220339,203,404,0.5024752475247525,0.487,173,217,0.7972350230414746
Jake Layman,laymaja01,SF,22,POR,2017,35,249.0,78,11,6,18,24,9,3,11,22,26,89,0.2921348314606741,13,51,0.2549019607843137,13,38,0.3421052631578947,0.365,13,17,0.7647058823529411
Courtney Lee,leeco01,SG,31,NYK,2017,77,2459.0,835,179,53,206,259,81,24,69,141,321,704,0.4559659090909091,108,269,0.4014869888475836,213,435,0.4896551724137931,0.533,85,98,0.8673469387755102
David Lee,leeda02,PF,33,SAS,2017,79,1477.0,576,124,149,292,441,31,40,82,125,248,420,0.5904761904761905,0,0,0.0,248,420,0.5904761904761905,0.59,80,113,0.7079646017699115
Alex Len,lenal01,C,23,PHO,2017,77,1560.0,613,44,156,354,510,38,98,102,242,230,463,0.4967602591792656,3,12,0.25,227,451,0.5033259423503326,0.5,150,208,0.7211538461538461
Kawhi Leonard,leonaka01,SF,25,SAS,2017,74,2474.0,1888,260,80,350,430,133,55,154,122,636,1312,0.4847560975609756,147,387,0.3798449612403101,489,925,0.5286486486486487,0.541,469,533,0.8799249530956847
Meyers Leonard,leoname01,PF,24,POR,2017,74,1222.0,401,71,27,210,237,13,28,35,172,146,378,0.3862433862433862,74,213,0.3474178403755869,72,165,0.4363636363636363,0.484,35,40,0.875
Jon Leuer,leuerjo01,PF,27,DET,2017,75,1944.0,767,111,102,300,402,31,26,66,145,310,646,0.479876160990712,49,167,0.2934131736526946,261,479,0.5448851774530271,0.518,98,113,0.8672566371681416
Caris LeVert,leverca01,SF,22,BRK,2017,57,1237.0,468,110,23,165,188,49,8,59,91,171,380,0.45,59,184,0.3206521739130434,112,196,0.5714285714285714,0.528,67,93,0.7204301075268817
DeAndre Liggins,liggide01,SG,28,TOT,2017,62,777.0,152,54,20,88,108,47,14,42,81,55,142,0.3873239436619718,17,46,0.3695652173913043,38,96,0.3958333333333333,0.447,25,40,0.625
Damian Lillard,lillada01,PG,26,POR,2017,75,2694.0,2024,440,46,322,368,68,20,197,152,661,1488,0.4442204301075269,214,579,0.3696027633851468,447,909,0.4917491749174917,0.516,488,545,0.8954128440366973
Jeremy Lin,linje01,PG,28,BRK,2017,36,883.0,523,184,11,124,135,42,14,86,79,175,400,0.4375,58,156,0.3717948717948718,117,244,0.4795081967213114,0.51,115,141,0.8156028368794326
Shaun Livingston,livinsh01,PG,31,GSW,2017,76,1345.0,389,139,28,123,151,38,20,62,120,173,316,0.5474683544303798,1,3,0.3333333333333333,172,313,0.549520766773163,0.549,42,60,0.7
Shawn Long,longsh01,C,24,PHI,2017,18,234.0,148,13,41,44,85,9,9,13,49,61,109,0.5596330275229358,7,19,0.3684210526315789,54,90,0.6,0.592,19,35,0.5428571428571428
Kevon Looney,looneke01,C,20,GSW,2017,53,447.0,135,29,44,80,124,15,17,17,64,56,107,0.5233644859813084,2,9,0.2222222222222222,54,98,0.5510204081632653,0.533,21,34,0.6176470588235294
Brook Lopez,lopezbr01,C,28,BRK,2017,75,2222.0,1539,176,121,282,403,38,124,184,192,555,1172,0.4735494880546075,134,387,0.3462532299741602,421,785,0.5363057324840764,0.531,295,364,0.8104395604395604
Robin Lopez,lopezro01,C,28,CHI,2017,81,2271.0,839,80,244,276,520,18,117,91,151,382,775,0.4929032258064516,0,2,0.0,382,773,0.4941785252263906,0.493,75,104,0.7211538461538461
Kevin Love,loveke01,PF,28,CLE,2017,60,1885.0,1142,116,148,518,666,53,21,122,125,370,867,0.4267589388696655,145,389,0.3727506426735218,225,478,0.4707112970711297,0.51,257,295,0.8711864406779661
Kyle Lowry,lowryky01,PG,30,TOR,2017,60,2244.0,1344,417,48,238,286,88,19,173,170,426,918,0.4640522875816993,193,468,0.4123931623931623,233,450,0.5177777777777778,0.569,299,365,0.8191780821917808
John Lucas III,lucasjo02,PG,34,MIN,2017,5,11.0,2,1,0,0,0,2,0,0,0,1,4,0.25,0,1,0.0,1,3,0.3333333333333333,0.25,0,0,0.0
Timothé Luwawu-Cabarrot,luwawti01,SF,21,PHI,2017,69,1190.0,445,75,25,124,149,32,10,73,154,145,361,0.4016620498614958,50,161,0.3105590062111801,95,200,0.475,0.471,105,123,0.8536585365853658
Trey Lyles,lylestr01,PF,21,UTA,2017,71,1158.0,440,69,48,187,235,26,20,64,97,159,439,0.3621867881548975,65,204,0.3186274509803921,94,235,0.4,0.436,57,79,0.7215189873417721
Sheldon Mac,mcclesh01,SG,24,WAS,2017,30,287.0,90,15,4,30,34,8,2,5,17,30,75,0.4,7,30,0.2333333333333333,23,45,0.5111111111111111,0.447,23,27,0.8518518518518519
Shelvin Mack,macksh01,PG,26,UTA,2017,55,1205.0,430,154,20,105,125,42,3,90,100,170,381,0.4461942257217848,37,120,0.3083333333333333,133,261,0.5095785440613027,0.495,53,77,0.6883116883116883
Ian Mahinmi,mahinia01,C,30,WAS,2017,31,555.0,173,19,47,103,150,33,24,34,90,65,111,0.5855855855855856,0,0,0.0,65,111,0.5855855855855856,0.586,43,75,0.5733333333333334
Thon Maker,makerth01,C,19,MIL,2017,57,562.0,226,23,40,74,114,10,26,17,84,83,181,0.4585635359116022,28,74,0.3783783783783784,55,107,0.514018691588785,0.536,32,49,0.6530612244897959
Boban Marjanović,marjabo01,C,28,DET,2017,35,293.0,191,9,46,84,130,6,12,10,25,72,132,0.5454545454545454,0,0,0.0,72,132,0.5454545454545454,0.545,47,58,0.8103448275862069
Jarell Martin,martija01,PF,22,MEM,2017,42,558.0,165,8,42,120,162,17,9,28,91,58,151,0.3841059602649007,9,25,0.36,49,126,0.3888888888888889,0.414,40,50,0.8
Wesley Matthews,matthwe02,SG,30,DAL,2017,73,2495.0,986,210,18,241,259,77,15,102,161,333,847,0.3931523022432113,174,479,0.3632567849686847,159,368,0.4320652173913043,0.496,146,179,0.8156424581005587
Luc Mbah a Moute,mbahalu01,SF,30,LAC,2017,80,1787.0,484,39,44,126,170,81,35,46,122,191,378,0.5052910052910053,43,110,0.3909090909090909,148,268,0.5522388059701493,0.562,59,87,0.6781609195402298
James Michael McAdoo,mcadoja01,PF,24,GSW,2017,52,457.0,147,18,34,57,91,18,29,19,47,62,117,0.5299145299145299,2,8,0.25,60,109,0.5504587155963303,0.538,21,42,0.5
Patrick McCaw,mccawpa01,SG,21,GSW,2017,71,1074.0,282,77,21,79,100,32,15,36,62,106,245,0.4326530612244898,41,123,0.3333333333333333,65,122,0.5327868852459017,0.516,29,37,0.7837837837837838
CJ McCollum,mccolcj01,SG,25,POR,2017,80,2796.0,1837,285,60,229,289,72,42,172,202,692,1441,0.4802220680083275,185,439,0.4214123006833713,507,1002,0.5059880239520959,0.544,268,294,0.91156462585034
T.J. McConnell,mccontj01,PG,24,PHI,2017,81,2133.0,556,534,39,212,251,134,10,159,139,236,512,0.4609375,11,55,0.2,225,457,0.4923413566739606,0.472,73,90,0.8111111111111111
Chris McCullough,mcculch01,PF,21,TOT,2017,16,80.0,36,2,9,10,19,2,2,3,7,16,32,0.5,1,7,0.1428571428571428,15,25,0.6,0.516,3,5,0.6
K.J. McDaniels,mcdankj01,SF,23,TOT,2017,49,505.0,206,13,15,67,82,19,18,29,49,77,169,0.4556213017751479,20,66,0.303030303030303,57,103,0.5533980582524272,0.515,32,38,0.8421052631578947
Doug McDermott,mcderdo01,SF,25,TOT,2017,66,1508.0,592,58,20,159,179,13,5,38,79,222,497,0.4466800804828973,77,208,0.3701923076923077,145,289,0.5017301038062284,0.524,71,84,0.8452380952380952
JaVale McGee,mcgeeja01,C,29,GSW,2017,77,739.0,472,17,100,144,244,19,67,40,109,208,319,0.6520376175548589,0,3,0.0,208,316,0.6582278481012658,0.652,56,111,0.5045045045045045
Rodney McGruder,mcgruro01,SG,25,MIA,2017,78,1966.0,497,124,94,162,256,46,18,56,140,190,460,0.4130434782608695,73,220,0.3318181818181818,117,240,0.4875,0.492,44,71,0.6197183098591549
Ben McLemore,mclembe01,SG,23,SAC,2017,61,1176.0,495,51,19,110,129,29,6,62,108,180,419,0.4295942720763723,65,170,0.3823529411764705,115,249,0.4618473895582329,0.507,70,93,0.7526881720430108
Jordan McRae,mcraejo01,SG,25,CLE,2017,37,384.0,161,19,6,35,41,8,6,14,31,58,150,0.3866666666666666,18,51,0.3529411764705882,40,99,0.404040404040404,0.447,27,34,0.7941176470588235
Josh McRoberts,mcrobjo01,PF,29,MIA,2017,22,381.0,107,50,23,51,74,10,4,23,31,44,118,0.3728813559322034,13,31,0.4193548387096774,31,87,0.3563218390804598,0.428,6,9,0.6666666666666666
Jodie Meeks,meeksjo01,SG,29,ORL,2017,36,738.0,327,45,5,72,77,34,4,36,41,103,256,0.40234375,56,137,0.4087591240875912,47,119,0.3949579831932773,0.512,65,74,0.8783783783783784
Salah Mejri,mejrisa01,C,30,DAL,2017,73,905.0,213,14,97,211,308,32,61,40,152,88,137,0.6423357664233577,1,3,0.3333333333333333,87,134,0.6492537313432836,0.646,36,61,0.5901639344262295
Jordan Mickey,mickejo01,PF,22,BOS,2017,25,141.0,38,7,13,21,34,3,6,9,12,15,34,0.4411764705882353,0,1,0.0,15,33,0.4545454545454545,0.441,8,14,0.5714285714285714
Khris Middleton,middlkh01,SF,25,MIL,2017,29,889.0,426,99,11,112,123,41,7,65,79,150,333,0.4504504504504504,45,104,0.4326923076923077,105,229,0.4585152838427948,0.518,81,92,0.8804347826086957
C.J. Miles,milescj01,SF,29,IND,2017,76,1776.0,815,48,30,199,229,46,25,40,151,281,647,0.4343122102009273,169,409,0.4132029339853301,112,238,0.4705882352941176,0.565,84,93,0.9032258064516128
Mike Miller,millemi01,SF,36,DEN,2017,20,151.0,28,22,2,36,38,2,0,13,9,9,23,0.391304347826087,8,20,0.4,1,3,0.3333333333333333,0.565,2,2,1.0
Patty Mills,millspa02,PG,28,SAS,2017,80,1754.0,759,280,24,117,141,65,3,101,109,273,621,0.4396135265700483,147,355,0.4140845070422535,126,266,0.4736842105263157,0.558,66,80,0.825
Elijah Millsap,millsel01,SG,29,PHO,2017,2,23.0,3,1,3,3,6,0,0,2,2,1,7,0.1428571428571428,0,2,0.0,1,5,0.2,0.143,1,2,0.5
Paul Millsap,millspa01,PF,31,ATL,2017,69,2343.0,1246,252,111,422,533,90,62,158,186,430,972,0.4423868312757201,75,241,0.3112033195020747,355,731,0.4856361149110807,0.481,311,405,0.7679012345679013
Nikola Mirotić,mirotni01,PF,25,CHI,2017,70,1679.0,744,75,61,323,384,53,55,80,128,258,625,0.4128,129,377,0.3421750663129973,129,248,0.5201612903225806,0.516,99,128,0.7734375
Greg Monroe,monrogr01,C,26,MIL,2017,81,1823.0,951,187,167,365,532,92,38,140,168,387,726,0.5330578512396694,0,4,0.0,387,722,0.53601108033241,0.533,177,239,0.7405857740585774
E'Twaun Moore,mooreet01,SG,27,NOP,2017,73,1820.0,700,164,33,119,152,50,32,62,131,283,619,0.4571890145395799,77,208,0.3701923076923077,206,411,0.5012165450121655,0.519,57,74,0.7702702702702703
Marcus Morris,morrima03,SF,27,DET,2017,79,2565.0,1105,160,77,289,366,52,25,87,168,421,1007,0.4180734856007944,118,357,0.330532212885154,303,650,0.4661538461538461,0.477,145,185,0.7837837837837838
Markieff Morris,morrima02,PF,27,WAS,2017,76,2374.0,1063,126,107,386,493,82,42,129,254,406,889,0.4566929133858268,71,196,0.3622448979591837,335,693,0.4834054834054834,0.497,180,215,0.8372093023255814
Anthony Morrow,morroan01,SG,31,TOT,2017,49,714.0,271,25,12,19,31,24,2,6,44,98,252,0.3888888888888889,41,133,0.3082706766917293,57,119,0.4789915966386555,0.47,34,37,0.918918918918919
Donatas Motiejūnas,motiedo01,PF,26,NOP,2017,34,479.0,150,32,26,75,101,18,11,31,55,57,138,0.4130434782608695,11,47,0.2340425531914893,46,91,0.5054945054945055,0.453,25,49,0.5102040816326531
Timofey Mozgov,mozgoti01,C,30,LAL,2017,54,1104.0,401,43,104,160,264,16,31,72,133,169,328,0.5152439024390244,0,1,0.0,169,327,0.5168195718654435,0.515,63,78,0.8076923076923077
Emmanuel Mudiay,mudiaem01,PG,20,DEN,2017,55,1406.0,603,217,29,149,178,41,13,123,95,208,551,0.3774954627949183,56,178,0.3146067415730337,152,373,0.4075067024128686,0.428,131,167,0.7844311377245509
Shabazz Muhammad,muhamsh01,SF,24,MIN,2017,78,1516.0,772,35,84,136,220,22,6,56,86,288,598,0.4816053511705686,49,145,0.3379310344827586,239,453,0.5275938189845475,0.523,147,190,0.7736842105263158
Dejounte Murray,murrade01,PG,20,SAS,2017,38,322.0,130,48,6,36,42,8,6,38,29,50,116,0.4310344827586206,9,23,0.391304347826087,41,93,0.4408602150537634,0.47,21,30,0.7
Jamal Murray,murraja01,SG,19,DEN,2017,82,1764.0,811,170,41,173,214,51,24,113,124,295,730,0.4041095890410959,115,344,0.3343023255813953,180,386,0.466321243523316,0.483,106,120,0.8833333333333333
Mike Muscala,muscami01,C,25,ATL,2017,70,1237.0,435,95,76,164,240,30,41,55,97,170,337,0.5044510385756676,46,110,0.4181818181818181,124,227,0.5462555066079295,0.573,49,64,0.765625
Larry Nance Jr.,nancela02,PF,24,LAL,2017,63,1442.0,449,96,120,249,369,82,39,56,149,190,361,0.5263157894736842,10,36,0.2777777777777778,180,325,0.5538461538461539,0.54,59,80,0.7375
Shabazz Napier,napiesh01,PG,25,POR,2017,53,512.0,218,67,8,53,61,32,2,41,38,73,183,0.3989071038251366,34,92,0.3695652173913043,39,91,0.4285714285714285,0.492,38,49,0.7755102040816326
Maurice Ndour,ndourma01,PF,24,NYK,2017,32,331.0,98,8,22,42,64,15,8,12,30,39,86,0.4534883720930232,1,7,0.1428571428571428,38,79,0.4810126582278481,0.459,19,26,0.7307692307692307
Gary Neal,nealga01,SG,32,ATL,2017,2,18.0,4,1,0,1,1,0,0,0,1,0,7,0.0,0,2,0.0,0,5,0.0,0.0,4,4,1.0
Jameer Nelson,nelsoja01,PG,34,DEN,2017,75,2045.0,687,385,28,164,192,54,8,128,197,268,604,0.4437086092715231,106,273,0.3882783882783883,162,331,0.4894259818731117,0.531,45,63,0.7142857142857143
Raul Neto,netora01,PG,24,UTA,2017,40,346.0,100,34,4,26,30,21,5,15,48,41,91,0.4505494505494505,10,31,0.3225806451612903,31,60,0.5166666666666667,0.505,8,9,0.8888888888888888
Georges Niang,niangge01,PF,23,IND,2017,23,93.0,21,5,2,15,17,3,0,5,6,9,36,0.25,1,12,0.0833333333333333,8,24,0.3333333333333333,0.264,2,2,1.0
Andrew Nicholson,nichoan01,PF,27,TOT,2017,38,342.0,100,10,15,46,61,16,6,17,55,43,111,0.3873873873873873,5,27,0.1851851851851851,38,84,0.4523809523809524,0.41,9,14,0.6428571428571429
Joakim Noah,noahjo01,C,31,NYK,2017,46,1015.0,232,103,162,241,403,30,37,58,127,99,202,0.4900990099009901,0,1,0.0,99,201,0.4925373134328358,0.49,34,78,0.4358974358974359
Nerlens Noel,noelne01,C,22,TOT,2017,51,1047.0,445,50,93,201,294,65,50,51,126,184,309,0.5954692556634305,0,1,0.0,184,308,0.5974025974025974,0.595,77,111,0.6936936936936937
Lucas Nogueira,noguelu01,C,24,TOR,2017,57,1088.0,253,42,82,162,244,52,89,46,137,103,156,0.6602564102564102,3,12,0.25,100,144,0.6944444444444444,0.67,44,67,0.6567164179104478
Steve Novak,novakst01,PF,33,MIL,2017,8,22.0,5,0,0,3,3,0,0,0,1,2,7,0.2857142857142857,1,6,0.1666666666666666,1,1,1.0,0.357,0,0,0.0
Dirk Nowitzki,nowitdi01,PF,38,DAL,2017,54,1424.0,769,82,23,330,353,30,38,51,113,296,678,0.4365781710914454,79,209,0.3779904306220095,217,469,0.4626865671641791,0.495,98,112,0.875
Jusuf Nurkić,nurkiju01,C,22,TOT,2017,65,1391.0,662,123,154,313,467,50,74,143,161,271,534,0.5074906367041199,0,1,0.0,271,533,0.5084427767354597,0.507,120,210,0.5714285714285714
David Nwaba,nwabada01,SG,24,LAL,2017,20,397.0,120,14,17,46,63,13,7,11,36,47,81,0.5802469135802469,1,5,0.2,46,76,0.6052631578947368,0.586,25,39,0.6410256410256411
Johnny O'Bryant,obryajo01,PF,23,TOT,2017,11,80.0,38,6,9,10,19,0,1,6,10,15,30,0.5,3,6,0.5,12,24,0.5,0.55,5,6,0.8333333333333334
Kyle O'Quinn,oquinky01,C,26,NYK,2017,79,1229.0,496,117,157,282,439,36,104,76,174,215,413,0.5205811138014528,2,17,0.1176470588235294,213,396,0.5378787878787878,0.523,64,83,0.7710843373493976
Daniel Ochefu,ochefda01,C,23,WAS,2017,19,75.0,24,3,5,17,22,2,0,3,17,12,27,0.4444444444444444,0,0,0.0,12,27,0.4444444444444444,0.444,0,2,0.0
Jahlil Okafor,okafoja01,C,21,PHI,2017,50,1134.0,590,58,81,159,240,20,49,91,122,242,471,0.5138004246284501,0,0,0.0,242,471,0.5138004246284501,0.514,106,158,0.6708860759493671
Victor Oladipo,oladivi01,SG,24,OKC,2017,67,2222.0,1067,176,39,252,291,78,21,119,155,412,932,0.4420600858369098,127,352,0.3607954545454545,285,580,0.4913793103448275,0.51,116,154,0.7532467532467533
Kelly Olynyk,olynyke01,C,25,BOS,2017,75,1538.0,678,148,73,288,361,43,29,96,207,260,508,0.5118110236220472,68,192,0.3541666666666667,192,316,0.6075949367088608,0.579,90,123,0.7317073170731707
Arinze Onuaku,onuakar01,C,29,ORL,2017,8,28.0,4,2,2,4,6,0,1,2,3,2,4,0.5,0,0,0.0,2,4,0.5,0.5,0,0,0.0
Chinanu Onuaku,onuakch01,C,20,HOU,2017,5,52.0,14,3,2,8,10,3,1,4,6,5,7,0.7142857142857143,0,0,0.0,5,7,0.7142857142857143,0.714,4,4,1.0
Kelly Oubre Jr.,oubreke01,SF,21,WAS,2017,79,1605.0,501,47,61,200,261,58,17,50,195,186,442,0.420814479638009,54,188,0.2872340425531915,132,254,0.5196850393700787,0.482,75,99,0.7575757575757576
Zaza Pachulia,pachuza01,C,32,GSW,2017,70,1268.0,426,132,140,270,410,59,33,87,166,164,307,0.5342019543973942,0,2,0.0,164,305,0.5377049180327869,0.534,98,126,0.7777777777777778
Georgios Papagiannis,papagge01,C,19,SAC,2017,22,355.0,124,20,24,62,86,3,17,24,44,56,102,0.5490196078431373,0,2,0.0,56,100,0.56,0.549,12,14,0.8571428571428571
Jabari Parker,parkeja01,PF,21,MIL,2017,51,1728.0,1025,142,79,235,314,50,22,93,111,399,814,0.4901719901719901,65,178,0.3651685393258427,334,636,0.5251572327044025,0.53,162,218,0.7431192660550459
Tony Parker,parketo01,PG,34,SAS,2017,63,1587.0,638,285,9,104,113,34,2,89,92,265,569,0.4657293497363796,23,69,0.3333333333333333,242,500,0.484,0.486,85,117,0.7264957264957265
Chandler Parsons,parsoch01,SF,28,MEM,2017,34,675.0,210,55,6,78,84,20,5,24,52,75,222,0.3378378378378378,25,93,0.2688172043010752,50,129,0.3875968992248062,0.394,35,43,0.813953488372093
Lamar Patterson,pattela01,SG,25,ATL,2017,5,40.0,9,6,1,6,7,1,0,4,6,3,15,0.2,1,6,0.1666666666666666,2,9,0.2222222222222222,0.233,2,3,0.6666666666666666
Patrick Patterson,pattepa01,PF,27,TOR,2017,65,1599.0,445,76,62,231,293,40,23,38,120,154,384,0.4010416666666667,94,253,0.3715415019762846,60,131,0.4580152671755725,0.523,43,60,0.7166666666666667
Chris Paul,paulch01,PG,31,LAC,2017,61,1921.0,1104,563,40,264,304,119,8,147,146,374,785,0.4764331210191083,124,302,0.4105960264900662,250,483,0.5175983436853002,0.555,232,260,0.8923076923076924
Adreian Payne,paynead01,PF,25,MIN,2017,18,135.0,63,7,9,24,33,8,7,8,32,23,54,0.4259259259259259,3,15,0.2,20,39,0.5128205128205128,0.454,14,19,0.7368421052631579
Cameron Payne,payneca01,PG,22,TOT,2017,31,462.0,160,55,3,45,48,14,4,29,52,64,193,0.3316062176165803,27,86,0.313953488372093,37,107,0.3457943925233644,0.402,5,8,0.625
Elfrid Payton,paytoel01,PG,22,ORL,2017,82,2412.0,1046,529,89,298,387,88,40,178,177,430,912,0.4714912280701754,40,146,0.273972602739726,390,766,0.5091383812010444,0.493,146,211,0.6919431279620853
Gary Payton II,paytoga02,PG,24,MIL,2017,6,99.0,20,13,0,12,12,3,4,10,9,8,22,0.3636363636363636,1,9,0.1111111111111111,7,13,0.5384615384615384,0.386,3,5,0.6
Paul Pierce,piercpa01,SF,39,LAC,2017,25,277.0,81,10,1,47,48,4,5,16,40,28,70,0.4,15,43,0.3488372093023256,13,27,0.4814814814814814,0.507,10,13,0.7692307692307693
Marshall Plumlee,plumlma02,C,24,NYK,2017,21,170.0,40,10,23,28,51,4,4,12,23,16,30,0.5333333333333333,0,0,0.0,16,30,0.5333333333333333,0.533,8,19,0.4210526315789473
Mason Plumlee,plumlma01,C,26,TOT,2017,81,2148.0,842,284,170,435,605,69,92,134,226,334,623,0.536115569823435,0,6,0.0,334,617,0.5413290113452188,0.536,174,300,0.58
Miles Plumlee,plumlmi01,C,28,TOT,2017,45,484.0,113,21,38,57,95,18,13,30,73,44,92,0.4782608695652174,0,0,0.0,44,92,0.4782608695652174,0.478,25,39,0.6410256410256411
Jakob Poeltl,poeltja01,C,21,TOR,2017,54,626.0,165,12,78,87,165,17,20,29,113,67,115,0.5826086956521739,0,0,0.0,67,115,0.5826086956521739,0.583,31,57,0.543859649122807
Otto Porter Jr.,porteot01,SF,23,WAS,2017,80,2605.0,1075,121,118,396,514,116,42,44,193,414,803,0.5155666251556662,148,341,0.4340175953079179,266,462,0.5757575757575758,0.608,99,119,0.8319327731092437
Bobby Portis,portibo01,PF,21,CHI,2017,64,1000.0,437,35,75,221,296,16,11,37,94,183,375,0.488,32,96,0.3333333333333333,151,279,0.5412186379928315,0.531,39,59,0.6610169491525424
Kristaps Porziņģis,porzikr01,PF,21,NYK,2017,66,2164.0,1196,97,111,364,475,47,129,118,244,443,985,0.449746192893401,112,314,0.3566878980891719,331,671,0.4932935916542474,0.507,198,252,0.7857142857142857
Dwight Powell,poweldw01,C,25,DAL,2017,77,1333.0,516,49,93,213,306,61,39,34,135,194,377,0.5145888594164456,21,74,0.2837837837837837,173,303,0.570957095709571,0.542,107,141,0.7588652482269503
Norman Powell,powelno01,SG,23,TOR,2017,76,1368.0,636,82,26,143,169,52,14,70,127,227,506,0.4486166007905138,56,173,0.3236994219653179,171,333,0.5135135135135135,0.504,126,159,0.7924528301886793
Alex Poythress,poythal01,PF,23,PHI,2017,6,157.0,64,5,11,18,29,3,2,3,14,25,54,0.4629629629629629,6,19,0.3157894736842105,19,35,0.5428571428571428,0.519,8,10,0.8
Ronnie Price,pricero01,PG,33,PHO,2017,14,134.0,14,18,3,8,11,11,1,3,14,4,24,0.1666666666666666,3,17,0.1764705882352941,1,7,0.1428571428571428,0.229,3,4,0.75
Taurean Prince,princta02,SF,22,ATL,2017,59,981.0,335,55,25,132,157,43,27,61,96,114,285,0.4,33,102,0.3235294117647059,81,183,0.4426229508196721,0.458,74,94,0.7872340425531915
Tim Quarterman,quartti01,SG,22,POR,2017,16,80.0,31,11,4,10,14,2,3,11,6,13,29,0.4482758620689655,5,13,0.3846153846153846,8,16,0.5,0.534,0,3,0.0
Chasson Randle,randlch01,PG,23,TOT,2017,26,299.0,137,34,6,26,32,9,2,19,39,40,98,0.4081632653061224,16,47,0.3404255319148936,24,51,0.4705882352941176,0.49,41,43,0.9534883720930232
Julius Randle,randlju01,PF,22,LAL,2017,74,2132.0,975,264,150,486,636,49,37,173,248,377,773,0.4877102199223803,17,63,0.2698412698412698,360,710,0.5070422535211268,0.499,204,282,0.723404255319149
Zach Randolph,randoza01,PF,35,MEM,2017,73,1786.0,1028,122,182,416,598,38,10,99,136,433,964,0.4491701244813278,21,94,0.2234042553191489,412,870,0.4735632183908046,0.46,141,193,0.7305699481865285
J.J. Redick,redicjj01,SG,32,LAC,2017,78,2198.0,1173,110,11,160,171,54,13,98,125,396,890,0.4449438202247191,201,468,0.4294871794871794,195,422,0.462085308056872,0.558,180,202,0.8910891089108911
Willie Reed,reedwi02,C,26,MIA,2017,71,1031.0,374,26,129,203,332,18,47,31,137,162,285,0.5684210526315789,1,4,0.25,161,281,0.5729537366548043,0.57,49,88,0.5568181818181818
Josh Richardson,richajo01,SG,23,MIA,2017,53,1614.0,539,140,35,133,168,60,39,65,132,202,513,0.3937621832358674,75,227,0.3303964757709251,127,286,0.444055944055944,0.467,60,77,0.7792207792207793
Malachi Richardson,richama01,SG,21,SAC,2017,22,198.0,79,11,3,20,23,5,1,8,23,28,68,0.4117647058823529,8,28,0.2857142857142857,20,40,0.5,0.471,15,19,0.7894736842105263
Austin Rivers,riverau01,SG,24,LAC,2017,74,2054.0,889,204,20,141,161,48,10,115,187,323,731,0.4418604651162791,111,299,0.3712374581939799,212,432,0.4907407407407407,0.518,132,191,0.6910994764397905
Andre Roberson,roberan03,SF,25,OKC,2017,79,2376.0,522,79,98,305,403,94,79,51,204,215,463,0.4643628509719222,45,184,0.2445652173913043,170,279,0.6093189964157706,0.513,47,111,0.4234234234234234
Brian Roberts,roberbr01,PG,31,CHO,2017,41,416.0,142,52,5,34,39,9,1,26,18,46,122,0.3770491803278688,17,44,0.3863636363636363,29,78,0.3717948717948718,0.447,33,39,0.8461538461538461
Glenn Robinson III,robingl02,SF,23,IND,2017,69,1427.0,419,47,57,189,246,41,20,37,63,158,338,0.4674556213017751,49,125,0.392,109,213,0.5117370892018779,0.54,54,76,0.7105263157894737
Thomas Robinson,robinth01,PF,25,LAL,2017,48,560.0,241,31,84,139,223,26,9,46,76,105,196,0.5357142857142857,0,1,0.0,105,195,0.5384615384615384,0.536,31,66,0.4696969696969697
Sergio Rodríguez,rodrise01,PG,30,PHI,2017,68,1518.0,530,344,21,136,157,49,4,128,95,210,536,0.3917910447761194,92,252,0.365079365079365,118,284,0.4154929577464789,0.478,18,27,0.6666666666666666
Rajon Rondo,rondora01,PG,30,CHI,2017,69,1843.0,538,461,73,282,355,99,11,169,144,229,561,0.4081996434937611,50,133,0.3759398496240601,179,428,0.4182242990654206,0.453,30,50,0.6
Derrick Rose,rosede01,PG,28,NYK,2017,64,2082.0,1154,283,66,180,246,44,17,147,84,460,977,0.4708290685772773,13,60,0.2166666666666666,447,917,0.4874591057797164,0.477,221,253,0.8735177865612648
Terrence Ross,rosste01,SF,25,TOT,2017,78,1955.0,858,88,18,188,206,87,33,68,143,326,746,0.4369973190348525,142,391,0.3631713554987212,184,355,0.5183098591549296,0.532,64,77,0.8311688311688312
Terry Rozier,roziete01,PG,22,BOS,2017,74,1263.0,410,131,40,187,227,46,11,47,69,151,411,0.3673965936739659,57,179,0.3184357541899441,94,232,0.4051724137931034,0.437,51,66,0.7727272727272727
Ricky Rubio,rubiori01,PG,26,MIN,2017,75,2469.0,836,682,68,237,305,128,10,195,202,261,650,0.4015384615384615,60,196,0.3061224489795918,201,454,0.4427312775330396,0.448,254,285,0.8912280701754386
Damjan Rudež,rudezda01,SF,30,ORL,2017,45,314.0,82,20,5,20,25,12,1,9,31,31,88,0.3522727272727273,20,64,0.3125,11,24,0.4583333333333333,0.466,0,0,0.0
Brandon Rush,rushbr01,SG,31,MIN,2017,47,1030.0,197,45,16,83,99,22,23,28,42,70,187,0.374331550802139,44,114,0.3859649122807017,26,73,0.3561643835616438,0.492,13,18,0.7222222222222222
D'Angelo Russell,russeda01,PG,20,LAL,2017,63,1811.0,984,303,31,190,221,87,16,176,130,351,867,0.4048442906574394,135,384,0.3515625,216,483,0.4472049689440994,0.483,147,188,0.7819148936170213
Domantas Sabonis,sabondo01,PF,20,OKC,2017,81,1632.0,479,82,46,242,288,39,32,83,200,192,481,0.3991683991683992,51,159,0.320754716981132,141,322,0.4378881987577639,0.452,44,67,0.6567164179104478
Larry Sanders,sandela01,C,28,CLE,2017,5,13.0,4,0,3,1,4,1,1,2,5,1,4,0.25,0,0,0.0,1,4,0.25,0.25,2,2,1.0
Dario Šarić,saricda01,PF,22,PHI,2017,81,2129.0,1040,182,112,401,513,57,30,183,162,381,927,0.4110032362459547,106,341,0.3108504398826979,275,586,0.4692832764505119,0.468,172,220,0.7818181818181819
Tomáš Satoranský,satorto01,SG,25,WAS,2017,57,719.0,154,92,25,58,83,26,6,38,60,61,147,0.4149659863945578,9,37,0.2432432432432432,52,110,0.4727272727272727,0.446,23,33,0.696969696969697
Dennis Schröder,schrode01,PG,23,ATL,2017,79,2485.0,1414,499,42,206,248,74,16,258,149,548,1214,0.4514003294892916,100,294,0.3401360544217687,448,920,0.4869565217391304,0.493,218,255,0.8549019607843137
Luis Scola,scolalu01,PF,36,BRK,2017,36,461.0,184,37,51,88,139,14,4,34,63,71,151,0.4701986754966887,17,50,0.34,54,101,0.5346534653465347,0.526,25,37,0.6756756756756757
Mike Scott,scottmi01,PF,28,ATL,2017,18,195.0,45,17,10,27,37,4,3,8,12,17,59,0.288135593220339,4,27,0.1481481481481481,13,32,0.40625,0.322,7,8,0.875
Thabo Sefolosha,sefolth01,SF,32,ATL,2017,62,1596.0,444,107,54,216,270,96,31,58,97,174,395,0.440506329113924,41,120,0.3416666666666667,133,275,0.4836363636363636,0.492,55,75,0.7333333333333333
Wayne Selden,seldewa01,SG,22,TOT,2017,14,236.0,71,13,1,15,16,6,1,12,18,25,58,0.4310344827586206,7,28,0.25,18,30,0.6,0.491,14,22,0.6363636363636364
Kevin Séraphin,serapke01,PF,27,IND,2017,49,559.0,232,23,41,101,142,7,20,29,66,109,198,0.5505050505050505,0,2,0.0,109,196,0.5561224489795918,0.551,14,22,0.6363636363636364
Ramon Sessions,sessira01,PG,30,CHO,2017,50,811.0,312,129,11,62,73,27,3,46,43,100,263,0.3802281368821292,21,62,0.3387096774193548,79,201,0.3930348258706467,0.42,91,118,0.7711864406779662
Iman Shumpert,shumpim01,SG,26,CLE,2017,76,1937.0,567,109,39,179,218,62,27,78,150,201,489,0.4110429447852761,94,261,0.3601532567049808,107,228,0.4692982456140351,0.507,71,90,0.7888888888888889
Pascal Siakam,siakapa01,PF,22,TOR,2017,55,859.0,229,17,64,121,185,26,45,33,109,103,205,0.5024390243902439,1,7,0.1428571428571428,102,198,0.5151515151515151,0.505,22,32,0.6875
Jonathon Simmons,simmojo02,SG,27,SAS,2017,78,1392.0,483,126,20,140,160,47,25,76,146,177,421,0.4204275534441805,30,102,0.2941176470588235,147,319,0.4608150470219436,0.456,99,132,0.75
Kyle Singler,singlky01,SF,28,OKC,2017,32,385.0,88,9,8,40,48,7,5,11,29,34,83,0.4096385542168674,7,37,0.1891891891891892,27,46,0.5869565217391305,0.452,13,17,0.7647058823529411
Marcus Smart,smartma01,SG,22,BOS,2017,79,2399.0,835,364,78,227,305,125,34,159,192,269,749,0.3591455273698264,94,332,0.2831325301204819,175,417,0.4196642685851319,0.422,203,250,0.812
Ish Smith,smithis01,PG,28,DET,2017,81,1955.0,758,418,21,214,235,61,33,112,127,329,749,0.4392523364485981,28,105,0.2666666666666666,301,644,0.4673913043478261,0.458,72,102,0.7058823529411765
J.R. Smith,smithjr01,SG,31,CLE,2017,41,1187.0,351,62,17,96,113,40,11,26,77,123,356,0.3455056179775281,95,271,0.3505535055350554,28,85,0.3294117647058823,0.479,10,15,0.6666666666666666
Jason Smith,smithja02,C,30,WAS,2017,74,1068.0,420,37,64,194,258,21,54,58,168,174,329,0.5288753799392097,37,78,0.4743589743589743,137,251,0.545816733067729,0.585,35,51,0.6862745098039216
Tony Snell,snellto01,SG,25,MIL,2017,80,2336.0,683,96,22,226,248,55,14,55,125,246,541,0.454713493530499,144,355,0.4056338028169014,102,186,0.5483870967741935,0.588,47,58,0.8103448275862069
Marreese Speights,speigma01,C,29,LAC,2017,82,1286.0,711,65,88,285,373,23,41,69,229,244,548,0.4452554744525547,103,277,0.371841155234657,141,271,0.5202952029520295,0.539,120,137,0.8759124087591241
Tiago Splitter,splitti01,C,32,PHI,2017,8,76.0,39,4,8,14,22,1,1,6,8,14,31,0.4516129032258064,2,6,0.3333333333333333,12,25,0.48,0.484,9,11,0.8181818181818182
Nik Stauskas,stausni01,SG,23,PHI,2017,80,2188.0,756,188,21,205,226,45,32,128,144,251,634,0.3958990536277602,132,359,0.3676880222841225,119,275,0.4327272727272727,0.5,122,150,0.8133333333333334
Lance Stephenson,stephla01,SG,26,TOT,2017,18,361.0,122,59,4,48,52,5,3,26,32,54,120,0.45,6,20,0.3,48,100,0.48,0.475,8,13,0.6153846153846154
Jarnell Stokes,stokeja01,C,23,DEN,2017,2,7.0,3,2,1,1,2,1,0,0,3,1,1,1.0,0,0,0.0,1,1,1.0,1.0,1,2,0.5
Diamond Stone,stonedi01,C,19,LAC,2017,7,24.0,10,0,1,5,6,0,1,2,5,3,13,0.2307692307692307,0,0,0.0,3,13,0.2307692307692307,0.231,4,4,1.0
Rodney Stuckey,stuckro01,PG,30,IND,2017,39,696.0,281,84,6,78,84,16,0,53,44,91,244,0.3729508196721312,19,60,0.3166666666666666,72,184,0.391304347826087,0.412,80,107,0.7476635514018691
Jared Sullinger,sullija01,PF,24,TOR,2017,11,118.0,37,3,10,17,27,4,1,4,17,15,47,0.3191489361702128,3,18,0.1666666666666666,12,29,0.4137931034482758,0.351,4,8,0.5
Edy Tavares,tavarwa01,C,24,TOT,2017,2,28.0,8,1,4,7,11,0,6,2,3,4,5,0.8,0,0,0.0,4,5,0.8,0.8,0,3,0.0
Isaiah Taylor,taylois01,PG,22,HOU,2017,4,52.0,3,3,1,2,3,1,1,0,6,1,7,0.1428571428571428,0,2,0.0,1,5,0.2,0.143,1,2,0.5
Jeff Teague,teaguje01,PG,28,IND,2017,82,2657.0,1254,639,33,297,330,100,32,216,165,402,909,0.4422442244224422,90,252,0.3571428571428571,312,657,0.4748858447488584,0.492,360,415,0.8674698795180723
Mirza Teletović,teletmi01,PF,31,MIL,2017,70,1133.0,451,48,11,151,162,12,13,37,109,156,418,0.3732057416267942,104,305,0.340983606557377,52,113,0.4601769911504424,0.498,35,45,0.7777777777777778
Garrett Temple,templga01,SG,30,SAC,2017,65,1728.0,506,168,32,152,184,84,28,78,141,183,432,0.4236111111111111,82,220,0.3727272727272727,101,212,0.4764150943396226,0.519,58,74,0.7837837837837838
Jason Terry,terryja01,SG,39,MIL,2017,74,1365.0,307,98,15,91,106,46,20,36,95,105,243,0.4320987654320987,73,171,0.4269005847953216,32,72,0.4444444444444444,0.582,24,29,0.8275862068965517
Isaiah Thomas,thomais02,PG,27,BOS,2017,76,2569.0,2199,448,43,162,205,70,13,210,167,682,1473,0.4630006788866259,245,646,0.3792569659442724,437,827,0.528415961305925,0.546,590,649,0.9090909090909092
Lance Thomas,thomala01,PF,28,NYK,2017,46,968.0,275,35,32,110,142,21,5,25,85,97,244,0.3975409836065574,38,85,0.4470588235294118,59,159,0.3710691823899371,0.475,43,51,0.8431372549019608
Hollis Thompson,thompho01,SG,25,TOT,2017,40,752.0,205,35,19,93,112,20,6,11,69,77,200,0.385,32,95,0.3368421052631579,45,105,0.4285714285714285,0.465,19,29,0.6551724137931034
Klay Thompson,thompkl01,SG,26,GSW,2017,78,2649.0,1742,160,49,236,285,66,40,128,139,644,1376,0.4680232558139535,268,647,0.4142194744976816,376,729,0.5157750342935528,0.565,186,218,0.8532110091743119
Tristan Thompson,thomptr01,C,25,CLE,2017,78,2336.0,630,77,286,429,715,39,84,64,176,262,437,0.5995423340961098,0,3,0.0,262,434,0.6036866359447005,0.6,106,213,0.4976525821596244
Marcus Thornton,thornma01,SG,29,WAS,2017,33,575.0,219,41,22,54,76,19,3,25,48,84,210,0.4,28,80,0.35,56,130,0.4307692307692308,0.467,23,27,0.8518518518518519
Mike Tobey,tobeymi01,C,22,CHO,2017,2,25.0,2,1,2,1,3,0,0,1,2,1,4,0.25,0,0,0.0,1,4,0.25,0.25,0,0,0.0
Anthony Tolliver,tollian01,PF,31,SAC,2017,65,1477.0,461,77,51,186,237,34,20,56,109,155,351,0.4415954415954416,90,230,0.391304347826087,65,121,0.5371900826446281,0.57,61,82,0.7439024390243902
Axel Toupane,toupaax01,SF,24,TOT,2017,4,47.0,11,0,0,1,1,1,1,0,6,5,9,0.5555555555555556,1,4,0.25,4,5,0.8,0.611,0,0,0.0
Karl-Anthony Towns,townska01,C,21,MIN,2017,82,3030.0,2061,220,296,711,1007,56,103,212,241,802,1480,0.5418918918918919,101,275,0.3672727272727272,701,1205,0.5817427385892117,0.576,356,428,0.8317757009345794
P.J. Tucker,tuckepj01,SF,31,TOT,2017,81,2236.0,540,99,117,354,471,116,19,66,196,199,482,0.412863070539419,70,196,0.3571428571428571,129,286,0.451048951048951,0.485,72,93,0.7741935483870968
Evan Turner,turneev01,SF,28,POR,2017,65,1658.0,586,205,36,211,247,53,24,100,121,235,552,0.4257246376811594,31,118,0.2627118644067797,204,434,0.4700460829493088,0.454,85,103,0.8252427184466019
Myles Turner,turnemy01,C,20,IND,2017,81,2541.0,1173,106,139,450,589,74,172,105,262,444,869,0.5109321058688148,40,115,0.3478260869565217,404,754,0.5358090185676393,0.534,245,303,0.8085808580858086
Beno Udrih,udrihbe01,PG,34,DET,2017,39,560.0,227,131,6,51,57,13,0,36,29,92,197,0.467005076142132,11,32,0.34375,81,165,0.4909090909090909,0.495,32,34,0.9411764705882352
Tyler Ulis,ulisty01,PG,21,PHO,2017,61,1123.0,444,226,20,75,95,48,5,77,73,184,437,0.4210526315789473,21,79,0.2658227848101265,163,358,0.4553072625698324,0.445,55,71,0.7746478873239436
Jarrod Uthoff,uthofja01,PF,23,DAL,2017,9,115.0,40,9,8,14,22,2,4,3,8,16,38,0.4210526315789473,3,9,0.3333333333333333,13,29,0.4482758620689655,0.461,5,7,0.7142857142857143
Jonas Valančiūnas,valanjo01,C,24,TOR,2017,80,2066.0,959,57,226,533,759,37,63,106,216,391,702,0.5569800569800569,1,2,0.5,390,700,0.5571428571428572,0.558,176,217,0.8110599078341014
Denzel Valentine,valende01,SG,23,CHI,2017,57,976.0,291,63,11,140,151,30,7,49,86,102,288,0.3541666666666667,73,208,0.3509615384615384,29,80,0.3625,0.481,14,18,0.7777777777777778
Fred VanVleet,vanvlfr01,PG,22,TOR,2017,37,294.0,107,35,4,38,42,16,3,15,36,39,111,0.3513513513513513,11,29,0.3793103448275862,28,82,0.3414634146341463,0.401,18,22,0.8181818181818182
Anderson Varejão,varejan01,C,34,GSW,2017,14,92.0,18,10,12,15,27,3,3,8,16,5,14,0.3571428571428571,0,0,0.0,5,14,0.3571428571428571,0.357,8,11,0.7272727272727273
Greivis Vásquez,vasqugr01,PG,30,BRK,2017,3,39.0,7,5,0,2,2,1,1,1,6,2,8,0.25,1,3,0.3333333333333333,1,5,0.2,0.313,2,3,0.6666666666666666
Rashad Vaughn,vaughra01,SG,20,MIL,2017,41,458.0,142,23,4,45,49,19,10,14,32,57,156,0.3653846153846153,26,81,0.3209876543209876,31,75,0.4133333333333333,0.449,2,5,0.4
Noah Vonleh,vonleno01,PF,21,POR,2017,74,1265.0,327,31,131,256,387,30,27,64,154,130,270,0.4814814814814814,7,20,0.35,123,250,0.492,0.494,60,94,0.6382978723404256
Nikola Vučević,vucevni01,C,26,ORL,2017,75,2163.0,1096,208,176,603,779,76,74,117,180,483,1031,0.4684772065955383,23,75,0.3066666666666666,460,956,0.4811715481171548,0.48,107,160,0.66875
Sasha Vujačić,vujacsa01,SG,32,NYK,2017,42,408.0,124,52,12,47,59,13,2,16,38,42,136,0.3088235294117647,23,74,0.3108108108108108,19,62,0.3064516129032258,0.393,17,24,0.7083333333333334
Dwyane Wade,wadedw01,SG,35,CHI,2017,60,1792.0,1096,228,63,207,270,86,41,138,112,414,955,0.4335078534031413,45,145,0.3103448275862069,369,810,0.4555555555555555,0.457,223,281,0.7935943060498221
Dion Waiters,waitedi01,SG,25,MIA,2017,46,1384.0,729,200,18,135,153,42,20,103,95,281,663,0.4238310708898944,85,215,0.3953488372093023,196,448,0.4375,0.488,82,127,0.6456692913385826
Kemba Walker,walkeke02,PG,26,CHO,2017,79,2739.0,1830,434,45,263,308,85,22,168,119,643,1449,0.4437543133195307,240,602,0.3986710963455149,403,847,0.4757969303423849,0.527,304,359,0.8467966573816156
John Wall,walljo01,PG,26,WAS,2017,78,2836.0,1805,831,59,267,326,157,49,322,151,647,1435,0.4508710801393728,89,272,0.3272058823529412,558,1163,0.4797936371453138,0.482,422,527,0.8007590132827325
T.J. Warren,warretj01,SF,23,PHO,2017,66,2048.0,951,75,125,214,339,76,39,57,175,403,814,0.4950859950859951,26,98,0.2653061224489796,377,716,0.526536312849162,0.511,119,154,0.7727272727272727
C.J. Watson,watsocj01,PG,32,ORL,2017,62,1012.0,281,114,16,73,89,43,2,47,84,96,248,0.3870967741935484,32,105,0.3047619047619048,64,143,0.4475524475524475,0.452,57,66,0.8636363636363636
Briante Weber,weberbr01,PG,24,TOT,2017,20,205.0,62,21,8,18,26,12,1,8,16,25,60,0.4166666666666667,1,10,0.1,24,50,0.48,0.425,11,16,0.6875
David West,westda01,C,36,GSW,2017,68,854.0,316,151,47,156,203,42,48,78,105,135,252,0.5357142857142857,3,8,0.375,132,244,0.5409836065573771,0.542,43,56,0.7678571428571429
Russell Westbrook,westbru01,PG,28,OKC,2017,81,2802.0,2558,840,137,727,864,132,31,438,190,824,1941,0.4245234415249871,200,583,0.3430531732418524,624,1358,0.4594992636229749,0.476,710,840,0.8452380952380952
Okaro White,whiteok01,PF,24,MIA,2017,35,471.0,98,21,25,57,82,10,10,18,52,33,87,0.3793103448275862,12,34,0.3529411764705882,21,53,0.3962264150943396,0.448,20,22,0.9090909090909092
Isaiah Whitehead,whiteis01,PG,21,BRK,2017,73,1643.0,543,192,32,152,184,42,36,142,175,204,508,0.4015748031496063,44,149,0.2953020134228188,160,359,0.4456824512534819,0.445,91,113,0.8053097345132744
Hassan Whiteside,whiteha01,C,27,MIA,2017,77,2513.0,1309,57,293,795,1088,57,161,154,226,542,973,0.5570400822199383,0,0,0.0,542,973,0.5570400822199383,0.557,225,358,0.6284916201117319
Andrew Wiggins,wiggian01,SF,21,MIN,2017,82,3048.0,1933,189,102,226,328,82,30,187,183,709,1570,0.4515923566878981,103,289,0.356401384083045,606,1281,0.4730679156908665,0.484,412,542,0.7601476014760148
C.J. Wilcox,wilcocj01,SG,26,ORL,2017,22,108.0,21,12,4,8,12,2,1,6,8,8,31,0.2580645161290322,3,15,0.2,5,16,0.3125,0.306,2,2,1.0
Alan Williams,willial03,C,24,PHO,2017,47,708.0,346,23,94,198,292,27,32,37,125,138,267,0.5168539325842697,0,1,0.0,138,266,0.518796992481203,0.517,70,112,0.625
Deron Williams,willide01,PG,32,TOT,2017,64,1657.0,701,360,14,133,147,31,8,138,138,263,600,0.4383333333333333,85,234,0.3632478632478632,178,366,0.4863387978142076,0.509,90,109,0.8256880733944955
Derrick Williams,willide02,PF,25,TOT,2017,50,804.0,304,28,19,111,130,14,7,28,60,108,244,0.4426229508196721,30,97,0.3092783505154639,78,147,0.5306122448979592,0.504,58,89,0.651685393258427
Lou Williams,willilo02,SG,30,TOT,2017,81,1994.0,1421,239,26,176,202,80,20,160,92,428,998,0.4288577154308617,163,446,0.3654708520179372,265,552,0.4800724637681159,0.511,402,457,0.8796498905908097
Marvin Williams,willima02,PF,30,CHO,2017,76,2295.0,849,106,89,411,500,58,53,60,134,297,704,0.421875,124,354,0.3502824858757062,173,350,0.4942857142857143,0.51,131,150,0.8733333333333333
Reggie Williams,willire02,SF,30,NOP,2017,6,79.0,27,4,2,4,6,3,0,0,2,8,23,0.3478260869565217,5,11,0.4545454545454545,3,12,0.25,0.457,6,7,0.8571428571428571
Troy Williams,willitr02,SF,22,TOT,2017,30,557.0,185,25,15,54,69,27,10,32,60,73,167,0.437125748502994,18,62,0.2903225806451613,55,105,0.5238095238095238,0.491,21,32,0.65625
Kyle Wiltjer,wiltjky01,PF,24,HOU,2017,14,44.0,13,2,4,6,10,3,1,5,4,4,14,0.2857142857142857,4,13,0.3076923076923077,0,1,0.0,0.429,1,2,0.5
Justise Winslow,winslju01,SF,20,MIA,2017,18,625.0,196,66,23,71,94,26,6,33,52,80,225,0.3555555555555555,7,35,0.2,73,190,0.3842105263157894,0.371,29,47,0.6170212765957447
Jeff Withey,witheje01,C,26,UTA,2017,51,432.0,146,7,52,69,121,16,32,14,52,55,103,0.5339805825242718,0,1,0.0,55,102,0.5392156862745098,0.534,36,48,0.75
Christian Wood,woodch01,PF,21,CHO,2017,13,107.0,35,2,14,15,29,3,6,7,11,12,23,0.5217391304347826,0,5,0.0,12,18,0.6666666666666666,0.522,11,15,0.7333333333333333
Metta World Peace,artesro01,SF,37,LAL,2017,25,160.0,57,11,5,15,20,10,2,7,18,19,68,0.2794117647058823,9,38,0.2368421052631578,10,30,0.3333333333333333,0.346,10,16,0.625
Brandan Wright,wrighbr03,PF,29,MEM,2017,28,447.0,189,15,31,47,78,11,20,10,42,83,135,0.6148148148148148,0,1,0.0,83,134,0.6194029850746269,0.615,23,35,0.6571428571428571
Delon Wright,wrighde01,PG,24,TOR,2017,27,446.0,150,57,16,32,48,27,11,25,31,49,116,0.4224137931034483,10,30,0.3333333333333333,39,86,0.4534883720930232,0.466,42,55,0.7636363636363637
James Young,youngja01,SG,21,BOS,2017,29,220.0,68,4,6,20,26,10,2,4,15,25,58,0.4310344827586206,12,35,0.3428571428571428,13,23,0.5652173913043478,0.534,6,9,0.6666666666666666
Joe Young,youngjo01,PG,24,IND,2017,33,135.0,68,15,1,16,17,4,0,5,5,26,72,0.3611111111111111,5,23,0.217391304347826,21,49,0.4285714285714285,0.396,11,15,0.7333333333333333
Nick Young,youngni01,SG,31,LAL,2017,60,1556.0,791,58,25,113,138,37,14,36,137,272,633,0.4296998420221169,170,421,0.4038004750593824,102,212,0.4811320754716981,0.564,77,90,0.8555555555555555
Thaddeus Young,youngth01,PF,28,IND,2017,74,2237.0,814,122,131,317,448,113,29,95,135,362,687,0.5269286754002911,45,118,0.3813559322033898,317,569,0.5571177504393673,0.56,45,86,0.5232558139534884
Cody Zeller,zelleco01,C,24,CHO,2017,62,1725.0,639,99,135,270,405,62,58,65,189,253,443,0.5711060948081265,0,1,0.0,253,442,0.5723981900452488,0.571,133,196,0.6785714285714286
Tyler Zeller,zellety01,C,27,BOS,2017,51,525.0,178,42,43,81,124,7,21,20,61,78,158,0.4936708860759494,0,1,0.0,78,157,0.4968152866242038,0.494,22,39,0.5641025641025641
Stephen Zimmerman,zimmest01,C,20,ORL,2017,19,108.0,23,4,11,24,35,2,5,3,17,10,31,0.3225806451612903,0,0,0.0,10,31,0.3225806451612903,0.323,3,5,0.6
Paul Zipser,zipsepa01,SF,22,CHI,2017,44,843.0,240,36,15,110,125,15,16,40,78,88,221,0.3981900452488687,33,99,0.3333333333333333,55,122,0.4508196721311475,0.473,31,40,0.775
Ivica Zubac,zubaciv01,C,19,LAL,2017,38,609.0,284,30,41,118,159,14,33,30,66,126,238,0.5294117647058824,0,3,0.0,126,235,0.5361702127659574,0.529,32,49,0.6530612244897959
Álex Abrines,abrinal01,SG,24,OKC,2018,75,1134.0,353,28,26,88,114,38,8,25,124,115,291,0.3951890034364261,84,221,0.3800904977375565,31,70,0.4428571428571428,0.54,39,46,0.8478260869565217
Quincy Acy,acyqu01,PF,27,BRK,2018,70,1359.0,411,57,40,217,257,33,29,60,149,130,365,0.3561643835616438,102,292,0.3493150684931507,28,73,0.3835616438356164,0.496,49,60,0.8166666666666667
Steven Adams,adamsst01,C,24,OKC,2018,76,2487.0,1056,88,384,301,685,92,78,128,215,448,712,0.6292134831460674,0,2,0.0,448,710,0.6309859154929578,0.629,160,286,0.5594405594405595
Bam Adebayo,adebaba01,C,20,MIA,2018,69,1368.0,477,101,118,263,381,32,41,66,138,174,340,0.5117647058823529,0,7,0.0,174,333,0.5225225225225225,0.512,129,179,0.7206703910614525
Arron Afflalo,afflaar01,SG,32,ORL,2018,53,682.0,179,30,4,62,66,4,9,21,56,65,162,0.4012345679012346,27,70,0.3857142857142857,38,92,0.4130434782608695,0.485,22,26,0.8461538461538461
Cole Aldrich,aldrico01,C,29,MIN,2018,21,49.0,12,3,3,12,15,2,1,1,11,5,15,0.3333333333333333,0,0,0.0,5,15,0.3333333333333333,0.333,2,6,0.3333333333333333
LaMarcus Aldridge,aldrila01,C,32,SAS,2018,75,2509.0,1735,152,246,389,635,43,90,111,161,687,1347,0.5100222717149221,27,92,0.2934782608695652,660,1255,0.5258964143426295,0.52,334,399,0.8370927318295739
Jarrett Allen,allenja01,C,19,BRK,2018,72,1441.0,587,49,144,244,388,28,88,82,147,234,397,0.5894206549118388,5,15,0.3333333333333333,229,382,0.599476439790576,0.596,114,147,0.7755102040816326
Kadeem Allen,allenka01,PG,25,BOS,2018,18,107.0,19,12,4,7,11,3,2,9,15,6,22,0.2727272727272727,0,11,0.0,6,11,0.5454545454545454,0.273,7,9,0.7777777777777778
Tony Allen,allento01,SF,36,NOP,2018,22,273.0,103,9,20,27,47,11,3,19,49,44,91,0.4835164835164835,4,12,0.3333333333333333,40,79,0.5063291139240507,0.505,11,21,0.5238095238095238
Al-Farouq Aminu,aminual01,PF,27,POR,2018,69,2072.0,644,84,97,428,525,79,40,79,136,230,582,0.3951890034364261,125,339,0.3687315634218289,105,243,0.4320987654320987,0.503,59,80,0.7375
Justin Anderson,anderju01,SF,24,PHI,2018,38,519.0,236,25,25,68,93,15,7,16,54,87,202,0.4306930693069307,34,103,0.3300970873786408,53,99,0.5353535353535354,0.515,28,38,0.7368421052631579
Kyle Anderson,anderky01,SF,24,SAS,2018,74,1978.0,585,202,84,312,396,115,60,94,114,231,438,0.5273972602739726,19,57,0.3333333333333333,212,381,0.5564304461942258,0.549,104,146,0.7123287671232876
Ryan Anderson,anderry01,PF,29,HOU,2018,66,1725.0,617,60,94,237,331,24,21,42,126,207,480,0.43125,131,339,0.3864306784660767,76,141,0.5390070921985816,0.568,72,93,0.7741935483870968
Ike Anigbogu,anigbik01,C,19,IND,2018,11,30.0,13,0,5,4,9,1,3,2,1,4,9,0.4444444444444444,0,0,0.0,4,9,0.4444444444444444,0.444,5,6,0.8333333333333334
Giannis Antetokounmpo,antetgi01,PF,23,MIL,2018,75,2756.0,2014,361,156,597,753,109,106,223,231,742,1402,0.5292439372325249,43,140,0.3071428571428571,699,1262,0.5538827258320127,0.545,487,641,0.7597503900156006
Carmelo Anthony,anthoca01,PF,33,OKC,2018,78,2501.0,1261,103,67,386,453,47,49,99,197,472,1168,0.4041095890410959,169,474,0.3565400843881856,303,694,0.4365994236311239,0.476,148,193,0.7668393782383419
OG Anunoby,anunoog01,SF,20,TOR,2018,74,1481.0,438,55,44,140,184,52,14,45,130,163,346,0.4710982658959537,73,197,0.3705583756345177,90,149,0.6040268456375839,0.577,39,62,0.6290322580645161
Ryan Arcidiacono,arcidry01,PG,23,CHI,2018,24,304.0,48,35,1,24,25,13,0,13,18,17,41,0.4146341463414634,9,31,0.2903225806451613,8,10,0.8,0.524,5,6,0.8333333333333334
Trevor Ariza,arizatr01,SF,32,HOU,2018,67,2269.0,782,105,33,261,294,98,13,52,132,268,651,0.4116743471582181,170,462,0.3679653679653679,98,189,0.5185185185185185,0.542,76,89,0.8539325842696629
Darrell Arthur,arthuda01,PF,29,DEN,2018,19,141.0,54,9,3,12,15,8,3,15,22,22,47,0.4680851063829787,8,23,0.3478260869565217,14,24,0.5833333333333334,0.553,2,3,0.6666666666666666
Jamel Artis,artisja01,SG,25,ORL,2018,15,279.0,77,18,4,34,38,2,3,8,11,31,79,0.3924050632911392,8,29,0.2758620689655172,23,50,0.46,0.443,7,12,0.5833333333333334
Ömer Aşık,asikom01,C,31,TOT,2018,18,182.0,22,3,9,38,47,2,4,9,20,9,22,0.4090909090909091,0,0,0.0,9,22,0.4090909090909091,0.409,4,13,0.3076923076923077
D.J. Augustin,augusdj01,PG,30,ORL,2018,75,1760.0,766,287,30,130,160,54,0,123,94,244,540,0.4518518518518518,114,272,0.4191176470588235,130,268,0.4850746268656716,0.557,164,189,0.8677248677248677
Luke Babbitt,babbilu01,SF,28,TOT,2018,50,715.0,259,31,7,89,96,8,7,19,54,91,215,0.4232558139534884,60,156,0.3846153846153846,31,59,0.5254237288135594,0.563,17,22,0.7727272727272727
Dwayne Bacon,bacondw01,SG,22,CHO,2018,53,713.0,175,38,4,120,124,16,2,23,46,72,192,0.375,11,43,0.2558139534883721,61,149,0.4093959731543624,0.404,20,25,0.8
Ron Baker,bakerro01,SG,24,NYK,2018,29,385.0,71,47,5,25,30,26,6,18,33,20,59,0.3389830508474576,11,33,0.3333333333333333,9,26,0.3461538461538461,0.432,20,26,0.7692307692307693
Wade Baldwin,baldwwa01,PG,21,POR,2018,7,80.0,38,5,1,7,8,2,1,4,12,14,21,0.6666666666666666,4,5,0.8,10,16,0.625,0.762,6,10,0.6
Lonzo Ball,balllo01,PG,20,LAL,2018,52,1780.0,528,376,69,291,360,88,43,136,117,203,564,0.3599290780141844,90,295,0.3050847457627119,113,269,0.4200743494423792,0.44,32,71,0.4507042253521127
J.J. Barea,bareajo01,PG,33,DAL,2018,69,1603.0,801,434,15,186,201,35,3,143,83,303,690,0.4391304347826087,115,313,0.3674121405750798,188,377,0.4986737400530504,0.522,80,102,0.7843137254901961
Harrison Barnes,barneha02,PF,25,DAL,2018,77,2634.0,1452,152,77,391,468,49,14,118,94,537,1208,0.4445364238410596,119,333,0.3573573573573573,418,875,0.4777142857142857,0.494,259,313,0.8274760383386581
Will Barton,bartowi01,SG,27,DEN,2018,81,2683.0,1268,331,70,339,409,82,52,149,168,465,1028,0.4523346303501945,156,422,0.3696682464454976,309,606,0.5099009900990099,0.528,182,226,0.8053097345132744
Nicolas Batum,batumni01,SG,29,CHO,2018,64,1981.0,740,349,57,249,306,65,23,131,72,270,650,0.4153846153846154,92,274,0.3357664233576642,178,376,0.4734042553191489,0.486,108,130,0.8307692307692308
Jerryd Bayless,bayleje01,SG,29,PHI,2018,39,925.0,307,54,15,65,80,23,6,46,91,109,262,0.416030534351145,54,146,0.3698630136986301,55,116,0.4741379310344827,0.519,35,44,0.7954545454545454
Aron Baynes,baynear01,C,31,BOS,2018,81,1485.0,482,93,130,304,434,22,51,80,200,210,446,0.4708520179372197,3,21,0.1428571428571428,207,425,0.4870588235294117,0.474,59,78,0.7564102564102564
Kent Bazemore,bazemke01,SG,28,ATL,2018,65,1789.0,836,228,25,223,248,100,45,157,147,284,676,0.4201183431952662,108,274,0.3941605839416058,176,402,0.4378109452736318,0.5,160,201,0.7960199004975125
Bradley Beal,bealbr01,SG,24,WAS,2018,82,2977.0,1857,373,61,302,363,96,36,214,160,683,1484,0.4602425876010781,199,530,0.3754716981132076,484,954,0.5073375262054507,0.527,292,369,0.7913279132791328
Malik Beasley,beaslma01,SG,21,DEN,2018,62,583.0,196,31,14,57,71,15,7,24,36,73,178,0.4101123595505618,28,82,0.3414634146341463,45,96,0.46875,0.489,22,33,0.6666666666666666
Michael Beasley,beaslmi01,PF,29,NYK,2018,74,1653.0,976,123,97,317,414,36,43,143,145,409,807,0.506815365551425,34,86,0.3953488372093023,375,721,0.5201109570041609,0.528,124,159,0.779874213836478
Marco Belinelli,belinma01,SG,31,TOT,2018,80,1947.0,971,148,20,131,151,66,12,94,91,337,764,0.4410994764397906,149,395,0.3772151898734177,188,369,0.5094850948509485,0.539,148,163,0.9079754601226994
Jordan Bell,belljo01,C,23,GSW,2018,57,809.0,262,102,60,147,207,35,56,51,92,116,185,0.6270270270270271,0,4,0.0,116,181,0.6408839779005525,0.627,30,44,0.6818181818181818
DeAndre' Bembry,bembrde01,SF,23,ATL,2018,26,455.0,136,49,8,64,72,21,12,47,38,53,128,0.4140625,11,30,0.3666666666666666,42,98,0.4285714285714285,0.457,19,33,0.5757575757575758
Dragan Bender,bendedr01,PF,20,PHO,2018,82,2069.0,531,130,40,321,361,22,53,112,166,187,484,0.3863636363636363,118,322,0.3664596273291925,69,162,0.4259259259259259,0.508,39,51,0.7647058823529411
Dāvis Bertāns,bertada01,PF,25,SAS,2018,77,1086.0,456,74,18,135,153,26,28,36,93,161,366,0.4398907103825136,94,252,0.373015873015873,67,114,0.5877192982456141,0.568,40,49,0.8163265306122449
Patrick Beverley,beverpa01,SG,29,LAC,2018,11,334.0,134,32,16,29,45,19,5,25,34,48,119,0.4033613445378151,24,60,0.4,24,59,0.4067796610169492,0.504,14,17,0.8235294117647058
Khem Birch,birchkh01,C,25,ORL,2018,42,578.0,178,34,70,110,180,15,21,21,56,68,126,0.5396825396825397,0,0,0.0,68,126,0.5396825396825397,0.54,42,61,0.6885245901639344
Jabari Bird,birdja01,SG,23,BOS,2018,13,115.0,39,8,6,13,19,3,1,8,7,15,26,0.5769230769230769,3,7,0.4285714285714285,12,19,0.631578947368421,0.635,6,13,0.4615384615384615
Bismack Biyombo,biyombi01,C,25,ORL,2018,82,1495.0,468,66,144,324,468,21,95,84,158,183,352,0.5198863636363636,0,1,0.0,183,351,0.5213675213675214,0.52,102,157,0.6496815286624203
Nemanja Bjelica,bjeline01,PF,29,MIN,2018,67,1371.0,454,86,53,221,274,50,16,52,141,171,371,0.4609164420485175,76,183,0.4153005464480874,95,188,0.5053191489361702,0.563,36,45,0.8
Tarik Black,blackta01,C,26,HOU,2018,51,536.0,180,13,63,100,163,21,30,35,107,75,127,0.5905511811023622,1,11,0.0909090909090909,74,116,0.6379310344827587,0.594,29,63,0.4603174603174603
Antonio Blakeney,blakean01,SG,21,CHI,2018,19,314.0,151,20,4,29,33,7,1,11,19,53,143,0.3706293706293706,15,52,0.2884615384615384,38,91,0.4175824175824176,0.423,30,39,0.7692307692307693
Eric Bledsoe,bledser01,PG,28,TOT,2018,74,2322.0,1313,370,51,233,284,149,42,216,185,468,989,0.4732052578361981,125,360,0.3472222222222222,343,629,0.5453100158982512,0.536,252,317,0.7949526813880127
Vander Blue,blueva01,SG,25,LAL,2018,5,45.0,3,3,0,1,1,1,0,3,2,1,5,0.2,0,2,0.0,1,3,0.3333333333333333,0.2,1,2,0.5
Bogdan Bogdanović,bogdabo01,SG,25,SAC,2018,78,2175.0,917,258,31,192,223,72,16,125,172,344,772,0.4455958549222797,129,329,0.39209726443769,215,443,0.4853273137697517,0.529,100,119,0.8403361344537815
Bojan Bogdanović,bogdabo02,SF,28,IND,2018,80,2464.0,1141,119,30,240,270,55,8,106,129,404,852,0.4741784037558685,155,386,0.4015544041450777,249,466,0.5343347639484979,0.565,178,205,0.8682926829268293
Andrew Bogut,bogutan01,C,33,LAL,2018,24,216.0,36,15,26,52,78,4,13,19,40,17,25,0.68,0,0,0.0,17,25,0.68,0.68,2,2,1.0
Joel Bolomboy,bolomjo01,PF,24,MIL,2018,6,38.0,9,0,6,4,10,2,0,2,3,3,6,0.5,0,1,0.0,3,5,0.6,0.5,3,6,0.5
Devin Booker,bookede01,SG,21,PHO,2018,54,1865.0,1346,253,26,218,244,47,14,194,168,455,1054,0.4316888045540797,147,384,0.3828125,308,670,0.4597014925373134,0.501,289,329,0.878419452887538
Trevor Booker,booketr01,PF,30,TOT,2018,68,1158.0,428,82,117,201,318,28,21,59,119,177,343,0.5160349854227405,8,33,0.2424242424242424,169,310,0.5451612903225806,0.528,66,93,0.7096774193548387
Chris Boucher,bouchch01,PF,25,GSW,2018,1,1.0,0,0,0,1,1,0,0,0,0,0,1,0.0,0,1,0.0,0,0,0.0,0.0,0,0,0.0
Avery Bradley,bradlav01,SG,27,TOT,2018,46,1433.0,656,94,22,94,116,51,8,101,92,259,625,0.4144,75,203,0.3694581280788177,184,422,0.4360189573459715,0.474,63,82,0.7682926829268293
Tony Bradley,bradlto01,C,20,UTA,2018,9,29.0,8,1,4,7,11,0,0,0,1,3,11,0.2727272727272727,0,1,0.0,3,10,0.3,0.273,2,2,1.0
Corey Brewer,breweco01,SF-SG,31,TOT,2018,72,1208.0,380,65,43,111,154,79,14,49,139,142,316,0.4493670886075949,31,110,0.2818181818181818,111,206,0.5388349514563107,0.498,65,90,0.7222222222222222
Malcolm Brogdon,brogdma01,PG,25,MIL,2018,48,1436.0,625,152,23,133,156,41,13,66,128,244,503,0.4850894632206759,62,161,0.3850931677018633,182,342,0.5321637426900585,0.547,75,85,0.8823529411764706
Aaron Brooks,brookaa01,PG,33,MIN,2018,32,189.0,75,20,7,10,17,6,0,11,28,28,69,0.4057971014492754,11,31,0.3548387096774194,17,38,0.4473684210526316,0.486,8,11,0.7272727272727273
Dillon Brooks,brookdi01,SF,22,MEM,2018,82,2350.0,898,135,49,208,257,73,17,124,233,340,772,0.4404145077720207,94,264,0.3560606060606061,246,508,0.484251968503937,0.501,124,166,0.7469879518072289
MarShon Brooks,brookma01,SG,29,MEM,2018,7,193.0,141,25,8,13,21,11,3,16,6,51,102,0.5,19,32,0.59375,32,70,0.4571428571428571,0.593,20,23,0.8695652173913043
Anthony Brown,brownan02,SF,25,MIN,2018,1,4.0,3,1,0,0,0,0,0,0,0,1,1,1.0,1,1,1.0,0,0,0.0,1.5,0,0,0.0
Bobby Brown,brownbo02,PG,33,HOU,2018,20,115.0,50,11,0,7,7,4,0,9,6,19,58,0.3275862068965517,11,40,0.275,8,18,0.4444444444444444,0.422,1,2,0.5
Jaylen Brown,brownja02,SG,21,BOS,2018,70,2152.0,1017,114,66,280,346,70,26,124,181,373,803,0.4645080946450809,121,306,0.3954248366013072,252,497,0.5070422535211268,0.54,150,233,0.6437768240343348
Lorenzo Brown,brownlo01,PG,27,TOR,2018,14,139.0,32,13,1,14,15,5,0,3,7,14,34,0.4117647058823529,2,12,0.1666666666666666,12,22,0.5454545454545454,0.441,2,2,1.0
Markel Brown,brownma02,SG,26,HOU,2018,4,31.0,5,2,1,4,5,0,0,2,6,2,7,0.2857142857142857,1,5,0.2,1,2,0.5,0.357,0,0,0.0
Sterling Brown,brownst02,SG,22,MIL,2018,54,776.0,217,25,27,116,143,31,13,25,80,82,205,0.4,32,91,0.3516483516483517,50,114,0.4385964912280701,0.478,21,24,0.875
Nicolás Brussino,brussni01,SF,24,ATL,2018,4,10.0,0,0,0,3,3,0,0,0,0,0,2,0.0,0,2,0.0,0,0,0.0,0.0,0,0,0.0
Thomas Bryant,bryanth01,C,20,LAL,2018,15,72.0,22,6,3,14,17,1,2,2,6,8,21,0.3809523809523809,1,10,0.1,7,11,0.6363636363636364,0.405,5,9,0.5555555555555556
Reggie Bullock,bullore01,SF,26,DET,2018,62,1732.0,698,95,27,127,154,47,13,47,70,267,546,0.489010989010989,125,281,0.4448398576512455,142,265,0.5358490566037736,0.603,39,49,0.7959183673469388
Trey Burke,burketr01,PG,25,NYK,2018,36,785.0,461,170,13,58,71,24,4,43,43,193,384,0.5026041666666666,38,105,0.3619047619047619,155,279,0.5555555555555556,0.552,37,57,0.6491228070175439
Alec Burks,burksal01,SG,26,UTA,2018,64,1059.0,494,67,19,173,192,37,8,60,75,170,414,0.4106280193236715,47,142,0.3309859154929577,123,272,0.4522058823529412,0.467,107,124,0.8629032258064516
Jimmy Butler,butleji01,SG,28,MIN,2018,59,2164.0,1307,288,79,235,314,116,24,108,78,437,921,0.4744842562432139,70,200,0.35,367,721,0.5090152565880721,0.512,363,425,0.8541176470588235
Dwight Buycks,buyckdw01,PG,28,DET,2018,29,427.0,215,59,12,29,41,19,2,39,39,82,198,0.4141414141414141,15,45,0.3333333333333333,67,153,0.4379084967320261,0.452,36,41,0.8780487804878049
Bruno Caboclo,cabocbr01,SF,22,TOT,2018,12,107.0,26,4,7,15,22,3,4,4,8,9,31,0.2903225806451613,3,17,0.1764705882352941,6,14,0.4285714285714285,0.339,5,6,0.8333333333333334
José Calderón,caldejo01,PG,36,CLE,2018,57,914.0,255,117,14,70,84,27,2,41,81,93,185,0.5027027027027027,45,97,0.4639175257731959,48,88,0.5454545454545454,0.624,24,30,0.8
Kentavious Caldwell-Pope,caldwke01,SG,24,LAL,2018,74,2458.0,992,162,60,327,387,106,16,97,145,340,798,0.4260651629072681,159,415,0.3831325301204819,181,383,0.4725848563968668,0.526,153,194,0.788659793814433
Isaiah Canaan,canaais01,PG-SG,26,TOT,2018,20,422.0,172,76,6,39,45,16,1,29,36,52,137,0.3795620437956204,22,66,0.3333333333333333,30,71,0.4225352112676056,0.46,46,51,0.9019607843137256
Clint Capela,capelca01,C,23,HOU,2018,74,2034.0,1026,68,241,561,802,58,137,103,185,441,676,0.6523668639053254,0,1,0.0,441,675,0.6533333333333333,0.652,144,257,0.5603112840466926
DeMarre Carroll,carrode01,PF,31,BRK,2018,73,2180.0,983,147,105,374,479,59,30,103,165,325,785,0.4140127388535032,145,391,0.3708439897698209,180,394,0.4568527918781725,0.506,188,246,0.7642276422764228
Vince Carter,cartevi01,SF,41,SAC,2018,58,1026.0,313,69,18,130,148,42,26,36,96,114,283,0.4028268551236749,57,165,0.3454545454545454,57,118,0.4830508474576271,0.504,28,37,0.7567567567567568
Michael Carter-Williams,cartemi01,PG,26,CHO,2018,52,835.0,239,116,37,101,138,44,23,52,99,76,229,0.3318777292576419,14,59,0.2372881355932203,62,170,0.3647058823529411,0.362,73,89,0.8202247191011236
Alex Caruso,carusal01,PG,23,LAL,2018,37,562.0,134,75,15,50,65,23,10,42,52,50,116,0.4310344827586206,13,43,0.3023255813953488,37,73,0.5068493150684932,0.487,21,30,0.7
Omri Casspi,casspom01,SF,29,GSW,2018,53,740.0,300,51,30,170,200,18,19,37,71,120,207,0.5797101449275363,10,22,0.4545454545454545,110,185,0.5945945945945946,0.604,50,69,0.7246376811594203
Willie Cauley-Stein,caulewi01,C,24,SAC,2018,73,2044.0,932,172,131,379,510,77,67,109,185,388,773,0.5019404915912031,3,12,0.25,385,761,0.5059132720105125,0.504,153,247,0.6194331983805668
Tyler Cavanaugh,cavanty01,PF,23,ATL,2018,39,518.0,183,27,45,82,127,9,4,14,61,67,152,0.4407894736842105,32,89,0.3595505617977528,35,63,0.5555555555555556,0.546,17,21,0.8095238095238095
Mario Chalmers,chalmma01,PG,31,MEM,2018,66,1421.0,507,197,13,144,157,79,14,117,179,168,443,0.3792325056433409,53,191,0.2774869109947644,115,252,0.4563492063492063,0.439,118,138,0.855072463768116
Tyson Chandler,chandty01,C,35,PHO,2018,46,1151.0,300,53,134,284,418,16,27,59,106,121,187,0.6470588235294118,0,0,0.0,121,187,0.6470588235294118,0.647,58,93,0.6236559139784946
Wilson Chandler,chandwi01,SF,30,DEN,2018,74,2346.0,738,159,102,296,398,43,39,92,156,281,631,0.4453248811410459,88,246,0.3577235772357723,193,385,0.5012987012987012,0.515,88,114,0.7719298245614035
Marquese Chriss,chrisma01,PF,20,PHO,2018,72,1527.0,556,83,76,319,395,51,70,107,205,202,477,0.4234800838574423,56,190,0.2947368421052631,146,287,0.5087108013937283,0.482,96,158,0.6075949367088608
Ian Clark,clarkia01,SG,26,NOP,2018,74,1455.0,551,110,10,117,127,33,10,57,120,222,495,0.4484848484848485,62,195,0.3179487179487179,160,300,0.5333333333333333,0.511,45,59,0.7627118644067796
Jordan Clarkson,clarkjo01,SG,25,TOT,2018,81,1888.0,1124,221,57,160,217,58,6,127,107,430,954,0.450733752620545,112,318,0.3522012578616352,318,636,0.5,0.509,152,190,0.8
Gian Clavell,clavegi01,SG,24,DAL,2018,7,64.0,20,3,1,6,7,2,0,2,8,6,18,0.3333333333333333,6,15,0.4,0,3,0.0,0.5,2,2,1.0
Antonius Cleveland,clevean01,SG,23,TOT,2018,17,123.0,23,2,3,11,14,7,5,7,23,8,21,0.3809523809523809,3,4,0.75,5,17,0.2941176470588235,0.452,4,6,0.6666666666666666
John Collins,collijo01,PF,20,ATL,2018,74,1785.0,777,98,176,365,541,47,80,105,215,314,545,0.5761467889908257,16,47,0.3404255319148936,298,498,0.5983935742971888,0.591,133,186,0.7150537634408602
Zach Collins,colliza01,C,20,POR,2018,66,1045.0,292,52,45,176,221,17,31,58,133,115,289,0.3979238754325259,35,113,0.3097345132743362,80,176,0.4545454545454545,0.458,27,42,0.6428571428571429
Kyle Collinsworth,colliky01,SF,26,DAL,2018,32,480.0,101,56,32,75,107,17,9,24,44,38,99,0.3838383838383838,4,17,0.2352941176470588,34,82,0.4146341463414634,0.404,21,40,0.525
Darren Collison,collida01,PG,30,IND,2018,69,2018.0,855,368,37,141,178,92,15,86,122,316,638,0.4952978056426332,96,205,0.4682926829268293,220,433,0.5080831408775982,0.571,127,144,0.8819444444444444
Nick Collison,collini01,PF,37,OKC,2018,15,75.0,31,4,7,13,20,0,0,7,7,13,19,0.6842105263157895,0,0,0.0,13,19,0.6842105263157895,0.684,5,13,0.3846153846153846
Mike Conley,conlemi01,PG,30,MEM,2018,12,373.0,205,49,0,27,27,12,3,18,24,64,168,0.3809523809523809,24,77,0.3116883116883117,40,91,0.4395604395604395,0.452,53,66,0.803030303030303
Pat Connaughton,connapa01,SG,25,POR,2018,82,1488.0,441,91,36,125,161,23,22,43,120,165,390,0.4230769230769231,74,210,0.3523809523809524,91,180,0.5055555555555555,0.518,37,44,0.8409090909090909
Quinn Cook,cookqu01,PG,24,GSW,2018,33,740.0,312,89,10,72,82,12,1,32,59,122,252,0.4841269841269841,46,104,0.4423076923076923,76,148,0.5135135135135135,0.575,22,25,0.88
Charles Cooke,cookech01,SG,23,NOP,2018,13,38.0,6,1,0,2,2,1,0,1,0,2,14,0.1428571428571428,1,8,0.125,1,6,0.1666666666666666,0.179,1,2,0.5
Jack Cooley,cooleja01,PF,26,SAC,2018,7,87.0,40,6,14,16,30,1,0,3,13,13,27,0.4814814814814814,0,0,0.0,13,27,0.4814814814814814,0.481,14,19,0.7368421052631579
Matt Costello,costema01,C,24,SAS,2018,4,32.0,4,2,1,8,9,2,2,1,7,2,4,0.5,0,0,0.0,2,4,0.5,0.5,0,0,0.0
DeMarcus Cousins,couside01,C,27,NOP,2018,48,1737.0,1210,257,105,512,617,79,76,242,183,406,864,0.4699074074074074,104,294,0.3537414965986394,302,570,0.5298245614035088,0.53,294,394,0.7461928934010152
Robert Covington,covinro01,SF,27,PHI,2018,80,2532.0,1009,156,55,378,433,137,72,126,238,345,836,0.4126794258373206,203,550,0.3690909090909091,142,286,0.4965034965034965,0.534,116,136,0.8529411764705882
Allen Crabbe,crabbal01,SG,25,BRK,2018,75,2197.0,990,117,28,296,324,47,35,78,168,337,827,0.407496977025393,201,532,0.3778195488721804,136,295,0.4610169491525424,0.529,115,135,0.8518518518518519
Torrey Craig,craigto01,SF,27,DEN,2018,39,629.0,163,25,40,87,127,12,15,20,63,62,137,0.4525547445255474,17,58,0.293103448275862,45,79,0.569620253164557,0.515,22,35,0.6285714285714286
Jamal Crawford,crawfja01,SG,37,MIN,2018,80,1653.0,822,185,21,78,99,40,9,95,85,308,742,0.4150943396226415,104,314,0.3312101910828025,204,428,0.4766355140186916,0.485,102,113,0.9026548672566372
Jordan Crawford,crawfjo02,SG,29,NOP,2018,5,53.0,33,13,2,2,4,1,1,5,7,12,27,0.4444444444444444,8,14,0.5714285714285714,4,13,0.3076923076923077,0.593,1,1,1.0
Jae Crowder,crowdja01,SF,27,TOT,2018,80,2090.0,773,99,59,216,275,64,21,74,187,271,671,0.4038748137108793,110,341,0.3225806451612903,161,330,0.4878787878787878,0.486,121,148,0.8175675675675675
Dante Cunningham,cunnida01,SF,30,TOT,2018,73,1562.0,417,48,78,220,298,39,30,33,111,164,364,0.4505494505494505,58,168,0.3452380952380952,106,196,0.5408163265306123,0.53,31,52,0.5961538461538461
Stephen Curry,curryst01,PG,29,GSW,2018,51,1631.0,1346,310,36,225,261,80,8,153,114,428,864,0.4953703703703703,212,501,0.4231536926147705,216,363,0.5950413223140496,0.618,278,302,0.9205298013245032
Troy Daniels,danietr01,SG,26,PHO,2018,79,1622.0,703,48,12,115,127,26,5,56,137,232,575,0.4034782608695652,183,458,0.3995633187772925,49,117,0.4188034188034188,0.563,56,64,0.875
Anthony Davis,davisan02,PF,24,NOP,2018,75,2727.0,2110,174,187,645,832,115,193,162,159,780,1462,0.533515731874145,55,162,0.3395061728395062,725,1300,0.5576923076923077,0.552,495,598,0.8277591973244147
Deyonta Davis,davisde01,C,21,MEM,2018,62,943.0,360,40,75,175,250,15,39,32,125,161,265,0.6075471698113207,0,0,0.0,161,265,0.6075471698113207,0.608,38,57,0.6666666666666666
Ed Davis,davised01,C,28,POR,2018,78,1471.0,414,40,183,392,575,32,52,66,188,170,292,0.5821917808219178,0,1,0.0,170,291,0.584192439862543,0.582,74,111,0.6666666666666666
Dewayne Dedmon,dedmode01,C,28,ATL,2018,62,1542.0,617,90,100,389,489,40,51,86,162,250,477,0.5241090146750524,50,141,0.3546099290780142,200,336,0.5952380952380952,0.577,67,86,0.7790697674418605
Sam Dekker,dekkesa01,PF,23,LAC,2018,73,883.0,303,38,44,130,174,24,9,33,71,128,259,0.4942084942084942,10,60,0.1666666666666666,118,199,0.592964824120603,0.514,37,56,0.6607142857142857
Malcolm Delaney,delanma01,PG,28,ATL,2018,54,1014.0,338,163,9,91,100,35,6,66,82,109,285,0.3824561403508772,46,124,0.3709677419354839,63,161,0.391304347826087,0.463,74,92,0.8043478260869565
Matthew Dellavedova,dellama01,PG,27,MIL,2018,38,712.0,164,145,14,50,64,14,0,49,67,55,152,0.3618421052631579,29,78,0.3717948717948718,26,74,0.3513513513513513,0.457,25,27,0.925925925925926
Luol Deng,denglu01,SF,32,LAL,2018,1,13.0,2,1,0,0,0,1,0,1,0,1,2,0.5,0,0,0.0,1,2,0.5,0.5,0,0,0.0
DeMar DeRozan,derozde01,SG,28,TOR,2018,80,2711.0,1840,417,59,256,315,85,22,175,151,645,1413,0.4564755838641189,89,287,0.3101045296167247,556,1126,0.4937833037300178,0.488,461,559,0.8246869409660107
Cheick Diallo,diallch01,PF,21,NOP,2018,52,581.0,254,19,47,164,211,11,21,28,82,102,176,0.5795454545454546,0,0,0.0,102,176,0.5795454545454546,0.58,50,66,0.7575757575757576
Gorgui Dieng,dienggo01,C,28,MIN,2018,79,1333.0,470,71,106,254,360,45,39,59,147,186,388,0.4793814432989691,19,61,0.3114754098360656,167,327,0.5107033639143731,0.504,79,102,0.7745098039215687
Spencer Dinwiddie,dinwisp01,PG,24,BRK,2018,80,2306.0,1007,524,40,219,259,68,23,128,186,324,838,0.386634844868735,141,433,0.325635103926097,183,405,0.4518518518518518,0.471,218,268,0.8134328358208955
Tyler Dorsey,dorsety01,SG,21,ATL,2018,56,974.0,405,79,17,113,130,17,5,37,63,144,382,0.3769633507853403,72,199,0.3618090452261306,72,183,0.3934426229508196,0.471,45,63,0.7142857142857143
Damyean Dotson,dotsoda01,SG,23,NYK,2018,44,474.0,182,31,9,75,84,12,2,17,34,72,161,0.4472049689440994,22,68,0.3235294117647059,50,93,0.5376344086021505,0.516,16,23,0.6956521739130435
Milton Doyle,doylemi01,SG,24,BRK,2018,10,125.0,34,10,3,15,18,6,2,2,13,13,47,0.2765957446808511,4,23,0.1739130434782608,9,24,0.375,0.319,4,8,0.5
PJ Dozier,doziepj01,PG,21,OKC,2018,2,3.0,2,0,0,1,1,0,0,1,1,1,2,0.5,0,0,0.0,1,2,0.5,0.5,0,0,0.0
Goran Dragić,dragigo01,PG,31,MIA,2018,75,2378.0,1296,359,54,252,306,63,12,166,180,484,1075,0.4502325581395349,111,300,0.37,373,775,0.4812903225806451,0.502,217,271,0.8007380073800738
Larry Drew II,drewla02,PG,27,TOT,2018,10,70.0,17,10,3,0,3,0,0,3,6,7,24,0.2916666666666667,3,9,0.3333333333333333,4,15,0.2666666666666666,0.354,0,0,0.0
Andre Drummond,drumman01,C,24,DET,2018,78,2625.0,1171,237,399,848,1247,114,127,200,250,466,881,0.52894438138479,0,11,0.0,466,870,0.535632183908046,0.529,239,395,0.6050632911392405
Jared Dudley,dudleja01,PF,32,PHO,2018,48,686.0,152,78,8,86,94,24,11,28,85,48,122,0.3934426229508196,29,80,0.3625,19,42,0.4523809523809524,0.512,27,35,0.7714285714285715
Kris Dunn,dunnkr01,PG,23,CHI,2018,52,1525.0,699,310,24,197,221,104,27,150,174,286,666,0.4294294294294294,43,134,0.3208955223880597,243,532,0.4567669172932331,0.462,84,114,0.7368421052631579
Kevin Durant,duranke01,SF,29,GSW,2018,68,2325.0,1792,366,31,433,464,50,119,207,133,630,1222,0.5155482815057283,173,413,0.4188861985472155,457,809,0.5648949320148331,0.586,359,404,0.8886138613861386
Jarell Eddie,eddieja01,SF,26,TOT,2018,3,9.0,0,0,0,1,1,1,0,0,0,0,2,0.0,0,2,0.0,0,0,0.0,0.0,0,0,0.0
Henry Ellenson,ellenhe01,PF,21,DET,2018,38,329.0,151,20,10,71,81,5,0,18,22,53,146,0.363013698630137,20,60,0.3333333333333333,33,86,0.3837209302325581,0.432,25,29,0.8620689655172413
Wayne Ellington,ellinwa01,SG,30,MIA,2018,77,2041.0,864,79,23,195,218,53,8,52,94,285,700,0.4071428571428571,227,579,0.3920552677029361,58,121,0.4793388429752066,0.569,67,78,0.8589743589743589
Joel Embiid,embiijo01,C,23,PHI,2018,63,1912.0,1445,199,143,547,690,40,111,234,209,510,1056,0.4829545454545454,66,214,0.308411214953271,444,842,0.5273159144893111,0.514,359,467,0.7687366167023555
James Ennis III,ennisja01,SF,27,TOT,2018,72,1604.0,512,71,73,151,224,47,18,56,134,182,384,0.4739583333333333,51,153,0.3333333333333333,131,231,0.5670995670995671,0.54,97,116,0.8362068965517241
Tyler Ennis,ennisty01,PG,23,LAL,2018,54,683.0,224,105,19,76,95,30,10,38,75,94,224,0.4196428571428571,14,56,0.25,80,168,0.4761904761904761,0.451,22,29,0.7586206896551724
Jawun Evans,evansja01,PG,21,LAC,2018,48,778.0,231,100,9,75,84,36,6,44,97,89,253,0.3517786561264822,15,54,0.2777777777777778,74,199,0.371859296482412,0.381,38,49,0.7755102040816326
Jeremy Evans,evansje01,SF,30,ATL,2018,1,5.0,2,0,1,0,1,0,0,1,1,1,1,1.0,0,0,0.0,1,1,1.0,1.0,0,0,0.0
Tyreke Evans,evansty01,PG,28,MEM,2018,52,1607.0,1010,269,44,221,265,57,17,117,96,366,809,0.4524103831891223,114,286,0.3986013986013986,252,523,0.4818355640535373,0.523,164,209,0.784688995215311
Dante Exum,exumda01,PG,22,UTA,2018,14,235.0,114,43,4,22,26,8,3,20,20,42,87,0.4827586206896552,5,18,0.2777777777777778,37,69,0.5362318840579711,0.511,25,31,0.8064516129032258
Kenneth Faried,farieke01,PF,28,DEN,2018,32,461.0,188,18,68,85,153,12,13,23,51,76,148,0.5135135135135135,0,1,0.0,76,147,0.5170068027210885,0.514,36,51,0.7058823529411765
Derrick Favors,favorde01,C,26,UTA,2018,77,2153.0,944,102,198,354,552,54,82,88,164,395,702,0.5626780626780626,14,63,0.2222222222222222,381,639,0.596244131455399,0.573,140,215,0.6511627906976745
Kay Felder,feldeka01,PG,22,TOT,2018,16,140.0,57,20,3,15,18,3,1,16,11,21,70,0.3,4,19,0.2105263157894736,17,51,0.3333333333333333,0.329,11,12,0.9166666666666666
Cristiano Felício,feliccr01,C,25,CHI,2018,55,977.0,308,55,83,150,233,16,11,54,104,127,215,0.5906976744186047,0,2,0.0,127,213,0.596244131455399,0.591,54,81,0.6666666666666666
Raymond Felton,feltora01,PG,33,OKC,2018,82,1365.0,565,203,25,131,156,49,16,76,91,224,552,0.4057971014492754,81,230,0.3521739130434783,143,322,0.4440993788819876,0.479,36,44,0.8181818181818182
Terrance Ferguson,fergute01,SG,19,OKC,2018,61,763.0,189,19,19,28,47,24,10,11,83,70,169,0.4142011834319526,40,120,0.3333333333333333,30,49,0.6122448979591837,0.533,9,10,0.9
Yogi Ferrell,ferreyo01,SG,24,DAL,2018,82,2282.0,838,201,26,223,249,64,9,78,153,311,730,0.426027397260274,134,359,0.3732590529247911,177,371,0.477088948787062,0.518,82,103,0.7961165048543689
Dorian Finney-Smith,finnedo01,PF,24,DAL,2018,21,448.0,123,26,22,53,75,10,4,21,43,46,121,0.3801652892561983,20,67,0.2985074626865671,26,54,0.4814814814814814,0.463,11,15,0.7333333333333333
Bryn Forbes,forbebr01,SG,24,SAS,2018,80,1517.0,555,80,12,98,110,28,2,37,108,209,497,0.4205231388329979,89,228,0.3903508771929824,120,269,0.4460966542750929,0.51,48,72,0.6666666666666666
Evan Fournier,fournev01,SF,25,ORL,2018,57,1837.0,1013,165,23,157,180,47,16,95,138,368,802,0.4588528678304239,127,335,0.3791044776119402,241,467,0.5160599571734475,0.538,150,173,0.8670520231213873
De'Aaron Fox,foxde01,PG,20,SAC,2018,73,2026.0,844,320,33,171,204,70,20,173,163,328,797,0.411543287327478,47,153,0.3071895424836601,281,644,0.4363354037267081,0.441,141,195,0.7230769230769231
Tim Frazier,fraziti01,PG,27,WAS,2018,59,838.0,176,194,18,97,115,47,7,57,97,68,172,0.3953488372093023,17,56,0.3035714285714285,51,116,0.4396551724137931,0.445,23,30,0.7666666666666667
Enes Freedom,kanteen01,C,25,NYK,2018,71,1830.0,1000,105,273,507,780,36,37,122,187,422,713,0.5918653576437588,0,2,0.0,422,711,0.5935302390998594,0.592,156,184,0.8478260869565217
Channing Frye,fryech01,C,34,TOT,2018,53,695.0,264,38,12,123,135,18,13,21,69,104,212,0.490566037735849,39,115,0.3391304347826087,65,97,0.6701030927835051,0.583,17,19,0.8947368421052632
Markelle Fultz,fultzma01,SG,19,PHI,2018,14,253.0,100,53,11,32,43,12,4,17,22,45,111,0.4054054054054054,0,1,0.0,45,110,0.4090909090909091,0.405,10,21,0.4761904761904761
Danilo Gallinari,gallida01,SF,29,LAC,2018,21,671.0,321,41,9,92,101,12,10,26,30,102,256,0.3984375,36,111,0.3243243243243243,66,145,0.4551724137931034,0.469,81,87,0.9310344827586208
Langston Galloway,gallola01,SG,26,DET,2018,58,863.0,360,58,13,79,92,35,5,18,39,126,340,0.3705882352941176,75,218,0.3440366972477064,51,122,0.4180327868852459,0.481,33,41,0.8048780487804879
Marc Gasol,gasolma01,C,33,MEM,2018,73,2408.0,1258,305,78,514,592,54,101,194,185,434,1033,0.420135527589545,109,320,0.340625,325,713,0.455820476858345,0.473,281,337,0.8338278931750742
Pau Gasol,gasolpa01,C,37,SAS,2018,77,1812.0,775,238,129,490,619,24,79,108,121,287,627,0.4577352472089314,43,120,0.3583333333333333,244,507,0.4812623274161736,0.492,158,209,0.7559808612440191
Rudy Gay,gayru01,PF,31,SAS,2018,57,1231.0,655,73,76,215,291,46,38,78,98,253,537,0.4711359404096834,37,118,0.3135593220338983,216,419,0.5155131264916468,0.506,112,145,0.7724137931034483
Paul George,georgpa01,SF,27,OKC,2018,79,2891.0,1734,263,72,375,447,161,39,212,233,576,1340,0.4298507462686567,244,609,0.4006568144499179,332,731,0.454172366621067,0.521,338,411,0.8223844282238443
Marcus Georges-Hunt,georgma01,SG,23,MIN,2018,42,224.0,59,7,7,9,16,6,0,3,32,21,48,0.4375,4,15,0.2666666666666666,17,33,0.5151515151515151,0.479,13,21,0.6190476190476191
Jonathan Gibson,gibsojo01,PG,30,BOS,2018,4,40.0,34,4,0,3,3,0,0,3,5,14,23,0.6086956521739131,6,12,0.5,8,11,0.7272727272727273,0.739,0,0,0.0
Taj Gibson,gibsota01,PF,32,MIN,2018,82,2726.0,999,99,194,390,584,62,59,89,218,425,737,0.576662143826323,7,35,0.2,418,702,0.5954415954415955,0.581,142,185,0.7675675675675676
Manu Ginóbili,ginobma01,SG,40,SAS,2018,65,1299.0,576,163,19,123,142,43,16,105,126,201,463,0.4341252699784017,64,192,0.3333333333333333,137,271,0.5055350553505535,0.503,110,131,0.8396946564885496
Rudy Gobert,goberru01,C,25,UTA,2018,56,1816.0,756,80,165,436,601,44,129,107,153,276,444,0.6216216216216216,0,0,0.0,276,444,0.6216216216216216,0.622,204,299,0.6822742474916388
Aaron Gordon,gordoaa01,PF,22,ORL,2018,58,1909.0,1022,136,87,370,457,59,45,107,111,375,865,0.4335260115606936,115,342,0.3362573099415205,260,523,0.497131931166348,0.5,157,225,0.6977777777777778
Eric Gordon,gordoer01,SG,29,HOU,2018,69,2154.0,1243,154,25,145,170,44,27,130,116,415,970,0.4278350515463917,218,608,0.3585526315789473,197,362,0.5441988950276243,0.54,195,241,0.8091286307053942
Marcin Gortat,gortama01,C,33,WAS,2018,82,2075.0,690,151,181,442,623,40,61,99,175,290,560,0.5178571428571429,0,0,0.0,290,560,0.5178571428571429,0.518,110,163,0.6748466257668712
Treveon Graham,grahatr01,SG,24,CHO,2018,63,1050.0,273,59,42,79,121,33,2,27,109,96,221,0.4343891402714932,40,97,0.4123711340206185,56,124,0.4516129032258064,0.525,41,59,0.6949152542372882
Jerami Grant,grantje01,PF,23,OKC,2018,81,1647.0,682,57,86,233,319,31,77,54,155,244,456,0.5350877192982456,32,110,0.2909090909090909,212,346,0.6127167630057804,0.57,162,240,0.675
Jerian Grant,grantje02,PG,25,CHI,2018,74,1686.0,619,342,31,141,172,63,8,89,132,209,503,0.415506958250497,61,187,0.3262032085561497,148,316,0.4683544303797468,0.476,140,188,0.7446808510638298
Josh Gray,grayjo01,PG,24,PHO,2018,5,86.0,32,12,2,8,10,8,2,7,8,11,41,0.2682926829268293,3,13,0.2307692307692307,8,28,0.2857142857142857,0.305,7,11,0.6363636363636364
Danny Green,greenda02,SG,30,SAS,2018,70,1791.0,600,110,41,208,249,63,80,74,122,217,561,0.3868092691622103,116,320,0.3625,101,241,0.4190871369294606,0.49,50,65,0.7692307692307693
Draymond Green,greendr01,PF,27,GSW,2018,70,2287.0,773,508,75,460,535,95,91,202,185,281,619,0.4539579967689822,77,256,0.30078125,204,363,0.5619834710743802,0.516,134,173,0.7745664739884393
Gerald Green,greenge01,SG,32,HOU,2018,41,929.0,497,25,15,118,133,24,15,31,87,168,413,0.4067796610169492,110,298,0.3691275167785235,58,115,0.5043478260869565,0.54,51,60,0.85
JaMychal Green,greenja01,PF,27,MEM,2018,55,1542.0,569,79,147,317,464,32,25,76,153,223,488,0.4569672131147541,43,127,0.3385826771653543,180,361,0.4986149584487535,0.501,80,111,0.7207207207207207
Jeff Green,greenje02,PF,31,CLE,2018,78,1828.0,846,99,60,186,246,41,34,75,149,295,618,0.4773462783171521,53,170,0.3117647058823529,242,448,0.5401785714285714,0.52,203,234,0.8675213675213675
Blake Griffin,griffbl01,PF,28,TOT,2018,58,1970.0,1242,334,73,355,428,41,18,165,139,436,996,0.4377510040160642,111,322,0.3447204968944099,325,674,0.4821958456973294,0.493,259,330,0.7848484848484848
Daniel Hamilton,hamilda02,SG,22,OKC,2018,6,28.0,12,8,0,5,5,1,0,2,2,5,11,0.4545454545454545,2,5,0.4,3,6,0.5,0.545,0,0,0.0
Tim Hardaway Jr.,hardati02,SG,25,NYK,2018,57,1885.0,996,155,32,192,224,62,10,92,123,360,856,0.4205607476635514,130,410,0.3170731707317073,230,446,0.515695067264574,0.496,146,179,0.8156424581005587
James Harden,hardeja01,SG,28,HOU,2018,72,2551.0,2191,630,41,348,389,126,50,315,169,651,1449,0.4492753623188406,265,722,0.3670360110803324,386,727,0.530949105914718,0.541,624,727,0.8583218707015131
Maurice Harkless,harklma01,SF,24,POR,2018,59,1264.0,385,53,46,116,162,48,43,40,103,147,297,0.494949494949495,49,118,0.4152542372881356,98,179,0.547486033519553,0.577,42,59,0.711864406779661
Montrezl Harrell,harremo01,C,24,LAC,2018,76,1293.0,836,74,103,203,306,36,52,68,143,348,548,0.635036496350365,1,7,0.1428571428571428,347,541,0.6414048059149723,0.636,139,222,0.6261261261261262
Devin Harris,harride01,PG,34,TOT,2018,71,1340.0,595,152,12,115,127,47,12,76,158,187,454,0.4118942731277533,79,227,0.3480176211453744,108,227,0.4757709251101321,0.499,142,170,0.8352941176470589
Gary Harris,harriga01,SG,23,DEN,2018,67,2304.0,1170,194,37,139,176,122,15,119,119,440,908,0.4845814977973568,156,394,0.3959390862944162,284,514,0.5525291828793775,0.57,134,162,0.8271604938271605
Joe Harris,harrijo01,SG,26,BRK,2018,78,1975.0,846,128,51,209,260,35,20,91,153,305,621,0.4911433172302737,150,358,0.4189944134078212,155,263,0.5893536121673004,0.612,86,104,0.8269230769230769
Tobias Harris,harrito02,PF,25,TOT,2018,80,2668.0,1486,192,58,379,437,71,35,105,164,562,1221,0.4602784602784602,183,445,0.4112359550561797,379,776,0.4884020618556701,0.535,179,216,0.8287037037037037
Aaron Harrison,harriaa01,SG,23,DAL,2018,9,233.0,60,11,4,20,24,9,2,3,27,19,69,0.2753623188405797,9,43,0.2093023255813953,10,26,0.3846153846153846,0.341,13,17,0.7647058823529411
Andrew Harrison,harrian01,PG,23,MEM,2018,56,1326.0,533,177,23,108,131,38,26,81,138,181,429,0.4219114219114219,47,142,0.3309859154929577,134,287,0.4668989547038327,0.477,124,159,0.779874213836478
Shaquille Harrison,harrish01,PG,24,PHO,2018,23,384.0,152,55,9,52,61,26,7,22,42,59,124,0.4758064516129032,6,26,0.2307692307692307,53,98,0.5408163265306123,0.5,28,38,0.7368421052631579
Josh Hart,hartjo01,SG,22,LAL,2018,63,1461.0,496,80,42,221,263,47,16,47,107,176,375,0.4693333333333333,78,197,0.3959390862944162,98,178,0.550561797752809,0.573,66,94,0.7021276595744681
Udonis Haslem,hasleud01,C,37,MIA,2018,14,72.0,8,5,3,7,10,0,2,2,3,3,15,0.2,1,8,0.125,2,7,0.2857142857142857,0.233,1,2,0.5
Nigel Hayes,hayesni01,SF,23,TOT,2018,9,122.0,27,6,4,18,22,2,3,2,8,11,33,0.3333333333333333,4,16,0.25,7,17,0.4117647058823529,0.394,1,3,0.3333333333333333
Gordon Hayward,haywago01,SF,27,BOS,2018,1,5.0,2,0,0,1,1,0,0,0,1,1,2,0.5,0,1,0.0,1,1,1.0,0.5,0,0,0.0
Reggie Hearn,hearnre01,SG,26,DET,2018,3,7.0,3,0,0,0,0,0,0,0,0,1,2,0.5,1,2,0.5,0,0,0.0,0.75,0,0,0.0
Myke Henry,henrymy01,SF,25,MEM,2018,20,378.0,107,22,10,28,38,31,6,19,28,41,109,0.3761467889908257,19,58,0.3275862068965517,22,51,0.4313725490196078,0.463,6,10,0.6
John Henson,hensojo01,C,27,MIL,2018,76,1970.0,665,114,150,363,513,45,109,84,202,287,502,0.5717131474103586,1,7,0.1428571428571428,286,495,0.5777777777777777,0.573,90,158,0.569620253164557
Juancho Hernangómez,hernaju01,PF,22,DEN,2018,25,277.0,82,12,18,36,54,6,3,9,25,29,75,0.3866666666666666,14,50,0.28,15,25,0.6,0.48,10,12,0.8333333333333334
Willy Hernangómez,hernawi01,C,23,TOT,2018,48,495.0,246,33,61,122,183,18,16,35,64,91,164,0.5548780487804879,5,12,0.4166666666666667,86,152,0.5657894736842105,0.57,59,90,0.6555555555555556
Mario Hezonja,hezonma01,SF,22,ORL,2018,75,1657.0,722,106,41,240,281,81,31,86,134,273,617,0.4424635332252836,90,267,0.3370786516853932,183,350,0.5228571428571429,0.515,86,105,0.819047619047619
Isaiah Hicks,hicksis01,PF,23,NYK,2018,18,240.0,80,16,10,31,41,2,4,16,45,33,72,0.4583333333333333,2,9,0.2222222222222222,31,63,0.492063492063492,0.472,12,18,0.6666666666666666
Buddy Hield,hieldbu01,SG,25,SAC,2018,80,2024.0,1079,155,55,252,307,85,22,124,148,416,933,0.4458735262593783,176,408,0.4313725490196078,240,525,0.4571428571428571,0.54,71,81,0.8765432098765432
Nenê,hilarne01,C,35,HOU,2018,52,758.0,340,45,54,122,176,28,14,38,123,136,239,0.5690376569037657,0,2,0.0,136,237,0.5738396624472574,0.569,68,107,0.6355140186915887
George Hill,hillge01,PG,31,TOT,2018,67,1812.0,667,186,42,139,181,61,27,88,128,236,513,0.4600389863547758,85,205,0.4146341463414634,151,308,0.4902597402597403,0.543,110,140,0.7857142857142857
Solomon Hill,hillso01,SF,26,NOP,2018,12,187.0,29,22,9,27,36,7,1,9,22,11,41,0.2682926829268293,4,21,0.1904761904761904,7,20,0.35,0.317,3,6,0.5
Darrun Hilliard,hillida01,SG,24,SAS,2018,14,95.0,16,11,0,7,7,2,0,4,7,5,19,0.2631578947368421,0,6,0.0,5,13,0.3846153846153846,0.263,6,7,0.8571428571428571
Jrue Holiday,holidjr01,SG,27,NOP,2018,81,2927.0,1537,486,62,303,365,123,64,213,201,615,1244,0.4943729903536977,120,356,0.3370786516853932,495,888,0.5574324324324325,0.543,187,238,0.7857142857142857
Justin Holiday,holidju01,SG,28,CHI,2018,72,2265.0,876,153,31,260,291,80,31,93,134,290,782,0.3708439897698209,161,449,0.3585746102449889,129,333,0.3873873873873873,0.474,135,164,0.823170731707317
John Holland,hollajo02,SF,29,CLE,2018,24,174.0,54,5,6,18,24,7,2,8,10,17,59,0.288135593220339,11,36,0.3055555555555556,6,23,0.2608695652173913,0.381,9,13,0.6923076923076923
Rondae Hollis-Jefferson,holliro01,SF,23,BRK,2018,68,1920.0,946,167,101,358,459,65,48,121,145,342,724,0.4723756906077348,13,54,0.2407407407407407,329,670,0.491044776119403,0.481,249,316,0.7879746835443038
Richaun Holmes,holmeri01,C,24,PHI,2018,48,746.0,311,61,57,154,211,20,29,25,97,135,241,0.5601659751037344,4,31,0.1290322580645161,131,210,0.6238095238095238,0.568,37,56,0.6607142857142857
Rodney Hood,hoodro01,SG,25,TOT,2018,60,1616.0,882,95,22,143,165,45,12,70,105,322,751,0.4287616511318242,127,333,0.3813813813813814,195,418,0.4665071770334928,0.513,111,129,0.8604651162790697
Scotty Hopson,hopsosc01,SG,28,DAL,2018,1,8.0,1,1,0,0,0,0,0,1,0,0,1,0.0,0,0,0.0,0,1,0.0,0.0,1,2,0.5
Al Horford,horfoal01,C,31,BOS,2018,72,2277.0,927,339,103,427,530,43,78,132,138,368,753,0.4887118193891102,97,226,0.4292035398230088,271,527,0.5142314990512334,0.553,94,120,0.7833333333333333
Danuel House Jr.,houseda01,SG,24,PHO,2018,23,403.0,152,25,13,63,76,7,6,11,23,56,129,0.4341085271317829,15,58,0.2586206896551724,41,71,0.5774647887323944,0.492,25,31,0.8064516129032258
Dwight Howard,howardw01,C,32,CHO,2018,81,2463.0,1347,105,255,757,1012,48,131,208,249,506,911,0.5554335894621295,1,7,0.1428571428571428,505,904,0.5586283185840708,0.556,334,582,0.5738831615120275
Josh Huestis,huestjo01,PF,26,OKC,2018,69,982.0,159,20,42,119,161,15,43,26,82,60,182,0.3296703296703296,33,115,0.2869565217391304,27,67,0.4029850746268656,0.42,6,20,0.3
R.J. Hunter,hunterj01,SG,24,HOU,2018,5,45.0,19,3,0,5,5,3,0,2,7,7,20,0.35,3,14,0.2142857142857142,4,6,0.6666666666666666,0.425,2,2,1.0
Vince Hunter,huntevi01,PF,23,MEM,2018,4,7.0,6,0,2,1,3,0,1,1,0,3,5,0.6,0,0,0.0,3,5,0.6,0.6,0,0,0.0
Serge Ibaka,ibakase01,PF,28,TOR,2018,76,2093.0,959,62,78,400,478,29,99,90,209,379,784,0.4834183673469387,107,297,0.3602693602693603,272,487,0.5585215605749486,0.552,94,118,0.7966101694915254
Andre Iguodala,iguodan01,SF,34,GSW,2018,64,1622.0,384,210,50,196,246,54,38,67,99,148,320,0.4625,33,117,0.282051282051282,115,203,0.5665024630541872,0.514,55,87,0.632183908045977
Ersan İlyasova,ilyaser01,PF,30,TOT,2018,69,1729.0,750,90,118,287,405,61,26,72,157,277,613,0.4518760195758564,91,253,0.3596837944664031,186,360,0.5166666666666667,0.526,105,135,0.7777777777777778
Joe Ingles,inglejo01,SF,30,UTA,2018,82,2578.0,940,392,24,320,344,90,20,159,178,335,718,0.4665738161559888,204,464,0.4396551724137931,131,254,0.515748031496063,0.609,66,83,0.7951807228915663
Andre Ingram,ingraan01,SG,32,LAL,2018,2,64.0,24,7,1,5,6,3,3,3,3,8,17,0.4705882352941176,5,9,0.5555555555555556,3,8,0.375,0.618,3,3,1.0
Brandon Ingram,ingrabr01,SF,20,LAL,2018,59,1975.0,949,230,57,257,314,45,43,149,163,358,761,0.4704336399474376,41,105,0.3904761904761905,317,656,0.4832317073170731,0.497,192,282,0.6808510638297872
Kyrie Irving,irvinky01,PG,25,BOS,2018,60,1931.0,1466,306,33,194,227,65,17,140,122,534,1087,0.4912603495860165,166,407,0.4078624078624078,368,680,0.5411764705882353,0.568,232,261,0.8888888888888888
Jonathan Isaac,isaacjo01,PF,20,ORL,2018,27,536.0,145,18,16,83,99,33,30,27,48,55,145,0.3793103448275862,16,46,0.3478260869565217,39,99,0.3939393939393939,0.434,19,25,0.76
Wes Iwundu,iwundwe01,SF,23,ORL,2018,62,1020.0,229,57,36,101,137,33,12,30,81,93,218,0.4266055045871559,9,46,0.1956521739130435,84,172,0.4883720930232558,0.447,34,47,0.723404255319149
Jarrett Jack,jackja01,PG,34,NYK,2018,62,1548.0,466,348,22,169,191,35,4,115,98,189,443,0.4266365688487584,25,86,0.2906976744186046,164,357,0.4593837535014005,0.455,63,75,0.84
Aaron Jackson,jacksaa01,PG,31,HOU,2018,1,35.0,8,1,2,1,3,0,0,1,4,3,9,0.3333333333333333,1,4,0.25,2,5,0.4,0.389,1,2,0.5
Demetrius Jackson,jacksde01,PG,23,TOT,2018,15,80.0,16,9,5,7,12,5,1,10,7,7,18,0.3888888888888889,1,7,0.1428571428571428,6,11,0.5454545454545454,0.417,1,2,0.5
Josh Jackson,jacksjo02,SF,20,PHO,2018,77,1959.0,1012,119,95,256,351,80,35,146,218,389,932,0.417381974248927,57,217,0.2626728110599078,332,715,0.4643356643356643,0.448,177,279,0.6344086021505376
Justin Jackson,jacksju01,SF,22,SAC,2018,68,1506.0,453,74,27,160,187,28,13,40,81,185,419,0.441527446300716,57,185,0.3081081081081081,128,234,0.5470085470085471,0.51,26,36,0.7222222222222222
Reggie Jackson,jacksre01,PG,27,DET,2018,45,1201.0,656,238,29,96,125,27,4,99,87,246,577,0.4263431542461005,52,169,0.3076923076923077,194,408,0.4754901960784313,0.471,112,134,0.835820895522388
LeBron James,jamesle01,PF,33,CLE,2018,82,3026.0,2251,747,97,612,709,116,71,347,136,857,1580,0.5424050632911392,149,406,0.3669950738916256,708,1174,0.6030664395229983,0.59,388,531,0.7306967984934086
Mike James,jamesmi02,PG,27,TOT,2018,36,687.0,336,126,13,77,90,28,7,49,48,123,321,0.3831775700934579,26,98,0.2653061224489796,97,223,0.4349775784753363,0.424,64,84,0.7619047619047619
Al Jefferson,jeffeal01,C,33,IND,2018,36,484.0,252,30,30,113,143,16,23,21,66,111,208,0.5336538461538461,0,3,0.0,111,205,0.5414634146341464,0.534,30,36,0.8333333333333334
Richard Jefferson,jefferi01,SF,37,DEN,2018,20,163.0,30,15,2,15,17,2,1,5,11,12,27,0.4444444444444444,2,7,0.2857142857142857,10,20,0.5,0.481,4,7,0.5714285714285714
Brandon Jennings,jennibr01,PG,28,MIL,2018,14,205.0,73,44,5,26,31,6,4,18,11,27,72,0.375,9,33,0.2727272727272727,18,39,0.4615384615384615,0.438,10,10,1.0
Jonas Jerebko,jerebjo01,PF,30,UTA,2018,74,1134.0,429,42,53,193,246,24,12,27,127,159,341,0.4662756598240469,65,157,0.4140127388535032,94,184,0.5108695652173914,0.562,46,57,0.8070175438596491
Amir Johnson,johnsam01,C,30,PHI,2018,74,1171.0,342,118,123,207,330,45,44,55,192,140,260,0.5384615384615384,10,32,0.3125,130,228,0.5701754385964912,0.558,52,85,0.611764705882353
Brice Johnson,johnsbr02,PF,23,TOT,2018,18,98.0,43,2,9,22,31,9,6,5,13,20,42,0.4761904761904761,0,1,0.0,20,41,0.4878048780487805,0.476,3,5,0.6
Dakari Johnson,johnsda04,C,22,OKC,2018,31,161.0,55,8,16,18,34,6,8,3,27,22,39,0.5641025641025641,0,0,0.0,22,39,0.5641025641025641,0.564,11,20,0.55
James Johnson,johnsja01,PF,30,MIA,2018,73,1943.0,788,280,61,297,358,70,51,141,192,309,614,0.503257328990228,57,185,0.3081081081081081,252,429,0.5874125874125874,0.55,113,162,0.6975308641975309
Joe Johnson,johnsjo02,SF,36,TOT,2018,55,1205.0,372,83,14,158,172,18,7,49,67,146,360,0.4055555555555555,40,145,0.2758620689655172,106,215,0.4930232558139535,0.461,40,45,0.8888888888888888
Omari Johnson,johnsom01,PF,28,MEM,2018,4,75.0,22,7,4,7,11,2,0,3,6,9,21,0.4285714285714285,4,12,0.3333333333333333,5,9,0.5555555555555556,0.524,0,0,0.0
Stanley Johnson,johnsst04,SF,21,DET,2018,69,1894.0,599,112,33,219,252,95,14,77,169,210,560,0.375,67,234,0.2863247863247863,143,326,0.4386503067484663,0.435,112,145,0.7724137931034483
Tyler Johnson,johnsty01,PG,25,MIA,2018,72,2052.0,843,165,34,214,248,60,34,81,148,309,711,0.4345991561181435,119,324,0.3672839506172839,190,387,0.4909560723514212,0.518,106,129,0.8217054263565892
Wesley Johnson,johnswe01,SF,30,LAC,2018,74,1486.0,403,61,29,187,216,76,62,55,146,150,368,0.4076086956521739,60,177,0.3389830508474576,90,191,0.4712041884816754,0.489,43,58,0.7413793103448276
Nikola Jokić,jokicni01,C,22,DEN,2018,75,2443.0,1385,458,195,608,803,90,61,210,212,504,1010,0.499009900990099,111,280,0.3964285714285714,393,730,0.5383561643835616,0.554,266,313,0.8498402555910544
Damian Jones,jonesda03,C,22,GSW,2018,15,89.0,25,2,5,9,14,1,3,4,14,11,22,0.5,0,0,0.0,11,22,0.5,0.5,3,5,0.6
Derrick Jones Jr.,jonesde02,SF,20,TOT,2018,20,245.0,61,9,21,17,38,4,13,7,24,21,53,0.3962264150943396,3,18,0.1666666666666666,18,35,0.5142857142857142,0.425,16,24,0.6666666666666666
Jalen Jones,jonesja04,SF,24,TOT,2018,16,181.0,74,4,13,25,38,5,1,7,22,26,68,0.3823529411764705,10,26,0.3846153846153846,16,42,0.3809523809523809,0.456,12,19,0.631578947368421
Tyus Jones,jonesty01,PG,21,MIN,2018,82,1467.0,416,232,16,116,132,95,6,59,110,150,328,0.4573170731707317,45,129,0.3488372093023256,105,199,0.5276381909547738,0.526,71,81,0.8765432098765432
DeAndre Jordan,jordade01,C,29,LAC,2018,77,2424.0,927,117,329,842,1171,39,71,137,203,373,578,0.6453287197231834,0,0,0.0,373,578,0.6453287197231834,0.645,181,312,0.5801282051282052
Cory Joseph,josepco01,PG,26,IND,2018,82,2210.0,649,260,39,224,263,80,18,87,141,256,604,0.423841059602649,67,190,0.3526315789473684,189,414,0.4565217391304347,0.479,70,94,0.7446808510638298
Frank Kaminsky,kaminfr01,PF,24,CHO,2018,79,1835.0,873,129,46,242,288,36,19,66,95,307,716,0.4287709497206703,104,274,0.3795620437956204,203,442,0.4592760180995475,0.501,155,194,0.7989690721649485
Luke Kennard,kennalu01,SG,21,DET,2018,73,1463.0,558,124,21,155,176,44,13,69,86,206,465,0.443010752688172,81,195,0.4153846153846154,125,270,0.4629629629629629,0.53,65,76,0.8552631578947368
Michael Kidd-Gilchrist,kiddgmi01,SF,24,CHO,2018,74,1850.0,681,71,84,218,302,51,32,53,143,282,560,0.5035714285714286,0,2,0.0,282,558,0.5053763440860215,0.504,117,171,0.6842105263157895
Sean Kilpatrick,kilpase01,SG,28,TOT,2018,52,640.0,330,46,5,82,87,13,5,38,33,110,294,0.3741496598639456,46,144,0.3194444444444444,64,150,0.4266666666666667,0.452,64,72,0.8888888888888888
Maxi Kleber,klebima01,PF,26,DAL,2018,72,1206.0,386,51,71,163,234,26,47,30,114,151,309,0.4886731391585761,40,128,0.3125,111,181,0.6132596685082873,0.553,44,59,0.7457627118644068
Furkan Korkmaz,korkmfu01,SG,20,PHI,2018,14,80.0,23,4,2,9,11,2,1,2,12,8,28,0.2857142857142857,5,17,0.2941176470588235,3,11,0.2727272727272727,0.375,2,4,0.5
Luke Kornet,kornelu01,PF,22,NYK,2018,20,326.0,134,26,11,53,64,6,16,12,28,49,125,0.392,28,79,0.3544303797468354,21,46,0.4565217391304347,0.504,8,11,0.7272727272727273
Kyle Korver,korveky01,SG,36,CLE,2018,73,1574.0,672,88,9,156,165,31,27,55,130,222,484,0.4586776859504132,164,376,0.4361702127659574,58,108,0.5370370370370371,0.628,64,72,0.8888888888888888
Kosta Koufos,koufoko01,C,28,SAC,2018,71,1391.0,477,87,149,323,472,47,32,49,146,222,389,0.570694087403599,0,0,0.0,222,389,0.570694087403599,0.571,33,74,0.4459459459459459
Kyle Kuzma,kuzmaky01,PF,22,LAL,2018,77,2401.0,1242,141,88,395,483,49,34,140,160,468,1039,0.4504331087584216,159,434,0.3663594470046083,309,605,0.5107438016528926,0.527,147,208,0.7067307692307693
Mindaugas Kuzminskas,kuzmimi01,SF,28,NYK,2018,1,2.0,0,0,0,0,0,0,0,0,0,0,2,0.0,0,0,0.0,0,2,0.0,0.0,0,0,0.0
Skal Labissière,labissk01,PF,21,SAC,2018,60,1240.0,523,72,99,189,288,25,49,73,132,205,458,0.4475982532751091,18,51,0.3529411764705882,187,407,0.4594594594594595,0.467,95,118,0.8050847457627118
Jeremy Lamb,lambje01,SG,25,CHO,2018,80,1967.0,1033,186,49,275,324,61,32,93,138,380,832,0.4567307692307692,94,254,0.3700787401574803,286,578,0.4948096885813148,0.513,179,208,0.8605769230769231
Shane Larkin,larkish01,PG,25,BOS,2018,54,775.0,231,98,15,77,92,29,2,33,58,84,219,0.3835616438356164,31,86,0.3604651162790697,53,133,0.3984962406015037,0.454,32,37,0.8648648648648649
Joffrey Lauvergne,lauvejo01,C,26,SAS,2018,55,534.0,226,41,63,108,171,9,3,33,45,98,190,0.5157894736842106,0,5,0.0,98,185,0.5297297297297298,0.516,30,47,0.6382978723404256
Zach LaVine,lavinza01,SG,22,CHI,2018,24,656.0,401,72,9,85,94,24,4,43,55,136,355,0.3830985915492957,42,123,0.3414634146341463,94,232,0.4051724137931034,0.442,87,107,0.8130841121495327
Jake Layman,laymaja01,SF,23,POR,2018,35,160.0,34,11,4,12,16,6,4,5,13,14,47,0.2978723404255319,4,20,0.2,10,27,0.3703703703703703,0.34,2,3,0.6666666666666666
T.J. Leaf,leaftj01,PF,20,IND,2018,53,459.0,156,9,29,53,82,5,4,10,45,64,136,0.4705882352941176,18,42,0.4285714285714285,46,94,0.4893617021276595,0.537,10,16,0.625
Courtney Lee,leeco01,SG,32,NYK,2018,76,2310.0,913,180,30,194,224,80,17,84,109,343,755,0.4543046357615894,113,278,0.4064748201438849,230,477,0.4821802935010482,0.529,114,124,0.9193548387096774
Damion Lee,leeda03,SG,25,ATL,2018,15,404.0,161,29,11,60,71,19,1,14,25,62,152,0.4078947368421052,15,60,0.25,47,92,0.5108695652173914,0.457,22,29,0.7586206896551724
Walt Lemon Jr.,lemonwa01,PG,25,NOP,2018,5,35.0,17,5,0,2,2,0,1,4,5,7,16,0.4375,1,1,1.0,6,15,0.4,0.469,2,3,0.6666666666666666
Alex Len,lenal01,C,24,PHO,2018,69,1395.0,587,82,175,343,518,27,61,78,158,214,378,0.5661375661375662,1,3,0.3333333333333333,213,375,0.568,0.567,158,231,0.683982683982684
Kawhi Leonard,leonaka01,SF,26,SAS,2018,9,210.0,146,21,6,36,42,18,9,16,9,52,111,0.4684684684684684,11,35,0.3142857142857143,41,76,0.5394736842105263,0.518,31,38,0.8157894736842105
Meyers Leonard,leoname01,C,25,POR,2018,33,254.0,112,17,12,58,70,7,0,10,36,46,78,0.5897435897435898,11,26,0.4230769230769231,35,52,0.6730769230769231,0.66,9,11,0.8181818181818182
Jon Leuer,leuerjo01,PF,28,DET,2018,8,136.0,43,5,7,25,32,1,3,7,16,15,36,0.4166666666666667,0,3,0.0,15,33,0.4545454545454545,0.417,13,15,0.8666666666666667
Caris LeVert,leverca01,SF,23,BRK,2018,71,1864.0,858,299,53,207,260,82,22,153,159,320,735,0.4353741496598639,85,245,0.3469387755102041,235,490,0.4795918367346938,0.493,133,187,0.7112299465240641
DeAndre Liggins,liggide01,SG,29,TOT,2018,58,724.0,101,48,7,68,75,37,14,20,81,40,106,0.3773584905660377,19,53,0.3584905660377358,21,53,0.3962264150943396,0.467,2,5,0.4
Damian Lillard,lillada01,PG,27,POR,2018,73,2670.0,1962,481,62,263,325,77,27,206,117,621,1415,0.43886925795053,227,629,0.3608903020667726,394,786,0.5012722646310432,0.519,493,538,0.91635687732342
Jeremy Lin,linje01,PG,29,BRK,2018,1,25.0,18,4,0,0,0,0,0,3,3,5,12,0.4166666666666667,1,2,0.5,4,10,0.4,0.458,7,7,1.0
Shaun Livingston,livinsh01,PG,32,GSW,2018,71,1129.0,394,140,32,99,131,35,21,58,117,172,343,0.5014577259475219,0,5,0.0,172,338,0.5088757396449705,0.501,50,61,0.819672131147541
Kevon Looney,looneke01,C,21,GSW,2018,66,910.0,267,42,83,132,215,34,56,31,106,112,193,0.5803108808290155,1,5,0.2,111,188,0.5904255319148937,0.583,42,77,0.5454545454545454
Brook Lopez,lopezbr01,C,29,LAL,2018,74,1735.0,961,126,74,220,294,30,98,98,195,369,793,0.4653215636822194,112,325,0.3446153846153846,257,468,0.5491452991452992,0.536,111,158,0.7025316455696202
Robin Lopez,lopezro01,C,29,CHI,2018,64,1690.0,756,124,134,156,290,14,53,107,109,342,645,0.5302325581395348,4,14,0.2857142857142857,338,631,0.5356576862123613,0.533,68,90,0.7555555555555555
Kevin Love,loveke01,C,29,CLE,2018,59,1651.0,1039,103,101,445,546,43,24,90,120,334,729,0.4581618655692729,137,330,0.4151515151515151,197,399,0.4937343358395989,0.552,234,266,0.8796992481203008
Kyle Lowry,lowryky01,PG,31,TOR,2018,78,2510.0,1267,537,66,368,434,85,19,183,192,403,944,0.4269067796610169,238,596,0.3993288590604026,165,348,0.4741379310344827,0.553,223,261,0.8544061302681992
Timothé Luwawu-Cabarrot,luwawti01,SF,22,PHI,2018,52,807.0,299,54,14,58,72,12,5,38,97,100,267,0.3745318352059925,53,158,0.3354430379746835,47,109,0.4311926605504587,0.474,46,58,0.7931034482758621
Tyler Lydon,lydonty01,PF,21,DEN,2018,1,2.0,0,0,0,0,0,0,0,0,0,0,0,0.0,0,0,0.0,0,0,0.0,0.0,0,0,0.0
Trey Lyles,lylestr01,PF,22,DEN,2018,73,1391.0,724,91,55,292,347,30,34,61,111,270,550,0.4909090909090909,83,218,0.3807339449541284,187,332,0.5632530120481928,0.566,101,143,0.7062937062937062
Shelvin Mack,macksh01,PG,27,ORL,2018,69,1365.0,473,272,23,143,166,54,8,89,91,178,414,0.429951690821256,48,139,0.3453237410071942,130,275,0.4727272727272727,0.488,69,97,0.711340206185567
Josh Magette,magetjo01,PG,28,ATL,2018,18,216.0,46,57,2,17,19,8,1,9,16,15,46,0.3260869565217391,8,22,0.3636363636363636,7,24,0.2916666666666667,0.413,8,8,1.0
Ian Mahinmi,mahinia01,C,31,WAS,2018,77,1145.0,366,53,135,177,312,38,42,100,230,138,248,0.5564516129032258,0,2,0.0,138,246,0.5609756097560976,0.556,90,128,0.703125
Thon Maker,makerth01,C,20,MIL,2018,74,1238.0,356,46,75,150,225,38,53,44,162,130,316,0.4113924050632911,31,104,0.2980769230769231,99,212,0.4669811320754717,0.46,65,93,0.6989247311827957
Boban Marjanović,marjabo01,C,29,TOT,2018,39,337.0,235,22,48,96,144,10,11,36,51,79,148,0.5337837837837838,0,0,0.0,79,148,0.5337837837837838,0.534,77,97,0.7938144329896907
Lauri Markkanen,markkla01,PF,20,CHI,2018,68,2020.0,1033,79,79,429,508,39,40,83,103,374,862,0.4338747099767981,145,401,0.3615960099750623,229,461,0.4967462039045553,0.518,140,166,0.8433734939759037
Jarell Martin,martija01,PF,23,MEM,2018,73,1661.0,565,73,97,221,318,39,49,86,211,221,496,0.4455645161290322,34,98,0.3469387755102041,187,398,0.4698492462311557,0.48,89,116,0.7672413793103449
Frank Mason III,masonfr01,PG,23,SAC,2018,52,984.0,413,147,30,100,130,34,10,65,72,144,380,0.3789473684210526,31,86,0.3604651162790697,113,294,0.3843537414965986,0.42,94,115,0.8173913043478261
Mangok Mathiang,mathima01,C,25,CHO,2018,4,20.0,8,0,3,7,10,1,0,0,5,4,7,0.5714285714285714,0,0,0.0,4,7,0.5714285714285714,0.571,0,1,0.0
Wesley Matthews,matthwe02,SF,31,DAL,2018,63,2131.0,802,172,28,170,198,76,16,83,140,283,697,0.406025824964132,153,402,0.3805970149253731,130,295,0.4406779661016949,0.516,83,101,0.8217821782178217
Luc Mbah a Moute,mbahalu01,PF,31,HOU,2018,61,1564.0,460,55,22,164,186,72,25,68,100,166,345,0.4811594202898551,63,173,0.3641618497109826,103,172,0.5988372093023255,0.572,65,95,0.6842105263157895
James Michael McAdoo,mcadoja01,PF,25,PHI,2018,3,18.0,8,0,0,2,2,0,1,1,1,2,7,0.2857142857142857,2,7,0.2857142857142857,0,0,0.0,0.429,2,2,1.0
Patrick McCaw,mccawpa01,SG,22,GSW,2018,57,961.0,229,81,16,66,82,43,10,41,67,92,225,0.4088888888888889,19,80,0.2375,73,145,0.503448275862069,0.451,26,34,0.7647058823529411
CJ McCollum,mccolcj01,SG,26,POR,2018,81,2923.0,1732,272,53,268,321,77,35,151,168,667,1505,0.4431893687707641,189,476,0.3970588235294117,478,1029,0.4645286686103013,0.506,209,250,0.836
T.J. McConnell,mccontj01,PG,25,PHI,2018,76,1706.0,478,303,37,189,226,92,13,112,122,210,421,0.498812351543943,27,62,0.4354838709677419,183,359,0.5097493036211699,0.531,31,39,0.7948717948717948
Erik McCree,mccreer01,SF,24,UTA,2018,4,8.0,0,0,0,1,1,1,0,1,0,0,2,0.0,0,1,0.0,0,1,0.0,0.0,0,0,0.0
Chris McCullough,mcculch01,PF,22,WAS,2018,19,90.0,46,4,7,18,25,0,5,2,8,18,42,0.4285714285714285,1,8,0.125,17,34,0.5,0.44,9,14,0.6428571428571429
Doug McDermott,mcderdo01,SF,26,TOT,2018,81,1768.0,630,79,40,160,200,19,16,56,122,237,508,0.4665354330708661,92,216,0.4259259259259259,145,292,0.4965753424657534,0.557,64,81,0.7901234567901234
JaVale McGee,mcgeeja01,C,30,GSW,2018,65,615.0,310,33,59,110,169,21,57,27,91,136,219,0.6210045662100456,0,6,0.0,136,213,0.6384976525821596,0.621,38,52,0.7307692307692307
Rodney McGruder,mcgruro01,SG,26,MIA,2018,18,299.0,91,17,11,22,33,8,3,4,21,36,73,0.4931506849315068,15,35,0.4285714285714285,21,38,0.5526315789473685,0.596,4,8,0.5
Trey McKinney-Jones,mckintr01,SG,27,IND,2018,1,1.0,0,0,0,0,0,0,0,0,0,0,0,0.0,0,0,0.0,0,0,0.0,0.0,0,0,0.0
Alfonzo McKinnie,mckinal01,SF,25,TOR,2018,14,53.0,21,1,1,6,7,1,1,3,8,8,15,0.5333333333333333,3,9,0.3333333333333333,5,6,0.8333333333333334,0.633,2,3,0.6666666666666666
Ben McLemore,mclembe01,SG,24,MEM,2018,56,1091.0,422,51,34,105,139,38,15,61,139,157,373,0.420911528150134,55,159,0.3459119496855345,102,214,0.4766355140186916,0.495,53,64,0.828125
Josh McRoberts,mcrobjo01,PF,30,DAL,2018,2,6.0,0,0,0,0,0,0,0,0,2,0,1,0.0,0,1,0.0,0,0,0.0,0.0,0,0,0.0
Jodie Meeks,meeksjo01,SG,30,WAS,2018,77,1119.0,487,70,15,111,126,29,4,37,55,157,393,0.3994910941475827,72,210,0.3428571428571428,85,183,0.4644808743169399,0.491,101,117,0.8632478632478633
Salah Mejri,mejrisa01,C,31,DAL,2018,61,729.0,214,35,85,161,246,22,67,39,121,88,137,0.6423357664233577,0,3,0.0,88,134,0.6567164179104478,0.642,38,66,0.5757575757575758
Jordan Mickey,mickejo01,PF,23,MIA,2018,23,284.0,93,9,18,63,81,6,10,18,36,39,82,0.4756097560975609,2,16,0.125,37,66,0.5606060606060606,0.488,13,19,0.6842105263157895
Khris Middleton,middlkh01,SF,26,MIL,2018,82,2982.0,1652,328,45,384,429,119,21,191,270,593,1272,0.4661949685534591,146,407,0.3587223587223587,447,865,0.5167630057803468,0.524,320,362,0.8839779005524862
C.J. Miles,milescj01,SF,30,TOR,2018,70,1337.0,699,55,18,134,152,37,21,39,134,227,599,0.3789649415692821,164,454,0.3612334801762114,63,145,0.4344827586206896,0.516,81,97,0.8350515463917526
Darius Miller,milleda01,SF,27,NOP,2018,82,1944.0,637,111,18,146,164,28,17,58,160,216,487,0.4435318275154004,147,358,0.4106145251396648,69,129,0.5348837209302325,0.594,58,67,0.8656716417910447
Malcolm Miller,millema01,SF,24,TOR,2018,15,126.0,38,3,4,11,15,1,2,5,10,13,28,0.4642857142857143,8,21,0.3809523809523809,5,7,0.7142857142857143,0.607,4,4,1.0
Patty Mills,millspa02,PG,29,SAS,2018,82,2107.0,819,229,26,128,154,55,11,106,128,280,682,0.4105571847507331,154,414,0.3719806763285024,126,268,0.4701492537313433,0.523,105,118,0.8898305084745762
Paul Millsap,millspa01,PF,32,DEN,2018,38,1143.0,555,105,65,180,245,39,44,73,99,202,435,0.464367816091954,39,113,0.3451327433628318,163,322,0.5062111801242236,0.509,112,161,0.6956521739130435
Nikola Mirotić,mirotni01,PF,26,TOT,2018,55,1494.0,859,80,59,346,405,44,39,62,108,306,684,0.4473684210526316,135,358,0.3770949720670391,171,326,0.5245398773006135,0.546,112,137,0.8175182481751825
Donovan Mitchell,mitchdo01,SG,21,UTA,2018,79,2638.0,1616,291,52,244,296,118,27,215,213,595,1362,0.4368575624082232,187,550,0.34,408,812,0.5024630541871922,0.506,239,297,0.8047138047138047
Naz Mitrou-Long,mitrona01,SG,24,UTA,2018,1,1.0,3,0,0,0,0,0,0,0,0,1,1,1.0,1,1,1.0,0,0,0.0,1.5,0,0,0.0
Malik Monk,monkma01,SG,19,CHO,2018,63,854.0,421,91,8,58,66,20,9,49,60,153,425,0.36,83,243,0.3415637860082304,70,182,0.3846153846153846,0.458,32,38,0.8421052631578947
Greg Monroe,monrogr01,C,27,TOT,2018,51,1040.0,524,114,109,241,350,44,23,94,95,218,386,0.5647668393782384,0,0,0.0,218,386,0.5647668393782384,0.565,88,119,0.7394957983193278
Luis Montero,montelu01,SG,24,DET,2018,2,8.0,0,0,0,2,2,0,0,2,0,0,1,0.0,0,0,0.0,0,1,0.0,0.0,0,0,0.0
Ben Moore,moorebe01,PF,22,IND,2018,2,9.0,0,1,0,1,1,0,0,0,4,0,0,0.0,0,0,0.0,0,0,0.0,0.0,0,0,0.0
E'Twaun Moore,mooreet01,SG,28,NOP,2018,82,2586.0,1022,187,57,181,238,79,12,102,182,423,832,0.5084134615384616,128,301,0.4252491694352159,295,531,0.5555555555555556,0.585,48,68,0.7058823529411765
Eric Moreland,moreler01,PF,26,DET,2018,67,805.0,143,78,81,197,278,31,51,42,116,66,122,0.5409836065573771,0,0,0.0,66,122,0.5409836065573771,0.541,11,29,0.3793103448275862
Jaylen Morris,morrija01,SG,22,ATL,2018,6,98.0,28,7,2,14,16,2,1,6,2,13,32,0.40625,2,10,0.2,11,22,0.5,0.438,0,0,0.0
Marcus Morris,morrima03,PF,28,BOS,2018,54,1442.0,734,72,43,246,289,35,12,65,100,262,611,0.4288052373158756,86,234,0.3675213675213675,176,377,0.4668435013262599,0.499,124,154,0.8051948051948052
Markieff Morris,morrima02,PF,28,WAS,2018,73,1968.0,841,142,75,334,409,56,38,127,216,330,687,0.4803493449781659,76,207,0.3671497584541063,254,480,0.5291666666666667,0.536,105,128,0.8203125
Monte Morris,morrimo01,PG,22,DEN,2018,3,25.0,10,7,0,2,2,3,0,1,1,4,6,0.6666666666666666,0,1,0.0,4,5,0.8,0.667,2,2,1.0
Johnathan Motley,motlejo01,PF,22,DAL,2018,11,176.0,96,7,14,35,49,3,2,9,18,40,75,0.5333333333333333,1,6,0.1666666666666666,39,69,0.5652173913043478,0.54,15,28,0.5357142857142857
Timofey Mozgov,mozgoti01,C,31,BRK,2018,31,359.0,131,11,32,66,98,5,13,33,39,52,93,0.5591397849462365,4,18,0.2222222222222222,48,75,0.64,0.581,23,30,0.7666666666666667
Emmanuel Mudiay,mudiaem01,PG,21,TOT,2018,64,1245.0,553,206,26,126,152,41,11,113,80,204,526,0.3878326996197718,47,148,0.3175675675675675,157,378,0.4153439153439153,0.433,98,129,0.7596899224806202
Shabazz Muhammad,muhamsh01,SF-SG,25,TOT,2018,43,418.0,214,14,23,53,76,9,3,6,30,84,188,0.4468085106382978,7,27,0.2592592592592592,77,161,0.4782608695652174,0.465,39,50,0.78
Xavier Munford,munfoxa02,SG,25,MIL,2018,6,21.0,3,4,1,0,1,1,0,2,4,1,6,0.1666666666666666,0,2,0.0,1,4,0.25,0.167,1,2,0.5
Dejounte Murray,murrade01,PG,21,SAS,2018,81,1743.0,654,231,110,349,459,97,31,134,151,270,609,0.4433497536945813,9,34,0.2647058823529412,261,575,0.4539130434782609,0.451,105,148,0.7094594594594594
Jamal Murray,murraja01,PG,20,DEN,2018,81,2565.0,1352,274,82,215,297,79,28,172,173,479,1062,0.4510357815442561,165,436,0.378440366972477,314,626,0.5015974440894568,0.529,229,253,0.9051383399209486
Mike Muscala,muscami01,C,26,ATL,2018,53,1060.0,405,51,56,174,230,31,27,42,80,143,312,0.4583333333333333,62,167,0.3712574850299401,81,145,0.5586206896551724,0.558,57,62,0.9193548387096774
Abdel Nader,naderab01,SF,24,BOS,2018,48,522.0,146,26,13,58,71,15,10,34,45,50,149,0.3355704697986577,23,65,0.3538461538461538,27,84,0.3214285714285714,0.413,23,39,0.5897435897435898
Larry Nance Jr.,nancela02,C,25,TOT,2018,66,1421.0,573,82,161,291,452,88,38,51,172,240,413,0.5811138014527845,2,12,0.1666666666666666,238,401,0.5935162094763092,0.584,91,137,0.6642335766423357
Shabazz Napier,napiesh01,PG,26,POR,2018,74,1535.0,644,150,26,144,170,81,14,90,84,223,531,0.4199623352165725,82,218,0.3761467889908257,141,313,0.4504792332268371,0.497,116,138,0.8405797101449275
Jameer Nelson,nelsoja01,PG,35,TOT,2018,50,1013.0,247,179,13,91,104,27,4,67,81,95,244,0.3893442622950819,41,124,0.3306451612903225,54,120,0.45,0.473,16,20,0.8
Raul Neto,netora01,PG,25,UTA,2018,41,498.0,183,75,7,42,49,13,4,36,38,69,151,0.4569536423841059,19,47,0.4042553191489361,50,104,0.4807692307692308,0.52,26,35,0.7428571428571429
Georges Niang,niangge01,PF,24,UTA,2018,9,32.0,9,3,3,6,9,2,0,3,1,4,11,0.3636363636363636,0,4,0.0,4,7,0.5714285714285714,0.364,1,2,0.5
Joakim Noah,noahjo01,C,32,NYK,2018,7,40.0,12,4,6,8,14,2,2,4,5,5,10,0.5,0,0,0.0,5,10,0.5,0.5,2,4,0.5
Nerlens Noel,noelne01,C,23,DAL,2018,30,472.0,131,20,48,120,168,31,22,26,59,55,105,0.5238095238095238,0,1,0.0,55,104,0.5288461538461539,0.524,21,28,0.75
Lucas Nogueira,noguelu01,C,25,TOR,2018,49,418.0,122,22,18,69,87,23,43,16,49,49,80,0.6125,5,19,0.2631578947368421,44,61,0.7213114754098361,0.644,19,28,0.6785714285714286
Dirk Nowitzki,nowitdi01,C,39,DAL,2018,77,1900.0,927,120,22,416,438,43,45,51,146,346,758,0.4564643799472295,138,337,0.4094955489614243,208,421,0.4940617577197149,0.547,97,108,0.8981481481481481
Frank Ntilikina,ntilila01,PG,19,NYK,2018,78,1706.0,463,250,37,140,177,65,18,131,181,182,500,0.364,50,157,0.3184713375796178,132,343,0.3848396501457726,0.414,49,68,0.7205882352941176
Jusuf Nurkić,nurkiju01,C,23,POR,2018,79,2088.0,1132,143,189,519,708,64,111,183,247,480,951,0.5047318611987381,0,7,0.0,480,944,0.5084745762711864,0.505,172,273,0.63003663003663
David Nwaba,nwabada01,SG,25,CHI,2018,70,1646.0,555,104,89,237,326,59,29,77,158,202,423,0.4775413711583924,18,52,0.3461538461538461,184,371,0.4959568733153638,0.499,133,203,0.6551724137931034
Johnny O'Bryant,obryajo01,PF,24,CHO,2018,36,379.0,171,14,29,64,93,9,6,15,45,68,171,0.3976608187134502,14,43,0.3255813953488372,54,128,0.421875,0.439,21,25,0.84
Royce O'Neale,onealro01,SF,24,UTA,2018,69,1150.0,343,95,25,211,236,36,16,55,105,120,284,0.4225352112676056,42,118,0.3559322033898305,78,166,0.4698795180722891,0.496,61,76,0.8026315789473685
Kyle O'Quinn,oquinky01,C,27,NYK,2018,77,1387.0,550,158,121,349,470,36,98,100,192,224,384,0.5833333333333334,4,17,0.2352941176470588,220,367,0.5994550408719346,0.589,98,127,0.7716535433070866
Semi Ojeleye,ojelese01,PF,23,BOS,2018,73,1150.0,195,20,37,124,161,21,4,25,91,65,188,0.3457446808510638,40,125,0.32,25,63,0.3968253968253968,0.452,25,41,0.6097560975609756
Emeka Okafor,okafoem01,C,35,NOP,2018,26,353.0,114,8,47,73,120,8,25,13,30,48,95,0.5052631578947369,0,0,0.0,48,95,0.5052631578947369,0.505,18,22,0.8181818181818182
Jahlil Okafor,okafoja01,C,22,TOT,2018,28,353.0,176,12,21,64,85,3,18,21,51,77,138,0.5579710144927537,1,4,0.25,76,134,0.5671641791044776,0.562,21,29,0.7241379310344828
Victor Oladipo,oladivi01,SG,25,IND,2018,75,2552.0,1735,323,47,343,390,177,57,219,175,640,1342,0.4769001490312965,161,434,0.3709677419354839,479,908,0.5275330396475771,0.537,294,368,0.7989130434782609
Kelly Olynyk,olynyke01,PF,26,MIA,2018,76,1779.0,872,207,89,342,431,62,35,147,222,316,636,0.4968553459119497,106,280,0.3785714285714285,210,356,0.5898876404494382,0.58,134,174,0.7701149425287356
Chinanu Onuaku,onuakch01,C,21,HOU,2018,1,22.0,4,1,1,3,4,0,0,3,4,2,5,0.4,0,0,0.0,2,5,0.4,0.4,0,0,0.0
Cedi Osman,osmande01,SF,22,CLE,2018,61,672.0,238,41,19,101,120,22,3,32,78,90,186,0.4838709677419355,32,87,0.367816091954023,58,99,0.5858585858585859,0.57,26,46,0.5652173913043478
Kelly Oubre Jr.,oubreke01,SF,22,WAS,2018,81,2231.0,953,98,59,304,363,80,35,90,234,318,790,0.4025316455696202,126,369,0.3414634146341463,192,421,0.4560570071258907,0.482,191,233,0.8197424892703863
Zaza Pachulia,pachuza01,C,33,GSW,2018,69,972.0,373,109,89,232,321,38,17,72,122,149,264,0.5643939393939394,0,1,0.0,149,263,0.5665399239543726,0.564,75,93,0.8064516129032258
Marcus Paige,paigema01,PG,24,CHO,2018,5,28.0,12,3,0,4,4,0,0,0,0,4,14,0.2857142857142857,2,8,0.25,2,6,0.3333333333333333,0.357,2,2,1.0
Georgios Papagiannis,papagge01,C,20,TOT,2018,17,122.0,36,9,13,24,37,4,6,8,12,18,42,0.4285714285714285,0,0,0.0,18,42,0.4285714285714285,0.429,0,0,0.0
Jabari Parker,parkeja01,PF,22,MIL,2018,31,743.0,391,59,42,109,151,25,10,45,50,160,332,0.4819277108433735,31,81,0.382716049382716,129,251,0.5139442231075697,0.529,40,54,0.7407407407407407
Tony Parker,parketo01,PG,35,SAS,2018,55,1071.0,421,195,7,88,95,28,1,68,52,178,388,0.4587628865979381,10,37,0.2702702702702703,168,351,0.4786324786324786,0.472,55,78,0.7051282051282052
Chandler Parsons,parsoch01,SF,29,MEM,2018,36,691.0,284,69,14,76,90,18,11,35,53,108,234,0.4615384615384615,51,121,0.4214876033057851,57,113,0.504424778761062,0.571,17,27,0.6296296296296297
Patrick Patterson,pattepa01,PF,28,OKC,2018,82,1270.0,318,57,32,161,193,48,23,33,87,106,266,0.3984962406015037,66,171,0.3859649122807017,40,95,0.4210526315789473,0.523,40,46,0.8695652173913043
Justin Patton,pattoju01,C,20,MIN,2018,1,4.0,2,0,0,0,0,1,0,0,1,1,2,0.5,0,0,0.0,1,2,0.5,0.5,0,0,0.0
Brandon Paul,paulbr01,SG,26,SAS,2018,64,576.0,147,37,6,62,68,25,7,29,58,55,127,0.4330708661417323,15,54,0.2777777777777778,40,73,0.547945205479452,0.492,22,43,0.5116279069767442
Chris Paul,paulch01,PG,32,HOU,2018,58,1847.0,1081,457,37,276,313,96,14,128,141,367,798,0.4598997493734336,144,379,0.3799472295514511,223,419,0.5322195704057279,0.55,203,221,0.918552036199095
Adreian Payne,paynead01,PF,26,ORL,2018,5,43.0,21,0,2,7,9,2,0,2,6,7,10,0.7,2,3,0.6666666666666666,5,7,0.7142857142857143,0.8,5,6,0.8333333333333334
Cameron Payne,payneca01,PG,23,CHI,2018,25,582.0,221,113,18,51,69,26,9,36,44,87,215,0.4046511627906977,35,91,0.3846153846153846,52,124,0.4193548387096774,0.486,12,16,0.75
Elfrid Payton,paytoel01,PG,23,TOT,2018,63,1808.0,797,393,64,210,274,83,22,168,147,329,667,0.4932533733133433,30,92,0.3260869565217391,299,575,0.52,0.516,109,168,0.6488095238095238
Gary Payton II,paytoga02,PG,25,TOT,2018,23,221.0,69,21,13,31,44,7,3,7,30,30,74,0.4054054054054054,6,25,0.24,24,49,0.4897959183673469,0.446,3,9,0.3333333333333333
Kendrick Perkins,perkike01,C,33,CLE,2018,1,15.0,3,2,0,1,1,1,0,1,1,1,2,0.5,0,0,0.0,1,2,0.5,0.5,1,2,0.5
London Perrantes,perralo01,PG,23,CLE,2018,14,66.0,7,5,1,3,4,2,1,1,6,2,13,0.1538461538461538,0,3,0.0,2,10,0.2,0.154,3,5,0.6
Alec Peters,peteral01,PF,22,PHO,2018,20,225.0,82,12,8,29,37,2,2,4,13,28,74,0.3783783783783784,18,58,0.3103448275862069,10,16,0.625,0.5,8,10,0.8
Marshall Plumlee,plumlma02,C,25,MIL,2018,8,52.0,14,2,4,13,17,0,1,3,10,1,3,0.3333333333333333,0,0,0.0,1,3,0.3333333333333333,0.333,12,16,0.75
Mason Plumlee,plumlma01,C,27,DEN,2018,74,1439.0,524,142,132,268,400,49,81,103,184,221,368,0.6005434782608695,0,1,0.0,221,367,0.6021798365122616,0.601,82,179,0.4581005586592179
Miles Plumlee,plumlmi01,C,29,ATL,2018,55,918.0,237,45,77,151,228,17,30,63,79,105,180,0.5833333333333334,0,0,0.0,105,180,0.5833333333333334,0.583,27,60,0.45
Jakob Poeltl,poeltja01,C,22,TOR,2018,82,1524.0,567,57,165,228,393,39,100,85,212,253,384,0.6588541666666666,1,2,0.5,252,382,0.6596858638743456,0.66,60,101,0.594059405940594
Quincy Pondexter,pondequ01,SF,29,CHI,2018,23,196.0,45,9,8,19,27,8,2,11,24,14,49,0.2857142857142857,3,22,0.1363636363636363,11,27,0.4074074074074074,0.316,14,17,0.8235294117647058
Otto Porter Jr.,porteot01,SF,24,WAS,2018,77,2432.0,1134,157,103,389,492,116,41,75,151,445,885,0.5028248587570622,138,313,0.4408945686900958,307,572,0.5367132867132867,0.581,106,128,0.828125
Bobby Portis,portibo01,PF,22,CHI,2018,73,1643.0,964,123,159,339,498,50,23,103,130,382,811,0.471023427866831,80,223,0.358744394618834,302,588,0.5136054421768708,0.52,120,156,0.7692307692307693
Kristaps Porziņģis,porzikr01,PF,22,NYK,2018,48,1553.0,1088,57,62,254,316,36,115,93,141,390,889,0.4386951631046119,90,228,0.3947368421052631,300,661,0.453857791225416,0.489,218,275,0.7927272727272727
Dwight Powell,poweldw01,C,26,DAL,2018,79,1672.0,671,91,135,309,444,67,32,59,186,255,430,0.5930232558139535,28,84,0.3333333333333333,227,346,0.6560693641618497,0.626,133,185,0.7189189189189189
Norman Powell,powelno01,SG,24,TOR,2018,70,1062.0,385,89,14,105,119,37,16,66,111,150,374,0.4010695187165775,53,186,0.2849462365591398,97,188,0.5159574468085106,0.472,32,39,0.8205128205128205
Alex Poythress,poythal01,PF,24,IND,2018,25,104.0,26,2,7,10,17,3,1,2,16,11,26,0.4230769230769231,4,11,0.3636363636363636,7,15,0.4666666666666667,0.5,0,0,0.0
Taurean Prince,princta02,SF,23,ATL,2018,82,2464.0,1158,214,50,339,389,85,42,191,168,415,975,0.4256410256410256,176,457,0.3851203501094092,239,518,0.4613899613899614,0.516,152,180,0.8444444444444444
Jacob Pullen,pulleja01,PG,28,PHI,2018,3,6.0,2,0,0,0,0,0,0,1,0,1,2,0.5,0,1,0.0,1,1,1.0,0.5,0,0,0.0
Rodney Purvis,purviro01,SG,23,ORL,2018,16,290.0,96,17,1,26,27,3,3,10,26,35,107,0.3271028037383177,13,52,0.25,22,55,0.4,0.388,13,15,0.8666666666666667
Zhou Qi,qizh01,C,22,HOU,2018,18,124.0,22,2,6,16,22,2,14,10,14,6,32,0.1875,2,19,0.1052631578947368,4,13,0.3076923076923077,0.219,8,12,0.6666666666666666
Tim Quarterman,quartti01,SG,23,HOU,2018,3,13.0,4,1,0,3,3,0,0,2,1,1,3,0.3333333333333333,0,2,0.0,1,1,1.0,0.333,2,2,1.0
Ivan Rabb,rabbiv01,PF,20,MEM,2018,36,516.0,201,32,53,105,158,12,13,35,55,86,152,0.5657894736842105,0,0,0.0,86,152,0.5657894736842105,0.566,29,36,0.8055555555555556
Julius Randle,randlju01,C,23,LAL,2018,82,2190.0,1323,210,181,473,654,43,45,213,274,504,904,0.5575221238938053,10,45,0.2222222222222222,494,859,0.5750873108265425,0.563,305,425,0.7176470588235294
Zach Randolph,randoza01,PF,36,SAC,2018,59,1508.0,857,127,97,300,397,42,10,116,119,361,763,0.473132372214941,51,147,0.3469387755102041,310,616,0.5032467532467533,0.507,84,107,0.7850467289719626
Xavier Rathan-Mayes,rathaxa01,SG,23,MEM,2018,5,118.0,29,18,0,5,5,6,3,11,18,12,42,0.2857142857142857,1,14,0.0714285714285714,11,28,0.3928571428571428,0.298,4,9,0.4444444444444444
J.J. Redick,redicjj01,SG,33,PHI,2018,70,2116.0,1198,210,9,169,178,35,6,103,123,404,879,0.459613196814562,193,460,0.4195652173913043,211,419,0.5035799522673031,0.569,197,218,0.9036697247706422
Davon Reed,reedda01,SG,22,PHO,2018,21,242.0,63,13,2,37,39,10,2,10,17,22,76,0.2894736842105263,11,38,0.2894736842105263,11,38,0.2894736842105263,0.362,8,12,0.6666666666666666
Willie Reed,reedwi02,C,27,TOT,2018,42,428.0,195,10,35,86,121,9,22,19,56,81,121,0.6694214876033058,1,2,0.5,80,119,0.6722689075630253,0.674,32,55,0.5818181818181818
Josh Richardson,richajo01,SF,24,MIA,2018,81,2689.0,1045,231,69,216,285,121,75,140,199,399,885,0.4508474576271186,127,336,0.3779761904761904,272,549,0.4954462659380692,0.523,120,142,0.8450704225352113
Malachi Richardson,richama01,SG,22,TOT,2018,26,324.0,89,13,5,29,34,10,1,10,27,30,90,0.3333333333333333,12,40,0.3,18,50,0.36,0.4,17,22,0.7727272727272727
Austin Rivers,riverau01,SG,25,LAC,2018,61,2057.0,920,242,27,118,145,74,16,109,152,341,805,0.4236024844720497,136,360,0.3777777777777777,205,445,0.4606741573033708,0.508,102,159,0.6415094339622641
Andre Roberson,roberan03,SG,26,OKC,2018,39,1037.0,194,46,75,110,185,45,35,30,89,87,162,0.5370370370370371,8,36,0.2222222222222222,79,126,0.626984126984127,0.562,12,38,0.3157894736842105
Devin Robinson,robinde01,SF,22,WAS,2018,1,13.0,2,0,2,3,5,1,0,0,2,1,3,0.3333333333333333,0,0,0.0,1,3,0.3333333333333333,0.333,0,0,0.0
Glenn Robinson III,robingl02,SF,24,IND,2018,23,338.0,95,17,11,26,37,13,1,5,14,36,85,0.4235294117647059,14,34,0.4117647058823529,22,51,0.4313725490196078,0.506,9,11,0.8181818181818182
Rajon Rondo,rondora01,PG,31,NOP,2018,65,1705.0,537,533,31,232,263,70,10,151,119,231,494,0.4676113360323887,50,150,0.3333333333333333,181,344,0.5261627906976745,0.518,25,46,0.5434782608695652
Derrick Rose,rosede01,PG,29,TOT,2018,25,420.0,209,37,13,22,35,7,4,35,16,81,186,0.4354838709677419,7,30,0.2333333333333333,74,156,0.4743589743589743,0.454,40,46,0.8695652173913043
Terrence Ross,rosste01,SG,26,ORL,2018,24,600.0,209,38,10,63,73,27,11,29,45,76,191,0.3979057591623036,30,93,0.3225806451612903,46,98,0.4693877551020408,0.476,27,36,0.75
Terry Rozier,roziete01,PG,23,BOS,2018,80,2068.0,900,232,63,313,376,80,19,80,123,316,800,0.395,153,402,0.3805970149253731,163,398,0.4095477386934673,0.491,115,149,0.7718120805369127
Ricky Rubio,rubiori01,PG,27,UTA,2018,77,2254.0,1008,410,44,307,351,121,11,207,206,346,827,0.4183796856106409,96,273,0.3516483516483517,250,554,0.4512635379061371,0.476,220,254,0.8661417322834646
D'Angelo Russell,russeda01,PG,21,BRK,2018,48,1234.0,743,249,30,159,189,36,17,147,93,278,672,0.4136904761904761,90,278,0.3237410071942446,188,394,0.4771573604060913,0.481,97,131,0.7404580152671756
Domantas Sabonis,sabondo01,C,21,IND,2018,74,1810.0,861,151,165,407,572,40,32,137,220,340,661,0.5143721633888049,13,37,0.3513513513513513,327,624,0.5240384615384616,0.524,168,224,0.75
JaKarr Sampson,sampsja02,SF,24,SAC,2018,22,344.0,103,9,21,57,78,8,22,8,48,44,81,0.5432098765432098,5,10,0.5,39,71,0.5492957746478874,0.574,10,16,0.625
Dario Šarić,saricda01,PF,23,PHI,2018,78,2310.0,1141,202,154,366,520,51,20,148,160,403,890,0.4528089887640449,157,399,0.3934837092731829,246,491,0.5010183299389002,0.541,178,207,0.8599033816425121
Tomáš Satoranský,satorto01,SG,26,WAS,2018,73,1643.0,524,286,72,161,233,52,15,83,131,201,384,0.5234375,47,101,0.4653465346534653,154,283,0.5441696113074205,0.585,75,96,0.78125
Dennis Schröder,schrode01,PG,24,ATL,2018,67,2078.0,1301,417,44,164,208,72,6,183,147,500,1146,0.4363001745200698,76,262,0.2900763358778626,424,884,0.4796380090497738,0.469,225,265,0.8490566037735849
Mike Scott,scottmi01,PF,29,WAS,2018,76,1406.0,668,80,50,197,247,23,10,79,148,276,524,0.5267175572519084,66,163,0.4049079754601227,210,361,0.5817174515235457,0.59,50,76,0.6578947368421053
Thabo Sefolosha,sefolth01,SF,33,UTA,2018,38,806.0,312,33,29,132,161,52,12,30,59,118,240,0.4916666666666666,32,84,0.3809523809523809,86,156,0.5512820512820513,0.558,44,54,0.8148148148148148
Wayne Selden,seldewa01,SG,23,MEM,2018,35,692.0,325,66,16,40,56,18,5,54,59,116,269,0.4312267657992565,49,122,0.4016393442622951,67,147,0.4557823129251701,0.522,44,59,0.7457627118644068
Ramon Sessions,sessira01,PG,31,TOT,2018,28,392.0,136,77,6,32,38,14,2,30,29,42,117,0.358974358974359,8,26,0.3076923076923077,34,91,0.3736263736263736,0.393,44,57,0.7719298245614035
Iman Shumpert,shumpim01,SG,27,CLE,2018,14,276.0,62,17,7,34,41,9,4,16,22,22,58,0.3793103448275862,7,26,0.2692307692307692,15,32,0.46875,0.44,11,15,0.7333333333333333
Pascal Siakam,siakapa01,PF,23,TOR,2018,81,1679.0,589,159,79,285,364,62,42,67,166,253,498,0.5080321285140562,29,132,0.2196969696969697,224,366,0.6120218579234973,0.537,54,87,0.6206896551724138
Xavier Silas,silasxa01,SG,30,BOS,2018,2,7.0,0,0,1,1,2,1,0,0,1,0,3,0.0,0,2,0.0,0,1,0.0,0.0,0,0,0.0
Ben Simmons,simmobe01,PG,21,PHI,2018,81,2732.0,1279,661,145,514,659,140,70,278,211,544,998,0.5450901803607214,0,11,0.0,544,987,0.5511651469098278,0.545,191,341,0.5601173020527859
Jonathon Simmons,simmojo02,SG,28,ORL,2018,69,2029.0,962,171,61,178,239,58,16,146,175,354,761,0.4651773981603154,69,204,0.3382352941176471,285,557,0.5116696588868941,0.511,185,241,0.7676348547717843
Kobi Simmons,simmoko01,PG,20,MEM,2018,32,643.0,196,68,14,36,50,18,5,44,61,80,189,0.4232804232804232,11,39,0.282051282051282,69,150,0.46,0.452,25,25,1.0
Kyle Singler,singlky01,SF,29,OKC,2018,12,59.0,23,2,1,9,10,1,0,3,4,7,21,0.3333333333333333,2,5,0.4,5,16,0.3125,0.381,7,13,0.5384615384615384
Marcus Smart,smartma01,SG,23,BOS,2018,54,1614.0,550,259,43,146,189,71,23,129,133,189,515,0.3669902912621359,75,249,0.3012048192771084,114,266,0.4285714285714285,0.44,97,133,0.7293233082706767
Dennis Smith Jr.,smithde03,PG,20,DAL,2018,69,2049.0,1048,358,50,210,260,71,18,194,152,404,1024,0.39453125,106,339,0.3126843657817109,298,685,0.4350364963503649,0.446,134,193,0.694300518134715
Ish Smith,smithis01,PG,29,DET,2018,82,2043.0,894,360,27,197,224,64,20,108,140,389,801,0.4856429463171036,35,101,0.3465346534653465,354,700,0.5057142857142857,0.507,81,116,0.6982758620689655
J.R. Smith,smithjr01,SG,32,CLE,2018,80,2244.0,662,141,29,206,235,68,11,81,161,240,595,0.4033613445378151,143,381,0.3753280839895013,97,214,0.4532710280373832,0.524,39,56,0.6964285714285714
Jason Smith,smithja02,C,31,WAS,2018,33,285.0,113,14,18,35,53,3,13,16,44,45,115,0.391304347826087,4,32,0.125,41,83,0.4939759036144578,0.409,19,21,0.9047619047619048
Josh Smith,smithjo03,PF,32,NOP,2018,3,12.0,2,0,3,1,4,0,0,0,3,1,4,0.25,0,0,0.0,1,4,0.25,0.25,0,0,0.0
Tony Snell,snellto01,SG,26,MIL,2018,75,2053.0,516,98,9,132,141,47,28,36,115,185,425,0.4352941176470588,108,268,0.4029850746268656,77,157,0.4904458598726114,0.562,38,48,0.7916666666666666
Marreese Speights,speigma01,C,30,ORL,2018,52,675.0,402,40,21,112,133,8,22,40,106,138,349,0.3954154727793696,86,233,0.3690987124463519,52,116,0.4482758620689655,0.519,40,55,0.7272727272727273
Nik Stauskas,stausni01,SG,24,TOT,2018,41,523.0,181,39,4,60,64,9,4,26,24,60,154,0.3896103896103896,40,100,0.4,20,54,0.3703703703703703,0.519,21,29,0.7241379310344828
Lance Stephenson,stephla01,SG,27,IND,2018,82,1850.0,757,235,62,362,424,46,17,131,177,303,709,0.4273624823695345,67,232,0.2887931034482758,236,477,0.4947589098532495,0.475,84,127,0.6614173228346457
David Stockton,stockda01,PG,26,UTA,2018,3,9.0,10,0,0,0,0,0,0,1,3,2,3,0.6666666666666666,2,3,0.6666666666666666,0,0,0.0,1.0,4,4,1.0
Julyan Stone,stoneju01,SG,29,CHO,2018,23,175.0,19,26,1,28,29,4,2,7,21,6,13,0.4615384615384615,6,13,0.4615384615384615,0,0,0.0,0.692,1,2,0.5
Edmond Sumner,sumneed01,PG,22,IND,2018,1,2.0,2,0,0,1,1,0,0,0,1,1,1,1.0,0,0,0.0,1,1,1.0,1.0,0,0,0.0
Caleb Swanigan,swanica01,PF,20,POR,2018,27,189.0,61,14,15,39,54,5,3,18,37,24,60,0.4,1,8,0.125,23,52,0.4423076923076923,0.408,12,18,0.6666666666666666
Jayson Tatum,tatumja01,SF,19,BOS,2018,80,2443.0,1112,128,50,352,402,83,58,114,170,397,835,0.4754491017964072,105,242,0.4338842975206611,292,593,0.4924114671163575,0.538,213,258,0.8255813953488372
Isaiah Taylor,taylois01,PG,23,ATL,2018,67,1167.0,445,206,22,72,94,34,10,84,116,163,390,0.4179487179487179,20,80,0.25,143,310,0.4612903225806452,0.444,99,141,0.7021276595744681
Jeff Teague,teaguje01,PG,29,MIN,2018,70,2311.0,994,492,24,185,209,102,23,177,171,354,794,0.4458438287153652,84,228,0.3684210526315789,270,566,0.4770318021201413,0.499,202,239,0.8451882845188284
Marquis Teague,teaguma01,PG,24,MEM,2018,3,74.0,11,13,1,5,6,4,0,3,5,4,16,0.25,1,4,0.25,3,12,0.25,0.281,2,5,0.4
Mirza Teletović,teletmi01,PF,32,MIL,2018,10,159.0,71,10,3,20,23,4,1,7,14,25,57,0.4385964912280701,21,45,0.4666666666666667,4,12,0.3333333333333333,0.623,0,0,0.0
Garrett Temple,templga01,SG,31,SAC,2018,65,1615.0,547,124,22,130,152,57,27,79,135,199,476,0.4180672268907563,89,227,0.3920704845814978,110,249,0.4417670682730923,0.512,60,78,0.7692307692307693
Miloš Teodosić,teodomi01,PG,30,LAC,2018,45,1134.0,429,209,16,110,126,23,5,97,103,151,360,0.4194444444444444,88,232,0.3793103448275862,63,128,0.4921875,0.542,39,46,0.8478260869565217
Jason Terry,terryja01,SG,40,MIL,2018,51,814.0,166,59,5,43,48,42,13,25,52,59,154,0.3831168831168831,40,115,0.3478260869565217,19,39,0.4871794871794871,0.513,8,9,0.8888888888888888
Daniel Theis,theisda01,C,25,BOS,2018,63,936.0,331,56,90,184,274,30,48,56,157,126,233,0.5407725321888412,18,58,0.3103448275862069,108,175,0.6171428571428571,0.579,61,81,0.7530864197530864
Isaiah Thomas,thomais02,PG,28,TOT,2018,32,862.0,486,153,17,50,67,15,3,95,58,157,421,0.3729216152019002,55,188,0.2925531914893617,102,233,0.4377682403433476,0.438,117,131,0.8931297709923665
Lance Thomas,thomala01,PF,29,NYK,2018,73,1353.0,298,44,44,131,175,30,14,40,134,102,267,0.3820224719101123,50,124,0.4032258064516129,52,143,0.3636363636363636,0.476,44,53,0.8301886792452831
Klay Thompson,thompkl01,SG,27,GSW,2018,73,2506.0,1461,185,31,246,277,55,34,128,117,575,1179,0.4877014418999151,229,521,0.4395393474088291,346,658,0.5258358662613982,0.585,82,98,0.8367346938775511
Tristan Thompson,thomptr01,C,26,CLE,2018,53,1072.0,307,33,126,226,352,16,17,36,102,132,235,0.5617021276595745,0,0,0.0,132,235,0.5617021276595745,0.562,43,79,0.5443037974683544
Sindarius Thornwell,thornsi01,SG,23,LAC,2018,73,1156.0,282,68,33,107,140,48,25,53,125,100,233,0.4291845493562232,23,61,0.3770491803278688,77,172,0.4476744186046512,0.479,59,88,0.6704545454545454
Anthony Tolliver,tollian01,PF,32,DET,2018,79,1757.0,703,90,50,191,241,32,21,58,144,219,472,0.4639830508474576,159,365,0.4356164383561643,60,107,0.5607476635514018,0.632,106,133,0.7969924812030075
Karl-Anthony Towns,townska01,C,22,MIN,2018,82,2918.0,1743,199,238,774,1012,64,115,159,285,639,1172,0.5452218430034129,120,285,0.4210526315789473,519,887,0.5851183765501691,0.596,345,402,0.8582089552238806
P.J. Tucker,tuckepj01,PF,32,HOU,2018,82,2281.0,502,77,93,364,457,78,26,74,205,172,441,0.3900226757369615,115,310,0.3709677419354839,57,131,0.4351145038167939,0.52,43,60,0.7166666666666667
Evan Turner,turneev01,SF,29,POR,2018,79,2034.0,649,173,30,214,244,47,29,99,163,258,577,0.4471403812824956,42,132,0.3181818181818182,216,445,0.4853932584269663,0.484,91,107,0.8504672897196262
Myles Turner,turnemy01,C,21,IND,2018,65,1836.0,828,87,93,324,417,38,118,96,186,306,639,0.4788732394366197,56,157,0.3566878980891719,250,482,0.5186721991701245,0.523,160,206,0.7766990291262136
Ekpe Udoh,udohek01,C,30,UTA,2018,63,810.0,162,53,68,82,150,43,74,20,105,60,120,0.5,0,1,0.0,60,119,0.5042016806722689,0.5,42,56,0.75
Tyler Ulis,ulisty01,PG,22,PHO,2018,71,1658.0,554,311,24,104,128,70,7,127,120,214,551,0.3883847549909255,42,146,0.2876712328767123,172,405,0.4246913580246914,0.426,84,101,0.8316831683168316
Jonas Valančiūnas,valanjo01,C,25,TOR,2018,77,1727.0,980,81,183,477,660,29,69,115,192,390,687,0.5676855895196506,30,74,0.4054054054054054,360,613,0.5872756933115824,0.59,170,211,0.8056872037914692
Denzel Valentine,valende01,SG,24,CHI,2018,77,2095.0,783,244,48,345,393,65,11,99,185,301,721,0.4174757281553398,143,370,0.3864864864864865,158,351,0.4501424501424501,0.517,38,51,0.7450980392156863
Fred VanVleet,vanvlfr01,PG,23,TOR,2018,76,1520.0,656,243,25,159,184,68,19,74,130,232,545,0.4256880733944954,108,261,0.4137931034482758,124,284,0.4366197183098591,0.525,84,101,0.8316831683168316
Rashad Vaughn,vaughra01,SG,21,TOT,2018,28,212.0,64,13,3,18,21,5,3,6,15,23,56,0.4107142857142857,14,37,0.3783783783783784,9,19,0.4736842105263157,0.536,4,6,0.6666666666666666
Noah Vonleh,vonleno01,PF,22,TOT,2018,54,875.0,264,34,70,241,311,19,17,31,68,104,234,0.4444444444444444,20,66,0.303030303030303,84,168,0.5,0.487,36,58,0.6206896551724138
Nikola Vučević,vucevni01,C,27,ORL,2018,57,1683.0,939,191,101,422,523,56,62,109,144,399,840,0.475,64,204,0.3137254901960784,335,636,0.5267295597484277,0.513,77,94,0.8191489361702128
Dwyane Wade,wadedw01,SG,36,TOT,2018,67,1536.0,765,228,50,202,252,61,47,140,124,299,682,0.43841642228739,32,111,0.2882882882882883,267,571,0.467600700525394,0.462,135,189,0.7142857142857143
Dion Waiters,waitedi01,SG,26,MIA,2018,30,918.0,429,113,8,69,77,23,9,70,61,163,410,0.3975609756097561,52,170,0.3058823529411765,111,240,0.4625,0.461,51,69,0.7391304347826086
Kemba Walker,walkeke02,PG,27,CHO,2018,80,2736.0,1770,444,32,216,248,91,24,179,98,588,1363,0.4314013206162876,231,601,0.3843594009983361,357,762,0.468503937007874,0.516,363,420,0.8642857142857143
John Wall,walljo01,PG,27,WAS,2018,41,1410.0,797,393,22,128,150,57,45,158,80,280,667,0.4197901049475262,62,167,0.3712574850299401,218,500,0.436,0.466,175,241,0.7261410788381742
Tyrone Wallace,wallaty01,PG,23,LAC,2018,30,851.0,291,71,21,84,105,27,13,46,83,110,247,0.4453441295546558,10,40,0.25,100,207,0.4830917874396135,0.466,61,78,0.782051282051282
Derrick Walton,waltode01,PG,22,MIA,2018,16,147.0,29,16,2,14,16,7,3,2,7,8,25,0.32,7,17,0.4117647058823529,1,8,0.125,0.46,6,6,1.0
Jameel Warney,warneja01,PF,24,DAL,2018,3,27.0,17,0,4,5,9,0,0,1,2,7,12,0.5833333333333334,0,0,0.0,7,12,0.5833333333333334,0.583,3,5,0.6
T.J. Warren,warretj01,SF,24,PHO,2018,65,2142.0,1271,85,125,208,333,65,41,85,149,529,1063,0.4976481655691439,20,90,0.2222222222222222,509,973,0.5231243576567317,0.507,193,255,0.7568627450980392
Travis Wear,weartr01,SF,27,LAL,2018,17,228.0,75,7,0,38,38,4,5,6,30,25,72,0.3472222222222222,17,47,0.3617021276595745,8,25,0.32,0.465,8,8,1.0
James Webb III,webbja01,SF,24,BRK,2018,10,120.0,16,4,8,16,24,1,0,4,10,6,24,0.25,4,19,0.2105263157894736,2,5,0.4,0.333,0,0,0.0
Briante Weber,weberbr01,PG,25,TOT,2018,18,237.0,50,22,8,27,35,18,5,15,28,19,43,0.4418604651162791,4,11,0.3636363636363636,15,32,0.46875,0.488,8,10,0.8
David West,westda01,C,37,GSW,2018,73,999.0,495,138,64,174,238,47,75,80,120,216,378,0.5714285714285714,3,8,0.375,213,370,0.5756756756756757,0.575,60,79,0.759493670886076
Russell Westbrook,westbru01,PG,29,OKC,2018,80,2914.0,2028,820,152,652,804,147,20,381,200,757,1687,0.4487255483106105,97,326,0.2975460122699386,660,1361,0.4849375459221161,0.477,417,566,0.7367491166077739
Andrew White,whitean01,SF,24,ATL,2018,15,209.0,69,6,4,30,34,3,1,8,12,25,73,0.3424657534246575,18,49,0.3673469387755102,7,24,0.2916666666666667,0.466,1,4,0.25
Derrick White,whitede01,PG,23,SAS,2018,17,139.0,54,9,5,21,26,4,3,6,8,16,33,0.4848484848484848,8,13,0.6153846153846154,8,20,0.4,0.606,14,20,0.7
Okaro White,whiteok01,PF,25,MIA,2018,6,80.0,20,2,3,8,11,1,1,1,6,7,16,0.4375,4,11,0.3636363636363636,3,5,0.6,0.563,2,3,0.6666666666666666
Isaiah Whitehead,whiteis01,PG,22,BRK,2018,16,180.0,100,20,4,22,26,8,2,24,23,40,86,0.4651162790697674,7,18,0.3888888888888889,33,68,0.4852941176470588,0.506,13,19,0.6842105263157895
Hassan Whiteside,whiteha01,C,28,MIA,2018,54,1364.0,754,54,174,444,618,37,94,92,131,312,578,0.5397923875432526,2,2,1.0,310,576,0.5381944444444444,0.542,128,182,0.7032967032967034
Andrew Wiggins,wiggian01,SF,22,MIN,2018,82,2979.0,1452,160,82,276,358,91,51,138,163,569,1300,0.4376923076923077,112,338,0.3313609467455621,457,962,0.475051975051975,0.481,202,314,0.643312101910828
Jacob Wiley,wileyja01,PF,23,BRK,2018,5,33.0,4,2,2,9,11,1,0,0,4,1,4,0.25,1,2,0.5,0,2,0.0,0.375,1,2,0.5
Damien Wilkins,wilkida02,SF,38,IND,2018,19,152.0,33,9,5,11,16,2,1,5,7,13,39,0.3333333333333333,4,18,0.2222222222222222,9,21,0.4285714285714285,0.385,3,4,0.75
Alan Williams,willial03,PF,25,PHO,2018,5,70.0,20,8,3,19,22,5,1,7,13,7,18,0.3888888888888889,0,0,0.0,7,18,0.3888888888888889,0.389,6,9,0.6666666666666666
C.J. Williams,willicj01,SG,27,LAC,2018,38,707.0,209,43,12,44,56,31,13,20,63,87,197,0.4416243654822335,22,78,0.282051282051282,65,119,0.5462184873949579,0.497,13,16,0.8125
Derrick Williams,willide02,PF,26,LAL,2018,2,9.0,2,0,0,1,1,0,0,0,0,1,4,0.25,0,2,0.0,1,2,0.5,0.25,0,0,0.0
Lou Williams,willilo02,SG,31,LAC,2018,79,2589.0,1782,417,40,158,198,85,19,234,106,582,1337,0.4353029169783096,186,518,0.3590733590733591,396,819,0.4835164835164835,0.505,432,491,0.879837067209776
Marvin Williams,willima02,PF,31,CHO,2018,78,2006.0,744,96,74,296,370,56,38,66,116,258,563,0.458259325044405,126,305,0.4131147540983607,132,258,0.5116279069767442,0.57,102,123,0.8292682926829268
Matt Williams,willima05,SG,24,MIA,2018,3,11.0,5,0,0,1,1,0,0,1,1,2,6,0.3333333333333333,1,5,0.2,1,1,1.0,0.417,0,0,0.0
Troy Williams,willitr02,SF,23,TOT,2018,21,307.0,133,16,22,41,63,20,4,19,34,51,109,0.4678899082568807,11,38,0.2894736842105263,40,71,0.5633802816901409,0.518,20,30,0.6666666666666666
D.J. Wilson,wilsodj01,PF,21,MIL,2018,22,71.0,21,3,2,8,10,3,1,4,7,9,16,0.5625,2,5,0.4,7,11,0.6363636363636364,0.625,1,2,0.5
Jamil Wilson,wilsoja02,SF,27,LAC,2018,15,274.0,105,10,3,29,32,5,8,8,34,38,81,0.4691358024691358,27,63,0.4285714285714285,11,18,0.6111111111111112,0.636,2,4,0.5
Justise Winslow,winslju01,PF,21,MIA,2018,68,1680.0,529,148,64,306,370,54,33,77,140,207,488,0.4241803278688524,49,129,0.3798449612403101,158,359,0.4401114206128134,0.474,66,104,0.6346153846153846
Jeff Withey,witheje01,C,27,DAL,2018,9,39.0,15,0,1,9,10,0,3,2,3,6,16,0.375,2,10,0.2,4,6,0.6666666666666666,0.438,1,2,0.5
Nate Wolters,woltena01,PG,26,UTA,2018,5,19.0,2,1,1,1,2,0,0,0,1,1,6,0.1666666666666666,0,0,0.0,1,6,0.1666666666666666,0.167,0,0,0.0
Brandan Wright,wrighbr03,PF,30,TOT,2018,28,381.0,139,13,33,62,95,13,26,8,32,59,102,0.5784313725490197,0,0,0.0,59,102,0.5784313725490197,0.578,21,33,0.6363636363636364
Delon Wright,wrighde01,PG,25,TOR,2018,69,1433.0,555,200,45,153,198,72,33,78,81,201,432,0.4652777777777778,56,153,0.3660130718954248,145,279,0.5197132616487455,0.53,97,117,0.8290598290598291
Guerschon Yabusele,yabusgu01,PF,22,BOS,2018,33,235.0,79,16,17,35,52,4,5,12,23,26,61,0.4262295081967213,12,37,0.3243243243243243,14,24,0.5833333333333334,0.525,15,22,0.6818181818181818
James Young,youngja01,SG,22,PHI,2018,6,61.0,17,2,0,2,2,0,0,1,4,5,14,0.3571428571428571,3,10,0.3,2,4,0.5,0.464,4,6,0.6666666666666666
Joe Young,youngjo01,PG,25,IND,2018,53,558.0,207,39,12,51,63,14,1,26,39,80,186,0.4301075268817204,25,66,0.3787878787878788,55,120,0.4583333333333333,0.497,22,29,0.7586206896551724
Nick Young,youngni01,SG,32,GSW,2018,80,1393.0,581,36,20,105,125,38,7,39,100,201,488,0.4118852459016393,123,326,0.3773006134969325,78,162,0.4814814814814814,0.538,56,65,0.8615384615384616
Thaddeus Young,youngth01,PF,29,IND,2018,81,2607.0,955,152,184,328,512,135,36,105,175,421,864,0.4872685185185185,58,181,0.3204419889502762,363,683,0.5314787701317716,0.521,55,92,0.5978260869565217
Cody Zeller,zelleco01,C,25,CHO,2018,33,627.0,233,31,67,110,177,14,21,33,81,85,156,0.5448717948717948,2,3,0.6666666666666666,83,153,0.5424836601307189,0.551,61,85,0.7176470588235294
Tyler Zeller,zellety01,C,28,TOT,2018,66,1109.0,441,47,110,195,305,15,35,47,126,187,334,0.5598802395209581,10,28,0.3571428571428571,177,306,0.5784313725490197,0.575,57,79,0.7215189873417721
Paul Zipser,zipsepa01,SF,23,CHI,2018,54,824.0,218,46,13,118,131,20,15,43,86,81,234,0.3461538461538461,37,110,0.3363636363636363,44,124,0.3548387096774194,0.425,19,25,0.76
Ante Žižić,zizican01,C,21,CLE,2018,32,214.0,119,5,24,36,60,2,13,11,30,49,67,0.7313432835820896,0,0,0.0,49,67,0.7313432835820896,0.731,21,29,0.7241379310344828
Ivica Zubac,zubaciv01,C,20,LAL,2018,43,410.0,161,25,45,78,123,8,15,26,47,61,122,0.5,0,1,0.0,61,121,0.5041322314049587,0.5,39,51,0.7647058823529411
Álex Abrines,abrinal01,SG,25,OKC,2019,31,588.0,165,20,5,43,48,17,6,14,53,56,157,0.3566878980891719,41,127,0.3228346456692913,15,30,0.5,0.487,12,13,0.9230769230769232
Quincy Acy,acyqu01,PF,28,PHO,2019,10,123.0,17,8,3,22,25,1,4,4,24,4,18,0.2222222222222222,2,15,0.1333333333333333,2,3,0.6666666666666666,0.278,7,10,0.7
Jaylen Adams,adamsja01,PG,22,ATL,2019,34,428.0,108,65,11,49,60,14,5,28,45,38,110,0.3454545454545454,25,74,0.3378378378378378,13,36,0.3611111111111111,0.459,7,9,0.7777777777777778
Steven Adams,adamsst01,C,25,OKC,2019,80,2669.0,1108,124,391,369,760,117,76,135,204,481,809,0.5945611866501854,0,2,0.0,481,807,0.5960346964064436,0.595,146,292,0.5
Bam Adebayo,adebaba01,C,21,MIA,2019,82,1913.0,729,184,165,432,597,71,65,121,203,280,486,0.5761316872427984,3,15,0.2,277,471,0.5881104033970276,0.579,166,226,0.7345132743362832
Deng Adel,adelde01,SF,21,CLE,2019,19,194.0,32,5,3,16,19,1,4,6,13,11,36,0.3055555555555556,6,23,0.2608695652173913,5,13,0.3846153846153846,0.389,4,4,1.0
DeVaughn Akoon-Purcell,akoonde01,SG,25,DEN,2019,7,22.0,7,6,1,3,4,2,0,2,4,3,10,0.3,0,4,0.0,3,6,0.5,0.3,1,2,0.5
LaMarcus Aldridge,aldrila01,C,33,SAS,2019,81,2687.0,1727,194,251,493,744,43,107,144,179,684,1319,0.5185746777862017,10,42,0.238095238095238,674,1277,0.5277995301487862,0.522,349,412,0.8470873786407767
Rawle Alkins,alkinra01,SG,21,CHI,2019,10,120.0,37,13,11,15,26,1,0,8,7,13,39,0.3333333333333333,3,12,0.25,10,27,0.3703703703703703,0.372,8,12,0.6666666666666666
Grayson Allen,allengr01,SG,23,UTA,2019,38,416.0,211,25,3,20,23,6,6,33,47,67,178,0.3764044943820224,32,99,0.3232323232323232,35,79,0.4430379746835443,0.466,45,60,0.75
Jarrett Allen,allenja01,C,20,BRK,2019,80,2096.0,873,110,191,481,672,43,120,103,184,335,568,0.5897887323943662,6,45,0.1333333333333333,329,523,0.6290630975143403,0.595,197,278,0.7086330935251799
Kadeem Allen,allenka01,PG,26,NYK,2019,19,416.0,189,76,8,43,51,16,4,26,46,65,141,0.4609929078014184,17,36,0.4722222222222222,48,105,0.4571428571428571,0.521,42,54,0.7777777777777778
Al-Farouq Aminu,aminual01,PF,28,POR,2019,81,2292.0,760,104,112,498,610,68,33,72,143,257,593,0.433389544688027,96,280,0.3428571428571428,161,313,0.5143769968051118,0.514,150,173,0.8670520231213873
Justin Anderson,anderju01,SF,25,ATL,2019,48,463.0,178,23,24,60,84,22,13,23,48,64,157,0.4076433121019108,24,77,0.3116883116883117,40,80,0.5,0.484,26,35,0.7428571428571429
Kyle Anderson,anderky01,SF,25,MEM,2019,43,1281.0,346,128,48,203,251,54,37,58,112,150,276,0.5434782608695652,9,34,0.2647058823529412,141,242,0.5826446280991735,0.56,37,64,0.578125
Ryan Anderson,anderry01,PF,30,TOT,2019,25,322.0,63,19,18,36,54,4,1,14,25,21,69,0.3043478260869565,9,40,0.225,12,29,0.4137931034482758,0.37,12,16,0.75
Ike Anigbogu,anigbik01,C,20,IND,2019,3,6.0,0,1,1,2,3,0,1,1,0,0,3,0.0,0,0,0.0,0,3,0.0,0.0,0,0,0.0
Giannis Antetokounmpo,antetgi01,PF,24,MIL,2019,72,2358.0,1994,424,159,739,898,92,110,268,232,721,1247,0.5781876503608661,52,203,0.2561576354679803,669,1044,0.6408045977011494,0.599,500,686,0.7288629737609329
Kostas Antetokounmpo,antetko01,PF,21,DAL,2019,2,11.0,2,0,0,1,1,2,0,1,0,0,3,0.0,0,0,0.0,0,3,0.0,0.0,2,4,0.5
Carmelo Anthony,anthoca01,PF,34,HOU,2019,10,294.0,134,5,9,45,54,4,7,8,32,49,121,0.4049586776859504,21,64,0.328125,28,57,0.4912280701754385,0.492,15,22,0.6818181818181818
OG Anunoby,anunoog01,SF,21,TOR,2019,67,1352.0,469,47,58,139,197,46,22,55,140,183,404,0.452970297029703,67,202,0.3316831683168317,116,202,0.5742574257425742,0.536,36,62,0.5806451612903226
Ryan Arcidiacono,arcidry01,PG,24,CHI,2019,81,1961.0,544,269,27,192,219,65,4,63,171,187,418,0.4473684210526316,81,217,0.3732718894009216,106,201,0.527363184079602,0.544,89,102,0.8725490196078431
Trevor Ariza,arizatr01,SF,33,TOT,2019,69,2349.0,863,252,50,321,371,91,21,106,130,294,736,0.3994565217391304,145,434,0.3341013824884792,149,302,0.4933774834437086,0.498,130,164,0.7926829268292683
D.J. Augustin,augusdj01,PG,31,ORL,2019,81,2269.0,948,426,41,162,203,52,4,128,115,318,677,0.4697193500738552,131,311,0.4212218649517685,187,366,0.5109289617486339,0.566,181,209,0.8660287081339713
Deandre Ayton,aytonde01,C,20,PHO,2019,71,2183.0,1159,125,223,506,729,61,67,126,209,509,870,0.5850574712643678,0,4,0.0,509,866,0.5877598152424942,0.585,141,189,0.746031746031746
Dwayne Bacon,bacondw01,SG,23,CHO,2019,43,759.0,316,47,8,81,89,12,5,18,72,122,257,0.4747081712062256,38,87,0.4367816091954023,84,170,0.4941176470588235,0.549,34,46,0.7391304347826086
Marvin Bagley III,baglema01,PF,19,SAC,2019,62,1567.0,923,62,162,309,471,33,59,98,120,356,706,0.5042492917847026,30,96,0.3125,326,610,0.5344262295081967,0.525,181,262,0.6908396946564885
Ron Baker,bakerro01,SG,25,TOT,2019,15,152.0,14,15,1,10,11,6,1,5,18,4,20,0.2,1,13,0.0769230769230769,3,7,0.4285714285714285,0.225,5,6,0.8333333333333334
Wade Baldwin,baldwwa01,PG,22,POR,2019,16,94.0,30,12,2,13,15,1,2,14,11,10,33,0.303030303030303,2,9,0.2222222222222222,8,24,0.3333333333333333,0.333,8,11,0.7272727272727273
Lonzo Ball,balllo01,PG,21,LAL,2019,47,1423.0,465,255,54,197,251,69,19,103,114,185,456,0.4057017543859649,75,228,0.3289473684210526,110,228,0.4824561403508772,0.488,20,48,0.4166666666666667
Mo Bamba,bambamo01,C,20,ORL,2019,47,766.0,292,39,64,169,233,13,64,43,102,117,243,0.4814814814814814,21,70,0.3,96,173,0.5549132947976878,0.525,37,63,0.5873015873015873
J.J. Barea,bareajo01,PG,34,DAL,2019,38,752.0,415,211,13,82,95,22,1,72,50,161,385,0.4181818181818181,38,128,0.296875,123,257,0.4785992217898833,0.468,55,78,0.7051282051282052
Harrison Barnes,barneha02,PF-SF,26,TOT,2019,77,2533.0,1265,115,57,304,361,50,13,98,122,431,1027,0.4196689386562804,174,441,0.3945578231292517,257,586,0.4385665529010238,0.504,229,278,0.8237410071942446
Will Barton,bartowi01,SF,28,DEN,2019,43,1189.0,494,124,32,167,199,18,22,65,82,185,460,0.4021739130434782,67,196,0.3418367346938775,118,264,0.4469696969696969,0.475,57,74,0.7702702702702703
Keita Bates-Diop,bateske01,SF,23,MIN,2019,30,503.0,151,17,16,67,83,18,14,14,29,60,142,0.4225352112676056,13,52,0.25,47,90,0.5222222222222223,0.468,18,28,0.6428571428571429
Nicolas Batum,batumni01,SF,30,CHO,2019,75,2354.0,699,247,71,319,390,71,43,117,140,253,562,0.4501779359430605,116,298,0.3892617449664429,137,264,0.5189393939393939,0.553,77,89,0.8651685393258427
Jerryd Bayless,bayleje01,PG,30,MIN,2019,34,657.0,209,119,11,51,62,18,2,32,56,82,230,0.3565217391304348,29,98,0.2959183673469387,53,132,0.4015151515151515,0.42,16,28,0.5714285714285714
Aron Baynes,baynear01,C,32,BOS,2019,51,821.0,284,57,88,152,240,12,34,40,125,105,223,0.4708520179372197,21,61,0.3442622950819672,84,162,0.5185185185185185,0.518,53,62,0.8548387096774194
Kent Bazemore,bazemke01,SG,29,ATL,2019,67,1643.0,779,152,37,224,261,89,42,121,170,278,691,0.402315484804631,96,300,0.32,182,391,0.4654731457800511,0.472,127,175,0.7257142857142858
Bradley Beal,bealbr01,SG,25,WAS,2019,82,3028.0,2099,448,89,322,411,121,58,224,226,764,1609,0.4748290863890615,209,596,0.3506711409395973,555,1013,0.5478775913129319,0.54,362,448,0.8080357142857143
Malik Beasley,beaslma01,SG,22,DEN,2019,81,1879.0,917,97,35,165,200,55,10,55,116,349,737,0.4735413839891452,163,405,0.4024691358024691,186,332,0.5602409638554217,0.584,56,66,0.8484848484848485
Michael Beasley,beaslmi01,PF,30,LAL,2019,26,277.0,181,25,13,47,60,9,10,27,42,75,153,0.4901960784313725,3,17,0.1764705882352941,72,136,0.5294117647058824,0.5,28,39,0.717948717948718
Marco Belinelli,belinma01,SG,32,SAS,2019,79,1815.0,829,132,16,182,198,35,8,72,121,285,690,0.4130434782608695,147,395,0.3721518987341772,138,295,0.4677966101694915,0.52,112,124,0.9032258064516128
Jordan Bell,belljo01,C,24,GSW,2019,68,788.0,223,76,55,129,184,20,51,42,80,99,192,0.515625,0,2,0.0,99,190,0.5210526315789473,0.516,25,41,0.6097560975609756
DeAndre' Bembry,bembrde01,SG,24,ATL,2019,82,1931.0,687,202,54,304,358,105,41,142,190,275,616,0.4464285714285714,50,173,0.2890173410404624,225,443,0.5079006772009029,0.487,87,136,0.6397058823529411
Dragan Bender,bendedr01,PF,21,PHO,2019,46,826.0,230,56,34,149,183,18,22,37,90,88,197,0.4467005076142132,22,101,0.2178217821782178,66,96,0.6875,0.503,32,54,0.5925925925925926
Dairis Bertāns,bertada02,SG,29,NOP,2019,12,167.0,34,10,2,7,9,1,0,2,7,12,47,0.2553191489361702,10,34,0.2941176470588235,2,13,0.1538461538461538,0.362,0,0,0.0
Dāvis Bertāns,bertada01,PF,26,SAS,2019,76,1632.0,606,100,23,241,264,35,33,43,133,204,453,0.4503311258278146,145,338,0.4289940828402367,59,115,0.5130434782608696,0.61,53,60,0.8833333333333333
Patrick Beverley,beverpa01,PG,30,LAC,2019,78,2137.0,596,300,76,312,388,67,43,85,265,194,477,0.4067085953878406,112,282,0.3971631205673759,82,195,0.4205128205128205,0.524,96,123,0.7804878048780488
Khem Birch,birchkh01,C,26,ORL,2019,50,643.0,240,38,79,111,190,18,29,20,72,91,151,0.6026490066225165,0,1,0.0,91,150,0.6066666666666667,0.603,58,83,0.6987951807228916
Bismack Biyombo,biyombi01,C,26,CHO,2019,54,783.0,236,33,81,166,247,11,41,34,103,89,156,0.5705128205128205,0,0,0.0,89,156,0.5705128205128205,0.571,58,91,0.6373626373626373
Nemanja Bjelica,bjeline01,PF,30,SAC,2019,77,1788.0,741,147,125,319,444,54,56,82,197,284,593,0.4789207419898819,103,257,0.4007782101167315,181,336,0.5386904761904762,0.566,70,92,0.7608695652173914
Antonio Blakeney,blakean01,SG,22,CHI,2019,57,829.0,418,42,7,99,106,12,9,35,41,166,396,0.4191919191919191,36,91,0.3956043956043956,130,305,0.4262295081967213,0.465,50,76,0.6578947368421053
Eric Bledsoe,bledser01,PG,29,MIL,2019,78,2272.0,1241,430,82,280,362,116,29,165,156,470,971,0.4840370751802266,124,377,0.3289124668435013,346,594,0.5824915824915825,0.548,177,236,0.75
Jaron Blossomgame,blossja01,SF,25,CLE,2019,27,439.0,114,13,26,72,98,7,8,11,20,47,106,0.4433962264150943,10,39,0.2564102564102564,37,67,0.5522388059701493,0.491,10,13,0.7692307692307693
Bogdan Bogdanović,bogdabo01,SG,26,SAC,2019,70,1947.0,990,267,40,203,243,72,15,117,142,361,863,0.4183082271147161,134,372,0.3602150537634409,227,491,0.4623217922606925,0.496,134,162,0.8271604938271605
Bojan Bogdanović,bogdabo02,SF,29,IND,2019,81,2573.0,1454,161,33,300,333,69,1,134,138,522,1051,0.4966698382492864,164,386,0.4248704663212435,358,665,0.5383458646616541,0.575,246,305,0.8065573770491803
Andrew Bogut,bogutan01,C,34,GSW,2019,11,134.0,39,11,12,43,55,3,8,8,22,18,36,0.5,0,0,0.0,18,36,0.5,0.5,3,3,1.0
Jonah Bolden,boldejo01,PF,23,PHI,2019,44,639.0,207,40,47,118,165,17,39,36,99,80,162,0.4938271604938271,34,96,0.3541666666666667,46,66,0.696969696969697,0.599,13,27,0.4814814814814814
Isaac Bonga,bongais01,PG,19,LAL,2019,22,120.0,19,15,9,16,25,9,4,6,9,5,33,0.1515151515151515,0,8,0.0,5,25,0.2,0.152,9,15,0.6
Devin Booker,bookede01,SG,22,PHO,2019,64,2242.0,1700,433,39,226,265,56,13,264,200,586,1255,0.4669322709163346,135,414,0.3260869565217391,451,841,0.5362663495838288,0.521,393,454,0.8656387665198237
Chris Boucher,bouchch01,PF,26,TOR,2019,28,163.0,93,2,16,40,56,6,24,7,31,34,76,0.4473684210526316,12,37,0.3243243243243243,22,39,0.5641025641025641,0.526,13,15,0.8666666666666667
Avery Bradley,bradlav01,SG,28,TOT,2019,63,1905.0,625,152,43,132,175,41,16,89,167,248,608,0.4078947368421052,86,245,0.3510204081632653,162,363,0.4462809917355372,0.479,43,50,0.86
Tony Bradley,bradlto01,C,21,UTA,2019,3,36.0,17,1,9,6,15,2,2,3,6,8,16,0.5,0,0,0.0,8,16,0.5,0.5,1,2,0.5
Corey Brewer,breweco01,SF,32,TOT,2019,31,492.0,151,39,26,50,76,32,7,19,63,53,123,0.4308943089430894,14,44,0.3181818181818182,39,79,0.4936708860759494,0.488,31,43,0.7209302325581395
Mikal Bridges,bridgmi01,SF,22,PHO,2019,82,2417.0,684,173,56,208,264,129,38,70,201,242,563,0.4298401420959147,105,313,0.3354632587859425,137,250,0.548,0.523,95,118,0.8050847457627118
Miles Bridges,bridgmi02,SF,20,CHO,2019,80,1696.0,597,95,67,256,323,55,49,50,111,237,511,0.4637964774951076,65,200,0.325,172,311,0.5530546623794212,0.527,58,77,0.7532467532467533
Isaiah Briscoe,briscis01,PG,22,ORL,2019,39,559.0,136,87,5,69,74,11,2,31,66,55,138,0.3985507246376811,11,34,0.3235294117647059,44,104,0.4230769230769231,0.438,15,26,0.5769230769230769
Ryan Broekhoff,broekry01,SG,28,DAL,2019,42,453.0,167,22,8,55,63,6,4,16,35,57,126,0.4523809523809524,38,93,0.4086021505376344,19,33,0.5757575757575758,0.603,15,19,0.7894736842105263
Malcolm Brogdon,brogdma01,SG,26,MIL,2019,64,1832.0,1001,205,65,223,288,46,13,91,102,378,748,0.5053475935828877,104,244,0.4262295081967213,274,504,0.5436507936507936,0.575,141,152,0.9276315789473684
Dillon Brooks,brookdi01,SF,23,MEM,2019,18,330.0,135,16,9,22,31,10,4,19,50,49,122,0.4016393442622951,15,40,0.375,34,82,0.4146341463414634,0.463,22,30,0.7333333333333333
MarShon Brooks,brookma01,SG,30,MEM,2019,29,387.0,190,25,12,33,45,9,4,21,33,76,169,0.4497041420118343,15,54,0.2777777777777778,61,115,0.5304347826086957,0.494,23,33,0.696969696969697
Bruce Brown,brownbr01,SG,22,DET,2019,74,1449.0,319,91,48,137,185,40,36,46,178,125,314,0.3980891719745223,24,93,0.2580645161290322,101,221,0.4570135746606334,0.436,45,60,0.75
Jaylen Brown,brownja02,SG,22,BOS,2019,74,1913.0,964,100,65,248,313,69,32,99,186,368,792,0.4646464646464646,95,276,0.3442028985507246,273,516,0.5290697674418605,0.525,133,202,0.6584158415841584
Lorenzo Brown,brownlo01,PG,28,TOR,2019,26,212.0,55,28,5,26,31,12,5,16,22,23,71,0.323943661971831,6,28,0.2142857142857142,17,43,0.3953488372093023,0.366,3,3,1.0
Sterling Brown,brownst02,SG,23,MIL,2019,58,1034.0,372,84,29,155,184,25,8,46,88,145,312,0.4647435897435897,53,147,0.3605442176870748,92,165,0.5575757575757576,0.55,29,42,0.6904761904761905
Troy Brown Jr.,browntr01,SF,19,WAS,2019,52,730.0,248,80,35,110,145,21,5,30,56,97,234,0.4145299145299145,22,69,0.3188405797101449,75,165,0.4545454545454545,0.462,32,47,0.6808510638297872
Jalen Brunson,brunsja01,PG,22,DAL,2019,73,1591.0,678,230,25,144,169,37,4,88,127,264,565,0.4672566371681416,63,181,0.3480662983425414,201,384,0.5234375,0.523,87,120,0.725
Thomas Bryant,bryanth01,C,21,WAS,2019,72,1496.0,758,92,113,341,454,25,67,60,126,309,502,0.6155378486055777,33,99,0.3333333333333333,276,403,0.684863523573201,0.648,107,137,0.781021897810219
Reggie Bullock,bullore01,SG,27,TOT,2019,63,1879.0,711,129,22,151,173,40,12,65,109,245,594,0.4124579124579124,148,393,0.376590330788804,97,201,0.4825870646766169,0.537,73,85,0.8588235294117647
Trey Burke,burketr01,PG,26,TOT,2019,58,1125.0,631,159,28,71,99,33,7,49,58,236,548,0.4306569343065693,56,159,0.3522012578616352,180,389,0.4627249357326478,0.482,103,124,0.8306451612903226
Alec Burks,burksal01,SG,27,TOT,2019,64,1375.0,561,128,30,205,235,39,21,65,91,192,474,0.4050632911392405,61,168,0.3630952380952381,131,306,0.4281045751633986,0.469,116,141,0.8226950354609929
Deonte Burton,burtode02,SG,25,OKC,2019,32,240.0,82,9,4,24,28,6,8,9,31,33,82,0.4024390243902439,8,27,0.2962962962962963,25,55,0.4545454545454545,0.451,8,12,0.6666666666666666
Jimmy Butler,butleji01,SF-SG,29,TOT,2019,65,2185.0,1215,263,121,221,342,123,39,95,111,418,904,0.4623893805309734,67,193,0.3471502590673575,351,711,0.4936708860759494,0.499,312,365,0.8547945205479452
Bruno Caboclo,cabocbr01,PF,23,MEM,2019,34,800.0,282,50,42,116,158,14,33,38,81,96,225,0.4266666666666667,48,130,0.3692307692307692,48,95,0.5052631578947369,0.533,42,50,0.84
José Calderón,caldejo01,PG,37,DET,2019,49,632.0,113,115,11,49,60,16,3,35,64,45,120,0.375,14,57,0.2456140350877192,31,63,0.492063492063492,0.433,9,11,0.8181818181818182
Kentavious Caldwell-Pope,caldwke01,SG,25,LAL,2019,82,2035.0,938,110,48,190,238,73,13,65,137,325,756,0.4298941798941799,151,435,0.3471264367816092,174,321,0.5420560747663551,0.53,137,158,0.8670886075949367
Isaiah Canaan,canaais01,PG,27,TOT,2019,30,629.0,181,84,6,52,58,14,2,35,52,64,164,0.3902439024390244,34,96,0.3541666666666667,30,68,0.4411764705882353,0.494,19,24,0.7916666666666666
Clint Capela,capelca01,C,24,HOU,2019,67,2249.0,1114,96,298,550,848,44,102,94,168,474,732,0.6475409836065574,0,0,0.0,474,732,0.6475409836065574,0.648,166,261,0.6360153256704981
DeMarre Carroll,carrode01,PF,32,BRK,2019,67,1703.0,744,85,68,281,349,31,10,73,114,227,575,0.3947826086956522,106,310,0.3419354838709677,121,265,0.4566037735849056,0.487,184,242,0.7603305785123967
Jevon Carter,carteje01,PG,23,MEM,2019,39,577.0,172,69,14,52,66,26,11,33,55,56,185,0.3027027027027027,34,102,0.3333333333333333,22,83,0.2650602409638554,0.395,26,32,0.8125
Vince Carter,cartevi01,PF,42,ATL,2019,76,1330.0,562,87,31,163,194,44,27,48,141,196,468,0.4188034188034188,123,316,0.3892405063291139,73,152,0.4802631578947368,0.55,47,66,0.7121212121212122
Wendell Carter Jr.,cartewe01,C,19,CHI,2019,44,1110.0,455,78,87,220,307,26,58,65,152,180,371,0.4851752021563342,6,32,0.1875,174,339,0.5132743362831859,0.493,89,112,0.7946428571428571
Michael Carter-Williams,cartemi01,PG,27,TOT,2019,28,372.0,134,70,19,51,70,20,15,20,48,46,123,0.3739837398373983,10,38,0.2631578947368421,36,85,0.4235294117647059,0.415,32,53,0.6037735849056604
Alex Caruso,carusal01,PG,24,LAL,2019,25,531.0,229,77,20,47,67,24,9,42,54,77,173,0.4450867052023121,24,50,0.48,53,123,0.4308943089430894,0.514,51,64,0.796875
Omri Casspi,casspom01,SF,30,MEM,2019,36,520.0,226,26,17,98,115,20,9,23,35,86,161,0.5341614906832298,15,43,0.3488372093023256,71,118,0.6016949152542372,0.581,39,58,0.6724137931034483
Willie Cauley-Stein,caulewi01,C,25,SAC,2019,81,2213.0,965,194,181,497,678,96,51,84,227,412,741,0.5560053981106613,1,2,0.5,411,739,0.5561569688768606,0.557,140,254,0.5511811023622047
Troy Caupain,caupatr01,PG,23,ORL,2019,4,16.0,10,4,1,2,3,1,0,0,0,4,8,0.5,2,3,0.6666666666666666,2,5,0.4,0.625,0,0,0.0
Tyler Cavanaugh,cavanty01,PF,24,UTA,2019,11,39.0,9,1,3,5,8,0,0,1,3,3,10,0.3,1,5,0.2,2,5,0.4,0.35,2,2,1.0
Tyson Chandler,chandty01,C,36,TOT,2019,55,875.0,173,37,92,215,307,21,23,42,110,61,99,0.6161616161616161,0,1,0.0,61,98,0.6224489795918368,0.616,51,87,0.5862068965517241
Wilson Chandler,chandwi01,PF-SF,31,TOT,2019,51,1177.0,305,82,48,167,215,25,21,46,123,114,273,0.4175824175824176,59,158,0.3734177215189873,55,115,0.4782608695652174,0.526,18,25,0.72
Joe Chealey,chealjo01,PG,23,CHO,2019,1,8.0,2,1,0,0,0,0,0,0,1,1,3,0.3333333333333333,0,0,0.0,1,3,0.3333333333333333,0.333,0,0,0.0
Chris Chiozza,chiozch01,PG,23,HOU,2019,7,33.0,6,4,1,3,4,1,1,1,2,2,8,0.25,2,5,0.4,0,3,0.0,0.375,0,0,0.0
Marquese Chriss,chrisma01,PF,21,TOT,2019,43,499.0,182,22,40,102,142,17,11,36,81,67,180,0.3722222222222222,16,72,0.2222222222222222,51,108,0.4722222222222222,0.417,32,45,0.7111111111111111
Gary Clark,clarkga01,PF,24,HOU,2019,51,641.0,148,18,24,92,116,20,26,7,47,50,151,0.3311258278145695,41,138,0.2971014492753623,9,13,0.6923076923076923,0.467,7,7,1.0
Ian Clark,clarkia01,SG,27,NOP,2019,60,973.0,401,94,13,76,89,22,8,58,95,151,383,0.3942558746736292,66,202,0.3267326732673267,85,181,0.4696132596685083,0.48,33,37,0.8918918918918919
Jordan Clarkson,clarkjo01,SG,26,CLE,2019,81,2214.0,1364,196,82,188,270,57,13,135,112,529,1180,0.4483050847457627,144,445,0.3235955056179775,385,735,0.5238095238095238,0.509,162,192,0.84375
John Collins,collijo01,PF,21,ATL,2019,61,1829.0,1188,121,219,376,595,22,39,120,199,465,831,0.5595667870036101,55,158,0.3481012658227848,410,673,0.6092124814264487,0.593,203,266,0.7631578947368421
Zach Collins,colliza01,C,21,POR,2019,77,1356.0,512,71,109,215,324,25,66,77,174,189,400,0.4725,40,121,0.3305785123966942,149,279,0.5340501792114696,0.523,94,126,0.746031746031746
Darren Collison,collida01,PG,31,IND,2019,76,2143.0,853,459,36,196,232,110,9,125,138,308,659,0.4673748103186646,79,194,0.4072164948453608,229,465,0.4924731182795699,0.527,158,190,0.8315789473684211
Bonzie Colson,colsobo01,SF,23,MIL,2019,8,98.0,39,3,8,22,30,5,1,3,3,13,39,0.3333333333333333,5,21,0.238095238095238,8,18,0.4444444444444444,0.397,8,9,0.8888888888888888
Mike Conley,conlemi01,PG,31,MEM,2019,70,2342.0,1478,449,40,199,239,94,22,130,123,490,1120,0.4375,155,426,0.3638497652582159,335,694,0.4827089337175792,0.507,343,406,0.8448275862068966
Pat Connaughton,connapa01,SG,26,MIL,2019,61,1261.0,421,122,61,197,258,33,25,33,81,163,350,0.4657142857142857,66,200,0.33,97,150,0.6466666666666666,0.56,29,40,0.725
Quinn Cook,cookqu01,PG,25,GSW,2019,74,1059.0,509,116,22,135,157,20,3,50,92,204,439,0.4646924829157175,81,200,0.405,123,239,0.5146443514644351,0.557,20,26,0.7692307692307693
DeMarcus Cousins,couside01,C,28,GSW,2019,30,771.0,488,107,43,204,247,40,44,72,109,178,371,0.4797843665768194,26,95,0.2736842105263158,152,276,0.5507246376811594,0.515,106,144,0.7361111111111112
Robert Covington,covinro01,SF,28,TOT,2019,35,1203.0,465,46,28,165,193,74,47,47,126,156,362,0.430939226519337,85,225,0.3777777777777777,71,137,0.5182481751824818,0.548,68,89,0.7640449438202247
Allen Crabbe,crabbal01,SG,26,BRK,2019,43,1133.0,413,46,16,132,148,23,13,46,102,137,373,0.3672922252010724,98,259,0.3783783783783784,39,114,0.3421052631578947,0.499,41,56,0.7321428571428571
Torrey Craig,craigto01,SF,28,DEN,2019,75,1503.0,430,72,89,174,263,37,46,44,175,160,362,0.4419889502762431,61,188,0.324468085106383,99,174,0.5689655172413793,0.526,49,70,0.7
Jamal Crawford,crawfja01,SG,38,PHO,2019,64,1211.0,508,229,8,77,85,33,12,99,75,174,438,0.3972602739726027,67,202,0.3316831683168317,107,236,0.4533898305084746,0.474,93,110,0.8454545454545455
Mitch Creek,creekmi01,SF,26,TOT,2019,5,48.0,21,6,6,6,12,2,0,1,3,8,16,0.5,0,2,0.0,8,14,0.5714285714285714,0.5,5,7,0.7142857142857143
Jae Crowder,crowdja01,SF,28,UTA,2019,80,2166.0,951,133,60,324,384,64,31,85,170,318,797,0.3989962358845671,173,522,0.3314176245210728,145,275,0.5272727272727272,0.508,142,197,0.7208121827411168
Dante Cunningham,cunnida01,PF,31,SAS,2019,64,928.0,194,50,48,140,188,27,13,22,71,75,158,0.4746835443037974,30,65,0.4615384615384615,45,93,0.4838709677419355,0.57,14,18,0.7777777777777778
Seth Curry,curryse01,SG,28,POR,2019,74,1399.0,581,66,27,93,120,36,12,61,97,212,465,0.4559139784946237,113,251,0.450199203187251,99,214,0.4626168224299065,0.577,44,52,0.8461538461538461
Stephen Curry,curryst01,PG,30,GSW,2019,69,2331.0,1881,361,45,324,369,92,25,192,166,632,1340,0.4716417910447761,354,810,0.437037037037037,278,530,0.5245283018867924,0.604,263,287,0.9163763066202092
Troy Daniels,danietr01,SG,27,PHO,2019,51,760.0,318,26,13,60,73,26,5,27,79,113,275,0.4109090909090909,74,194,0.3814432989690721,39,81,0.4814814814814814,0.545,18,23,0.782608695652174
Anthony Davis,davisan02,C,25,NOP,2019,56,1850.0,1452,218,174,498,672,88,135,112,132,530,1026,0.5165692007797271,48,145,0.3310344827586207,482,881,0.547105561861521,0.54,344,433,0.7944572748267898
Deyonta Davis,davisde01,C,22,ATL,2019,9,118.0,36,5,10,26,36,3,5,3,12,15,22,0.6818181818181818,0,1,0.0,15,21,0.7142857142857143,0.682,6,10,0.6
Ed Davis,davised01,C,29,BRK,2019,81,1446.0,472,61,216,478,694,35,33,64,226,186,302,0.6158940397350994,0,2,0.0,186,300,0.62,0.616,100,162,0.6172839506172839
Tyler Davis,davisty01,C,21,OKC,2019,1,1.0,0,0,1,0,1,0,0,0,0,0,1,0.0,0,0,0.0,0,1,0.0,0.0,0,0,0.0
Dewayne Dedmon,dedmode01,C,29,ATL,2019,64,1609.0,693,90,105,375,480,69,71,84,214,259,526,0.4923954372623574,83,217,0.3824884792626728,176,309,0.56957928802589,0.571,92,113,0.8141592920353983
Sam Dekker,dekkesa01,PF,24,TOT,2019,47,788.0,287,46,53,95,148,38,7,24,47,120,256,0.46875,19,62,0.3064516129032258,101,194,0.520618556701031,0.506,28,46,0.6086956521739131
Ángel Delgado,delgaan01,C,24,LAC,2019,2,15.0,3,0,2,2,4,1,0,0,2,1,5,0.2,0,0,0.0,1,5,0.2,0.2,1,2,0.5
Matthew Dellavedova,dellama01,PG,28,TOT,2019,48,812.0,282,181,6,71,77,14,2,68,75,98,242,0.4049586776859504,44,130,0.3384615384615385,54,112,0.4821428571428571,0.496,42,52,0.8076923076923077
Luol Deng,denglu01,SF,33,MIN,2019,22,392.0,157,18,20,53,73,15,8,14,24,59,118,0.5,14,44,0.3181818181818182,45,74,0.6081081081081081,0.559,25,35,0.7142857142857143
DeMar DeRozan,derozde01,SG,29,SAS,2019,77,2688.0,1635,475,54,408,462,86,36,199,177,631,1313,0.4805788271134806,7,45,0.1555555555555555,624,1268,0.4921135646687697,0.483,366,441,0.8299319727891157
Marcus Derrickson,derrima01,PF,22,GSW,2019,11,67.0,46,1,8,5,13,0,1,3,9,16,33,0.4848484848484848,10,20,0.5,6,13,0.4615384615384615,0.636,4,5,0.8
Cheick Diallo,diallch01,PF,22,NOP,2019,64,896.0,387,33,75,257,332,29,33,49,113,168,271,0.6199261992619927,1,4,0.25,167,267,0.6254681647940075,0.622,50,67,0.746268656716418
Hamidou Diallo,diallha01,SG,20,OKC,2019,51,526.0,190,17,38,59,97,21,10,23,77,75,165,0.4545454545454545,4,24,0.1666666666666666,71,141,0.5035460992907801,0.467,36,59,0.6101694915254238
Gorgui Dieng,dienggo01,C,29,MIN,2019,76,1031.0,485,72,81,230,311,48,41,57,134,189,377,0.5013262599469496,19,56,0.3392857142857143,170,321,0.5295950155763239,0.527,88,106,0.8301886792452831
Spencer Dinwiddie,dinwisp01,PG,25,BRK,2019,68,1914.0,1143,311,26,140,166,40,17,152,187,366,828,0.4420289855072464,124,370,0.3351351351351351,242,458,0.5283842794759825,0.517,287,356,0.8061797752808989
Donte DiVincenzo,divindo01,SG,22,MIL,2019,27,411.0,131,31,16,49,65,13,6,19,38,50,124,0.4032258064516129,22,83,0.2650602409638554,28,41,0.6829268292682927,0.492,9,12,0.75
Luka Dončić,doncilu01,SG,19,DAL,2019,72,2318.0,1526,429,86,477,563,77,25,247,137,506,1186,0.4266441821247892,168,514,0.3268482490272373,338,672,0.5029761904761905,0.497,346,485,0.7134020618556701
Tyler Dorsey,dorsety01,SG,22,TOT,2019,48,698.0,296,56,27,86,113,14,2,27,53,107,264,0.4053030303030303,44,132,0.3333333333333333,63,132,0.4772727272727273,0.489,38,61,0.6229508196721312
Damyean Dotson,dotsoda01,SG,24,NYK,2019,73,2004.0,779,135,34,228,262,58,10,71,135,290,698,0.4154727793696275,126,342,0.3684210526315789,164,356,0.4606741573033708,0.506,73,98,0.7448979591836735
PJ Dozier,doziepj01,SG,22,BOS,2019,6,51.0,19,5,6,11,17,2,0,0,2,8,21,0.3809523809523809,2,8,0.25,6,13,0.4615384615384615,0.429,1,2,0.5
Goran Dragić,dragigo01,PG,32,MIA,2019,36,991.0,494,174,20,91,111,30,5,71,81,179,433,0.4133949191685912,57,164,0.3475609756097561,122,269,0.4535315985130111,0.479,79,101,0.7821782178217822
Andre Drummond,drumman01,C,25,DET,2019,79,2647.0,1370,112,423,809,1232,136,138,175,272,561,1052,0.5332699619771863,5,38,0.131578947368421,556,1014,0.5483234714003945,0.536,243,412,0.5898058252427184
Jared Dudley,dudleja01,PF,33,BRK,2019,59,1220.0,287,83,34,121,155,36,16,43,131,101,239,0.4225941422594142,53,151,0.3509933774834437,48,88,0.5454545454545454,0.533,32,46,0.6956521739130435
Kris Dunn,dunnkr01,PG,24,CHI,2019,46,1389.0,519,277,19,168,187,68,21,104,166,215,506,0.424901185770751,34,96,0.3541666666666667,181,410,0.4414634146341463,0.458,55,69,0.7971014492753623
Kevin Durant,duranke01,SF,30,GSW,2019,78,2702.0,2027,457,33,464,497,58,84,225,155,721,1383,0.5213304410701374,137,388,0.3530927835051546,584,995,0.5869346733668341,0.571,448,506,0.8853754940711462
Trevon Duval,duvaltr01,PG,20,MIL,2019,3,6.0,5,2,0,1,1,0,0,0,0,2,3,0.6666666666666666,1,1,1.0,1,2,0.5,0.833,0,0,0.0
Vince Edwards,edwarvi01,SF,22,HOU,2019,2,16.0,3,0,1,1,2,0,0,0,0,1,4,0.25,1,4,0.25,0,0,0.0,0.375,0,0,0.0
Henry Ellenson,ellenhe01,PF,22,TOT,2019,19,259.0,114,16,5,61,66,7,2,9,27,39,95,0.4105263157894737,17,38,0.4473684210526316,22,57,0.3859649122807017,0.5,19,25,0.76
Wayne Ellington,ellinwa01,SG,31,TOT,2019,53,1297.0,545,72,14,93,107,54,6,40,92,184,457,0.4026258205689278,138,372,0.3709677419354839,46,85,0.5411764705882353,0.554,39,49,0.7959183673469388
Joel Embiid,embiijo01,C,24,PHI,2019,64,2154.0,1761,234,160,711,871,46,122,226,211,580,1199,0.4837364470391993,79,263,0.3003802281368821,501,936,0.5352564102564102,0.517,522,649,0.8043143297380585
James Ennis III,ennisja01,SF,28,TOT,2019,58,1230.0,389,41,60,122,182,41,23,34,150,138,294,0.4693877551020408,55,156,0.3525641025641026,83,138,0.6014492753623188,0.563,58,81,0.7160493827160493
Drew Eubanks,eubandr01,PF,21,SAS,2019,23,113.0,41,7,6,28,34,2,5,8,11,15,26,0.5769230769230769,0,0,0.0,15,26,0.5769230769230769,0.577,11,13,0.8461538461538461
Jacob Evans,evansja02,SG,21,GSW,2019,30,204.0,40,23,6,19,25,5,3,11,28,18,53,0.3396226415094339,4,15,0.2666666666666666,14,38,0.3684210526315789,0.377,0,1,0.0
Jawun Evans,evansja01,PG,22,TOT,2019,8,65.0,6,10,1,11,12,3,0,6,8,3,14,0.2142857142857142,0,3,0.0,3,11,0.2727272727272727,0.214,0,0,0.0
Tyreke Evans,evansty01,SG,29,IND,2019,69,1402.0,706,166,33,168,201,58,18,118,117,257,660,0.3893939393939394,77,216,0.3564814814814814,180,444,0.4054054054054054,0.448,115,160,0.71875
Dante Exum,exumda01,PG,23,UTA,2019,42,664.0,288,110,16,52,68,14,5,52,69,101,241,0.4190871369294606,18,62,0.2903225806451613,83,179,0.4636871508379888,0.456,68,86,0.7906976744186046
Kenneth Faried,farieke01,C,29,TOT,2019,37,728.0,384,20,97,153,250,17,23,33,82,156,265,0.5886792452830188,8,25,0.32,148,240,0.6166666666666667,0.604,64,99,0.6464646464646465
Derrick Favors,favorde01,C,27,UTA,2019,76,1766.0,897,89,207,353,560,56,106,84,163,363,619,0.5864297253634895,17,78,0.2179487179487179,346,541,0.6395563770794824,0.6,154,228,0.6754385964912281
Cristiano Felício,feliccr01,C,26,CHI,2019,60,746.0,240,37,79,139,218,11,7,33,69,95,179,0.5307262569832403,0,4,0.0,95,175,0.5428571428571428,0.531,50,73,0.684931506849315
Raymond Felton,feltora01,PG,34,OKC,2019,33,379.0,142,52,4,30,34,10,6,14,29,55,135,0.4074074074074074,20,61,0.3278688524590163,35,74,0.4729729729729729,0.481,12,13,0.9230769230769232
Terrance Ferguson,fergute01,SG,20,OKC,2019,74,1931.0,513,72,33,108,141,40,16,47,231,185,431,0.4292343387470997,106,290,0.3655172413793103,79,141,0.5602836879432624,0.552,37,51,0.7254901960784313
Yogi Ferrell,ferreyo01,PG,25,SAC,2019,71,1067.0,420,137,13,96,109,36,4,40,64,153,352,0.4346590909090909,54,149,0.3624161073825503,99,203,0.4876847290640394,0.511,60,67,0.8955223880597015
Dorian Finney-Smith,finnedo01,SF,25,DAL,2019,81,1985.0,608,95,138,251,389,69,36,74,186,228,528,0.4318181818181818,79,254,0.3110236220472441,149,274,0.5437956204379562,0.507,73,103,0.7087378640776699
Bryn Forbes,forbebr01,SG,25,SAS,2019,82,2293.0,967,175,18,221,239,45,4,80,159,361,791,0.4563843236409608,176,413,0.4261501210653753,185,378,0.4894179894179894,0.568,69,78,0.8846153846153846
Evan Fournier,fournev01,SG,26,ORL,2019,81,2553.0,1226,295,38,220,258,71,12,154,225,468,1069,0.4377923292797006,153,450,0.34,315,619,0.5088852988691438,0.509,137,170,0.8058823529411765
De'Aaron Fox,foxde01,PG,21,SAC,2019,81,2546.0,1399,590,43,261,304,133,45,227,204,505,1102,0.4582577132486388,86,232,0.3706896551724138,419,870,0.4816091954022988,0.497,303,417,0.7266187050359713
Melvin Frazier,frazime01,SG,22,ORL,2019,10,44.0,15,1,3,2,5,1,0,1,6,7,21,0.3333333333333333,0,6,0.0,7,15,0.4666666666666667,0.333,1,4,0.25
Tim Frazier,fraziti01,PG,28,TOT,2019,59,1120.0,310,248,41,127,168,30,5,76,112,116,261,0.4444444444444444,37,101,0.3663366336633663,79,160,0.49375,0.515,41,54,0.7592592592592593
Jimmer Fredette,fredeji01,SG,29,PHO,2019,6,65.0,22,8,1,6,7,3,0,5,5,8,29,0.2758620689655172,0,13,0.0,8,16,0.5,0.276,6,6,1.0
Enes Freedom,kanteen01,C,26,TOT,2019,67,1640.0,915,116,257,402,659,32,26,118,167,375,683,0.5490483162518301,10,34,0.2941176470588235,365,649,0.5624036979969184,0.556,155,197,0.7868020304568528
Channing Frye,fryech01,C,35,CLE,2019,36,341.0,129,20,4,48,52,6,5,13,44,43,117,0.3675213675213675,32,79,0.4050632911392405,11,38,0.2894736842105263,0.504,11,14,0.7857142857142857
Markelle Fultz,fultzma01,SG,20,PHI,2019,19,427.0,155,59,26,44,70,17,5,25,52,65,155,0.4193548387096774,4,14,0.2857142857142857,61,141,0.4326241134751773,0.432,21,37,0.5675675675675675
Danilo Gallinari,gallida01,SF,30,LAC,2019,68,2059.0,1346,178,54,363,417,49,23,99,129,409,884,0.4626696832579186,161,372,0.4327956989247312,248,512,0.484375,0.554,367,406,0.9039408866995072
Langston Galloway,gallola01,SG,27,DET,2019,80,1745.0,672,85,49,122,171,37,8,24,135,228,587,0.3884156729131175,135,380,0.3552631578947368,93,207,0.4492753623188406,0.503,81,96,0.84375
Billy Garrett,garrebi01,SG,24,NYK,2019,4,63.0,26,7,0,3,3,1,1,2,3,11,27,0.4074074074074074,0,8,0.0,11,19,0.5789473684210527,0.407,4,4,1.0
Marc Gasol,gasolma01,C,34,TOT,2019,79,2436.0,1071,349,80,547,627,84,86,155,217,390,870,0.4482758620689655,99,273,0.3626373626373626,291,597,0.4874371859296482,0.505,192,253,0.758893280632411
Pau Gasol,gasolpa01,C,38,TOT,2019,30,360.0,118,52,22,115,137,5,15,16,29,42,94,0.4468085106382978,6,13,0.4615384615384615,36,81,0.4444444444444444,0.479,28,40,0.7
Rudy Gay,gayru01,PF,32,SAS,2019,69,1842.0,946,182,63,407,470,54,34,114,159,376,746,0.5040214477211796,74,184,0.4021739130434782,302,562,0.5373665480427047,0.554,120,147,0.8163265306122449
Paul George,georgpa01,SF,28,OKC,2019,77,2841.0,2159,318,105,523,628,170,34,205,214,707,1614,0.4380421313506815,292,757,0.3857331571994716,415,857,0.484247374562427,0.529,453,540,0.8388888888888889
Taj Gibson,gibsota01,PF,33,MIN,2019,70,1686.0,753,84,172,286,458,53,39,73,186,304,537,0.5661080074487895,11,34,0.3235294117647059,293,503,0.5825049701789264,0.576,134,177,0.7570621468926554
Harry Giles,gilesha01,PF,20,SAC,2019,58,820.0,408,85,66,156,222,31,22,73,150,175,348,0.5028735632183908,0,6,0.0,175,342,0.5116959064327485,0.503,58,91,0.6373626373626373
Shai Gilgeous-Alexander,gilgesh01,PG,20,LAC,2019,82,2174.0,889,270,57,175,232,96,45,141,175,341,716,0.4762569832402235,51,139,0.3669064748201439,290,577,0.5025996533795494,0.512,156,195,0.8
Rudy Gobert,goberru01,C,26,UTA,2019,81,2577.0,1284,161,309,732,1041,66,187,130,231,476,712,0.6685393258426966,0,0,0.0,476,712,0.6685393258426966,0.669,332,522,0.6360153256704981
Brandon Goodwin,goodwbr01,PG,23,DEN,2019,16,57.0,23,14,1,2,3,0,0,3,7,6,23,0.2608695652173913,2,6,0.3333333333333333,4,17,0.2352941176470588,0.304,9,11,0.8181818181818182
Aaron Gordon,gordoaa01,PF,23,ORL,2019,78,2633.0,1246,289,129,445,574,57,56,162,172,470,1046,0.4493307839388145,121,347,0.3487031700288184,349,699,0.4992846924177396,0.507,185,253,0.7312252964426877
Eric Gordon,gordoer01,SG,30,HOU,2019,68,2158.0,1103,129,17,131,148,41,27,90,143,384,938,0.4093816631130064,216,600,0.36,168,338,0.4970414201183432,0.525,119,152,0.7828947368421053
Marcin Gortat,gortama01,C,34,LAC,2019,47,751.0,233,65,67,194,261,6,24,50,92,99,186,0.532258064516129,0,0,0.0,99,186,0.532258064516129,0.532,35,48,0.7291666666666666
Devonte' Graham,grahade01,PG,23,CHO,2019,46,676.0,217,121,10,53,63,23,2,30,48,74,216,0.3425925925925926,34,121,0.2809917355371901,40,95,0.4210526315789473,0.421,35,46,0.7608695652173914
Treveon Graham,grahatr01,SG,25,BRK,2019,35,715.0,184,34,23,84,107,13,7,17,68,64,191,0.3350785340314136,38,128,0.296875,26,63,0.4126984126984127,0.435,18,22,0.8181818181818182
Jerami Grant,grantje01,PF,24,OKC,2019,80,2612.0,1090,79,96,321,417,61,100,67,214,409,823,0.496962332928311,115,293,0.3924914675767918,294,530,0.5547169811320755,0.567,157,221,0.7104072398190046
Jerian Grant,grantje02,PG,26,ORL,2019,60,939.0,250,156,19,79,98,44,6,51,78,92,220,0.4181818181818181,40,110,0.3636363636363636,52,110,0.4727272727272727,0.509,26,40,0.65
Donte Grantham,grantdo01,SF,23,OKC,2019,3,2.0,0,0,0,0,0,0,0,0,0,0,2,0.0,0,2,0.0,0,0,0.0,0.0,0,0,0.0
Danny Green,greenda02,SG,31,TOR,2019,80,2216.0,821,126,60,257,317,73,53,75,171,293,630,0.4650793650793651,198,435,0.4551724137931034,95,195,0.4871794871794871,0.622,37,44,0.8409090909090909
Draymond Green,greendr01,PF,28,GSW,2019,66,2065.0,486,454,60,421,481,95,70,169,197,188,422,0.4454976303317535,47,165,0.2848484848484848,141,257,0.5486381322957199,0.501,63,91,0.6923076923076923
Gerald Green,greenge01,SG,33,HOU,2019,73,1473.0,675,40,30,152,182,33,27,55,126,231,578,0.3996539792387543,156,441,0.3537414965986394,75,137,0.5474452554744526,0.535,57,68,0.8382352941176471
JaMychal Green,greenja01,PF,28,TOT,2019,65,1371.0,611,50,104,305,409,45,34,87,193,230,476,0.4831932773109244,71,176,0.4034090909090909,159,300,0.53,0.558,80,101,0.7920792079207921
Jeff Green,greenje02,PF,32,WAS,2019,77,2097.0,946,137,57,252,309,43,39,101,160,326,687,0.4745269286754003,111,320,0.346875,215,367,0.5858310626702997,0.555,183,206,0.8883495145631068
Blake Griffin,griffbl01,PF,29,DET,2019,75,2622.0,1841,402,100,465,565,52,28,253,199,619,1341,0.4615958240119314,189,522,0.3620689655172414,430,819,0.525030525030525,0.532,414,550,0.7527272727272727
Daniel Hamilton,hamilda02,SG,23,ATL,2019,19,204.0,57,22,10,37,47,6,1,16,19,23,60,0.3833333333333333,8,23,0.3478260869565217,15,37,0.4054054054054054,0.45,3,6,0.5
Dusty Hannahs,hannadu01,SG,25,MEM,2019,2,26.0,8,5,0,1,1,1,0,1,1,3,12,0.25,0,5,0.0,3,7,0.4285714285714285,0.25,2,2,1.0
Tim Hardaway Jr.,hardati02,SG,26,TOT,2019,65,2057.0,1174,159,33,189,222,54,8,105,141,390,993,0.3927492447129909,162,477,0.3396226415094339,228,516,0.4418604651162791,0.474,232,276,0.8405797101449275
James Harden,hardeja01,PG,29,HOU,2019,78,2867.0,2818,586,66,452,518,158,58,387,244,843,1909,0.4415924567836564,378,1028,0.367704280155642,465,881,0.5278093076049943,0.541,754,858,0.8787878787878788
Maurice Harkless,harklma01,SF,25,POR,2019,60,1415.0,460,74,77,192,269,67,53,45,163,189,388,0.4871134020618556,33,120,0.275,156,268,0.582089552238806,0.53,49,73,0.6712328767123288
Montrezl Harrell,harremo01,C,25,LAC,2019,82,2158.0,1361,162,184,351,535,71,110,132,255,546,888,0.6148648648648649,3,17,0.1764705882352941,543,871,0.6234213547646383,0.617,266,414,0.642512077294686
Devin Harris,harride01,PG,35,DAL,2019,68,1071.0,428,122,12,100,112,35,16,56,133,132,347,0.3804034582132565,62,200,0.31,70,147,0.4761904761904761,0.47,102,134,0.7611940298507462
Gary Harris,harriga01,SG,24,DEN,2019,57,1639.0,737,127,41,119,160,55,19,68,113,270,637,0.423861852433281,82,242,0.3388429752066115,188,395,0.4759493670886076,0.488,115,144,0.7986111111111112
Joe Harris,harrijo01,SG,27,BRK,2019,76,2293.0,1041,181,52,239,291,38,17,121,182,374,748,0.5,183,386,0.4740932642487047,191,362,0.5276243093922652,0.622,110,133,0.8270676691729323
Tobias Harris,harrito02,PF,26,TOT,2019,82,2847.0,1644,229,69,576,645,51,37,151,184,611,1254,0.4872408293460925,156,393,0.3969465648854962,455,861,0.5284552845528455,0.549,266,307,0.8664495114006515
Andrew Harrison,harrian01,PG,24,TOT,2019,17,187.0,54,24,6,14,20,4,2,12,34,16,53,0.3018867924528302,5,25,0.2,11,28,0.3928571428571428,0.349,17,18,0.9444444444444444
Shaquille Harrison,harrish01,SG,25,CHI,2019,73,1430.0,474,139,33,189,222,89,30,60,124,184,426,0.431924882629108,24,89,0.2696629213483146,160,337,0.4747774480712166,0.46,82,123,0.6666666666666666
Josh Hart,hartjo01,SG,23,LAL,2019,67,1715.0,525,93,35,213,248,64,40,58,147,189,464,0.4073275862068966,92,274,0.3357664233576642,97,190,0.5105263157894737,0.506,55,80,0.6875
Isaiah Hartenstein,harteis01,PF,20,HOU,2019,28,221.0,53,15,21,26,47,7,12,13,56,20,41,0.4878048780487805,2,6,0.3333333333333333,18,35,0.5142857142857142,0.512,11,14,0.7857142857142857
Udonis Haslem,hasleud01,C,38,MIA,2019,10,74.0,25,2,3,24,27,0,0,3,9,11,33,0.3333333333333333,0,12,0.0,11,21,0.5238095238095238,0.333,3,4,0.75
Gordon Hayward,haywago01,PF,28,BOS,2019,72,1863.0,825,244,51,271,322,62,23,105,104,296,635,0.4661417322834645,77,231,0.3333333333333333,219,404,0.5420792079207921,0.527,156,187,0.8342245989304813
John Henson,hensojo01,C,28,MIL,2019,14,188.0,79,14,16,55,71,7,11,12,16,31,67,0.4626865671641791,11,31,0.3548387096774194,20,36,0.5555555555555556,0.545,6,10,0.6
Juancho Hernangómez,hernaju01,PF,23,DEN,2019,70,1358.0,408,55,64,201,265,27,24,37,94,138,314,0.4394904458598726,66,181,0.3646408839779005,72,133,0.5413533834586466,0.545,66,86,0.7674418604651163
Willy Hernangómez,hernawi01,C,24,CHO,2019,58,812.0,421,60,117,194,311,16,20,58,98,153,295,0.5186440677966102,15,39,0.3846153846153846,138,256,0.5390625,0.544,100,144,0.6944444444444444
Mario Hezonja,hezonma01,SF,23,NYK,2019,58,1206.0,511,88,28,211,239,57,8,88,110,191,464,0.4116379310344827,42,152,0.2763157894736842,149,312,0.4775641025641026,0.457,87,114,0.7631578947368421
Isaiah Hicks,hicksis01,PF,24,NYK,2019,3,32.0,12,2,2,5,7,1,3,1,5,4,8,0.5,0,0,0.0,4,8,0.5,0.5,4,5,0.8
Buddy Hield,hieldbu01,SG,26,SAC,2019,82,2615.0,1695,205,106,306,412,58,33,146,202,623,1360,0.4580882352941176,278,651,0.4270353302611367,345,709,0.4866008462623413,0.56,171,193,0.8860103626943006
Haywood Highsmith,highsha01,SF,22,PHI,2019,5,40.0,9,2,0,5,5,1,0,1,1,4,10,0.4,1,5,0.2,3,5,0.6,0.45,0,2,0.0
Nenê,hilarne01,C,36,HOU,2019,42,546.0,151,26,34,89,123,18,15,11,87,60,116,0.5172413793103449,0,3,0.0,60,113,0.5309734513274337,0.517,31,47,0.6595744680851063
George Hill,hillge01,PG,32,TOT,2019,60,1302.0,458,135,39,109,148,52,8,51,102,170,376,0.4521276595744681,48,153,0.3137254901960784,122,223,0.547085201793722,0.516,70,85,0.8235294117647058
Solomon Hill,hillso01,SF,27,NOP,2019,44,878.0,191,55,34,99,133,23,10,31,80,68,178,0.3820224719101123,32,101,0.3168316831683168,36,77,0.4675324675324675,0.472,23,32,0.71875
Aaron Holiday,holidaa01,PG,22,IND,2019,50,646.0,294,87,5,62,67,21,13,40,71,105,262,0.4007633587786259,43,127,0.3385826771653543,62,135,0.4592592592592592,0.483,41,50,0.82
Jrue Holiday,holidjr01,SG,28,NOP,2019,67,2402.0,1420,518,75,259,334,109,54,210,148,547,1159,0.4719585849870578,118,363,0.325068870523416,429,796,0.5389447236180904,0.523,208,271,0.7675276752767528
Justin Holiday,holidju01,SG,29,TOT,2019,82,2607.0,857,146,46,277,323,121,36,104,164,300,777,0.3861003861003861,162,465,0.3483870967741935,138,312,0.4423076923076923,0.49,95,106,0.8962264150943396
John Holland,hollajo02,SF,30,CLE,2019,1,1.0,0,0,0,0,0,0,0,0,0,0,0,0.0,0,0,0.0,0,0,0.0,0.0,0,0,0.0
Rondae Hollis-Jefferson,holliro01,SF,24,BRK,2019,59,1234.0,527,96,83,227,310,44,27,68,107,200,487,0.4106776180698152,9,49,0.1836734693877551,191,438,0.4360730593607306,0.42,118,183,0.644808743169399
Richaun Holmes,holmeri01,C,25,PHO,2019,70,1184.0,572,60,115,216,331,42,79,52,194,222,365,0.6082191780821918,0,0,0.0,222,365,0.6082191780821918,0.608,128,175,0.7314285714285714
Rodney Hood,hoodro01,SG,26,TOT,2019,72,1893.0,805,126,25,132,157,59,12,55,146,292,671,0.4351713859910581,84,236,0.3559322033898305,208,435,0.4781609195402299,0.498,137,155,0.8838709677419355
Al Horford,horfoal01,C,32,BOS,2019,68,1973.0,925,283,120,338,458,59,86,102,126,387,723,0.5352697095435685,73,203,0.3596059113300492,314,520,0.6038461538461538,0.586,78,95,0.8210526315789474
Danuel House Jr.,houseda01,SF,25,HOU,2019,39,979.0,366,40,25,115,140,21,11,35,80,118,252,0.4682539682539682,74,178,0.4157303370786517,44,74,0.5945945945945946,0.615,56,71,0.7887323943661971
Dwight Howard,howardw01,C,33,WAS,2019,9,230.0,115,4,24,59,83,7,4,16,34,43,69,0.6231884057971014,0,0,0.0,43,69,0.6231884057971014,0.623,29,48,0.6041666666666666
Kevin Huerter,huertke01,SG,20,ATL,2019,75,2048.0,727,214,60,185,245,65,25,109,155,275,657,0.4185692541856925,136,353,0.3852691218130311,139,304,0.4572368421052631,0.522,41,56,0.7321428571428571
Isaac Humphries,humphis01,C,21,ATL,2019,5,56.0,15,0,4,7,11,1,0,0,7,6,21,0.2857142857142857,3,11,0.2727272727272727,3,10,0.3,0.357,0,0,0.0
R.J. Hunter,hunterj01,SG,25,BOS,2019,1,26.0,17,3,1,2,3,1,0,0,3,6,13,0.4615384615384615,4,10,0.4,2,3,0.6666666666666666,0.615,1,2,0.5
Chandler Hutchison,hutchch01,SF,22,CHI,2019,44,895.0,229,34,31,154,185,23,6,25,59,96,209,0.4593301435406698,14,50,0.28,82,159,0.5157232704402516,0.493,23,38,0.6052631578947368
Serge Ibaka,ibakase01,C,29,TOR,2019,74,2010.0,1112,99,156,445,601,29,103,114,211,464,877,0.5290763968072976,49,169,0.2899408284023668,415,708,0.5861581920903954,0.557,135,177,0.7627118644067796
Andre Iguodala,iguodan01,SF,35,GSW,2019,68,1578.0,389,216,48,204,252,61,51,52,95,151,302,0.5,48,144,0.3333333333333333,103,158,0.6518987341772152,0.579,39,67,0.582089552238806
Ersan İlyasova,ilyaser01,PF,31,MIL,2019,67,1231.0,453,52,94,208,302,32,20,48,172,167,381,0.4383202099737532,58,160,0.3625,109,221,0.4932126696832579,0.514,61,74,0.8243243243243243
Joe Ingles,inglejo01,PF,31,UTA,2019,82,2568.0,994,469,35,295,330,98,20,193,180,359,802,0.4476309226932668,189,483,0.391304347826087,170,319,0.5329153605015674,0.565,87,123,0.7073170731707317
Andre Ingram,ingraan01,SG,33,LAL,2019,4,15.0,0,0,1,1,2,1,0,1,0,0,6,0.0,0,3,0.0,0,3,0.0,0.0,0,0,0.0
Brandon Ingram,ingrabr01,SF,21,LAL,2019,52,1760.0,950,154,41,226,267,28,31,129,149,362,729,0.4965706447187928,31,94,0.3297872340425531,331,635,0.521259842519685,0.518,195,289,0.6747404844290658
Kyrie Irving,irvinky01,PG,26,BOS,2019,67,2214.0,1596,464,71,264,335,103,34,172,167,604,1241,0.4867042707493956,174,434,0.4009216589861751,430,807,0.5328376703841388,0.557,214,245,0.8734693877551021
Jonathan Isaac,isaacjo01,PF,21,ORL,2019,75,1996.0,720,80,99,312,411,59,98,75,143,262,611,0.4288052373158756,86,266,0.3233082706766917,176,345,0.5101449275362319,0.499,110,135,0.8148148148148148
Wes Iwundu,iwundwe01,SF,24,ORL,2019,68,1233.0,339,73,37,147,184,28,22,44,123,113,274,0.4124087591240876,29,79,0.3670886075949367,84,195,0.4307692307692308,0.465,84,103,0.8155339805825242
Demetrius Jackson,jacksde01,PG,24,PHI,2019,6,39.0,22,5,2,1,3,2,0,1,4,8,15,0.5333333333333333,2,6,0.3333333333333333,6,9,0.6666666666666666,0.6,4,4,1.0
Frank Jackson,jacksfr01,PG,20,NOP,2019,61,1169.0,495,69,25,109,134,25,2,48,92,194,447,0.4340044742729306,53,169,0.3136094674556213,141,278,0.5071942446043165,0.493,54,73,0.7397260273972602
Jaren Jackson Jr.,jacksja02,PF,19,MEM,2019,58,1515.0,798,64,73,199,272,52,82,98,220,298,589,0.5059422750424448,51,142,0.3591549295774648,247,447,0.5525727069351231,0.549,151,197,0.766497461928934
Josh Jackson,jacksjo02,SG,21,PHO,2019,79,1988.0,910,183,66,281,347,74,56,173,209,347,841,0.4126040428061831,73,225,0.3244444444444444,274,616,0.4448051948051948,0.456,143,213,0.6713615023474179
Justin Jackson,jacksju01,SF,23,TOT,2019,81,1614.0,583,96,44,168,212,32,14,29,99,217,485,0.4474226804123711,87,245,0.3551020408163265,130,240,0.5416666666666666,0.537,62,79,0.7848101265822784
Reggie Jackson,jacksre01,PG,28,DET,2019,82,2289.0,1260,344,45,171,216,55,9,148,208,441,1047,0.4212034383954154,174,471,0.3694267515923566,267,576,0.4635416666666667,0.504,204,236,0.864406779661017
LeBron James,jamesle01,SF,34,LAL,2019,55,1937.0,1505,454,57,408,465,72,33,197,94,558,1095,0.5095890410958904,111,327,0.3394495412844037,447,768,0.58203125,0.56,278,418,0.6650717703349283
Amile Jefferson,jeffeam01,PF,25,ORL,2019,12,68.0,27,3,6,15,21,3,3,1,8,10,16,0.625,0,0,0.0,10,16,0.625,0.625,7,8,0.875
John Jenkins,jenkijo01,SG,27,TOT,2019,26,333.0,121,22,6,31,37,0,2,9,10,42,105,0.4,22,58,0.3793103448275862,20,47,0.425531914893617,0.505,15,18,0.8333333333333334
Jonas Jerebko,jerebjo01,PF,31,GSW,2019,73,1218.0,459,96,72,216,288,27,18,43,137,163,355,0.4591549295774648,69,188,0.3670212765957447,94,167,0.562874251497006,0.556,64,80,0.8
Alize Johnson,johnsal02,PF,22,IND,2019,14,64.0,13,1,4,15,19,1,3,0,7,4,16,0.25,1,2,0.5,3,14,0.2142857142857142,0.281,4,8,0.5
Amir Johnson,johnsam01,C,31,PHI,2019,51,529.0,201,60,47,100,147,16,13,45,99,79,157,0.5031847133757962,12,40,0.3,67,117,0.5726495726495726,0.541,31,41,0.7560975609756098
B.J. Johnson,johnsbj01,SF,23,TOT,2019,7,49.0,23,0,2,6,8,2,0,2,4,9,18,0.5,3,7,0.4285714285714285,6,11,0.5454545454545454,0.583,2,2,1.0
James Johnson,johnsja01,PF,31,MIA,2019,55,1164.0,428,135,22,154,176,35,27,74,114,164,379,0.4327176781002638,50,149,0.3355704697986577,114,230,0.4956521739130435,0.499,50,70,0.7142857142857143
Stanley Johnson,johnsst04,SF,22,TOT,2019,66,1208.0,454,88,34,183,217,60,14,81,114,171,440,0.3886363636363636,62,215,0.2883720930232558,109,225,0.4844444444444444,0.459,50,64,0.78125
Tyler Johnson,johnsty01,PG,26,TOT,2019,57,1529.0,619,166,34,139,173,54,27,77,97,217,526,0.4125475285171102,90,260,0.3461538461538461,127,266,0.4774436090225564,0.498,95,127,0.7480314960629921
Wesley Johnson,johnswe01,SF,31,TOT,2019,38,534.0,128,23,12,60,72,14,12,18,63,45,128,0.3515625,25,76,0.3289473684210526,20,52,0.3846153846153846,0.449,13,19,0.6842105263157895
Nikola Jokić,jokicni01,C,23,DEN,2019,80,2504.0,1604,580,228,637,865,108,55,248,228,616,1206,0.5107794361525705,83,270,0.3074074074074074,533,936,0.5694444444444444,0.545,289,352,0.8210227272727273
Damian Jones,jonesda03,C,23,GSW,2019,24,410.0,130,28,31,44,75,12,25,16,63,53,74,0.7162162162162162,0,0,0.0,53,74,0.7162162162162162,0.716,24,37,0.6486486486486487
Derrick Jones Jr.,jonesde02,SF,21,MIA,2019,60,1153.0,422,37,96,144,240,46,42,43,123,160,324,0.4938271604938271,28,91,0.3076923076923077,132,233,0.5665236051502146,0.537,74,122,0.6065573770491803
Jalen Jones,jonesja04,SF,25,CLE,2019,16,214.0,81,7,11,23,34,9,2,8,27,26,62,0.4193548387096774,10,28,0.3571428571428571,16,34,0.4705882352941176,0.5,19,27,0.7037037037037037
Jemerrio Jones,jonesje01,SF,23,LAL,2019,6,143.0,27,13,16,33,49,7,5,5,10,12,33,0.3636363636363636,2,10,0.2,10,23,0.4347826086956521,0.394,1,2,0.5
Terrence Jones,joneste01,PF,27,HOU,2019,2,5.0,2,0,0,4,4,0,0,1,1,1,4,0.25,0,2,0.0,1,2,0.5,0.25,0,1,0.0
Tyus Jones,jonesty01,PG,22,MIN,2019,68,1560.0,468,327,23,111,134,81,5,47,78,185,446,0.4147982062780269,40,126,0.3174603174603174,145,320,0.453125,0.46,58,69,0.8405797101449275
DeAndre Jordan,jordade01,C,30,TOT,2019,69,2047.0,758,156,225,677,902,42,73,153,167,286,446,0.6412556053811659,0,0,0.0,286,446,0.6412556053811659,0.641,186,264,0.7045454545454546
Cory Joseph,josepco01,PG,27,IND,2019,82,2063.0,537,321,39,240,279,94,22,80,131,226,548,0.4124087591240876,55,171,0.3216374269005848,171,377,0.4535809018567639,0.463,30,43,0.6976744186046512
Frank Kaminsky,kaminfr01,C,25,CHO,2019,47,755.0,405,63,39,124,163,12,12,41,68,138,298,0.4630872483221476,50,139,0.3597122302158273,88,159,0.5534591194968553,0.547,79,107,0.7383177570093458
Luke Kennard,kennalu01,SG,22,DET,2019,63,1437.0,613,114,12,171,183,26,10,57,92,228,520,0.4384615384615384,106,269,0.3940520446096654,122,251,0.4860557768924303,0.54,51,61,0.8360655737704918
Michael Kidd-Gilchrist,kiddgmi01,PF,25,CHO,2019,64,1179.0,427,61,88,158,246,32,39,43,156,158,332,0.4759036144578313,16,47,0.3404255319148936,142,285,0.4982456140350877,0.5,95,123,0.7723577235772358
George King,kingge03,SF,25,PHO,2019,1,6.0,0,0,0,1,1,0,0,0,0,0,0,0.0,0,0,0.0,0,0,0.0,0.0,0,0,0.0
Maxi Kleber,klebima01,PF,27,DAL,2019,71,1502.0,485,70,90,239,329,36,78,54,143,175,386,0.4533678756476684,77,218,0.3532110091743119,98,168,0.5833333333333334,0.553,58,74,0.7837837837837838
Brandon Knight,knighbr03,PG,27,TOT,2019,39,736.0,266,71,10,49,59,21,2,30,62,99,260,0.3807692307692307,41,129,0.3178294573643411,58,131,0.4427480916030534,0.46,27,34,0.7941176470588235
Kevin Knox,knoxke01,PF,19,NYK,2019,75,2158.0,963,82,61,274,335,43,24,114,175,338,914,0.3698030634573304,125,364,0.3434065934065934,213,550,0.3872727272727272,0.438,162,226,0.7168141592920354
Furkan Korkmaz,korkmfu01,SG,21,PHI,2019,48,679.0,279,52,16,91,107,29,2,25,62,98,245,0.4,47,144,0.3263888888888889,51,101,0.504950495049505,0.496,36,44,0.8181818181818182
Luke Kornet,kornelu01,PF,23,NYK,2019,46,784.0,322,54,28,107,135,27,42,25,41,107,283,0.3780918727915194,70,193,0.3626943005181347,37,90,0.4111111111111111,0.502,38,46,0.8260869565217391
Kyle Korver,korveky01,SG-PF,37,TOT,2019,70,1334.0,600,81,9,153,162,25,12,59,106,201,483,0.4161490683229814,138,348,0.396551724137931,63,135,0.4666666666666667,0.559,60,73,0.821917808219178
Kosta Koufos,koufoko01,C,29,SAC,2019,42,502.0,156,36,52,125,177,15,18,27,68,73,153,0.477124183006536,0,0,0.0,73,153,0.477124183006536,0.477,10,24,0.4166666666666667
Rodions Kurucs,kurucro01,SF,20,BRK,2019,63,1294.0,534,52,56,190,246,41,25,77,146,202,449,0.4498886414253897,58,184,0.3152173913043478,144,265,0.5433962264150943,0.514,72,92,0.782608695652174
Kyle Kuzma,kuzmaky01,PF,23,LAL,2019,70,2314.0,1308,178,60,322,382,41,26,133,170,496,1087,0.4563017479300828,128,422,0.3033175355450237,368,665,0.5533834586466165,0.515,188,250,0.752
Skal Labissière,labissk01,PF,22,TOT,2019,22,176.0,67,11,9,34,43,5,6,11,29,26,49,0.5306122448979592,6,13,0.4615384615384615,20,36,0.5555555555555556,0.592,9,17,0.5294117647058824
Jeremy Lamb,lambje01,SG,26,CHO,2019,79,2250.0,1208,172,65,369,434,88,32,80,140,431,979,0.4402451481103167,115,330,0.3484848484848485,316,649,0.4869029275808937,0.499,231,260,0.8884615384615384
Zach LaVine,lavinza01,SG,23,CHI,2019,63,2171.0,1492,283,40,254,294,60,26,215,140,530,1135,0.4669603524229075,120,321,0.3738317757009345,410,814,0.5036855036855037,0.52,312,375,0.832
Jake Layman,laymaja01,SF,24,POR,2019,71,1327.0,541,53,56,161,217,31,30,46,116,216,424,0.5094339622641509,59,181,0.3259668508287293,157,243,0.6460905349794238,0.579,50,71,0.704225352112676
T.J. Leaf,leaftj01,PF,21,IND,2019,58,522.0,225,24,43,82,125,9,19,12,35,99,183,0.5409836065573771,8,31,0.2580645161290322,91,152,0.5986842105263158,0.563,19,31,0.6129032258064516
Courtney Lee,leeco01,SG,33,TOT,2019,34,428.0,136,37,9,45,54,21,3,14,32,53,129,0.4108527131782946,16,55,0.2909090909090909,37,74,0.5,0.473,14,21,0.6666666666666666
Damion Lee,leeda03,SG,26,GSW,2019,32,375.0,158,13,8,56,64,13,0,11,28,56,127,0.4409448818897638,27,68,0.3970588235294117,29,59,0.4915254237288136,0.547,19,22,0.8636363636363636
Walt Lemon Jr.,lemonwa01,PG,26,CHI,2019,6,167.0,86,30,4,23,27,11,1,10,14,38,87,0.4367816091954023,2,5,0.4,36,82,0.4390243902439024,0.448,8,11,0.7272727272727273
Alex Len,lenal01,C,25,ATL,2019,77,1544.0,854,86,158,266,424,27,69,97,200,320,648,0.4938271604938271,74,204,0.3627450980392157,246,444,0.5540540540540541,0.551,140,216,0.6481481481481481
Kawhi Leonard,leonaka01,SF,27,TOR,2019,60,2040.0,1596,199,78,361,439,106,24,121,87,560,1129,0.4960141718334809,112,302,0.3708609271523179,448,827,0.5417170495767836,0.546,364,426,0.8544600938967136
Meyers Leonard,leoname01,C,26,POR,2019,61,878.0,357,75,49,184,233,13,9,43,105,132,242,0.5454545454545454,50,111,0.4504504504504504,82,131,0.6259541984732825,0.649,43,51,0.8431372549019608
Jon Leuer,leuerjo01,PF,29,DET,2019,41,402.0,156,14,27,70,97,12,4,23,60,66,113,0.584070796460177,1,11,0.0909090909090909,65,102,0.6372549019607843,0.588,23,31,0.7419354838709677
Caris LeVert,leverca01,SF,24,BRK,2019,40,1063.0,547,156,35,116,151,42,14,69,77,207,483,0.4285714285714285,48,154,0.3116883116883117,159,329,0.4832826747720364,0.478,85,123,0.6910569105691057
Damian Lillard,lillada01,PG,28,POR,2019,80,2838.0,2067,551,68,303,371,88,34,212,148,681,1533,0.4442270058708414,237,643,0.3685847589424572,444,890,0.498876404494382,0.522,468,513,0.912280701754386
Jeremy Lin,linje01,PG,30,TOT,2019,74,1436.0,707,231,22,157,179,47,13,124,144,238,541,0.4399260628465804,55,187,0.2941176470588235,183,354,0.5169491525423728,0.491,176,210,0.8380952380952381
Shaun Livingston,livinsh01,PG,33,GSW,2019,64,967.0,258,114,42,75,117,31,27,38,74,109,210,0.5190476190476191,0,2,0.0,109,208,0.5240384615384616,0.519,40,51,0.7843137254901961
Zach Lofton,loftoza01,SG,26,DET,2019,1,4.0,0,0,0,0,0,1,0,1,0,0,1,0.0,0,1,0.0,0,0,0.0,0.0,0,0,0.0
Kevon Looney,looneke01,C,22,GSW,2019,80,1481.0,500,123,194,223,417,46,53,51,211,217,347,0.6253602305475504,1,10,0.1,216,337,0.6409495548961425,0.627,65,105,0.6190476190476191
Brook Lopez,lopezbr01,C,30,MIL,2019,81,2322.0,1009,98,33,363,396,51,179,82,189,355,786,0.4516539440203562,187,512,0.365234375,168,274,0.6131386861313869,0.571,112,133,0.8421052631578947
Robin Lopez,lopezro01,C,30,CHI,2019,74,1606.0,704,89,140,146,286,11,78,96,124,304,535,0.5682242990654206,7,31,0.2258064516129032,297,504,0.5892857142857143,0.575,89,123,0.7235772357723578
Kevin Love,loveke01,PF,30,CLE,2019,22,598.0,374,48,33,206,239,6,5,42,54,109,283,0.3851590106007067,53,147,0.3605442176870748,56,136,0.4117647058823529,0.479,103,114,0.9035087719298246
Kyle Lowry,lowryky01,PG,32,TOR,2019,65,2213.0,926,564,41,271,312,91,31,182,166,304,739,0.4113667117726657,157,453,0.3465783664459161,147,286,0.513986013986014,0.518,161,194,0.8298969072164949
Jordan Loyd,loydjo01,PG,25,TOR,2019,12,55.0,29,6,1,8,9,0,0,2,5,8,18,0.4444444444444444,4,8,0.5,4,10,0.4,0.556,9,11,0.8181818181818182
Kalin Lucas,lucaska01,PG,29,DET,2019,1,6.0,2,1,0,3,3,0,0,0,1,0,1,0.0,0,1,0.0,0,0,0.0,0.0,2,2,1.0
Timothé Luwawu-Cabarrot,luwawti01,SF,23,TOT,2019,50,669.0,231,26,11,86,97,19,8,21,73,82,218,0.3761467889908257,36,116,0.3103448275862069,46,102,0.4509803921568627,0.459,31,41,0.7560975609756098
Tyler Lydon,lydonty01,PF,22,DEN,2019,25,94.0,23,6,7,11,18,2,0,4,10,9,18,0.5,4,10,0.4,5,8,0.625,0.611,1,3,0.3333333333333333
Trey Lyles,lylestr01,PF,23,DEN,2019,64,1120.0,546,87,44,202,246,30,23,68,93,207,495,0.4181818181818181,51,200,0.255,156,295,0.5288135593220339,0.47,81,116,0.6982758620689655
Scott Machado,machasc01,PG,28,LAL,2019,4,19.0,10,3,0,0,0,1,0,0,2,4,6,0.6666666666666666,1,1,1.0,3,5,0.6,0.75,1,1,1.0
Shelvin Mack,macksh01,PG,28,TOT,2019,57,1246.0,430,183,18,86,104,47,4,66,84,163,403,0.4044665012406948,46,130,0.3538461538461538,117,273,0.4285714285714285,0.462,58,84,0.6904761904761905
Daryl Macon,maconda01,SG,23,DAL,2019,8,90.0,29,7,2,10,12,1,0,6,8,10,27,0.3703703703703703,5,11,0.4545454545454545,5,16,0.3125,0.463,4,7,0.5714285714285714
J.P. Macura,macurjp01,SG,23,CHO,2019,2,17.0,6,2,0,3,3,0,0,0,0,3,9,0.3333333333333333,0,4,0.0,3,5,0.6,0.333,0,0,0.0
Ian Mahinmi,mahinia01,C,32,WAS,2019,34,498.0,139,25,48,80,128,25,16,21,84,47,104,0.4519230769230769,3,16,0.1875,44,88,0.5,0.466,42,61,0.6885245901639344
Thon Maker,makerth01,C-PF,21,TOT,2019,64,972.0,323,45,41,161,202,21,51,33,105,109,268,0.4067164179104477,49,153,0.3202614379084967,60,115,0.5217391304347826,0.498,56,84,0.6666666666666666
Boban Marjanović,marjabo01,C,30,TOT,2019,58,681.0,422,54,87,178,265,16,27,59,90,160,260,0.6153846153846154,4,10,0.4,156,250,0.624,0.623,98,131,0.7480916030534351
Lauri Markkanen,markkla01,PF,21,CHI,2019,52,1682.0,974,75,74,396,470,37,33,85,122,342,795,0.430188679245283,120,332,0.3614457831325301,222,463,0.4794816414686825,0.506,170,195,0.8717948717948718
Jarell Martin,martija01,PF,24,ORL,2019,42,328.0,115,18,11,62,73,3,8,11,51,43,104,0.4134615384615384,20,57,0.3508771929824561,23,47,0.4893617021276595,0.51,9,11,0.8181818181818182
Frank Mason III,masonfr01,PG,24,SAC,2019,38,435.0,195,84,6,37,43,16,4,36,34,71,169,0.4201183431952662,14,64,0.21875,57,105,0.5428571428571428,0.462,39,57,0.6842105263157895
Yante Maten,matenya01,PF,22,MIA,2019,2,13.0,2,0,1,2,3,1,0,0,0,1,4,0.25,0,1,0.0,1,3,0.3333333333333333,0.25,0,0,0.0
Wesley Matthews,matthwe02,SF-SG,32,TOT,2019,69,2091.0,840,160,32,138,170,54,17,91,160,279,698,0.3997134670487106,150,403,0.3722084367245657,129,295,0.4372881355932203,0.507,132,163,0.8098159509202454
Luc Mbah a Moute,mbahalu01,PF,32,LAC,2019,4,61.0,20,2,2,5,7,1,1,2,8,8,18,0.4444444444444444,2,6,0.3333333333333333,6,12,0.5,0.5,2,5,0.4
Tahjere McCall,mccalta01,SG,24,BRK,2019,1,8.0,4,0,0,1,1,0,0,0,2,2,3,0.6666666666666666,0,1,0.0,2,2,1.0,0.667,0,1,0.0
Patrick McCaw,mccawpa01,SG,23,TOT,2019,29,397.0,74,29,7,41,48,23,2,17,38,26,63,0.4126984126984127,9,28,0.3214285714285714,17,35,0.4857142857142857,0.484,13,15,0.8666666666666667
CJ McCollum,mccolcj01,SG,27,POR,2019,70,2375.0,1468,207,62,220,282,55,28,106,172,571,1243,0.4593724859211585,167,445,0.3752808988764045,404,798,0.506265664160401,0.527,159,192,0.828125
T.J. McConnell,mccontj01,PG,26,PHI,2019,76,1470.0,483,258,28,146,174,79,17,91,105,220,419,0.5250596658711217,14,42,0.3333333333333333,206,377,0.5464190981432361,0.542,29,37,0.7837837837837838
Doug McDermott,mcderdo01,SF,27,IND,2019,77,1340.0,564,67,17,92,109,18,8,42,104,207,422,0.490521327014218,84,206,0.4077669902912621,123,216,0.5694444444444444,0.59,66,79,0.8354430379746836
JaVale McGee,mcgeeja01,C,31,LAL,2019,75,1671.0,897,52,195,371,566,47,148,108,208,400,641,0.62402496099844,1,12,0.0833333333333333,399,629,0.6343402225755167,0.625,96,152,0.631578947368421
Rodney McGruder,mcgruro01,SG,27,MIA,2019,66,1550.0,503,112,60,178,238,36,12,64,115,186,461,0.403470715835141,79,225,0.3511111111111111,107,236,0.4533898305084746,0.489,52,72,0.7222222222222222
Alfonzo McKinnie,mckinal01,SF,26,GSW,2019,72,1003.0,337,31,81,166,247,18,15,30,134,134,275,0.4872727272727272,42,118,0.3559322033898305,92,157,0.5859872611464968,0.564,27,48,0.5625
Ben McLemore,mclembe01,SG,25,SAC,2019,19,158.0,75,4,3,14,17,6,3,5,22,25,64,0.390625,17,41,0.4146341463414634,8,23,0.3478260869565217,0.523,8,12,0.6666666666666666
Jordan McRae,mcraejo01,SG,27,WAS,2019,27,333.0,160,30,6,34,40,13,7,15,26,61,130,0.4692307692307692,10,35,0.2857142857142857,51,95,0.5368421052631579,0.508,28,35,0.8
Jodie Meeks,meeksjo01,SG,31,TOR,2019,8,104.0,51,8,1,11,12,1,1,2,5,21,39,0.5384615384615384,8,18,0.4444444444444444,13,21,0.6190476190476191,0.641,1,1,1.0
Salah Mejri,mejrisa01,C,32,DAL,2019,36,399.0,141,35,36,95,131,10,26,21,55,55,112,0.4910714285714285,11,34,0.3235294117647059,44,78,0.5641025641025641,0.54,20,32,0.625
De'Anthony Melton,meltode01,PG,20,PHO,2019,50,984.0,250,159,25,109,134,68,23,75,113,100,256,0.390625,29,95,0.3052631578947368,71,161,0.4409937888198758,0.447,21,28,0.75
Chimezie Metu,metuch01,PF,21,SAS,2019,29,145.0,51,13,9,27,36,6,2,15,14,19,58,0.3275862068965517,0,2,0.0,19,56,0.3392857142857143,0.328,13,17,0.7647058823529411
Khris Middleton,middlkh01,SF,27,MIL,2019,77,2393.0,1407,331,50,411,461,80,7,174,172,506,1148,0.440766550522648,179,474,0.3776371308016877,327,674,0.4851632047477744,0.519,216,258,0.8372093023255814
C.J. Miles,milescj01,SF,31,TOT,2019,53,856.0,339,36,13,82,95,26,15,30,79,112,311,0.360128617363344,67,203,0.3300492610837438,45,108,0.4166666666666667,0.468,48,58,0.8275862068965517
Darius Miller,milleda01,SF,28,NOP,2019,69,1757.0,567,146,14,114,128,40,23,59,165,189,484,0.390495867768595,133,364,0.3653846153846153,56,120,0.4666666666666667,0.528,56,71,0.7887323943661971
Malcolm Miller,millema01,SF,25,TOR,2019,10,67.0,35,1,1,4,5,1,1,1,5,11,26,0.4230769230769231,10,21,0.4761904761904761,1,5,0.2,0.615,3,4,0.75
Patty Mills,millspa02,PG,30,SAS,2019,82,1908.0,811,245,24,158,182,49,10,93,129,282,663,0.4253393665158371,159,404,0.3935643564356436,123,259,0.4749034749034749,0.545,88,103,0.8543689320388349
Paul Millsap,millspa01,PF,33,DEN,2019,70,1895.0,883,141,153,352,505,83,54,95,183,322,665,0.4842105263157895,58,159,0.3647798742138364,264,506,0.5217391304347826,0.528,181,249,0.7269076305220884
Shake Milton,miltosh01,SG,22,PHI,2019,20,268.0,87,18,9,26,35,8,8,6,29,34,87,0.3908045977011494,14,44,0.3181818181818182,20,43,0.4651162790697674,0.471,5,7,0.7142857142857143
Nikola Mirotić,mirotni01,PF,27,TOT,2019,46,1245.0,697,55,60,279,339,31,34,48,107,238,542,0.4391143911439114,116,318,0.3647798742138364,122,224,0.5446428571428571,0.546,105,124,0.8467741935483871
Donovan Mitchell,mitchdo01,SG,22,UTA,2019,77,2598.0,1829,322,59,257,316,106,31,218,208,661,1530,0.4320261437908497,188,519,0.3622350674373796,473,1011,0.4678536102868447,0.493,319,396,0.8055555555555556
Naz Mitrou-Long,mitrona01,SG,25,UTA,2019,14,84.0,16,15,1,5,6,1,1,8,10,6,20,0.3,2,11,0.1818181818181818,4,9,0.4444444444444444,0.35,2,2,1.0
Malik Monk,monkma01,SG,20,CHO,2019,73,1258.0,653,117,16,121,137,37,19,86,106,227,586,0.3873720136518771,109,330,0.3303030303030303,118,256,0.4609375,0.48,90,102,0.8823529411764706
Greg Monroe,monrogr01,C,28,TOT,2019,43,480.0,230,24,67,105,172,14,8,32,66,92,189,0.4867724867724867,1,5,0.2,91,184,0.4945652173913043,0.489,45,72,0.625
E'Twaun Moore,mooreet01,SG,29,NOP,2019,53,1463.0,633,102,35,92,127,40,8,59,112,256,532,0.4812030075187969,76,176,0.4318181818181818,180,356,0.5056179775280899,0.553,45,59,0.7627118644067796
Eric Moreland,moreler01,PF,27,TOT,2019,5,43.0,7,4,4,16,20,1,1,5,9,3,7,0.4285714285714285,1,1,1.0,2,6,0.3333333333333333,0.5,0,0,0.0
Jaylen Morris,morrija01,SG,23,MIL,2019,4,29.0,10,4,0,5,5,2,0,1,1,4,10,0.4,1,3,0.3333333333333333,3,7,0.4285714285714285,0.45,1,2,0.5
Marcus Morris,morrima03,PF,29,BOS,2019,75,2091.0,1046,109,76,382,458,43,25,92,181,377,844,0.4466824644549763,146,389,0.3753213367609254,231,455,0.5076923076923077,0.533,146,173,0.8439306358381503
Markieff Morris,morrima02,PF,29,TOT,2019,58,1270.0,547,79,61,204,265,36,22,54,175,204,484,0.4214876033057851,68,203,0.334975369458128,136,281,0.4839857651245551,0.492,71,92,0.7717391304347826
Monte Morris,morrimo01,PG,23,DEN,2019,82,1970.0,851,297,35,159,194,73,4,52,102,346,702,0.4928774928774929,94,227,0.4140969162995594,252,475,0.5305263157894737,0.56,65,81,0.8024691358024691
Donatas Motiejūnas,motiedo01,PF,28,SAS,2019,3,13.0,6,1,2,1,3,0,1,3,6,3,6,0.5,0,0,0.0,3,6,0.5,0.5,0,2,0.0
Johnathan Motley,motlejo01,PF,23,LAC,2019,22,156.0,102,11,18,33,51,5,3,16,27,39,73,0.5342465753424658,0,3,0.0,39,70,0.5571428571428572,0.534,24,40,0.6
Emmanuel Mudiay,mudiaem01,PG,22,NYK,2019,59,1607.0,873,228,33,163,196,43,19,140,103,330,740,0.4459459459459459,69,210,0.3285714285714285,261,530,0.4924528301886792,0.493,144,186,0.7741935483870968
Jamal Murray,murraja01,PG,21,DEN,2019,75,2447.0,1367,363,65,252,317,67,27,158,153,513,1173,0.4373401534526854,152,414,0.3671497584541063,361,759,0.4756258234519104,0.502,189,223,0.8475336322869955
Džanan Musa,musadz01,SG,19,BRK,2019,9,39.0,19,2,1,4,5,2,0,4,1,9,22,0.4090909090909091,1,10,0.1,8,12,0.6666666666666666,0.432,0,2,0.0
Mike Muscala,muscami01,PF,27,TOT,2019,64,1306.0,449,76,57,187,244,22,38,48,130,145,361,0.4016620498614958,89,256,0.34765625,56,105,0.5333333333333333,0.525,70,85,0.8235294117647058
Svi Mykhailiuk,mykhasv01,SF,21,TOT,2019,42,440.0,133,37,9,27,36,14,1,21,25,46,140,0.3285714285714285,29,89,0.3258426966292135,17,51,0.3333333333333333,0.432,12,20,0.6
Abdel Nader,naderab01,SF,25,OKC,2019,61,694.0,241,20,14,102,116,20,12,26,68,91,215,0.4232558139534884,32,100,0.32,59,115,0.5130434782608696,0.498,27,36,0.75
Larry Nance Jr.,nancela02,C,26,CLE,2019,67,1795.0,627,214,168,384,552,100,40,97,192,249,479,0.5198329853862212,33,98,0.336734693877551,216,381,0.5669291338582677,0.554,96,134,0.7164179104477612
Shabazz Napier,napiesh01,PG,27,BRK,2019,56,983.0,529,143,18,82,100,41,16,66,67,169,435,0.3885057471264367,76,228,0.3333333333333333,93,207,0.4492753623188406,0.476,115,138,0.8333333333333334
Raul Neto,netora01,PG,26,UTA,2019,37,474.0,196,93,6,56,62,14,4,35,49,74,161,0.4596273291925465,20,60,0.3333333333333333,54,101,0.5346534653465347,0.522,28,33,0.8484848484848485
Georges Niang,niangge01,PF,25,UTA,2019,59,516.0,235,35,11,76,87,10,6,23,57,86,181,0.4751381215469613,43,105,0.4095238095238095,43,76,0.5657894736842105,0.594,20,24,0.8333333333333334
Joakim Noah,noahjo01,C,33,MEM,2019,42,693.0,298,89,58,180,238,20,31,50,96,110,213,0.5164319248826291,0,1,0.0,110,212,0.5188679245283019,0.516,78,109,0.7155963302752294
Nerlens Noel,noelne01,C,24,OKC,2019,77,1055.0,378,45,127,198,325,66,96,48,166,162,276,0.5869565217391305,0,0,0.0,162,276,0.5869565217391305,0.587,54,79,0.6835443037974683
Dirk Nowitzki,nowitdi01,PF,40,DAL,2019,51,795.0,373,35,5,153,158,9,18,18,76,135,376,0.3590425531914893,64,205,0.3121951219512195,71,171,0.4152046783625731,0.444,39,50,0.78
Frank Ntilikina,ntilila01,PG,20,NYK,2019,43,904.0,246,121,12,75,87,30,14,56,104,95,282,0.3368794326241134,33,115,0.2869565217391304,62,167,0.3712574850299401,0.395,23,30,0.7666666666666667
James Nunnally,nunnaja01,SF,28,TOT,2019,15,102.0,36,7,0,5,5,1,0,1,10,12,34,0.3529411764705882,8,25,0.32,4,9,0.4444444444444444,0.471,4,4,1.0
Jusuf Nurkić,nurkiju01,C,24,POR,2019,72,1974.0,1125,233,243,505,748,71,103,168,250,420,826,0.5084745762711864,3,29,0.1034482758620689,417,797,0.5232120451693852,0.51,282,365,0.7726027397260274
David Nwaba,nwabada01,SF,26,CLE,2019,51,984.0,334,54,41,122,163,36,17,29,106,126,262,0.4809160305343511,24,75,0.32,102,187,0.5454545454545454,0.527,58,85,0.6823529411764706
Royce O'Neale,onealro01,SF,25,UTA,2019,82,1671.0,426,124,22,263,285,54,24,70,172,163,343,0.4752186588921283,68,176,0.3863636363636363,95,167,0.5688622754491018,0.574,32,42,0.7619047619047619
Kyle O'Quinn,oquinky01,C,28,IND,2019,45,371.0,156,56,29,90,119,9,25,31,68,69,136,0.5073529411764706,1,12,0.0833333333333333,68,124,0.5483870967741935,0.511,17,21,0.8095238095238095
Semi Ojeleye,ojelese01,PF,24,BOS,2019,56,594.0,186,23,24,62,86,10,4,19,43,67,158,0.4240506329113924,28,89,0.3146067415730337,39,69,0.5652173913043478,0.513,24,39,0.6153846153846154
Jahlil Okafor,okafoja01,C,23,NOP,2019,59,935.0,484,40,82,196,278,15,40,52,96,212,362,0.585635359116022,1,5,0.2,211,357,0.5910364145658263,0.587,59,89,0.6629213483146067
Elie Okobo,okoboel01,PG,21,PHO,2019,53,958.0,304,127,12,86,98,32,7,69,109,114,290,0.3931034482758621,39,132,0.2954545454545454,75,158,0.4746835443037974,0.46,37,47,0.7872340425531915
Josh Okogie,okogijo01,SG,20,MIN,2019,74,1757.0,570,91,41,177,218,88,33,63,166,196,508,0.3858267716535433,60,215,0.2790697674418604,136,293,0.4641638225255973,0.445,118,162,0.7283950617283951
Victor Oladipo,oladivi01,SG,26,IND,2019,36,1147.0,675,186,21,181,202,60,11,82,72,249,588,0.423469387755102,74,216,0.3425925925925926,175,372,0.4704301075268817,0.486,103,141,0.7304964539007093
Kelly Olynyk,olynyke01,PF,27,MIA,2019,79,1812.0,787,140,72,303,375,53,37,114,183,261,564,0.4627659574468085,113,319,0.3542319749216301,148,245,0.6040816326530613,0.563,152,185,0.8216216216216217
Cedi Osman,osmande01,SF,23,CLE,2019,76,2444.0,991,195,45,312,357,60,11,114,195,360,844,0.4265402843601896,130,374,0.3475935828877005,230,470,0.4893617021276595,0.504,141,181,0.7790055248618785
Kelly Oubre Jr.,oubreke01,SF,23,TOT,2019,69,1935.0,1047,84,71,254,325,84,59,103,181,375,842,0.4453681710213776,108,338,0.3195266272189349,267,504,0.5297619047619048,0.51,189,244,0.7745901639344263
Zaza Pachulia,pachuza01,C,34,DET,2019,68,878.0,267,91,99,166,265,31,17,57,151,85,193,0.4404145077720207,0,4,0.0,85,189,0.4497354497354497,0.44,97,124,0.782258064516129
Jabari Parker,parkeja01,PF,23,TOT,2019,64,1724.0,930,152,79,342,421,46,30,151,145,369,749,0.4926568758344459,61,195,0.3128205128205128,308,554,0.555956678700361,0.533,131,184,0.7119565217391305
Tony Parker,parketo01,PG,36,CHO,2019,56,1003.0,530,207,14,69,83,21,7,75,53,213,463,0.4600431965442764,13,51,0.2549019607843137,200,412,0.4854368932038835,0.474,91,124,0.7338709677419355
Chandler Parsons,parsoch01,SF,30,MEM,2019,25,496.0,187,43,4,66,70,19,5,32,45,68,182,0.3736263736263736,29,94,0.3085106382978723,39,88,0.4431818181818182,0.453,22,25,0.88
Patrick Patterson,pattepa01,PF,29,OKC,2019,63,861.0,229,31,42,105,147,16,13,22,46,82,219,0.3744292237442922,46,137,0.3357664233576642,36,82,0.4390243902439024,0.479,19,30,0.6333333333333333
Justin Patton,pattoju01,C,21,PHI,2019,3,21.0,5,3,2,4,6,2,0,0,5,2,7,0.2857142857142857,0,2,0.0,2,5,0.4,0.286,1,2,0.5
Chris Paul,paulch01,PG,33,HOU,2019,58,1857.0,906,473,36,229,265,114,18,152,146,302,720,0.4194444444444444,127,355,0.3577464788732394,175,365,0.4794520547945205,0.508,175,203,0.8620689655172413
Cameron Payne,payneca01,PG,24,TOT,2019,40,712.0,250,106,13,59,72,28,9,45,64,96,223,0.4304932735426009,25,84,0.2976190476190476,71,139,0.5107913669064749,0.487,33,41,0.8048780487804879
Elfrid Payton,paytoel01,PG,24,NOP,2019,42,1250.0,446,320,49,171,220,44,17,112,81,179,412,0.4344660194174757,33,105,0.3142857142857143,146,307,0.4755700325732899,0.475,55,74,0.7432432432432432
Gary Payton II,paytoga02,PG,26,WAS,2019,3,16.0,11,4,1,1,2,3,1,1,2,5,8,0.625,1,2,0.5,4,6,0.6666666666666666,0.688,0,0,0.0
Theo Pinson,pinsoth01,SG,23,BRK,2019,18,211.0,81,21,4,32,36,6,0,18,15,25,73,0.3424657534246575,12,46,0.2608695652173913,13,27,0.4814814814814814,0.425,19,22,0.8636363636363636
Mason Plumlee,plumlma01,C,28,DEN,2019,82,1731.0,637,243,165,359,524,66,76,126,252,262,442,0.5927601809954751,2,10,0.2,260,432,0.6018518518518519,0.595,111,198,0.5606060606060606
Miles Plumlee,plumlmi01,C,30,ATL,2019,18,173.0,80,17,16,23,39,6,4,10,14,32,48,0.6666666666666666,0,0,0.0,32,48,0.6666666666666666,0.667,16,30,0.5333333333333333
Jakob Poeltl,poeltja01,C,23,SAS,2019,77,1273.0,423,93,178,232,410,29,68,48,124,187,290,0.6448275862068965,0,0,0.0,187,290,0.6448275862068965,0.645,49,92,0.532608695652174
Quincy Pondexter,pondequ01,SF,30,SAS,2019,53,292.0,98,24,8,38,46,11,1,13,24,29,58,0.5,6,18,0.3333333333333333,23,40,0.575,0.552,34,42,0.8095238095238095
Otto Porter Jr.,porteot01,SF,25,TOT,2019,56,1683.0,780,120,54,260,314,82,31,65,108,299,643,0.4650077760497667,104,256,0.40625,195,387,0.5038759689922481,0.546,78,96,0.8125
Bobby Portis,portibo01,PF,23,TOT,2019,50,1299.0,710,72,109,294,403,35,20,74,145,279,628,0.4442675159235669,75,191,0.3926701570680628,204,437,0.4668192219679634,0.504,77,97,0.7938144329896907
Dwight Powell,poweldw01,C,27,DAL,2019,77,1662.0,815,112,140,271,411,44,50,67,201,290,486,0.5967078189300411,39,127,0.3070866141732283,251,359,0.6991643454038997,0.637,196,254,0.7716535433070866
Norman Powell,powelno01,SG,25,TOR,2019,60,1126.0,516,91,16,123,139,39,13,65,96,193,400,0.4825,68,170,0.4,125,230,0.5434782608695652,0.568,62,75,0.8266666666666667
Alex Poythress,poythal01,PF,25,ATL,2019,21,305.0,107,17,29,47,76,4,10,13,47,40,81,0.4938271604938271,9,23,0.391304347826087,31,58,0.5344827586206896,0.549,18,29,0.6206896551724138
Taurean Prince,princta02,SF,24,ATL,2019,55,1552.0,742,118,22,177,199,53,19,100,141,262,594,0.441077441077441,123,315,0.3904761904761905,139,279,0.4982078853046595,0.545,95,116,0.8189655172413793
Zhou Qi,qizh01,PF,23,HOU,2019,1,1.0,2,0,0,0,0,0,0,0,0,1,1,1.0,0,0,0.0,1,1,1.0,1.0,0,0,0.0
Ivan Rabb,rabbiv01,PF,21,MEM,2019,49,721.0,284,54,70,136,206,17,14,35,90,116,212,0.5471698113207547,3,15,0.2,113,197,0.5736040609137056,0.554,49,69,0.7101449275362319
Chasson Randle,randlch01,PG,25,WAS,2019,49,743.0,271,97,10,46,56,25,3,43,91,91,217,0.4193548387096774,46,115,0.4,45,102,0.4411764705882353,0.525,43,62,0.6935483870967742
Julius Randle,randlju01,PF,24,NOP,2019,73,2232.0,1565,229,162,472,634,52,45,208,246,571,1089,0.5243342516069789,67,195,0.3435897435897436,504,894,0.5637583892617449,0.555,356,487,0.731006160164271
J.J. Redick,redicjj01,SG,34,PHI,2019,76,2379.0,1372,206,20,166,186,32,17,101,129,452,1027,0.4401168451801363,240,605,0.396694214876033,212,422,0.5023696682464455,0.557,228,255,0.8941176470588236
Davon Reed,reedda01,SG,23,IND,2019,10,47.0,12,3,2,4,6,1,0,1,3,5,12,0.4166666666666667,2,4,0.5,3,8,0.375,0.5,0,0,0.0
Cameron Reynolds,reynoca01,SG,23,MIN,2019,19,259.0,95,13,4,27,31,6,2,5,26,33,78,0.4230769230769231,21,51,0.4117647058823529,12,27,0.4444444444444444,0.558,8,9,0.8888888888888888
Josh Richardson,richajo01,SG,25,MIA,2019,73,2539.0,1209,298,54,209,263,79,34,113,200,423,1026,0.4122807017543859,164,460,0.3565217391304348,259,566,0.4575971731448763,0.492,199,231,0.8614718614718615
Malachi Richardson,richama01,SG,23,TOR,2019,22,103.0,30,0,2,11,13,1,0,8,13,9,29,0.3103448275862069,8,25,0.32,1,4,0.25,0.448,4,5,0.8
Austin Rivers,riverau01,SG,26,TOT,2019,76,2028.0,618,167,25,137,162,47,23,68,207,232,572,0.4055944055944055,104,327,0.3180428134556575,128,245,0.5224489795918368,0.497,50,95,0.5263157894736842
Devin Robinson,robinde01,SF,23,WAS,2019,7,95.0,47,6,6,14,20,4,6,2,11,19,32,0.59375,0,2,0.0,19,30,0.6333333333333333,0.594,9,14,0.6428571428571429
Duncan Robinson,robindu01,SF,24,MIA,2019,15,161.0,50,5,2,17,19,5,0,4,11,18,46,0.391304347826087,10,35,0.2857142857142857,8,11,0.7272727272727273,0.5,4,6,0.6666666666666666
Glenn Robinson III,robingl02,SF,25,DET,2019,47,610.0,198,21,17,54,71,14,8,18,45,74,176,0.4204545454545454,18,62,0.2903225806451613,56,114,0.4912280701754385,0.472,32,40,0.8
Jerome Robinson,robinje01,SG,21,LAC,2019,33,320.0,112,19,3,38,41,11,3,13,46,44,110,0.4,18,57,0.3157894736842105,26,53,0.490566037735849,0.482,6,9,0.6666666666666666
Mitchell Robinson,robinmi01,C,20,NYK,2019,66,1360.0,485,37,177,246,423,52,161,35,217,202,291,0.6941580756013745,0,0,0.0,202,291,0.6941580756013745,0.694,81,135,0.6
Rajon Rondo,rondora01,PG,32,LAL,2019,46,1369.0,424,367,34,209,243,57,7,127,100,175,432,0.4050925925925926,51,142,0.3591549295774648,124,290,0.4275862068965517,0.464,23,36,0.6388888888888888
Derrick Rose,rosede01,PG,30,MIN,2019,51,1392.0,917,220,33,107,140,31,12,82,57,363,753,0.4820717131474104,54,146,0.3698630136986301,309,607,0.5090609555189456,0.518,137,160,0.85625
Terrence Ross,rosste01,SG,27,ORL,2019,81,2150.0,1223,135,27,253,280,72,29,90,119,440,1027,0.4284323271665043,217,566,0.3833922261484099,223,461,0.4837310195227766,0.534,126,144,0.875
Terry Rozier,roziete01,PG,24,BOS,2019,79,1791.0,708,231,32,275,307,68,21,68,101,258,666,0.3873873873873873,119,337,0.3531157270029673,139,329,0.4224924012158054,0.477,73,93,0.7849462365591398
Ricky Rubio,rubiori01,PG,28,UTA,2019,68,1899.0,864,416,33,210,243,91,10,180,180,295,730,0.4041095890410959,79,254,0.3110236220472441,216,476,0.453781512605042,0.458,195,228,0.8552631578947368
D'Angelo Russell,russeda01,PG,22,BRK,2019,81,2448.0,1712,563,53,262,315,100,20,253,141,659,1517,0.4344100197758734,234,635,0.368503937007874,425,882,0.481859410430839,0.512,160,205,0.7804878048780488
Domantas Sabonis,sabondo01,C,22,IND,2019,74,1838.0,1043,212,186,504,690,48,30,160,239,413,700,0.59,9,17,0.5294117647058824,404,683,0.5915080527086384,0.596,208,291,0.7147766323024055
Brandon Sampson,sampsbr01,SG,21,CHI,2019,14,214.0,71,10,3,13,16,8,3,12,19,28,60,0.4666666666666667,11,29,0.3793103448275862,17,31,0.5483870967741935,0.558,4,6,0.6666666666666666
JaKarr Sampson,sampsja02,SF,25,CHI,2019,4,127.0,80,4,5,27,32,4,3,4,8,29,54,0.5370370370370371,5,14,0.3571428571428571,24,40,0.6,0.583,17,21,0.8095238095238095
Dario Šarić,saricda01,PF,24,TOT,2019,81,2023.0,858,127,126,331,457,45,9,97,182,304,696,0.4367816091954023,118,323,0.3653250773993808,186,373,0.4986595174262734,0.522,132,150,0.88
Tomáš Satoranský,satorto01,PG,27,WAS,2019,80,2164.0,709,399,82,197,279,82,13,120,172,257,530,0.4849056603773585,64,162,0.3950617283950617,193,368,0.5244565217391305,0.545,131,160,0.81875
Dennis Schröder,schrode01,PG,25,OKC,2019,79,2314.0,1224,323,38,246,284,65,12,172,189,457,1104,0.4139492753623188,124,364,0.3406593406593406,333,740,0.45,0.47,186,227,0.8193832599118943
Mike Scott,scottmi01,PF,30,TOT,2019,79,1395.0,459,66,43,233,276,26,13,44,156,168,420,0.4,101,252,0.4007936507936508,67,168,0.3988095238095238,0.52,22,33,0.6666666666666666
Thabo Sefolosha,sefolth01,SF,34,UTA,2019,50,609.0,190,27,8,115,123,43,5,25,41,71,149,0.4765100671140939,34,78,0.4358974358974359,37,71,0.5211267605633803,0.591,14,22,0.6363636363636364
Wayne Selden,seldewa01,SG,24,TOT,2019,75,1439.0,514,109,37,143,180,33,13,79,131,196,483,0.4057971014492754,55,174,0.3160919540229885,141,309,0.4563106796116505,0.463,67,92,0.7282608695652174
Collin Sexton,sextoco01,PG,20,CLE,2019,82,2605.0,1371,243,57,179,236,44,6,185,186,519,1206,0.4303482587064676,119,296,0.402027027027027,400,910,0.4395604395604395,0.48,214,255,0.8392156862745098
Landry Shamet,shamela01,SG,21,TOT,2019,79,1802.0,722,117,21,113,134,37,10,45,155,240,557,0.4308797127468581,167,396,0.4217171717171717,73,161,0.453416149068323,0.581,75,93,0.8064516129032258
Iman Shumpert,shumpim01,SG,28,TOT,2019,62,1481.0,465,112,27,156,183,59,24,50,127,167,446,0.3744394618834081,95,273,0.3479853479853479,72,173,0.4161849710982659,0.481,36,45,0.8
Pascal Siakam,siakapa01,PF,24,TOR,2019,80,2548.0,1354,248,124,425,549,73,52,154,241,519,945,0.5492063492063493,79,214,0.3691588785046729,440,731,0.6019151846785226,0.591,237,302,0.7847682119205298
Jordan Sibert,siberjo01,SG,26,ATL,2019,1,4.0,3,0,0,0,0,0,0,0,0,1,1,1.0,1,1,1.0,0,0,0.0,1.5,0,0,0.0
Ben Simmons,simmobe01,PG,22,PHI,2019,79,2700.0,1337,610,172,525,697,112,61,274,209,540,960,0.5625,0,6,0.0,540,954,0.5660377358490566,0.563,257,428,0.6004672897196262
Jonathon Simmons,simmojo02,SG-SF,29,TOT,2019,56,1064.0,366,128,27,99,126,29,15,68,89,133,350,0.38,28,104,0.2692307692307692,105,246,0.4268292682926829,0.42,72,97,0.7422680412371134
Kobi Simmons,simmoko01,PG,21,CLE,2019,1,2.0,0,0,0,0,0,0,0,0,0,0,0,0.0,0,0,0.0,0,0,0.0,0.0,0,0,0.0
Anfernee Simons,simonan01,SG,19,POR,2019,20,141.0,75,13,3,10,13,1,0,11,9,28,63,0.4444444444444444,10,29,0.3448275862068966,18,34,0.5294117647058824,0.524,9,16,0.5625
Marcus Smart,smartma01,SG,24,BOS,2019,80,2200.0,708,321,57,177,234,143,28,123,201,239,567,0.4215167548500881,126,346,0.3641618497109826,113,221,0.5113122171945701,0.533,104,129,0.8062015503875969
Dennis Smith Jr.,smithde03,PG,21,TOT,2019,53,1508.0,722,252,32,123,155,67,20,154,129,278,650,0.4276923076923077,67,208,0.3221153846153846,211,442,0.4773755656108597,0.479,99,156,0.6346153846153846
Ish Smith,smithis01,PG,30,DET,2019,56,1251.0,501,203,23,122,145,28,11,61,109,205,489,0.4192229038854805,44,135,0.3259259259259259,161,354,0.4548022598870056,0.464,47,62,0.7580645161290323
J.R. Smith,smithjr01,SG,33,CLE,2019,11,222.0,74,21,0,18,18,11,3,11,19,27,79,0.3417721518987341,12,39,0.3076923076923077,15,40,0.375,0.418,8,10,0.8
Jason Smith,smithja02,C-PF,32,TOT,2019,20,190.0,65,14,16,36,52,3,7,13,30,21,59,0.3559322033898305,9,26,0.3461538461538461,12,33,0.3636363636363636,0.432,14,16,0.875
Zhaire Smith,smithzh01,SG,19,PHI,2019,6,111.0,40,10,3,10,13,2,2,6,8,14,34,0.4117647058823529,6,16,0.375,8,18,0.4444444444444444,0.5,6,8,0.75
Tony Snell,snellto01,SF,27,MIL,2019,74,1304.0,444,68,29,128,157,26,18,23,90,163,361,0.4515235457063712,81,204,0.3970588235294117,82,157,0.5222929936305732,0.564,37,42,0.8809523809523809
Ray Spalding,spaldra01,PF,21,TOT,2019,14,148.0,54,5,15,33,48,9,8,9,23,25,47,0.5319148936170213,0,3,0.0,25,44,0.5681818181818182,0.532,4,12,0.3333333333333333
Omari Spellman,spellom01,PF,21,ATL,2019,46,805.0,272,47,72,122,194,26,25,31,67,98,244,0.4016393442622951,44,128,0.34375,54,116,0.4655172413793103,0.492,32,45,0.7111111111111111
Nik Stauskas,stausni01,SG,25,TOT,2019,68,1015.0,399,81,18,109,127,21,7,51,50,136,338,0.4023668639053254,70,188,0.3723404255319149,66,150,0.44,0.506,57,64,0.890625
D.J. Stephens,stephdj01,SG,28,MEM,2019,1,7.0,2,0,0,0,0,1,0,1,0,1,2,0.5,0,0,0.0,1,2,0.5,0.5,0,0,0.0
Lance Stephenson,stephla01,SG,28,LAL,2019,68,1123.0,491,140,32,183,215,41,7,86,111,184,432,0.4259259259259259,73,197,0.3705583756345177,111,235,0.4723404255319149,0.51,50,73,0.684931506849315
Edmond Sumner,sumneed01,PG,23,IND,2019,23,210.0,66,10,9,15,24,12,5,10,26,22,64,0.34375,7,27,0.2592592592592592,15,37,0.4054054054054054,0.398,15,24,0.625
Caleb Swanigan,swanica01,PF,21,TOT,2019,21,178.0,43,11,17,47,64,6,1,18,28,18,53,0.3396226415094339,1,7,0.1428571428571428,17,46,0.3695652173913043,0.349,6,9,0.6666666666666666
Jayson Tatum,tatumja01,SF,20,BOS,2019,79,2455.0,1243,168,70,407,477,84,57,122,168,466,1036,0.4498069498069498,116,311,0.3729903536977492,350,725,0.4827586206896552,0.506,195,228,0.8552631578947368
Jeff Teague,teaguje01,PG,30,MIN,2019,42,1264.0,510,343,16,90,106,43,18,97,90,176,416,0.4230769230769231,35,105,0.3333333333333333,141,311,0.4533762057877814,0.465,123,153,0.803921568627451
Garrett Temple,templga01,SG,32,TOT,2019,75,2040.0,586,106,28,188,216,76,30,70,204,208,493,0.4219066937119675,90,264,0.3409090909090909,118,229,0.5152838427947598,0.513,80,107,0.7476635514018691
Miloš Teodosić,teodomi01,PG,31,LAC,2019,15,150.0,48,32,3,13,16,3,1,21,27,17,40,0.425,10,27,0.3703703703703703,7,13,0.5384615384615384,0.55,4,7,0.5714285714285714
Jared Terrell,terreja01,SG,23,MIN,2019,14,111.0,31,12,1,5,6,3,2,10,16,12,39,0.3076923076923077,4,17,0.2352941176470588,8,22,0.3636363636363636,0.359,3,6,0.5
Emanuel Terry,terryem01,PF,22,TOT,2019,3,23.0,10,2,3,4,7,3,0,2,4,4,7,0.5714285714285714,0,0,0.0,4,7,0.5714285714285714,0.571,2,4,0.5
Daniel Theis,theisda01,C,26,BOS,2019,66,908.0,374,68,87,138,225,21,42,33,161,146,266,0.5488721804511278,26,67,0.3880597014925373,120,199,0.6030150753768844,0.598,56,76,0.7368421052631579
Isaiah Thomas,thomais02,SG,29,DEN,2019,12,181.0,97,23,5,8,13,5,1,18,17,34,99,0.3434343434343434,12,43,0.2790697674418604,22,56,0.3928571428571428,0.404,17,27,0.6296296296296297
Khyri Thomas,thomakh01,SG,22,DET,2019,26,195.0,61,8,4,16,20,7,5,4,22,22,69,0.3188405797101449,10,35,0.2857142857142857,12,34,0.3529411764705882,0.391,7,11,0.6363636363636364
Lance Thomas,thomala01,PF,30,NYK,2019,46,783.0,205,27,21,96,117,17,7,24,83,78,197,0.3959390862944162,22,79,0.2784810126582278,56,118,0.4745762711864407,0.452,27,36,0.75
Klay Thompson,thompkl01,SG,28,GSW,2019,78,2652.0,1680,186,37,262,299,84,47,115,157,655,1402,0.4671897289586305,241,599,0.4023372287145242,414,803,0.5155666251556662,0.553,129,158,0.8164556962025317
Tristan Thompson,thomptr01,C,27,CLE,2019,43,1198.0,470,86,173,265,438,28,16,59,89,201,380,0.5289473684210526,0,0,0.0,201,380,0.5289473684210526,0.529,68,106,0.6415094339622641
Sindarius Thornwell,thornsi01,SG,24,LAC,2019,64,313.0,62,18,5,39,44,14,7,20,41,17,49,0.3469387755102041,3,15,0.2,14,34,0.4117647058823529,0.378,25,34,0.7352941176470589
Anthony Tolliver,tollian01,PF,33,MIN,2019,65,1079.0,326,46,15,162,177,17,21,36,91,99,259,0.3822393822393822,81,215,0.3767441860465116,18,44,0.4090909090909091,0.539,47,60,0.7833333333333333
Karl-Anthony Towns,townska01,C,23,MIN,2019,77,2545.0,1880,259,263,691,954,67,125,240,292,681,1314,0.5182648401826484,142,355,0.4,539,959,0.5620437956204379,0.572,376,450,0.8355555555555556
Gary Trent Jr.,trentga02,SG,20,POR,2019,15,111.0,40,5,1,10,11,1,2,4,4,16,50,0.32,5,21,0.238095238095238,11,29,0.3793103448275862,0.37,3,7,0.4285714285714285
Allonzo Trier,trieral01,SG,23,NYK,2019,64,1459.0,695,119,31,166,197,28,14,116,117,232,518,0.4478764478764478,52,132,0.3939393939393939,180,386,0.466321243523316,0.498,179,223,0.8026905829596412
P.J. Tucker,tuckepj01,PF,33,HOU,2019,82,2802.0,601,96,121,358,479,132,39,63,252,207,523,0.395793499043977,146,387,0.3772609819121447,61,136,0.4485294117647059,0.535,41,59,0.6949152542372882
Evan Turner,turneev01,PG,30,POR,2019,73,1605.0,494,283,37,291,328,33,18,114,110,204,443,0.4604966139954853,11,52,0.2115384615384615,193,391,0.4936061381074169,0.473,75,106,0.7075471698113207
Myles Turner,turnemy01,C,22,IND,2019,74,2119.0,984,115,101,430,531,60,199,100,195,380,780,0.4871794871794871,76,196,0.3877551020408163,304,584,0.5205479452054794,0.536,148,201,0.736318407960199
Ekpe Udoh,udohek01,C,31,UTA,2019,51,320.0,119,28,27,63,90,10,31,13,36,50,72,0.6944444444444444,0,0,0.0,50,72,0.6944444444444444,0.694,19,30,0.6333333333333333
Tyler Ulis,ulisty01,PG,23,CHI,2019,1,1.0,0,0,0,0,0,0,0,0,0,0,0,0.0,0,0,0.0,0,0,0.0,0.0,0,0,0.0
Jonas Valančiūnas,valanjo01,C,26,TOT,2019,49,1091.0,763,70,106,313,419,19,53,90,146,301,538,0.5594795539033457,14,48,0.2916666666666667,287,490,0.5857142857142857,0.572,147,185,0.7945945945945946
Jarred Vanderbilt,vandeja01,PF,19,DEN,2019,17,69.0,24,3,7,16,23,6,1,8,8,9,19,0.4736842105263157,0,1,0.0,9,18,0.5,0.474,6,10,0.6
Fred VanVleet,vanvlfr01,PG,24,TOR,2019,64,1760.0,701,307,21,146,167,57,20,82,110,246,600,0.41,112,296,0.3783783783783784,134,304,0.4407894736842105,0.503,97,115,0.8434782608695652
Noah Vonleh,vonleno01,PF,23,NYK,2019,68,1722.0,571,129,113,415,528,46,51,88,174,207,440,0.4704545454545454,46,137,0.3357664233576642,161,303,0.5313531353135313,0.523,111,156,0.7115384615384616
Nikola Vučević,vucevni01,C,28,ORL,2019,80,2510.0,1665,307,224,736,960,81,89,159,157,701,1354,0.517725258493353,84,231,0.3636363636363636,617,1123,0.5494211932324132,0.549,179,227,0.788546255506608
Dwyane Wade,wadedw01,SG,37,MIA,2019,72,1885.0,1083,301,69,216,285,59,38,166,118,416,960,0.4333333333333333,86,261,0.3295019157088122,330,699,0.4721030042918455,0.478,165,233,0.7081545064377682
Moritz Wagner,wagnemo01,C,21,LAL,2019,43,446.0,207,24,17,68,85,11,13,39,57,71,171,0.4152046783625731,22,77,0.2857142857142857,49,94,0.5212765957446809,0.48,43,53,0.8113207547169812
Dion Waiters,waitedi01,SG,27,MIA,2019,44,1138.0,527,121,7,109,116,29,9,64,72,198,478,0.4142259414225941,109,289,0.3771626297577855,89,189,0.4708994708994709,0.528,22,44,0.5
Kemba Walker,walkeke02,PG,28,CHO,2019,82,2863.0,2102,484,52,309,361,102,34,211,131,731,1684,0.4340855106888361,260,731,0.3556771545827633,471,953,0.4942287513116474,0.511,380,450,0.8444444444444444
Lonnie Walker IV,walkelo01,SG,20,SAS,2019,17,118.0,45,9,0,17,17,7,3,4,7,16,46,0.3478260869565217,5,13,0.3846153846153846,11,33,0.3333333333333333,0.402,8,10,0.8
John Wall,walljo01,PG,28,WAS,2019,32,1104.0,663,279,15,101,116,49,29,121,71,245,552,0.4438405797101449,51,169,0.301775147928994,194,383,0.5065274151436031,0.49,122,175,0.6971428571428572
Tyrone Wallace,wallaty01,PG,24,LAC,2019,62,628.0,218,42,20,81,101,21,7,36,83,92,217,0.423963133640553,4,19,0.2105263157894736,88,198,0.4444444444444444,0.433,30,57,0.5263157894736842
Brad Wanamaker,wanambr01,PG,29,BOS,2019,36,343.0,140,56,3,38,41,12,2,19,34,50,105,0.4761904761904761,16,39,0.4102564102564102,34,66,0.5151515151515151,0.552,24,28,0.8571428571428571
T.J. Warren,warretj01,SF,25,PHO,2019,43,1360.0,772,64,31,143,174,51,29,52,119,297,611,0.486088379705401,77,180,0.4277777777777777,220,431,0.5104408352668214,0.549,101,124,0.8145161290322581
Julian Washburn,washbju01,SF,27,MEM,2019,18,254.0,40,14,8,33,41,13,2,7,16,16,48,0.3333333333333333,5,24,0.2083333333333333,11,24,0.4583333333333333,0.385,3,4,0.75
Yuta Watanabe,watanyu01,SF,24,MEM,2019,15,174.0,39,8,4,27,31,4,1,6,11,15,51,0.2941176470588235,2,16,0.125,13,35,0.3714285714285714,0.314,7,10,0.7
Thomas Welsh,welshth01,C,22,DEN,2019,11,36.0,18,5,0,4,4,0,0,1,3,7,13,0.5384615384615384,3,7,0.4285714285714285,4,6,0.6666666666666666,0.654,1,2,0.5
Russell Westbrook,westbru01,PG,30,OKC,2019,73,2630.0,1675,784,109,698,807,142,33,325,245,630,1473,0.4276985743380855,119,411,0.2895377128953771,511,1062,0.4811676082862524,0.468,296,451,0.656319290465632
Derrick White,whitede01,PG,24,SAS,2019,67,1728.0,663,263,35,212,247,67,47,97,145,260,543,0.4788213627992633,48,142,0.3380281690140845,212,401,0.5286783042394015,0.523,95,123,0.7723577235772358
Okaro White,whiteok01,PF,26,WAS,2019,3,6.0,0,0,1,1,2,0,0,0,0,0,2,0.0,0,2,0.0,0,0,0.0,0.0,0,0,0.0
Hassan Whiteside,whiteha01,C,29,MIA,2019,72,1674.0,887,56,257,560,817,46,136,97,192,388,680,0.5705882352941176,2,16,0.125,386,664,0.5813253012048193,0.572,109,243,0.448559670781893
Andrew Wiggins,wiggian01,SF,23,MIN,2019,73,2543.0,1321,184,83,269,352,70,48,138,153,498,1209,0.4119106699751861,118,348,0.3390804597701149,380,861,0.4413472706155633,0.461,207,296,0.6993243243243243
Alan Williams,willial03,PF,26,BRK,2019,5,26.0,18,3,4,15,19,1,0,1,2,8,13,0.6153846153846154,0,1,0.0,8,12,0.6666666666666666,0.615,2,4,0.5
C.J. Williams,willicj01,SG,28,MIN,2019,15,128.0,39,12,1,7,8,6,0,5,16,17,35,0.4857142857142857,5,16,0.3125,12,19,0.631578947368421,0.557,0,1,0.0
Johnathan Williams,willijo04,C,23,LAL,2019,24,372.0,157,13,48,51,99,8,7,16,62,65,110,0.5909090909090909,0,2,0.0,65,108,0.6018518518518519,0.591,27,48,0.5625
Kenrich Williams,willike04,SF,24,NOP,2019,46,1079.0,279,83,55,164,219,45,19,36,95,107,279,0.3835125448028674,52,156,0.3333333333333333,55,123,0.4471544715447154,0.477,13,19,0.6842105263157895
Lou Williams,willilo02,SG,32,LAC,2019,75,1993.0,1498,402,40,182,222,57,11,181,80,484,1138,0.4253075571177504,105,291,0.3608247422680412,379,847,0.4474616292798111,0.471,425,485,0.8762886597938144
Marvin Williams,willima02,PF,32,CHO,2019,75,2133.0,756,92,76,331,407,71,61,47,156,275,652,0.4217791411042945,140,382,0.3664921465968586,135,270,0.5,0.529,66,86,0.7674418604651163
Robert Williams,williro04,C,21,BOS,2019,32,283.0,81,7,27,54,81,9,40,10,36,36,51,0.7058823529411765,0,0,0.0,36,51,0.7058823529411765,0.706,9,15,0.6
Troy Williams,willitr02,SF,24,SAC,2019,21,312.0,111,11,12,47,59,10,8,9,37,44,98,0.4489795918367347,14,44,0.3181818181818182,30,54,0.5555555555555556,0.52,9,15,0.6
D.J. Wilson,wilsodj01,PF,22,MIL,2019,48,882.0,280,52,45,177,222,18,20,32,85,104,251,0.4143426294820717,46,127,0.3622047244094488,58,124,0.4677419354838709,0.506,26,47,0.5531914893617021
Justise Winslow,winslju01,SF,22,MIA,2019,66,1959.0,830,282,63,292,355,72,19,142,177,324,749,0.4325767690253672,96,256,0.375,228,493,0.4624746450304259,0.497,86,137,0.6277372262773723
Christian Wood,woodch01,PF,23,TOT,2019,21,251.0,172,8,17,66,83,7,10,17,17,61,117,0.5213675213675214,9,26,0.3461538461538461,52,91,0.5714285714285714,0.56,41,56,0.7321428571428571
Delon Wright,wrighde01,PG,26,TOT,2019,75,1699.0,653,248,68,198,266,88,30,77,103,242,558,0.4336917562724014,50,168,0.2976190476190476,192,390,0.4923076923076923,0.478,119,150,0.7933333333333333
Guerschon Yabusele,yabusgu01,PF,23,BOS,2019,41,251.0,94,15,23,30,53,8,7,15,32,35,77,0.4545454545454545,9,28,0.3214285714285714,26,49,0.5306122448979592,0.513,15,22,0.6818181818181818
Nick Young,youngni01,SG,33,DEN,2019,4,37.0,9,2,0,1,1,0,1,2,4,3,9,0.3333333333333333,3,8,0.375,0,1,0.0,0.5,0,0,0.0
Thaddeus Young,youngth01,PF,30,IND,2019,81,2489.0,1024,204,192,331,523,123,36,123,194,443,841,0.5267538644470868,51,146,0.3493150684931507,392,695,0.5640287769784172,0.557,87,135,0.6444444444444445
Trae Young,youngtr01,PG,20,ATL,2019,81,2503.0,1549,653,64,237,301,72,15,308,140,525,1256,0.4179936305732484,156,482,0.3236514522821577,369,774,0.4767441860465116,0.48,343,414,0.8285024154589372
Cody Zeller,zelleco01,C,26,CHO,2019,49,1243.0,497,102,110,223,333,38,41,62,164,190,345,0.5507246376811594,6,22,0.2727272727272727,184,323,0.5696594427244582,0.559,111,141,0.7872340425531915
Tyler Zeller,zellety01,C,29,TOT,2019,6,93.0,46,4,11,13,24,1,3,4,20,16,30,0.5333333333333333,0,1,0.0,16,29,0.5517241379310345,0.533,14,18,0.7777777777777778
Ante Žižić,zizican01,C,22,CLE,2019,59,1082.0,459,53,108,212,320,13,22,61,113,183,331,0.552870090634441,0,0,0.0,183,331,0.552870090634441,0.553,93,132,0.7045454545454546
Ivica Zubac,zubaciv01,C,21,TOT,2019,59,1040.0,525,63,115,247,362,14,51,70,137,212,379,0.5593667546174143,0,0,0.0,212,379,0.5593667546174143,0.559,101,126,0.8015873015873016
Steven Adams,adamsst01,C,26,OKC,2020,63,1680.0,684,146,207,376,583,51,67,94,122,283,478,0.5920502092050209,1,3,0.3333333333333333,282,475,0.5936842105263158,0.593,117,201,0.582089552238806
Bam Adebayo,adebaba01,PF,22,MIA,2020,72,2417.0,1146,368,176,559,735,82,93,204,182,440,790,0.5569620253164557,2,14,0.1428571428571428,438,776,0.5644329896907216,0.558,264,382,0.6910994764397905
LaMarcus Aldridge,aldrila01,C,34,SAS,2020,53,1754.0,1001,129,103,289,392,36,87,74,128,391,793,0.4930643127364439,61,157,0.3885350318471338,330,636,0.5188679245283019,0.532,158,191,0.8272251308900523
Kyle Alexander,alexaky01,C,23,MIA,2020,2,13.0,2,0,2,1,3,0,0,1,1,1,2,0.5,0,0,0.0,1,2,0.5,0.5,0,0,0.0
Nickeil Alexander-Walker,alexani01,SG,21,NOP,2020,47,591.0,267,89,9,75,84,17,8,54,57,98,266,0.3684210526315789,46,133,0.3458646616541353,52,133,0.3909774436090225,0.455,25,37,0.6756756756756757
Grayson Allen,allengr01,SG,24,MEM,2020,38,718.0,330,52,8,77,85,10,2,33,53,117,251,0.4661354581673306,57,141,0.4042553191489361,60,110,0.5454545454545454,0.58,39,45,0.8666666666666667
Jarrett Allen,allenja01,C,21,BRK,2020,70,1852.0,775,110,216,455,671,40,92,77,162,302,465,0.6494623655913978,0,6,0.0,302,459,0.6579520697167756,0.649,171,270,0.6333333333333333
Kadeem Allen,allenka01,PG,27,NYK,2020,10,117.0,50,21,2,7,9,5,2,8,7,19,44,0.4318181818181818,5,16,0.3125,14,28,0.5,0.489,7,11,0.6363636363636364
Al-Farouq Aminu,aminual01,PF,29,ORL,2020,18,380.0,78,21,24,63,87,18,8,17,27,25,86,0.2906976744186046,9,36,0.25,16,50,0.32,0.343,19,29,0.6551724137931034
Justin Anderson,anderju01,SG,26,BRK,2020,10,107.0,28,8,1,20,21,0,6,4,13,10,38,0.2631578947368421,6,29,0.2068965517241379,4,9,0.4444444444444444,0.342,2,4,0.5
Kyle Anderson,anderky01,SF,26,MEM,2020,67,1330.0,390,162,58,227,285,54,37,66,111,157,331,0.4743202416918429,24,85,0.2823529411764706,133,246,0.540650406504065,0.511,52,78,0.6666666666666666
Ryan Anderson,anderry01,C,31,HOU,2020,2,14.0,5,2,0,7,7,1,0,1,1,2,7,0.2857142857142857,1,5,0.2,1,2,0.5,0.357,0,0,0.0
Giannis Antetokounmpo,antetgi01,PF,25,MIL,2020,63,1917.0,1857,354,140,716,856,61,66,230,195,685,1238,0.5533117932148627,89,293,0.3037542662116041,596,945,0.6306878306878307,0.589,398,629,0.6327503974562798
Kostas Antetokounmpo,antetko01,PF,22,LAL,2020,5,20.0,7,2,2,1,3,0,0,1,2,3,3,1.0,0,0,0.0,3,3,1.0,1.0,1,2,0.5
Thanasis Antetokounmpo,antetth01,SF,27,MIL,2020,20,129.0,55,15,12,12,24,7,2,12,18,24,48,0.5,0,10,0.0,24,38,0.631578947368421,0.5,7,17,0.4117647058823529
Carmelo Anthony,anthoca01,PF,35,POR,2020,58,1902.0,895,85,71,297,368,49,27,100,171,336,782,0.4296675191815857,87,226,0.3849557522123893,249,556,0.447841726618705,0.485,136,161,0.84472049689441
OG Anunoby,anunoog01,SF,22,TOR,2020,69,2066.0,733,108,80,284,364,96,45,79,167,286,566,0.5053003533568905,89,228,0.3903508771929824,197,338,0.5828402366863905,0.584,72,102,0.7058823529411765
Ryan Arcidiacono,arcidry01,PG,25,CHI,2020,58,930.0,261,96,20,90,110,27,3,37,96,90,220,0.4090909090909091,54,138,0.391304347826087,36,82,0.4390243902439024,0.532,27,38,0.7105263157894737
Trevor Ariza,arizatr01,SF,34,TOT,2020,53,1493.0,423,91,34,212,246,69,15,56,111,142,324,0.4382716049382716,77,207,0.3719806763285024,65,117,0.5555555555555556,0.557,62,74,0.8378378378378378
D.J. Augustin,augusdj01,PG,32,ORL,2020,57,1420.0,599,262,22,100,122,34,1,86,72,184,461,0.3991323210412147,70,201,0.3482587064676617,114,260,0.4384615384615384,0.475,161,181,0.8895027624309392
Deandre Ayton,aytonde01,C,21,PHO,2020,38,1236.0,690,72,147,289,436,26,58,80,117,310,568,0.545774647887324,3,13,0.2307692307692307,307,555,0.5531531531531532,0.548,67,89,0.7528089887640449
Dwayne Bacon,bacondw01,SG,24,CHO,2020,39,687.0,224,52,15,85,100,23,2,37,52,85,244,0.3483606557377049,19,67,0.2835820895522388,66,177,0.3728813559322034,0.387,35,53,0.660377358490566
Marvin Bagley III,baglema01,C,20,SAC,2020,13,334.0,185,10,29,68,97,6,12,18,43,78,167,0.467065868263473,4,22,0.1818181818181818,74,145,0.5103448275862069,0.479,25,31,0.8064516129032258
Lonzo Ball,balllo01,PG,22,NOP,2020,63,2025.0,745,438,71,312,383,88,38,193,128,277,687,0.4032023289665211,148,395,0.3746835443037974,129,292,0.4417808219178082,0.511,43,76,0.5657894736842105
Mo Bamba,bambamo01,C,21,ORL,2020,62,878.0,332,42,100,202,302,23,86,42,116,132,286,0.4615384615384615,37,107,0.3457943925233644,95,179,0.5307262569832403,0.526,31,46,0.6739130434782609
J.J. Barea,bareajo01,PG,35,DAL,2020,29,450.0,222,112,10,43,53,5,2,38,27,85,207,0.4106280193236715,32,85,0.3764705882352941,53,122,0.4344262295081967,0.488,20,22,0.9090909090909092
Harrison Barnes,barneha02,PF,27,SAC,2020,72,2482.0,1046,159,77,278,355,43,12,88,93,365,793,0.4602774274905422,102,268,0.3805970149253731,263,525,0.5009523809523809,0.525,214,267,0.8014981273408239
RJ Barrett,barrerj01,SG,19,NYK,2020,56,1704.0,803,143,50,229,279,55,17,124,122,292,727,0.4016506189821183,63,197,0.3197969543147208,229,530,0.4320754716981132,0.445,156,254,0.6141732283464567
Will Barton,bartowi01,SF,29,DEN,2020,58,1916.0,874,212,76,289,365,61,29,88,121,332,738,0.4498644986449864,108,288,0.375,224,450,0.4977777777777777,0.523,102,133,0.7669172932330827
Keita Bates-Diop,bateske01,PF-SF,24,TOT,2020,44,744.0,288,30,25,102,127,19,24,17,43,100,234,0.4273504273504273,34,103,0.3300970873786408,66,131,0.5038167938931297,0.5,54,75,0.72
Nicolas Batum,batumni01,SF,31,CHO,2020,22,505.0,79,66,25,75,100,17,8,22,41,28,81,0.345679012345679,14,49,0.2857142857142857,14,32,0.4375,0.432,9,10,0.9
Aron Baynes,baynear01,C,33,PHO,2020,42,934.0,481,67,71,166,237,10,23,50,141,183,381,0.4803149606299212,59,168,0.3511904761904761,124,213,0.5821596244131455,0.558,56,75,0.7466666666666667
Kent Bazemore,bazemke01,SF,30,TOT,2020,68,1688.0,597,93,27,267,294,74,40,91,196,200,534,0.3745318352059925,84,244,0.3442622950819672,116,290,0.4,0.453,113,147,0.7687074829931972
Darius Bazley,bazleda01,PF,19,OKC,2020,61,1130.0,342,41,30,216,246,23,41,45,55,125,317,0.3943217665615142,49,141,0.3475177304964539,76,176,0.4318181818181818,0.472,43,62,0.6935483870967742
Bradley Beal,bealbr01,SG,26,WAS,2020,57,2053.0,1741,347,52,190,242,71,23,194,126,593,1303,0.4551036070606293,170,481,0.3534303534303534,423,822,0.5145985401459854,0.52,385,457,0.8424507658643327
Malik Beasley,beaslma01,SG,23,TOT,2020,55,1209.0,615,75,18,130,148,40,8,57,77,227,534,0.4250936329588015,107,276,0.3876811594202898,120,258,0.4651162790697674,0.525,54,66,0.8181818181818182
Marco Belinelli,belinma01,SG,33,SAS,2020,57,883.0,361,69,7,92,99,12,1,19,45,123,314,0.3917197452229299,67,178,0.3764044943820224,56,136,0.4117647058823529,0.498,48,58,0.8275862068965517
Jordan Bell,belljo01,C,25,TOT,2020,29,256.0,93,16,30,51,81,3,10,21,19,35,67,0.5223880597014925,4,12,0.3333333333333333,31,55,0.5636363636363636,0.552,19,31,0.6129032258064516
DeAndre' Bembry,bembrde01,SG,25,ATL,2020,43,915.0,249,81,34,118,152,55,19,60,84,104,228,0.4561403508771929,15,65,0.2307692307692307,89,163,0.5460122699386503,0.489,26,48,0.5416666666666666
Dragan Bender,bendedr01,PF-C,22,TOT,2020,16,286.0,107,28,16,57,73,4,9,21,42,41,92,0.4456521739130434,15,43,0.3488372093023256,26,49,0.5306122448979592,0.527,10,14,0.7142857142857143
Dāvis Bertāns,bertada01,PF,27,WAS,2020,54,1583.0,834,92,35,210,245,37,33,59,139,265,610,0.4344262295081967,200,472,0.423728813559322,65,138,0.4710144927536231,0.598,104,122,0.8524590163934426
Patrick Beverley,beverpa01,PG,31,LAC,2020,51,1342.0,405,183,57,209,266,54,25,66,156,147,341,0.4310850439882698,80,206,0.3883495145631068,67,135,0.4962962962962963,0.548,31,47,0.6595744680851063
Khem Birch,birchkh01,C,27,ORL,2020,48,922.0,212,50,91,129,220,20,23,31,91,73,143,0.5104895104895105,0,1,0.0,73,142,0.5140845070422535,0.51,66,101,0.6534653465346535
Goga Bitadze,bitadgo01,C,20,IND,2020,54,471.0,172,23,25,81,106,10,37,28,65,70,150,0.4666666666666667,8,42,0.1904761904761904,62,108,0.5740740740740741,0.493,24,33,0.7272727272727273
Bismack Biyombo,biyombi01,C,27,CHO,2020,53,1029.0,393,50,120,188,308,10,49,48,116,151,278,0.5431654676258992,0,0,0.0,151,278,0.5431654676258992,0.543,91,151,0.6026490066225165
Nemanja Bjelica,bjeline01,PF,31,SAC,2020,72,2011.0,831,203,111,347,458,62,40,99,216,314,653,0.4808575803981623,134,320,0.41875,180,333,0.5405405405405406,0.583,69,84,0.8214285714285714
Eric Bledsoe,bledser01,PG,30,MIL,2020,61,1646.0,911,328,43,239,282,57,26,148,128,334,703,0.4751066856330014,74,215,0.3441860465116279,260,488,0.5327868852459017,0.528,169,214,0.7897196261682243
Bogdan Bogdanović,bogdabo01,SG,27,SAC,2020,61,1766.0,924,207,26,181,207,64,15,102,133,337,766,0.4399477806788511,164,441,0.3718820861678004,173,325,0.5323076923076923,0.547,86,116,0.7413793103448276
Bojan Bogdanović,bogdabo02,SF,30,UTA,2020,63,2083.0,1275,131,39,220,259,34,7,159,110,418,935,0.4470588235294118,189,457,0.4135667396061269,229,478,0.4790794979079498,0.548,250,277,0.9025270758122744
Bol Bol,bolbo01,PF,20,DEN,2020,7,87.0,40,6,5,14,19,2,6,10,11,14,28,0.5,4,9,0.4444444444444444,10,19,0.5263157894736842,0.571,8,10,0.8
Jonah Bolden,boldejo01,C,24,TOT,2020,7,47.0,10,0,3,6,9,3,2,2,10,4,11,0.3636363636363636,0,4,0.0,4,7,0.5714285714285714,0.364,2,4,0.5
Marques Bolden,boldema01,C,21,CLE,2020,1,3.0,0,0,0,2,2,1,0,0,1,0,0,0.0,0,0,0.0,0,0,0.0,0.0,0,0,0.0
Jordan Bone,bonejo01,PG,22,DET,2020,10,53.0,12,8,0,4,4,1,0,2,6,5,20,0.25,2,10,0.2,3,10,0.3,0.3,0,0,0.0
Isaac Bonga,bongais01,SF,20,WAS,2020,66,1250.0,330,76,71,151,222,45,22,58,156,118,234,0.5042735042735043,25,71,0.352112676056338,93,163,0.5705521472392638,0.558,69,85,0.8117647058823529
Devin Booker,bookede01,SG,23,PHO,2020,70,2512.0,1863,456,29,268,297,49,18,264,213,627,1283,0.4886983632112237,141,398,0.3542713567839196,486,885,0.5491525423728814,0.544,468,509,0.9194499017681728
Chris Boucher,bouchch01,C,27,TOR,2020,62,819.0,411,26,107,170,277,22,61,28,114,141,299,0.471571906354515,38,118,0.3220338983050847,103,181,0.569060773480663,0.535,91,116,0.7844827586206896
Brian Bowen,bowenbr02,SF,21,IND,2020,6,31.0,6,0,1,6,7,0,1,1,3,3,10,0.3,0,2,0.0,3,8,0.375,0.3,0,0,0.0
Ky Bowman,bowmaky01,PG,22,GSW,2020,45,1015.0,335,131,24,97,121,44,10,70,102,134,321,0.4174454828660436,33,107,0.308411214953271,101,214,0.4719626168224299,0.469,34,41,0.8292682926829268
Avery Bradley,bradlav01,SG,29,LAL,2020,49,1186.0,423,63,18,97,115,43,5,47,110,170,383,0.443864229765013,63,173,0.3641618497109826,107,210,0.5095238095238095,0.526,20,24,0.8333333333333334
Tony Bradley,bradlto01,C,22,UTA,2020,58,663.0,285,23,111,156,267,14,33,30,115,126,189,0.6666666666666666,3,3,1.0,123,186,0.6612903225806451,0.675,30,46,0.6521739130434783
Jarrell Brantley,brantja01,PF,23,UTA,2020,9,96.0,24,11,2,18,20,3,5,7,7,10,28,0.3571428571428571,3,13,0.2307692307692307,7,15,0.4666666666666667,0.411,1,2,0.5
Ignas Brazdeikis,brazdig01,SF,21,NYK,2020,9,53.0,17,4,2,3,5,0,1,2,3,6,22,0.2727272727272727,1,9,0.1111111111111111,5,13,0.3846153846153846,0.295,4,5,0.8
Corey Brewer,breweco01,PF,33,SAC,2020,5,33.0,5,2,2,6,8,4,0,2,7,2,4,0.5,0,1,0.0,2,3,0.6666666666666666,0.5,1,3,0.3333333333333333
Mikal Bridges,bridgmi01,SF,23,PHO,2020,73,2042.0,667,129,66,226,292,102,46,73,163,247,484,0.5103305785123967,70,194,0.3608247422680412,177,290,0.6103448275862069,0.583,103,122,0.8442622950819673
Miles Bridges,bridgmi02,SF,21,CHO,2020,65,1995.0,843,114,88,274,362,40,48,95,132,319,753,0.4236387782204515,99,300,0.33,220,453,0.4856512141280353,0.489,106,131,0.8091603053435115
Oshae Brissett,brissos01,SF,21,TOR,2020,19,135.0,37,7,9,17,26,4,1,7,18,13,36,0.3611111111111111,3,15,0.2,10,21,0.4761904761904761,0.403,8,10,0.8
Ryan Broekhoff,broekry01,SF,29,DAL,2020,17,180.0,71,11,5,38,43,5,4,6,15,22,59,0.3728813559322034,20,51,0.392156862745098,2,8,0.25,0.542,7,8,0.875
Malcolm Brogdon,brogdma01,PG,27,IND,2020,54,1666.0,893,381,46,216,262,35,10,131,98,326,744,0.4381720430107527,75,230,0.3260869565217391,251,514,0.4883268482490272,0.489,166,186,0.8924731182795699
Dillon Brooks,brookdi01,SG,24,MEM,2020,73,2112.0,1181,150,68,175,243,63,27,124,278,435,1068,0.4073033707865168,147,411,0.3576642335766423,288,657,0.4383561643835616,0.476,164,203,0.8078817733990148
Bruce Brown,brownbr01,PG,23,DET,2020,58,1634.0,517,230,61,213,274,63,29,100,162,198,447,0.4429530201342282,33,96,0.34375,165,351,0.4700854700854701,0.48,88,119,0.7394957983193278
Charlie Brown Jr.,brownch02,SG,22,ATL,2020,10,40.0,20,2,2,2,4,2,2,3,3,6,19,0.3157894736842105,3,9,0.3333333333333333,3,10,0.3,0.395,5,5,1.0
Jaylen Brown,brownja02,SG,23,BOS,2020,57,1934.0,1159,118,62,302,364,65,20,125,167,427,887,0.4813979706877114,129,338,0.3816568047337278,298,549,0.5428051001821493,0.554,176,243,0.7242798353909465
Moses Brown,brownmo01,C,20,POR,2020,9,33.0,11,1,3,11,14,1,1,3,7,4,10,0.4,0,0,0.0,4,10,0.4,0.4,3,8,0.375
Sterling Brown,brownst02,SF,24,MIL,2020,52,767.0,266,51,31,152,183,29,7,42,54,95,256,0.37109375,44,136,0.3235294117647059,51,120,0.425,0.457,32,40,0.8
Troy Brown Jr.,browntr01,SF,20,WAS,2020,69,1782.0,716,178,76,307,383,85,7,79,132,273,622,0.4389067524115755,61,179,0.3407821229050279,212,443,0.4785553047404063,0.488,109,139,0.7841726618705036
Jalen Brunson,brunsja01,PG,23,DAL,2020,57,1022.0,466,188,22,112,134,22,4,66,74,181,388,0.4664948453608247,43,120,0.3583333333333333,138,268,0.5149253731343284,0.522,61,75,0.8133333333333334
Thomas Bryant,bryanth01,C,22,WAS,2020,46,1147.0,609,83,98,233,331,25,49,53,103,243,418,0.5813397129186603,37,91,0.4065934065934066,206,327,0.6299694189602446,0.626,86,116,0.7413793103448276
Reggie Bullock,bullore01,SG,28,NYK,2020,29,684.0,234,42,13,55,68,25,3,19,56,90,224,0.4017857142857143,37,111,0.3333333333333333,53,113,0.4690265486725664,0.484,17,21,0.8095238095238095
Trey Burke,burketr01,PG,27,TOT,2020,33,520.0,243,83,16,34,50,16,2,21,33,94,209,0.4497607655502392,32,75,0.4266666666666667,62,134,0.4626865671641791,0.526,23,29,0.7931034482758621
Alec Burks,burksal01,SF-SG,28,TOT,2020,66,1754.0,993,189,48,234,282,62,17,91,128,321,768,0.41796875,116,301,0.3853820598006645,205,467,0.4389721627408993,0.493,235,265,0.8867924528301887
Deonte Burton,burtode02,SF,26,OKC,2020,39,356.0,104,17,7,50,57,7,10,19,34,43,125,0.344,10,53,0.1886792452830188,33,72,0.4583333333333333,0.384,8,14,0.5714285714285714
Jimmy Butler,butleji01,SF,30,MIA,2020,58,1959.0,1157,350,106,280,386,103,32,127,81,345,758,0.4551451187335092,29,119,0.2436974789915966,316,639,0.4945226917057903,0.474,438,525,0.8342857142857143
Bruno Caboclo,cabocbr01,C,24,TOT,2020,30,244.0,90,12,23,37,60,15,17,13,31,38,89,0.4269662921348314,6,33,0.1818181818181818,32,56,0.5714285714285714,0.461,8,9,0.8888888888888888
Devontae Cacok,cacokde01,C,23,LAL,2020,1,9.0,6,1,2,3,5,0,0,0,0,3,6,0.5,0,0,0.0,3,6,0.5,0.5,0,0,0.0
Kentavious Caldwell-Pope,caldwke01,SG,26,LAL,2020,69,1762.0,645,111,38,104,142,57,14,62,128,237,507,0.4674556213017751,92,239,0.3849372384937238,145,268,0.5410447761194029,0.558,79,102,0.7745098039215687
Vlatko Čančar,cancavl01,PF,22,DEN,2020,14,45.0,17,3,5,5,10,1,1,3,7,6,15,0.4,1,6,0.1666666666666666,5,9,0.5555555555555556,0.433,4,4,1.0
Clint Capela,capelca01,C,25,HOU,2020,39,1279.0,543,48,168,369,537,33,72,63,102,244,388,0.6288659793814433,0,0,0.0,244,388,0.6288659793814433,0.629,55,104,0.5288461538461539
DeMarre Carroll,carrode01,SF-C,33,TOT,2020,24,290.0,87,25,12,43,55,8,5,17,32,25,66,0.3787878787878788,8,33,0.2424242424242424,17,33,0.5151515151515151,0.439,29,42,0.6904761904761905
Jevon Carter,carteje01,PG,24,PHO,2020,58,945.0,287,84,30,88,118,47,17,32,86,101,243,0.4156378600823045,62,146,0.4246575342465753,39,97,0.4020618556701031,0.543,23,27,0.8518518518518519
Vince Carter,cartevi01,PF,43,ATL,2020,60,876.0,298,48,18,106,124,23,25,33,90,107,304,0.3519736842105263,61,202,0.3019801980198019,46,102,0.4509803921568627,0.452,23,29,0.7931034482758621
Wendell Carter Jr.,cartewe01,C,20,CHI,2020,43,1256.0,484,51,139,266,405,33,36,72,162,183,343,0.5335276967930029,6,29,0.2068965517241379,177,314,0.5636942675159236,0.542,112,152,0.7368421052631579
Michael Carter-Williams,cartemi01,SG,28,ORL,2020,45,833.0,323,109,46,101,147,49,22,52,87,111,260,0.4269230769230769,22,75,0.2933333333333333,89,185,0.4810810810810811,0.469,79,95,0.8315789473684211
Alex Caruso,carusal01,PG,25,LAL,2020,64,1175.0,349,124,17,106,123,70,18,53,98,120,291,0.4123711340206185,40,120,0.3333333333333333,80,171,0.4678362573099415,0.481,69,94,0.7340425531914894
Willie Cauley-Stein,caulewi01,C,26,TOT,2020,54,1097.0,390,70,84,231,315,49,61,40,121,175,302,0.5794701986754967,0,1,0.0,175,301,0.5813953488372093,0.579,40,66,0.6060606060606061
Tyson Chandler,chandty01,C,37,HOU,2020,26,219.0,34,6,25,41,66,6,8,8,32,14,18,0.7777777777777778,0,0,0.0,14,18,0.7777777777777778,0.778,6,13,0.4615384615384615
Wilson Chandler,chandwi01,PF,32,BRK,2020,35,734.0,205,39,11,134,145,16,12,34,79,74,183,0.4043715846994535,37,121,0.3057851239669421,37,62,0.5967741935483871,0.505,20,23,0.8695652173913043
Joe Chealey,chealjo01,PG,24,CHO,2020,4,33.0,2,1,0,0,0,4,0,2,2,0,7,0.0,0,4,0.0,0,3,0.0,0.0,2,2,1.0
Zylan Cheatham,cheatzy01,PF,24,NOP,2020,4,51.0,12,3,3,6,9,1,1,4,10,6,9,0.6666666666666666,0,1,0.0,6,8,0.75,0.667,0,0,0.0
Chris Chiozza,chiozch01,PG,24,TOT,2020,28,401.0,142,83,9,44,53,21,4,32,37,55,140,0.3928571428571428,27,72,0.375,28,68,0.4117647058823529,0.489,5,5,1.0
Marquese Chriss,chrisma01,PF,22,GSW,2020,59,1196.0,548,114,114,251,365,39,62,78,122,210,385,0.5454545454545454,8,39,0.2051282051282051,202,346,0.5838150289017341,0.556,120,156,0.7692307692307693
Gary Clark,clarkga01,SF-PF,25,TOT,2020,42,567.0,156,17,37,73,110,6,22,10,46,54,133,0.4060150375939849,39,111,0.3513513513513513,15,22,0.6818181818181818,0.553,9,10,0.9
Brandon Clarke,clarkbr01,PF,23,MEM,2020,58,1300.0,700,81,92,253,345,32,48,55,100,296,479,0.6179540709812108,23,64,0.359375,273,415,0.6578313253012048,0.642,85,112,0.7589285714285714
Jordan Clarkson,clarkjo01,SG,27,TOT,2020,71,1705.0,1078,136,50,137,187,46,16,97,108,394,867,0.4544405997693195,152,413,0.3680387409200968,242,454,0.5330396475770925,0.542,138,165,0.8363636363636363
Nic Claxton,claxtni01,C,20,BRK,2020,15,187.0,66,16,19,25,44,1,8,9,14,27,48,0.5625,1,7,0.1428571428571428,26,41,0.6341463414634146,0.573,11,21,0.5238095238095238
Chris Clemons,clemoch01,SG,22,HOU,2020,33,291.0,161,27,4,26,30,9,6,19,26,57,142,0.4014084507042254,37,107,0.3457943925233644,20,35,0.5714285714285714,0.532,10,11,0.9090909090909092
Antonius Cleveland,clevean01,SG,25,DAL,2020,11,46.0,11,1,2,5,7,1,3,2,8,4,14,0.2857142857142857,0,3,0.0,4,11,0.3636363636363636,0.286,3,5,0.6
Amir Coffey,coffeam01,SG,22,LAC,2020,18,159.0,58,14,4,12,16,5,2,8,20,23,54,0.4259259259259259,6,19,0.3157894736842105,17,35,0.4857142857142857,0.481,6,11,0.5454545454545454
John Collins,collijo01,PF,22,ATL,2020,41,1363.0,885,60,116,300,416,31,66,75,138,353,605,0.5834710743801653,59,147,0.4013605442176871,294,458,0.6419213973799127,0.632,120,150,0.8
Zach Collins,colliza01,PF,22,POR,2020,11,290.0,77,16,25,44,69,5,5,14,36,32,68,0.4705882352941176,7,19,0.3684210526315789,25,49,0.5102040816326531,0.522,6,8,0.75
Mike Conley,conlemi01,PG,32,UTA,2020,47,1363.0,675,208,33,118,151,36,5,92,104,232,567,0.4091710758377425,96,256,0.375,136,311,0.4372990353697749,0.494,115,139,0.8273381294964028
Pat Connaughton,connapa01,SG,27,MIL,2020,67,1243.0,360,107,60,224,284,25,31,52,70,137,301,0.4551495016611295,55,166,0.3313253012048193,82,135,0.6074074074074074,0.547,31,40,0.775
Quinn Cook,cookqu01,PG,26,LAL,2020,44,508.0,224,49,11,40,51,12,2,33,27,91,214,0.4252336448598131,31,85,0.3647058823529411,60,129,0.4651162790697674,0.498,11,14,0.7857142857142857
Tyler Cook,cookty01,PF-SF,22,TOT,2020,13,54.0,23,1,6,8,14,3,0,3,5,8,12,0.6666666666666666,0,0,0.0,8,12,0.6666666666666666,0.667,7,8,0.875
Robert Covington,covinro01,PF-C,29,TOT,2020,70,2137.0,870,88,63,400,463,115,93,103,220,305,723,0.4218533886583679,161,480,0.3354166666666666,144,243,0.5925925925925926,0.533,99,124,0.7983870967741935
Allen Crabbe,crabbal01,SG-SF,27,TOT,2020,37,653.0,172,33,11,66,77,15,4,17,47,63,177,0.3559322033898305,36,119,0.3025210084033613,27,58,0.4655172413793103,0.458,10,14,0.7142857142857143
Torrey Craig,craigto01,SF,29,DEN,2020,58,1072.0,315,47,63,126,189,23,36,25,135,124,269,0.4609665427509293,45,138,0.3260869565217391,79,131,0.6030534351145038,0.545,22,36,0.6111111111111112
Jamal Crawford,crawfja01,SG,39,BRK,2020,1,6.0,5,3,0,0,0,0,0,0,1,2,4,0.5,1,2,0.5,1,2,0.5,0.625,0,0,0.0
Jae Crowder,crowdja01,SF-PF,29,TOT,2020,65,1875.0,684,161,52,332,384,72,24,69,143,226,563,0.4014209591474245,135,394,0.3426395939086294,91,169,0.5384615384615384,0.521,97,125,0.776
Jarrett Culver,culveja01,SG,20,MIN,2020,63,1506.0,580,110,70,142,212,57,38,81,125,230,569,0.4042179261862917,66,221,0.2986425339366516,164,348,0.4712643678160919,0.462,54,117,0.4615384615384615
Seth Curry,curryse01,SG,29,DAL,2020,64,1576.0,793,124,27,118,145,38,9,62,113,284,574,0.494773519163763,145,321,0.4517133956386293,139,253,0.549407114624506,0.621,80,97,0.8247422680412371
Stephen Curry,curryst01,PG,31,GSW,2020,5,139.0,104,33,4,22,26,5,2,16,11,33,82,0.4024390243902439,12,49,0.2448979591836734,21,33,0.6363636363636364,0.476,26,26,1.0
Troy Daniels,danietr01,SG,28,TOT,2020,47,532.0,200,17,12,40,52,11,3,12,37,72,186,0.3870967741935484,46,132,0.3484848484848485,26,54,0.4814814814814814,0.511,10,16,0.625
Anthony Davis,davisan02,PF,26,LAL,2020,62,2131.0,1618,200,142,435,577,91,143,154,156,551,1096,0.5027372262773723,72,218,0.3302752293577982,479,878,0.5455580865603644,0.536,444,525,0.8457142857142858
Ed Davis,davised01,C,30,UTA,2020,28,303.0,51,12,35,70,105,11,9,13,61,22,46,0.4782608695652174,0,0,0.0,22,46,0.4782608695652174,0.478,7,14,0.5
Terence Davis,daviste02,SG,22,TOR,2020,72,1209.0,543,115,50,187,237,39,14,76,124,199,436,0.4564220183486238,94,242,0.3884297520661157,105,194,0.5412371134020618,0.564,51,59,0.864406779661017
Dewayne Dedmon,dedmode01,C,30,TOT,2020,44,774.0,256,22,60,189,249,25,41,57,133,102,255,0.4,22,107,0.205607476635514,80,148,0.5405405405405406,0.443,30,36,0.8333333333333334
Matthew Dellavedova,dellama01,PG,29,CLE,2020,57,821.0,177,180,18,57,75,20,2,59,78,62,175,0.3542857142857142,21,91,0.2307692307692307,41,84,0.4880952380952381,0.414,32,37,0.8648648648648649
DeMar DeRozan,derozde01,SF,30,SAS,2020,68,2316.0,1504,380,44,331,375,70,20,164,180,557,1049,0.5309818875119161,9,35,0.2571428571428571,548,1014,0.5404339250493096,0.535,381,451,0.844789356984479
Cheick Diallo,diallch01,C,23,PHO,2020,47,479.0,219,22,30,101,131,11,12,32,55,92,142,0.647887323943662,1,3,0.3333333333333333,91,139,0.6546762589928058,0.651,34,39,0.8717948717948718
Hamidou Diallo,diallha01,SF,21,OKC,2020,46,896.0,318,36,44,123,167,37,9,51,101,132,296,0.4459459459459459,16,57,0.2807017543859649,116,239,0.4853556485355648,0.473,38,63,0.6031746031746031
Gorgui Dieng,dienggo01,C,30,TOT,2020,63,1096.0,464,73,91,263,354,51,59,60,124,166,364,0.456043956043956,54,152,0.3552631578947368,112,212,0.5283018867924528,0.53,78,101,0.7722772277227723
Spencer Dinwiddie,dinwisp01,PG,26,BRK,2020,64,1994.0,1318,432,32,189,221,40,21,174,180,424,1021,0.4152791380999021,123,400,0.3075,301,621,0.4847020933977455,0.476,347,446,0.7780269058295964
Donte DiVincenzo,divindo01,SG,23,MIL,2020,66,1520.0,610,154,66,252,318,85,20,90,113,232,510,0.4549019607843137,83,247,0.3360323886639676,149,263,0.5665399239543726,0.536,63,86,0.7325581395348837
Luka Dončić,doncilu01,PG,20,DAL,2020,61,2047.0,1759,538,78,495,573,62,14,260,153,581,1255,0.4629482071713147,171,541,0.3160813308687615,410,714,0.5742296918767507,0.531,426,562,0.7580071174377224
Luguentz Dort,dortlu01,SF,20,OKC,2020,36,820.0,244,27,24,57,81,31,4,22,97,86,218,0.3944954128440367,30,101,0.297029702970297,56,117,0.4786324786324786,0.463,42,53,0.7924528301886793
Damyean Dotson,dotsoda01,SG,25,NYK,2020,48,836.0,321,57,10,81,91,23,4,21,44,120,290,0.4137931034482758,59,163,0.3619631901840491,61,127,0.4803149606299212,0.516,22,33,0.6666666666666666
Sekou Doumbouya,doumbse01,PF,19,DET,2020,38,754.0,243,19,20,98,118,20,8,35,80,92,236,0.3898305084745763,28,98,0.2857142857142857,64,138,0.463768115942029,0.449,31,46,0.6739130434782609
PJ Dozier,doziepj01,SG,23,DEN,2020,29,412.0,168,63,10,45,55,14,6,27,45,65,157,0.4140127388535032,17,49,0.3469387755102041,48,108,0.4444444444444444,0.468,21,29,0.7241379310344828
Goran Dragić,dragigo01,PG,33,MIA,2020,59,1663.0,953,301,29,158,187,40,10,144,124,319,724,0.4406077348066298,124,338,0.3668639053254438,195,386,0.5051813471502591,0.526,191,246,0.7764227642276422
Andre Drummond,drumman01,C,26,TOT,2020,57,1879.0,1010,152,250,614,864,109,93,203,201,418,784,0.5331632653061225,5,35,0.1428571428571428,413,749,0.5514018691588785,0.536,169,294,0.5748299319727891
Jared Dudley,dudleja01,PF,34,LAL,2020,45,364.0,68,28,6,46,52,15,3,8,41,24,60,0.4,18,42,0.4285714285714285,6,18,0.3333333333333333,0.55,2,2,1.0
Kris Dunn,dunnkr01,PG,25,CHI,2020,51,1269.0,373,173,23,163,186,101,17,68,158,152,342,0.4444444444444444,29,112,0.2589285714285714,123,230,0.5347826086956522,0.487,40,54,0.7407407407407407
Carsen Edwards,edwarca01,SG,21,BOS,2020,37,351.0,121,24,6,41,47,12,4,15,34,42,128,0.328125,24,76,0.3157894736842105,18,52,0.3461538461538461,0.422,13,19,0.6842105263157895
Henry Ellenson,ellenhe01,C,23,BRK,2020,5,15.0,2,1,2,4,6,0,0,0,1,1,7,0.1428571428571428,0,4,0.0,1,3,0.3333333333333333,0.143,0,0,0.0
Wayne Ellington,ellinwa01,SG,32,NYK,2020,36,558.0,183,44,4,61,65,13,4,18,41,61,174,0.3505747126436782,50,143,0.3496503496503496,11,31,0.3548387096774194,0.494,11,13,0.8461538461538461
Joel Embiid,embiijo01,C,25,PHI,2020,51,1506.0,1172,152,141,452,593,45,65,159,174,382,801,0.4769038701622971,57,172,0.3313953488372093,325,629,0.5166931637519873,0.512,351,435,0.8068965517241379
James Ennis III,ennisja01,SF-SG,29,TOT,2020,69,1265.0,454,63,71,174,245,35,22,58,137,160,359,0.4456824512534819,55,169,0.3254437869822485,105,190,0.5526315789473685,0.522,79,98,0.8061224489795918
Drew Eubanks,eubandr01,C,22,SAS,2020,22,272.0,107,15,28,57,85,5,17,21,37,43,67,0.6417910447761194,1,1,1.0,42,66,0.6363636363636364,0.649,20,26,0.7692307692307693
Jacob Evans,evansja02,SG,22,TOT,2020,29,418.0,128,31,9,32,41,11,12,25,41,45,134,0.3358208955223881,13,39,0.3333333333333333,32,95,0.3368421052631579,0.384,25,29,0.8620689655172413
Dante Exum,exumda01,SG,24,TOT,2020,35,485.0,159,40,12,55,67,13,8,31,38,56,119,0.4705882352941176,15,43,0.3488372093023256,41,76,0.5394736842105263,0.534,32,43,0.7441860465116279
Tacko Fall,fallta01,C,24,BOS,2020,7,33.0,23,1,1,14,15,1,4,3,7,11,14,0.7857142857142857,0,0,0.0,11,14,0.7857142857142857,0.786,1,3,0.3333333333333333
Derrick Favors,favorde01,C,28,NOP,2020,51,1243.0,459,81,163,338,501,30,46,55,107,209,339,0.616519174041298,1,7,0.1428571428571428,208,332,0.6265060240963856,0.618,40,71,0.5633802816901409
Cristiano Felício,feliccr01,C,27,CHI,2020,22,386.0,86,16,55,47,102,10,2,18,34,34,54,0.6296296296296297,0,2,0.0,34,52,0.6538461538461539,0.63,18,23,0.782608695652174
Terrance Ferguson,fergute01,SF,21,OKC,2020,56,1257.0,220,51,23,51,74,27,17,31,155,78,220,0.3545454545454545,49,168,0.2916666666666667,29,52,0.5576923076923077,0.466,15,20,0.75
Bruno Fernando,fernabr01,C,21,ATL,2020,56,713.0,240,49,67,131,198,18,17,42,107,103,199,0.5175879396984925,5,37,0.1351351351351351,98,162,0.6049382716049383,0.53,29,51,0.5686274509803921
Yogi Ferrell,ferreyo01,PG,26,SAC,2020,50,530.0,218,69,6,43,49,18,4,28,38,79,188,0.4202127659574468,24,79,0.3037974683544304,55,109,0.5045871559633027,0.484,36,42,0.8571428571428571
Dorian Finney-Smith,finnedo01,PF,26,DAL,2020,71,2120.0,678,114,145,260,405,45,39,69,178,243,522,0.4655172413793103,114,303,0.3762376237623762,129,219,0.589041095890411,0.575,78,108,0.7222222222222222
Bryn Forbes,forbebr01,SG,26,SAS,2020,63,1579.0,707,108,12,114,126,33,0,57,113,242,581,0.4165232358003442,148,381,0.3884514435695538,94,200,0.47,0.544,75,90,0.8333333333333334
Evan Fournier,fournev01,SF,27,ORL,2020,66,2076.0,1221,209,18,153,171,71,15,125,161,434,929,0.4671689989235737,173,434,0.3986175115207373,261,495,0.5272727272727272,0.56,180,220,0.8181818181818182
De'Aaron Fox,foxde01,PG,22,SAC,2020,51,1634.0,1077,348,35,161,196,74,25,158,145,391,815,0.4797546012269938,54,185,0.2918918918918919,337,630,0.5349206349206349,0.513,241,342,0.7046783625730995
Melvin Frazier,frazime01,SG,23,ORL,2020,19,126.0,40,3,2,8,10,9,2,5,11,15,34,0.4411764705882353,8,16,0.5,7,18,0.3888888888888889,0.559,2,4,0.5
Michael Frazier,frazimi01,SG,25,HOU,2020,13,145.0,27,2,1,9,10,2,0,5,22,7,29,0.2413793103448276,4,23,0.1739130434782608,3,6,0.5,0.31,9,14,0.6428571428571429
Tim Frazier,fraziti01,PG,29,DET,2020,27,355.0,97,93,9,24,33,14,4,36,42,34,94,0.3617021276595745,10,30,0.3333333333333333,24,64,0.375,0.415,19,24,0.7916666666666666
Enes Freedom,kanteen01,C,27,BOS,2020,58,983.0,469,56,163,268,431,22,41,56,100,199,348,0.5718390804597702,1,7,0.1428571428571428,198,341,0.5806451612903226,0.573,70,99,0.7070707070707071
Markelle Fultz,fultzma01,PG,21,ORL,2020,72,1996.0,870,369,41,197,238,90,11,147,142,359,772,0.4650259067357513,36,135,0.2666666666666666,323,637,0.5070643642072213,0.488,116,159,0.7295597484276729
Wenyen Gabriel,gabriwe01,PF,22,TOT,2020,30,235.0,63,8,21,31,52,11,7,16,39,21,48,0.4375,6,20,0.3,15,28,0.5357142857142857,0.5,15,22,0.6818181818181818
Daniel Gafford,gaffoda01,C,21,CHI,2020,43,609.0,220,21,52,54,106,13,56,29,98,94,134,0.7014925373134329,0,0,0.0,94,134,0.7014925373134329,0.701,32,60,0.5333333333333333
Danilo Gallinari,gallida01,PF,31,OKC,2020,62,1834.0,1160,119,34,288,322,42,5,76,75,358,817,0.438188494492044,178,439,0.4054669703872437,180,378,0.4761904761904761,0.547,266,298,0.8926174496644296
Langston Galloway,gallola01,SG,28,DET,2020,66,1702.0,677,101,33,116,149,48,11,40,96,236,542,0.4354243542435424,132,331,0.3987915407854985,104,211,0.4928909952606635,0.557,73,85,0.8588235294117647
Darius Garland,garlada01,SG,20,CLE,2020,59,1824.0,728,229,27,84,111,42,4,151,92,280,699,0.4005722460658083,105,296,0.3547297297297297,175,403,0.43424317617866,0.476,63,72,0.875
Marc Gasol,gasolma01,C,35,TOR,2020,44,1161.0,331,147,31,244,275,34,38,59,124,119,279,0.4265232974910394,57,148,0.3851351351351351,62,131,0.4732824427480916,0.529,36,49,0.7346938775510204
Rudy Gay,gayru01,PF,33,SAS,2020,67,1461.0,726,114,61,301,362,35,33,88,103,266,596,0.4463087248322148,74,220,0.3363636363636363,192,376,0.5106382978723404,0.508,120,136,0.8823529411764706
Paul George,georgpa01,SF,29,LAC,2020,48,1419.0,1033,185,24,248,272,68,20,125,113,343,782,0.438618925831202,157,381,0.4120734908136483,186,401,0.4638403990024937,0.539,190,217,0.8755760368663594
Taj Gibson,gibsota01,C,34,NYK,2020,62,1025.0,379,52,111,156,267,27,30,47,122,167,286,0.583916083916084,4,14,0.2857142857142857,163,272,0.5992647058823529,0.591,41,56,0.7321428571428571
Harry Giles,gilesha01,C,21,SAC,2020,46,667.0,316,60,43,145,188,22,18,44,119,139,251,0.5537848605577689,0,2,0.0,139,249,0.5582329317269076,0.554,38,49,0.7755102040816326
Shai Gilgeous-Alexander,gilgesh01,SG,21,OKC,2020,70,2428.0,1331,232,47,365,412,79,47,134,117,478,1015,0.470935960591133,87,251,0.3466135458167331,391,764,0.5117801047120419,0.514,288,357,0.8067226890756303
Rudy Gobert,goberru01,C,27,UTA,2020,68,2333.0,1026,101,230,686,916,51,135,130,215,386,557,0.6929982046678635,0,0,0.0,386,557,0.6929982046678635,0.693,254,403,0.630272952853598
Brandon Goodwin,goodwbr01,PG,24,ATL,2020,34,430.0,206,51,11,61,72,12,4,29,43,76,190,0.4,26,87,0.2988505747126437,50,103,0.4854368932038835,0.468,28,30,0.9333333333333332
Aaron Gordon,gordoaa01,PF,24,ORL,2020,62,2017.0,894,228,107,368,475,51,39,100,125,335,767,0.4367666232073012,73,237,0.3080168776371308,262,530,0.4943396226415094,0.484,151,224,0.6741071428571429
Eric Gordon,gordoer01,SF,31,HOU,2020,36,1016.0,520,54,9,62,71,23,13,43,70,171,463,0.3693304535637149,96,303,0.3168316831683168,75,160,0.46875,0.473,82,107,0.7663551401869159
Devonte' Graham,grahade01,PG,24,CHO,2020,63,2211.0,1145,471,42,170,212,62,15,181,115,368,963,0.3821391484942887,218,585,0.3726495726495726,150,378,0.3968253968253968,0.495,191,233,0.8197424892703863
Treveon Graham,grahatr01,SF,26,TOT,2020,55,929.0,243,45,51,99,150,24,6,29,102,87,242,0.359504132231405,33,120,0.275,54,122,0.4426229508196721,0.428,36,56,0.6428571428571429
Jerami Grant,grantje01,PF,25,DEN,2020,71,1892.0,851,88,58,190,248,50,57,63,154,303,634,0.4779179810725552,98,252,0.3888888888888889,205,382,0.5366492146596858,0.555,147,196,0.75
Jerian Grant,grantje02,SG,27,WAS,2020,6,80.0,27,9,2,4,6,1,1,3,11,10,27,0.3703703703703703,2,8,0.25,8,19,0.4210526315789473,0.407,5,7,0.7142857142857143
Josh Gray,grayjo01,PG,26,NOP,2020,2,23.0,2,2,1,1,2,0,0,5,1,1,2,0.5,0,0,0.0,1,2,0.5,0.5,0,0,0.0
Danny Green,greenda02,SG,32,LAL,2020,68,1687.0,547,91,51,174,225,85,32,63,136,197,474,0.4156118143459915,120,327,0.3669724770642202,77,147,0.5238095238095238,0.542,33,48,0.6875
Draymond Green,greendr01,PF,29,GSW,2020,43,1222.0,345,266,23,243,266,59,33,98,110,123,316,0.3892405063291139,36,129,0.2790697674418604,87,187,0.46524064171123,0.446,63,83,0.7590361445783133
JaMychal Green,greenja01,PF,29,LAC,2020,63,1307.0,430,49,77,311,388,29,24,54,174,151,352,0.4289772727272727,92,238,0.3865546218487395,59,114,0.5175438596491229,0.56,36,48,0.75
Javonte Green,greenja02,SG,26,BOS,2020,48,468.0,163,26,24,69,93,24,8,23,43,63,126,0.5,9,33,0.2727272727272727,54,93,0.5806451612903226,0.536,28,42,0.6666666666666666
Jeff Green,greenje02,PF-C,33,TOT,2020,48,960.0,453,50,24,109,133,26,19,42,89,159,344,0.4622093023255814,62,183,0.3387978142076502,97,161,0.6024844720496895,0.552,73,91,0.8021978021978022
Blake Griffin,griffbl01,PF,30,DET,2020,18,512.0,279,59,17,67,84,7,7,40,27,88,250,0.352,27,111,0.2432432432432432,61,139,0.4388489208633093,0.406,76,98,0.7755102040816326
Marko Guduric,gudurma01,SG,24,MEM,2020,44,484.0,173,45,14,59,73,12,8,36,34,62,157,0.3949044585987261,25,83,0.3012048192771084,37,74,0.5,0.475,24,26,0.9230769230769232
Kyle Guy,guyky01,SG,22,SAC,2020,3,10.0,4,1,0,1,1,0,0,0,1,2,5,0.4,0,3,0.0,2,2,1.0,0.4,0,0,0.0
Rui Hachimura,hachiru01,PF,21,WAS,2020,48,1444.0,649,87,78,216,294,37,8,53,105,254,545,0.4660550458715596,25,87,0.2873563218390804,229,458,0.5,0.489,116,140,0.8285714285714286
Devon Hall,hallde01,PG,24,OKC,2020,11,81.0,20,13,2,5,7,4,1,5,6,6,30,0.2,4,17,0.2352941176470588,2,13,0.1538461538461538,0.267,4,8,0.5
Donta Hall,halldo01,C-PF,22,TOT,2020,9,133.0,39,4,14,24,38,3,6,5,23,15,22,0.6818181818181818,0,0,0.0,15,22,0.6818181818181818,0.682,9,18,0.5
Dusty Hannahs,hannadu01,SG,26,MEM,2020,2,13.0,12,0,0,1,1,0,0,0,1,4,9,0.4444444444444444,2,3,0.6666666666666666,2,6,0.3333333333333333,0.556,2,2,1.0
Tim Hardaway Jr.,hardati02,SG,27,DAL,2020,71,2091.0,1121,137,25,207,232,41,5,69,125,384,884,0.4343891402714932,204,513,0.3976608187134502,180,371,0.4851752021563342,0.55,149,182,0.8186813186813187
James Harden,hardeja01,SG,30,HOU,2020,68,2483.0,2335,512,70,376,446,125,60,308,227,672,1514,0.4438573315719947,299,843,0.3546856465005931,373,671,0.555886736214605,0.543,692,800,0.865
Maurice Harkless,harklma01,PF-SF,26,TOT,2020,62,1427.0,357,68,55,185,240,58,33,53,148,142,283,0.5017667844522968,34,98,0.3469387755102041,108,185,0.5837837837837838,0.562,39,66,0.5909090909090909
Jared Harper,harpeja01,PG,22,PHO,2020,3,8.0,2,0,0,0,0,0,0,0,0,1,4,0.25,0,2,0.0,1,2,0.5,0.25,0,0,0.0
Montrezl Harrell,harremo01,C,26,LAC,2020,63,1749.0,1173,107,163,282,445,39,72,108,146,471,812,0.5800492610837439,0,18,0.0,471,794,0.593198992443325,0.58,231,351,0.6581196581196581
Gary Harris,harriga01,SG,25,DEN,2020,56,1780.0,581,118,26,137,163,76,14,60,116,218,519,0.420038535645472,70,210,0.3333333333333333,148,309,0.4789644012944983,0.487,75,92,0.8152173913043478
Joe Harris,harrijo01,SF,28,BRK,2020,69,2123.0,998,144,64,234,298,41,17,104,159,381,784,0.485969387755102,172,406,0.4236453201970443,209,378,0.5529100529100529,0.596,64,89,0.7191011235955056
Tobias Harris,harrito02,PF,27,PHI,2020,72,2469.0,1411,227,69,426,495,53,40,104,165,553,1173,0.4714407502131287,131,357,0.3669467787114845,422,816,0.5171568627450981,0.527,174,216,0.8055555555555556
Shaquille Harrison,harrish01,SG,26,CHI,2020,43,484.0,209,49,22,64,86,34,19,19,55,77,165,0.4666666666666667,16,42,0.3809523809523809,61,123,0.4959349593495935,0.515,39,50,0.78
Josh Hart,hartjo01,SF,24,NOP,2020,65,1755.0,656,108,61,364,425,63,23,75,160,225,532,0.4229323308270676,121,354,0.3418079096045198,104,178,0.5842696629213483,0.537,85,115,0.7391304347826086
Isaiah Hartenstein,harteis01,C,21,HOU,2020,23,266.0,107,18,29,61,90,9,12,16,41,44,67,0.6567164179104478,0,5,0.0,44,62,0.7096774193548387,0.657,19,28,0.6785714285714286
Udonis Haslem,hasleud01,C,39,MIA,2020,4,44.0,12,1,1,15,16,0,0,1,6,4,11,0.3636363636363636,1,3,0.3333333333333333,3,8,0.375,0.409,3,4,0.75
Jaxson Hayes,hayesja02,C,19,NOP,2020,64,1080.0,472,56,97,162,259,26,55,53,161,174,259,0.6718146718146718,1,4,0.25,173,255,0.6784313725490196,0.674,123,190,0.6473684210526316
Gordon Hayward,haywago01,SF,29,BOS,2020,52,1740.0,909,212,55,293,348,38,22,96,96,350,700,0.5,85,222,0.3828828828828828,265,478,0.5543933054393305,0.561,124,145,0.8551724137931035
John Henson,hensojo01,C,29,TOT,2020,40,600.0,221,54,46,116,162,24,42,36,78,95,171,0.5555555555555556,8,36,0.2222222222222222,87,135,0.6444444444444445,0.579,23,46,0.5
Dewan Hernandez,hernade01,C,23,TOR,2020,6,28.0,14,3,5,9,14,1,0,3,6,5,14,0.3571428571428571,1,2,0.5,4,12,0.3333333333333333,0.393,3,5,0.6
Juancho Hernangómez,hernaju01,PF,24,TOT,2020,48,833.0,288,40,43,154,197,19,9,32,64,100,247,0.4048582995951417,44,129,0.3410852713178294,56,118,0.4745762711864407,0.494,44,71,0.6197183098591549
Willy Hernangómez,hernawi01,C,25,CHO,2020,31,375.0,190,29,43,91,134,10,7,30,32,74,139,0.5323741007194245,5,22,0.2272727272727272,69,117,0.5897435897435898,0.55,37,59,0.6271186440677966
Tyler Herro,herroty01,SG,20,MIA,2020,55,1508.0,743,121,16,208,224,34,9,87,76,270,631,0.4278922345483359,116,298,0.3892617449664429,154,333,0.4624624624624625,0.52,87,100,0.87
Kevin Hervey,herveke01,PF,23,OKC,2020,10,52.0,17,5,1,11,12,1,1,0,4,7,27,0.2592592592592592,3,20,0.15,4,7,0.5714285714285714,0.315,0,0,0.0
Mario Hezonja,hezonma01,PF,24,POR,2020,53,871.0,256,50,30,154,184,36,9,42,107,92,218,0.4220183486238532,24,78,0.3076923076923077,68,140,0.4857142857142857,0.477,48,59,0.8135593220338984
Buddy Hield,hieldbu01,SG,27,SAC,2020,72,2216.0,1382,213,57,271,328,66,17,168,165,498,1162,0.4285714285714285,271,688,0.3938953488372093,227,474,0.4789029535864978,0.545,115,136,0.8455882352941176
George Hill,hillge01,PG,33,MIL,2020,59,1271.0,554,180,50,127,177,47,5,57,84,194,376,0.5159574468085106,81,176,0.4602272727272727,113,200,0.565,0.624,85,101,0.8415841584158416
Solomon Hill,hillso01,PF,28,TOT,2020,59,1088.0,323,104,29,136,165,43,12,51,85,110,278,0.39568345323741,63,171,0.3684210526315789,47,107,0.4392523364485981,0.509,40,54,0.7407407407407407
Jaylen Hoard,hoardja01,PF,20,POR,2020,13,103.0,38,4,14,18,32,5,0,4,12,15,32,0.46875,0,3,0.0,15,29,0.5172413793103449,0.469,8,13,0.6153846153846154
Aaron Holiday,holidaa01,PG,23,IND,2020,66,1617.0,627,225,22,134,156,55,16,88,120,233,563,0.413854351687389,87,221,0.3936651583710407,146,342,0.4269005847953216,0.491,74,87,0.8505747126436781
Jrue Holiday,holidjr01,SG,29,NOP,2020,61,2117.0,1167,408,77,216,293,99,48,184,145,458,1006,0.4552683896620278,122,346,0.3526011560693641,336,660,0.509090909090909,0.516,129,182,0.7087912087912088
Justin Holiday,holidju01,SF,30,IND,2020,73,1826.0,603,93,32,206,238,87,46,44,137,208,486,0.4279835390946502,134,331,0.404833836858006,74,155,0.4774193548387097,0.566,53,67,0.7910447761194029
Rondae Hollis-Jefferson,holliro01,PF,25,TOR,2020,60,1122.0,418,106,110,173,283,46,23,59,115,155,329,0.4711246200607902,3,23,0.1304347826086956,152,306,0.4967320261437908,0.476,105,143,0.7342657342657343
Richaun Holmes,holmeri01,C,26,SAC,2020,44,1242.0,539,42,127,231,358,41,56,52,169,223,344,0.6482558139534884,0,0,0.0,223,344,0.6482558139534884,0.648,93,118,0.788135593220339
Rodney Hood,hoodro01,SF,27,POR,2020,21,619.0,230,32,10,62,72,17,4,19,46,87,172,0.5058139534883721,35,71,0.4929577464788732,52,101,0.5148514851485149,0.608,21,27,0.7777777777777778
Al Horford,horfoal01,C,33,PHI,2020,67,2025.0,798,270,103,353,456,52,61,80,142,319,709,0.4499294781382228,99,283,0.3498233215547703,220,426,0.5164319248826291,0.52,61,80,0.7625
Talen Horton-Tucker,hortota01,SG,19,LAL,2020,6,81.0,34,6,2,5,7,8,1,6,10,14,30,0.4666666666666667,4,13,0.3076923076923077,10,17,0.5882352941176471,0.533,2,4,0.5
Danuel House Jr.,houseda01,SF,26,HOU,2020,63,1913.0,662,85,57,210,267,67,34,54,132,230,539,0.4267161410018553,129,355,0.3633802816901408,101,184,0.5489130434782609,0.546,73,90,0.8111111111111111
Dwight Howard,howardw01,C,34,LAL,2020,69,1306.0,517,45,172,335,507,31,79,84,222,202,277,0.7292418772563177,3,5,0.6,199,272,0.7316176470588235,0.735,110,214,0.514018691588785
William Howard,howarwi01,PF,26,HOU,2020,2,13.0,0,1,0,2,2,0,0,1,1,0,4,0.0,0,4,0.0,0,0,0.0,0.0,0,0,0.0
Kevin Huerter,huertke01,SG,21,ATL,2020,56,1760.0,684,213,35,193,228,51,27,87,139,252,610,0.4131147540983607,127,334,0.3802395209580838,125,276,0.4528985507246377,0.517,53,64,0.828125
De'Andre Hunter,huntede01,SF,22,ATL,2020,63,2018.0,778,112,44,242,286,44,18,103,182,280,683,0.4099560761346998,108,304,0.3552631578947368,172,379,0.4538258575197889,0.489,110,144,0.7638888888888888
Chandler Hutchison,hutchch01,SF,23,CHI,2020,28,527.0,218,26,18,90,108,27,7,27,47,80,175,0.4571428571428571,12,38,0.3157894736842105,68,137,0.4963503649635036,0.491,46,78,0.5897435897435898
Serge Ibaka,ibakase01,C,30,TOR,2020,55,1485.0,845,77,114,338,452,28,46,109,153,343,670,0.5119402985074627,70,182,0.3846153846153846,273,488,0.5594262295081968,0.564,89,124,0.717741935483871
Andre Iguodala,iguodan01,SF,36,MIA,2020,21,418.0,96,51,17,61,78,14,21,26,35,38,88,0.4318181818181818,14,47,0.2978723404255319,24,41,0.5853658536585366,0.511,6,15,0.4
Ersan İlyasova,ilyaser01,PF,32,MIL,2020,63,986.0,414,49,62,240,302,24,17,34,95,146,313,0.4664536741214057,50,137,0.364963503649635,96,176,0.5454545454545454,0.546,72,87,0.8275862068965517
Joe Ingles,inglejo01,PF,32,UTA,2020,72,2137.0,707,373,27,251,278,65,11,142,154,246,553,0.4448462929475588,141,353,0.3994334277620396,105,200,0.525,0.572,74,94,0.7872340425531915
Brandon Ingram,ingrabr01,PF,22,NOP,2020,62,2104.0,1477,259,51,329,380,61,38,189,179,507,1096,0.4625912408759124,150,384,0.390625,357,712,0.5014044943820225,0.531,313,368,0.8505434782608695
Kyrie Irving,irvinky01,PG,27,BRK,2020,20,658.0,548,128,22,81,103,27,10,52,53,199,416,0.4783653846153846,56,142,0.3943661971830985,143,274,0.5218978102189781,0.546,94,102,0.9215686274509804
Jonathan Isaac,isaacjo01,PF,22,ORL,2020,34,980.0,404,48,58,173,231,53,78,49,83,156,332,0.4698795180722891,32,94,0.3404255319148936,124,238,0.5210084033613446,0.518,60,77,0.7792207792207793
Wes Iwundu,iwundwe01,SF,25,ORL,2020,52,953.0,300,60,24,107,131,25,13,26,80,97,233,0.4163090128755364,28,82,0.3414634146341463,69,151,0.4569536423841059,0.476,78,97,0.8041237113402062
Frank Jackson,jacksfr01,PG,21,NOP,2020,59,797.0,371,61,22,61,83,17,4,49,77,134,331,0.404833836858006,47,144,0.3263888888888889,87,187,0.46524064171123,0.476,56,75,0.7466666666666667
Jaren Jackson Jr.,jacksja02,C,20,MEM,2020,57,1622.0,990,78,55,207,262,40,92,99,232,353,753,0.4687915006640106,145,368,0.3940217391304347,208,385,0.5402597402597402,0.565,139,186,0.7473118279569892
Josh Jackson,jacksjo02,SF,22,MEM,2020,22,381.0,198,35,11,55,66,18,9,28,40,70,159,0.440251572327044,23,72,0.3194444444444444,47,87,0.5402298850574713,0.513,35,50,0.7
Justin Jackson,jacksju01,PF,24,DAL,2020,65,1045.0,360,52,27,127,154,15,10,14,69,135,341,0.3958944281524926,48,163,0.294478527607362,87,178,0.4887640449438202,0.466,42,50,0.84
Reggie Jackson,jacksre01,SG-PG,29,TOT,2020,31,743.0,370,126,17,75,92,13,5,51,59,134,326,0.4110429447852761,57,145,0.3931034482758621,77,181,0.425414364640884,0.498,45,54,0.8333333333333334
Justin James,jamesju01,SF,23,SAC,2020,36,232.0,89,18,6,26,32,6,9,8,17,35,84,0.4166666666666667,9,29,0.3103448275862069,26,55,0.4727272727272727,0.47,10,21,0.4761904761904761
LeBron James,jamesle01,PG,35,LAL,2020,67,2316.0,1698,684,66,459,525,78,36,261,118,643,1303,0.4934765924788948,148,425,0.348235294117647,495,878,0.5637813211845103,0.55,264,381,0.6929133858267716
Amile Jefferson,jeffeam01,PF,26,ORL,2020,18,74.0,15,4,10,13,23,1,3,3,7,5,14,0.3571428571428571,0,0,0.0,5,14,0.3571428571428571,0.357,5,14,0.3571428571428571
DaQuan Jeffries,jeffrda01,SG,22,SAC,2020,13,141.0,50,7,3,15,18,4,1,2,19,20,40,0.5,5,18,0.2777777777777778,15,22,0.6818181818181818,0.563,5,6,0.8333333333333334
Ty Jerome,jeromty01,SG,22,PHO,2020,31,328.0,102,44,7,39,46,15,3,18,29,38,113,0.336283185840708,14,50,0.28,24,63,0.3809523809523809,0.398,12,16,0.75
Alize Johnson,johnsal02,PF,23,IND,2020,17,118.0,34,7,16,32,48,3,2,7,12,12,29,0.4137931034482758,3,8,0.375,9,21,0.4285714285714285,0.466,7,10,0.7
B.J. Johnson,johnsbj01,SF,24,ORL,2020,10,83.0,30,3,3,12,15,3,0,6,3,9,32,0.28125,3,9,0.3333333333333333,6,23,0.2608695652173913,0.328,9,10,0.9
Cameron Johnson,johnsca02,PF,23,PHO,2020,57,1255.0,504,69,49,138,187,36,20,32,88,176,405,0.4345679012345679,106,272,0.3897058823529412,70,133,0.5263157894736842,0.565,46,57,0.8070175438596491
James Johnson,johnsja01,PF-C,32,TOT,2020,32,619.0,270,74,25,93,118,25,32,48,80,103,215,0.4790697674418605,33,91,0.3626373626373626,70,124,0.5645161290322581,0.556,31,48,0.6458333333333334
Keldon Johnson,johnske04,SF,20,SAS,2020,17,301.0,154,15,10,47,57,14,2,13,28,53,89,0.5955056179775281,13,22,0.5909090909090909,40,67,0.5970149253731343,0.669,35,44,0.7954545454545454
Stanley Johnson,johnsst04,PF,23,TOR,2020,25,150.0,60,20,7,30,37,6,4,15,16,22,59,0.3728813559322034,7,24,0.2916666666666667,15,35,0.4285714285714285,0.432,9,16,0.5625
Tyler Johnson,johnsty01,PG-SG,27,TOT,2020,39,709.0,274,74,18,58,76,16,9,29,58,97,250,0.388,38,119,0.3193277310924369,59,131,0.4503816793893129,0.464,42,50,0.84
Nikola Jokić,jokicni01,C,24,DEN,2020,73,2336.0,1456,512,166,545,711,85,44,226,222,565,1071,0.5275443510737629,80,255,0.3137254901960784,485,816,0.5943627450980392,0.565,246,301,0.8172757475083057
Damian Jones,jonesda03,C,24,ATL,2020,55,887.0,306,35,74,132,206,26,40,28,149,121,178,0.6797752808988764,2,9,0.2222222222222222,119,169,0.7041420118343196,0.685,62,84,0.7380952380952381
Derrick Jones Jr.,jonesde02,SF,22,MIA,2020,59,1375.0,500,62,66,167,233,58,38,30,130,184,349,0.5272206303724928,37,132,0.2803030303030303,147,217,0.6774193548387096,0.58,95,123,0.7723577235772358
Tyus Jones,jonesty01,PG,23,MEM,2020,65,1232.0,484,285,9,94,103,59,6,55,44,197,429,0.4592074592074592,47,124,0.3790322580645161,150,305,0.4918032786885246,0.514,43,58,0.7413793103448276
DeAndre Jordan,jordade01,C,31,BRK,2020,56,1234.0,465,105,141,420,561,18,52,74,114,191,287,0.6655052264808362,0,0,0.0,191,287,0.6655052264808362,0.666,83,122,0.680327868852459
Cory Joseph,josepco01,PG,28,SAC,2020,72,1759.0,458,251,44,144,188,53,21,80,133,171,412,0.4150485436893203,56,159,0.3522012578616352,115,253,0.4545454545454545,0.483,60,70,0.8571428571428571
Mfiondu Kabengele,kabenmf01,C,22,LAC,2020,12,64.0,42,2,1,10,11,2,2,2,9,14,32,0.4375,9,20,0.45,5,12,0.4166666666666667,0.578,5,5,1.0
Frank Kaminsky,kaminfr01,C,26,PHO,2020,39,777.0,378,75,35,141,176,14,10,37,75,138,307,0.4495114006514658,41,124,0.3306451612903225,97,183,0.5300546448087432,0.516,61,90,0.6777777777777778
Luke Kennard,kennalu01,SG,23,DET,2020,28,922.0,442,115,9,89,98,12,6,43,65,151,342,0.4415204678362573,73,183,0.3989071038251366,78,159,0.490566037735849,0.548,67,75,0.8933333333333333
Stanton Kidd,kiddst01,SG,27,UTA,2020,4,15.0,0,1,0,3,3,0,0,2,3,0,3,0.0,0,1,0.0,0,2,0.0,0.0,0,0,0.0
Michael Kidd-Gilchrist,kiddgmi01,PF,26,TOT,2020,25,281.0,60,14,14,53,67,2,6,16,37,22,66,0.3333333333333333,5,20,0.25,17,46,0.3695652173913043,0.371,11,14,0.7857142857142857
Louis King,kinglo02,SF,20,DET,2020,10,62.0,20,5,1,9,10,2,0,2,10,8,21,0.3809523809523809,4,11,0.3636363636363636,4,10,0.4,0.476,0,3,0.0
Maxi Kleber,klebima01,PF,28,DAL,2020,74,1890.0,672,88,112,276,388,25,83,58,176,237,514,0.4610894941634241,119,319,0.3730407523510972,118,195,0.6051282051282051,0.577,79,93,0.8494623655913979
Brandon Knight,knighbr03,SG-PG,28,TOT,2020,25,462.0,183,69,4,37,41,10,3,38,40,59,167,0.3532934131736527,45,131,0.3435114503816794,14,36,0.3888888888888889,0.488,20,34,0.5882352941176471
Kevin Knox,knoxke01,SF,20,NYK,2020,65,1166.0,419,61,28,156,184,23,28,45,106,144,401,0.3591022443890274,65,199,0.3266331658291457,79,202,0.3910891089108911,0.44,66,101,0.6534653465346535
John Konchar,konchjo01,SG,23,MEM,2020,19,181.0,54,22,18,29,47,7,3,7,7,24,37,0.6486486486486487,5,10,0.5,19,27,0.7037037037037037,0.716,1,2,0.5
Furkan Korkmaz,korkmfu01,SG,22,PHI,2020,72,1559.0,704,79,18,150,168,41,16,59,98,242,563,0.4298401420959147,143,356,0.4016853932584269,99,207,0.4782608695652174,0.557,77,102,0.7549019607843137
Luke Kornet,kornelu01,C,24,CHI,2020,36,559.0,215,32,22,62,84,11,26,14,54,82,187,0.4385026737967914,31,108,0.287037037037037,51,79,0.6455696202531646,0.521,20,28,0.7142857142857143
Kyle Korver,korveky01,SF,38,MIL,2020,58,960.0,386,68,15,107,122,26,12,48,78,126,293,0.4300341296928328,99,237,0.4177215189873418,27,56,0.4821428571428571,0.599,35,41,0.8536585365853658
Rodions Kurucs,kurucro01,PF,21,BRK,2020,47,684.0,215,51,25,112,137,25,5,46,90,79,177,0.4463276836158192,33,90,0.3666666666666666,46,87,0.5287356321839081,0.54,24,38,0.631578947368421
Kyle Kuzma,kuzmaky01,PF,24,LAL,2020,61,1526.0,782,80,52,221,273,28,26,91,126,291,668,0.4356287425149701,86,272,0.3161764705882353,205,396,0.5176767676767676,0.5,114,155,0.7354838709677419
Skal Labissière,labissk01,C,23,POR,2020,33,567.0,190,42,65,104,169,7,31,30,89,81,147,0.5510204081632653,3,13,0.2307692307692307,78,134,0.582089552238806,0.561,25,33,0.7575757575757576
Jeremy Lamb,lambje01,SG,27,IND,2020,46,1291.0,577,96,24,176,200,55,22,50,104,216,479,0.4509394572025052,53,158,0.3354430379746835,163,321,0.5077881619937694,0.506,92,110,0.8363636363636363
Romeo Langford,langfro01,SG,20,BOS,2020,32,370.0,79,13,15,26,41,8,8,11,33,28,80,0.35,5,27,0.1851851851851851,23,53,0.4339622641509434,0.381,18,25,0.72
Zach LaVine,lavinza01,SF,24,CHI,2020,60,2085.0,1530,254,41,248,289,88,28,206,131,539,1199,0.4495412844036697,184,484,0.3801652892561983,355,715,0.4965034965034965,0.526,268,334,0.8023952095808383
Vic Law,lawvi01,PF,24,ORL,2020,8,62.0,15,3,2,9,11,2,0,2,6,6,18,0.3333333333333333,1,7,0.1428571428571428,5,11,0.4545454545454545,0.361,2,6,0.3333333333333333
Jake Layman,laymaja01,SF,25,MIN,2020,23,505.0,210,15,17,40,57,17,10,24,47,81,179,0.4525139664804469,24,72,0.3333333333333333,57,107,0.5327102803738317,0.52,24,32,0.75
T.J. Leaf,leaftj01,PF,22,IND,2020,28,222.0,84,9,23,48,71,10,4,8,22,36,86,0.4186046511627907,5,18,0.2777777777777778,31,68,0.4558823529411764,0.448,7,16,0.4375
Jalen Lecque,lecquja01,SG,19,PHO,2020,5,32.0,10,2,0,2,2,0,0,2,3,4,10,0.4,0,4,0.0,4,6,0.6666666666666666,0.4,2,2,1.0
Courtney Lee,leeco01,SG,34,DAL,2020,24,345.0,107,12,7,25,32,18,6,11,33,40,82,0.4878048780487805,21,47,0.4468085106382978,19,35,0.5428571428571428,0.616,6,7,0.8571428571428571
Damion Lee,leeda03,SG,27,GSW,2020,49,1423.0,621,133,32,207,239,50,6,67,116,213,511,0.4168297455968688,85,239,0.3556485355648535,128,272,0.4705882352941176,0.5,110,126,0.873015873015873
Alex Len,lenal01,C,26,TOT,2020,55,970.0,438,50,100,221,321,23,48,55,127,177,319,0.554858934169279,16,59,0.2711864406779661,161,260,0.6192307692307693,0.58,68,105,0.6476190476190476
Kawhi Leonard,leonaka01,SF,28,LAC,2020,57,1848.0,1543,280,54,348,402,103,33,149,113,532,1133,0.46954986760812,123,325,0.3784615384615384,409,808,0.5061881188118812,0.524,356,402,0.8855721393034826
Meyers Leonard,leoname01,C,27,MIA,2020,51,1034.0,309,55,30,230,260,14,15,39,107,119,234,0.5085470085470085,53,128,0.4140625,66,106,0.6226415094339622,0.622,18,28,0.6428571428571429
Caris LeVert,leverca01,SG,25,BRK,2020,45,1330.0,842,199,49,140,189,53,10,118,81,311,732,0.4248633879781421,80,220,0.3636363636363636,231,512,0.451171875,0.48,140,197,0.7106598984771574
Damian Lillard,lillada01,PG,29,POR,2020,66,2474.0,1978,530,33,251,284,70,22,194,114,624,1349,0.4625648628613788,270,674,0.400593471810089,354,675,0.5244444444444445,0.563,460,518,0.888030888030888
Nassir Little,littlna01,PF,19,POR,2020,48,573.0,172,22,31,77,108,13,14,15,72,65,151,0.4304635761589404,14,59,0.2372881355932203,51,92,0.5543478260869565,0.477,28,44,0.6363636363636364
Kevon Looney,looneke01,C,23,GSW,2020,20,262.0,68,20,28,38,66,12,6,12,34,29,79,0.3670886075949367,1,14,0.0714285714285714,28,65,0.4307692307692308,0.373,9,12,0.75
Brook Lopez,lopezbr01,C,31,MIL,2020,68,1817.0,813,99,58,254,312,46,163,70,163,292,671,0.4351713859910581,102,325,0.3138461538461538,190,346,0.5491329479768786,0.511,127,152,0.8355263157894737
Robin Lopez,lopezro01,C,31,MIL,2020,66,958.0,357,45,56,105,161,10,45,63,96,147,299,0.4916387959866221,35,105,0.3333333333333333,112,194,0.5773195876288659,0.55,28,53,0.5283018867924528
Kevin Love,loveke01,PF,31,CLE,2020,56,1780.0,987,178,54,493,547,33,19,140,90,327,727,0.4497936726272352,146,390,0.3743589743589743,181,337,0.5370919881305638,0.55,187,219,0.8538812785388128
Kyle Lowry,lowryky01,PG,33,TOR,2020,58,2098.0,1126,433,32,260,292,82,26,178,190,334,803,0.4159402241594022,164,466,0.351931330472103,170,337,0.5044510385756676,0.518,294,343,0.8571428571428571
Timothé Luwawu-Cabarrot,luwawti01,SF,24,BRK,2020,47,853.0,365,29,29,98,127,18,7,37,106,117,269,0.4349442379182156,62,160,0.3875,55,109,0.5045871559633027,0.55,69,81,0.8518518518518519
Trey Lyles,lylestr01,PF,24,SAS,2020,63,1271.0,404,69,71,290,361,28,28,39,98,153,343,0.446064139941691,65,168,0.3869047619047619,88,175,0.5028571428571429,0.541,33,45,0.7333333333333333
Daryl Macon,maconda01,PG,24,MIA,2020,4,14.0,3,1,0,0,0,0,0,2,1,1,3,0.3333333333333333,1,2,0.5,0,1,0.0,0.5,0,0,0.0
J.P. Macura,macurjp01,SG,24,CLE,2020,1,1.0,0,0,0,0,0,0,0,0,0,0,0,0.0,0,0,0.0,0,0,0.0,0.0,0,0,0.0
Josh Magette,magetjo01,PG,30,ORL,2020,8,38.0,12,5,1,5,6,3,1,5,4,5,15,0.3333333333333333,1,4,0.25,4,11,0.3636363636363636,0.367,1,2,0.5
Ian Mahinmi,mahinia01,C,33,WAS,2020,38,808.0,283,49,78,140,218,31,44,45,114,104,210,0.4952380952380952,5,26,0.1923076923076923,99,184,0.5380434782608695,0.507,70,113,0.6194690265486725
Thon Maker,makerth01,C,22,DET,2020,60,776.0,281,43,54,113,167,25,39,45,102,93,193,0.4818652849740932,22,64,0.34375,71,129,0.5503875968992248,0.539,73,110,0.6636363636363637
Terance Mann,mannte01,SF,23,LAC,2020,41,362.0,99,53,10,45,55,11,5,18,46,37,79,0.4683544303797468,7,20,0.35,30,59,0.5084745762711864,0.513,18,27,0.6666666666666666
Boban Marjanović,marjabo01,C,31,DAL,2020,44,422.0,289,20,66,131,197,8,10,30,56,121,211,0.5734597156398105,4,17,0.2352941176470588,117,194,0.6030927835051546,0.583,43,57,0.7543859649122807
Lauri Markkanen,markkla01,PF,22,CHI,2020,50,1492.0,737,74,60,253,313,42,23,81,96,251,591,0.4247038917089678,109,317,0.3438485804416404,142,274,0.5182481751824818,0.517,126,153,0.8235294117647058
Caleb Martin,martica02,SF,24,CHO,2020,18,317.0,111,23,10,28,38,12,7,15,32,37,84,0.4404761904761904,20,37,0.5405405405405406,17,47,0.3617021276595745,0.56,17,21,0.8095238095238095
Cody Martin,martico01,SF,24,CHO,2020,48,903.0,238,95,38,120,158,39,9,44,78,89,207,0.429951690821256,18,77,0.2337662337662337,71,130,0.5461538461538461,0.473,42,65,0.6461538461538462
Jeremiah Martin,martije02,PG,23,BRK,2020,9,99.0,64,18,1,9,10,7,2,4,7,24,53,0.4528301886792453,5,18,0.2777777777777778,19,35,0.5428571428571428,0.5,11,14,0.7857142857142857
Kelan Martin,martike03,SF,24,MIN,2020,31,495.0,197,23,12,84,96,7,9,20,51,71,181,0.3922651933701657,25,96,0.2604166666666667,46,85,0.5411764705882353,0.461,30,31,0.967741935483871
Frank Mason III,masonfr01,PG,25,MIL,2020,9,118.0,62,29,5,14,19,5,1,11,11,23,51,0.4509803921568627,6,21,0.2857142857142857,17,30,0.5666666666666667,0.51,10,17,0.5882352941176471
Garrison Mathews,mathega01,SG,23,WAS,2020,18,227.0,98,10,6,18,24,8,1,8,32,24,56,0.4285714285714285,19,46,0.4130434782608695,5,10,0.5,0.598,31,34,0.9117647058823528
Wesley Matthews,matthwe02,SG,33,MIL,2020,67,1635.0,494,92,22,144,166,38,9,43,103,167,422,0.3957345971563981,108,297,0.3636363636363636,59,125,0.472,0.524,52,68,0.7647058823529411
Luc Mbah a Moute,mbahalu01,PF,33,HOU,2020,3,25.0,5,0,1,1,2,2,0,1,0,2,5,0.4,0,2,0.0,2,3,0.6666666666666666,0.4,1,2,0.5
Patrick McCaw,mccawpa01,SF,24,TOR,2020,37,908.0,170,79,19,67,86,39,4,29,60,67,162,0.4135802469135802,23,71,0.323943661971831,44,91,0.4835164835164835,0.485,13,18,0.7222222222222222
CJ McCollum,mccolcj01,SG,28,POR,2020,70,2556.0,1556,310,46,251,297,54,42,127,183,611,1356,0.4505899705014749,194,512,0.37890625,417,844,0.4940758293838863,0.522,140,185,0.7567567567567568
T.J. McConnell,mccontj01,PG,27,IND,2020,71,1326.0,464,355,38,151,189,56,11,100,73,212,411,0.5158150851581509,5,17,0.2941176470588235,207,394,0.5253807106598984,0.522,35,42,0.8333333333333334
Jalen McDaniels,mcdanja01,SF,22,CHO,2020,16,293.0,89,13,15,50,65,8,3,11,36,33,70,0.4714285714285714,9,24,0.375,24,46,0.5217391304347826,0.536,14,17,0.8235294117647058
Doug McDermott,mcderdo01,PF,28,IND,2020,69,1372.0,710,78,26,148,174,12,5,42,117,267,547,0.4881170018281535,128,294,0.4353741496598639,139,253,0.549407114624506,0.605,48,58,0.8275862068965517
JaVale McGee,mcgeeja01,C,32,LAL,2020,68,1130.0,446,37,125,265,390,36,94,55,159,195,306,0.6372549019607843,3,6,0.5,192,300,0.64,0.642,53,82,0.6463414634146342
Rodney McGruder,mcgruro01,SG,28,LAC,2020,56,871.0,187,36,29,122,151,26,8,24,74,72,181,0.3977900552486187,24,89,0.2696629213483146,48,92,0.5217391304347826,0.464,19,34,0.5588235294117647
Alfonzo McKinnie,mckinal01,SF,27,CLE,2020,40,593.0,182,14,37,76,113,23,8,26,72,73,171,0.4269005847953216,14,65,0.2153846153846154,59,106,0.5566037735849056,0.468,22,31,0.7096774193548387
Jordan McLaughlin,mclaujo01,PG,23,MIN,2020,30,590.0,229,125,7,42,49,34,4,31,31,87,178,0.4887640449438202,29,76,0.3815789473684211,58,102,0.5686274509803921,0.57,26,39,0.6666666666666666
Ben McLemore,mclembe01,SF,26,HOU,2020,71,1619.0,715,58,21,136,157,45,16,50,155,242,545,0.4440366972477064,181,452,0.4004424778761062,61,93,0.6559139784946236,0.61,50,67,0.746268656716418
Jordan McRae,mcraejo01,SG,28,TOT,2020,37,784.0,426,93,18,106,124,21,16,43,73,149,366,0.407103825136612,45,126,0.3571428571428571,104,240,0.4333333333333333,0.469,83,109,0.7614678899082569
Nicolò Melli,mellini01,C,29,NOP,2020,60,1042.0,395,82,38,142,180,34,23,46,124,136,323,0.4210526315789473,69,206,0.3349514563106796,67,117,0.5726495726495726,0.528,54,73,0.7397260273972602
De'Anthony Melton,meltode01,PG,21,MEM,2020,60,1167.0,455,175,43,177,220,77,20,84,109,161,401,0.4014962593516209,40,140,0.2857142857142857,121,261,0.4636015325670498,0.451,93,121,0.768595041322314
Chimezie Metu,metuch01,C,22,SAS,2020,18,105.0,58,10,12,21,33,3,6,10,7,24,42,0.5714285714285714,0,2,0.0,24,40,0.6,0.571,10,13,0.7692307692307693
Khris Middleton,middlkh01,SF,28,MIL,2020,62,1853.0,1297,265,44,338,382,53,7,137,142,471,947,0.4973600844772967,147,354,0.4152542372881356,324,593,0.5463743676222597,0.575,208,227,0.9162995594713657
Eric Mika,mikaer01,C,25,SAC,2020,1,19.0,6,0,2,5,7,0,0,0,5,2,3,0.6666666666666666,0,0,0.0,2,3,0.6666666666666666,0.667,2,2,1.0
C.J. Miles,milescj01,SF,32,WAS,2020,10,161.0,64,12,4,8,12,10,4,4,14,19,59,0.3220338983050847,11,35,0.3142857142857143,8,24,0.3333333333333333,0.415,15,20,0.75
Malcolm Miller,millema01,SF,26,TOR,2020,28,162.0,35,11,2,14,16,5,2,4,18,12,29,0.4137931034482758,8,22,0.3636363636363636,4,7,0.5714285714285714,0.552,3,8,0.375
Patty Mills,millspa02,PG,31,SAS,2020,66,1485.0,767,118,22,86,108,53,6,54,105,258,598,0.431438127090301,154,403,0.3821339950372208,104,195,0.5333333333333333,0.56,97,112,0.8660714285714286
Paul Millsap,millspa01,PF,34,DEN,2020,51,1240.0,591,83,98,195,293,44,30,70,150,211,438,0.4817351598173516,54,124,0.4354838709677419,157,314,0.5,0.543,115,141,0.8156028368794326
Shake Milton,miltosh01,SG,23,PHI,2020,40,805.0,377,104,15,73,88,20,7,47,92,134,277,0.483754512635379,58,135,0.4296296296296296,76,142,0.5352112676056338,0.588,51,65,0.7846153846153846
Donovan Mitchell,mitchdo01,SG,23,UTA,2020,69,2364.0,1655,294,53,251,304,70,14,184,172,602,1342,0.4485842026825633,173,473,0.3657505285412262,429,869,0.4936708860759494,0.513,278,322,0.8633540372670807
Naz Mitrou-Long,mitrona01,SG,26,IND,2020,5,47.0,14,8,0,7,7,1,1,3,2,6,17,0.3529411764705882,2,12,0.1666666666666666,4,5,0.8,0.412,0,0,0.0
Adam Mokoka,mokokad01,SF,21,CHI,2020,11,112.0,32,4,7,3,10,4,0,2,17,12,28,0.4285714285714285,6,15,0.4,6,13,0.4615384615384615,0.536,2,4,0.5
Malik Monk,monkma01,SG,21,CHO,2020,55,1169.0,564,114,27,130,157,25,16,77,74,212,488,0.4344262295081967,58,204,0.284313725490196,154,284,0.5422535211267606,0.494,82,100,0.82
Matt Mooney,moonema01,SG,22,CLE,2020,4,19.0,2,1,0,3,3,2,1,0,1,1,4,0.25,0,2,0.0,1,2,0.5,0.25,0,0,0.0
E'Twaun Moore,mooreet01,SG,30,NOP,2020,56,1020.0,466,78,31,100,131,32,11,40,80,186,437,0.425629290617849,63,167,0.3772455089820359,123,270,0.4555555555555555,0.498,31,45,0.6888888888888889
Ja Morant,moranja01,PG,20,MEM,2020,67,2074.0,1193,488,51,208,259,58,18,220,110,447,937,0.4770544290288153,60,179,0.3351955307262569,387,758,0.5105540897097626,0.509,239,308,0.775974025974026
Juwan Morgan,morgaju01,PF,22,UTA,2020,21,134.0,36,6,10,19,29,1,2,6,19,15,26,0.5769230769230769,3,8,0.375,12,18,0.6666666666666666,0.635,3,4,0.75
Marcus Morris,morrima03,SF-PF,30,TOT,2020,62,1936.0,1033,86,59,252,311,47,30,97,180,355,810,0.4382716049382716,142,348,0.4080459770114942,213,462,0.461038961038961,0.526,181,220,0.8227272727272728
Markieff Morris,morrima02,PF,30,TOT,2020,58,1187.0,560,77,40,178,218,31,17,76,133,203,458,0.4432314410480349,88,228,0.3859649122807017,115,230,0.5,0.539,66,85,0.7764705882352941
Monte Morris,morrimo01,PG,24,DEN,2020,73,1636.0,660,255,24,113,137,55,17,53,73,260,566,0.4593639575971731,65,172,0.377906976744186,195,394,0.4949238578680203,0.517,75,89,0.8426966292134831
Johnathan Motley,motlejo01,PF,24,LAC,2020,13,41.0,28,8,3,7,10,3,0,5,6,11,15,0.7333333333333333,1,1,1.0,10,14,0.7142857142857143,0.767,5,7,0.7142857142857143
Emmanuel Mudiay,mudiaem01,PG,23,UTA,2020,54,850.0,395,116,18,108,126,24,10,76,72,151,327,0.4617737003058104,30,87,0.3448275862068966,121,240,0.5041666666666667,0.508,63,83,0.7590361445783133
Mychal Mulder,muldemy01,SF,25,GSW,2020,7,204.0,77,8,3,20,23,2,1,5,20,26,67,0.3880597014925373,16,52,0.3076923076923077,10,15,0.6666666666666666,0.507,9,12,0.75
Dejounte Murray,murrade01,PG,23,SAS,2020,66,1687.0,720,271,69,314,383,111,17,125,143,294,637,0.4615384615384615,41,111,0.3693693693693693,253,526,0.4809885931558935,0.494,91,114,0.7982456140350878
Jamal Murray,murraja01,PG,22,DEN,2020,59,1904.0,1091,284,45,191,236,67,17,127,102,408,894,0.4563758389261745,112,324,0.345679012345679,296,570,0.519298245614035,0.519,163,185,0.8810810810810811
Džanan Musa,musadz01,SF,20,BRK,2020,40,487.0,192,43,21,65,86,15,1,36,30,64,172,0.3720930232558139,19,78,0.2435897435897435,45,94,0.4787234042553192,0.427,45,60,0.75
Mike Muscala,muscami01,C,28,OKC,2020,47,572.0,226,40,16,92,108,9,12,17,58,77,189,0.4074074074074074,54,143,0.3776223776223776,23,46,0.5,0.55,18,22,0.8181818181818182
Svi Mykhailiuk,mykhasv01,SF,22,DET,2020,56,1265.0,504,106,17,87,104,41,4,61,87,166,405,0.4098765432098765,115,285,0.4035087719298245,51,120,0.425,0.552,57,70,0.8142857142857143
Abdel Nader,naderab01,SF,26,OKC,2020,55,867.0,345,38,14,86,100,23,20,43,78,123,263,0.467680608365019,48,128,0.375,75,135,0.5555555555555556,0.559,51,66,0.7727272727272727
Larry Nance Jr.,nancela02,PF,27,CLE,2020,56,1472.0,564,123,106,303,409,56,22,60,91,229,431,0.531322505800464,56,159,0.3522012578616352,173,272,0.6360294117647058,0.596,50,74,0.6756756756756757
Shabazz Napier,napiesh01,PG,28,TOT,2020,56,1344.0,578,262,26,132,158,69,11,128,101,188,456,0.4122807017543859,76,240,0.3166666666666666,112,216,0.5185185185185185,0.496,126,153,0.8235294117647058
Raul Neto,netora01,PG,27,PHI,2020,54,668.0,275,95,11,50,61,24,6,47,50,101,222,0.4549549549549549,34,88,0.3863636363636363,67,134,0.5,0.532,39,47,0.8297872340425532
Malik Newman,newmama01,SG,22,CLE,2020,1,4.0,2,0,0,0,0,0,0,1,0,0,2,0.0,0,1,0.0,0,1,0.0,0.0,2,2,1.0
Georges Niang,niangge01,PF,26,UTA,2020,66,923.0,392,44,15,112,127,18,5,30,75,141,322,0.4378881987577639,90,225,0.4,51,97,0.5257731958762887,0.578,20,24,0.8333333333333334
Joakim Noah,noahjo01,C,34,LAC,2020,5,50.0,14,7,5,11,16,1,1,6,9,4,8,0.5,0,0,0.0,4,8,0.5,0.5,6,8,0.75
Nerlens Noel,noelne01,C,25,OKC,2020,61,1127.0,449,57,91,209,300,59,91,66,166,184,269,0.6840148698884758,1,3,0.3333333333333333,183,266,0.6879699248120301,0.686,80,106,0.7547169811320755
Zach Norvell,norveza01,SG,22,TOT,2020,5,41.0,10,3,0,6,6,2,0,3,4,3,12,0.25,3,8,0.375,0,4,0.0,0.375,1,1,1.0
Jaylen Nowell,nowelja01,SG,20,MIN,2020,15,151.0,57,19,3,10,13,3,1,3,11,19,53,0.3584905660377358,3,26,0.1153846153846153,16,27,0.5925925925925926,0.387,16,17,0.9411764705882352
Frank Ntilikina,ntilila01,PG,21,NYK,2020,57,1187.0,357,172,23,98,121,54,16,71,142,131,333,0.3933933933933934,44,137,0.3211678832116788,87,196,0.4438775510204081,0.459,51,59,0.864406779661017
Kendrick Nunn,nunnke01,PG,24,MIA,2020,67,1962.0,1024,220,21,159,180,56,15,114,152,401,914,0.4387308533916849,137,391,0.3503836317135549,264,523,0.5047801147227533,0.514,85,100,0.85
Jusuf Nurkić,nurkiju01,C,25,POR,2020,8,253.0,141,32,23,59,82,11,16,19,39,54,109,0.4954128440366973,2,10,0.2,52,99,0.5252525252525253,0.505,31,35,0.8857142857142857
David Nwaba,nwabada01,SF,27,BRK,2020,20,268.0,104,8,8,37,45,11,12,8,32,37,71,0.5211267605633803,12,28,0.4285714285714285,25,43,0.5813953488372093,0.606,18,27,0.6666666666666666
Royce O'Neale,onealro01,SF,26,UTA,2020,71,2049.0,450,180,27,362,389,59,32,61,202,158,365,0.4328767123287671,92,244,0.3770491803278688,66,121,0.5454545454545454,0.559,42,55,0.7636363636363637
Kyle O'Quinn,oquinky01,C,29,PHI,2020,29,313.0,102,51,34,82,116,7,24,20,37,42,85,0.4941176470588235,7,27,0.2592592592592592,35,58,0.603448275862069,0.535,11,20,0.55
Semi Ojeleye,ojelese01,PF,25,BOS,2020,69,1011.0,236,37,26,119,145,21,5,19,80,80,196,0.4081632653061224,48,127,0.3779527559055118,32,69,0.463768115942029,0.531,28,32,0.875
Jahlil Okafor,okafoja01,C,24,NOP,2020,30,467.0,243,37,48,79,127,7,22,38,67,101,162,0.6234567901234568,1,3,0.3333333333333333,100,159,0.6289308176100629,0.627,40,62,0.6451612903225806
Elie Okobo,okoboel01,PG,22,PHO,2020,55,719.0,219,115,16,74,90,24,4,38,54,72,181,0.3977900552486187,25,71,0.352112676056338,47,110,0.4272727272727272,0.467,50,71,0.704225352112676
Josh Okogie,okogijo01,SG,21,MIN,2020,62,1547.0,533,99,87,181,268,68,26,87,139,170,398,0.4271356783919598,41,154,0.2662337662337662,129,244,0.5286885245901639,0.479,152,191,0.7958115183246073
KZ Okpala,okpalkz01,PF,20,MIA,2020,5,26.0,7,1,1,4,5,2,1,1,2,3,5,0.6,0,1,0.0,3,4,0.75,0.6,1,2,0.5
Victor Oladipo,oladivi01,SG,27,IND,2020,19,528.0,275,56,9,66,75,17,4,47,36,97,246,0.3943089430894309,33,104,0.3173076923076923,64,142,0.4507042253521127,0.461,48,59,0.8135593220338984
Kelly Olynyk,olynyke01,C,28,MIA,2020,67,1300.0,549,116,44,261,305,45,23,71,173,184,398,0.4623115577889447,95,234,0.405982905982906,89,164,0.5426829268292683,0.582,86,100,0.86
Miye Oni,onimi01,SF,22,UTA,2020,10,109.0,35,4,5,12,17,4,2,4,9,12,32,0.375,7,19,0.3684210526315789,5,13,0.3846153846153846,0.484,4,5,0.8
Cedi Osman,osmande01,SF,24,CLE,2020,65,1910.0,718,154,39,192,231,54,16,91,160,266,609,0.4367816091954023,123,321,0.3831775700934579,143,288,0.4965277777777778,0.538,63,94,0.6702127659574468
Kelly Oubre Jr.,oubreke01,SF,24,PHO,2020,56,1933.0,1046,85,67,294,361,71,40,83,192,373,826,0.4515738498789346,108,307,0.3517915309446254,265,519,0.5105973025048169,0.517,192,246,0.7804878048780488
Tariq Owens,owensta01,PF,24,PHO,2020,3,15.0,4,0,2,1,3,1,0,0,1,1,5,0.2,0,2,0.0,1,3,0.3333333333333333,0.2,2,2,1.0
Jeremy Pargo,pargoje01,PG,33,GSW,2020,3,44.0,25,8,1,2,3,1,0,4,8,11,22,0.5,3,7,0.4285714285714285,8,15,0.5333333333333333,0.568,0,1,0.0
Jabari Parker,parkeja01,PF,24,TOT,2020,38,917.0,531,68,61,153,214,45,16,64,99,219,429,0.5104895104895105,32,119,0.2689075630252101,187,310,0.603225806451613,0.548,61,81,0.7530864197530864
Chandler Parsons,parsoch01,PF,31,ATL,2020,5,54.0,14,3,1,6,7,4,1,3,3,5,18,0.2777777777777778,4,14,0.2857142857142857,1,4,0.25,0.389,0,0,0.0
Eric Paschall,pascher01,PF,23,GSW,2020,60,1654.0,837,127,82,193,275,32,13,94,125,318,640,0.496875,37,129,0.2868217054263566,281,511,0.5499021526418787,0.526,164,212,0.7735849056603774
Anžejs Pasečņiks,pasecan01,C,24,WAS,2020,27,437.0,156,18,42,65,107,9,12,24,75,61,116,0.5258620689655172,0,3,0.0,61,113,0.5398230088495575,0.526,34,58,0.5862068965517241
Patrick Patterson,pattepa01,PF,30,LAC,2020,59,776.0,292,41,35,116,151,7,3,21,54,95,233,0.407725321888412,67,172,0.3895348837209302,28,61,0.4590163934426229,0.552,35,43,0.813953488372093
Justin Patton,pattoju01,C,22,OKC,2020,5,24.0,9,2,1,4,5,0,0,2,4,4,10,0.4,1,4,0.25,3,6,0.5,0.45,0,0,0.0
Chris Paul,paulch01,PG,34,OKC,2020,70,2208.0,1232,472,26,323,349,111,11,161,158,434,887,0.4892897406989853,111,304,0.3651315789473684,323,583,0.5540308747855918,0.552,253,279,0.906810035842294
Cameron Payne,payneca01,SG,25,PHO,2020,8,183.0,87,24,4,27,31,8,2,11,20,33,68,0.4852941176470588,15,29,0.5172413793103449,18,39,0.4615384615384615,0.596,6,7,0.8571428571428571
Elfrid Payton,paytoel01,PG,25,NYK,2020,45,1246.0,449,323,52,160,212,70,17,96,89,193,440,0.4386363636363636,14,69,0.2028985507246377,179,371,0.4824797843665768,0.455,49,86,0.5697674418604651
Gary Payton II,paytoga02,SF,27,WAS,2020,29,432.0,113,48,26,54,80,33,7,20,54,48,116,0.4137931034482758,13,46,0.2826086956521739,35,70,0.5,0.47,4,8,0.5
Norvel Pelle,pelleno01,C,26,PHI,2020,24,232.0,57,8,20,52,72,3,31,18,55,25,48,0.5208333333333334,0,1,0.0,25,47,0.5319148936170213,0.521,7,14,0.5
Theo Pinson,pinsoth01,SG,24,BRK,2020,33,365.0,120,56,10,44,54,17,4,33,35,45,155,0.2903225806451613,15,80,0.1875,30,75,0.4,0.339,15,16,0.9375
Mason Plumlee,plumlma01,C,29,DEN,2020,61,1057.0,437,154,98,219,317,33,38,82,143,177,288,0.6145833333333334,0,5,0.0,177,283,0.6254416961130742,0.615,83,155,0.535483870967742
Jakob Poeltl,poeltja01,C,24,SAS,2020,66,1171.0,372,116,131,244,375,37,95,54,126,166,266,0.6240601503759399,0,0,0.0,166,266,0.6240601503759399,0.624,40,86,0.4651162790697674
Vincent Poirier,poirivi01,C,26,BOS,2020,22,130.0,41,8,13,30,43,2,9,8,25,17,36,0.4722222222222222,1,2,0.5,16,34,0.4705882352941176,0.486,6,7,0.8571428571428571
Shamorie Ponds,pondssh01,PG,21,TOR,2020,4,11.0,9,2,0,1,1,0,1,0,2,3,5,0.6,1,2,0.5,2,3,0.6666666666666666,0.7,2,2,1.0
Jordan Poole,poolejo01,SG,20,GSW,2020,57,1274.0,503,134,9,109,118,35,10,74,94,167,502,0.3326693227091633,74,265,0.2792452830188679,93,237,0.3924050632911392,0.406,95,119,0.7983193277310925
Kevin Porter Jr.,porteke02,SF,19,CLE,2020,50,1162.0,498,109,22,140,162,46,14,93,135,186,421,0.4418052256532066,53,158,0.3354430379746835,133,263,0.5057034220532319,0.505,73,101,0.7227722772277227
Michael Porter Jr.,portemi01,SF,21,DEN,2020,55,903.0,512,46,66,193,259,27,25,49,100,195,383,0.5091383812010444,62,147,0.4217687074829932,133,236,0.5635593220338984,0.59,60,72,0.8333333333333334
Otto Porter Jr.,porteot01,SF,26,CHI,2020,14,331.0,167,25,13,35,48,15,6,11,31,62,140,0.4428571428571428,24,62,0.3870967741935484,38,78,0.4871794871794871,0.529,19,27,0.7037037037037037
Bobby Portis,portibo01,PF,24,NYK,2020,66,1393.0,668,98,80,258,338,32,18,73,110,265,589,0.4499151103565365,67,187,0.3582887700534759,198,402,0.4925373134328358,0.507,71,93,0.7634408602150538
Kristaps Porziņģis,porzikr01,C,24,DAL,2020,57,1814.0,1164,102,100,440,540,41,115,92,185,398,932,0.4270386266094421,142,403,0.3523573200992556,256,529,0.4839319470699433,0.503,226,283,0.7985865724381626
Dwight Powell,poweldw01,C,28,DAL,2020,40,1061.0,376,59,75,152,227,34,22,36,102,146,229,0.6375545851528385,10,39,0.2564102564102564,136,190,0.7157894736842105,0.659,74,111,0.6666666666666666
Norman Powell,powelno01,SG,26,TOR,2020,52,1479.0,830,91,26,164,190,60,21,77,108,296,598,0.4949832775919732,109,273,0.3992673992673993,187,325,0.5753846153846154,0.586,129,153,0.8431372549019608
Taurean Prince,princta02,PF,25,BRK,2020,64,1857.0,773,116,50,331,381,57,25,127,159,278,739,0.3761840324763194,146,431,0.3387470997679814,132,308,0.4285714285714285,0.475,71,89,0.797752808988764
Chasson Randle,randlch01,PG,26,GSW,2020,3,40.0,5,5,0,2,2,2,0,0,3,0,4,0.0,0,2,0.0,0,2,0.0,0.0,5,6,0.8333333333333334
Julius Randle,randlju01,PF,25,NYK,2020,64,2080.0,1248,198,151,471,622,51,22,193,178,463,1006,0.4602385685884692,64,231,0.277056277056277,399,775,0.5148387096774194,0.492,258,352,0.7329545454545454
Josh Reaves,reavejo02,SF,22,DAL,2020,4,28.0,8,3,1,2,3,0,0,0,5,3,9,0.3333333333333333,0,2,0.0,3,7,0.4285714285714285,0.333,2,2,1.0
Cam Reddish,reddica01,SF,20,ATL,2020,58,1551.0,610,87,35,181,216,62,28,96,132,213,554,0.3844765342960289,83,250,0.332,130,304,0.4276315789473684,0.459,101,126,0.8015873015873016
J.J. Redick,redicjj01,SG,35,NOP,2020,60,1581.0,917,119,10,141,151,20,10,75,96,286,631,0.4532488114104596,180,397,0.4534005037783375,106,234,0.452991452991453,0.596,165,185,0.8918918918918919
Naz Reid,reidna01,C,20,MIN,2020,30,495.0,269,35,34,90,124,19,22,22,83,100,243,0.411522633744856,32,97,0.3298969072164948,68,146,0.4657534246575342,0.477,37,53,0.6981132075471698
Josh Richardson,richajo01,SG,26,PHI,2020,55,1693.0,755,162,41,133,174,52,36,104,136,278,646,0.4303405572755417,85,249,0.3413654618473896,193,397,0.4861460957178841,0.496,114,141,0.8085106382978723
Austin Rivers,riverau01,SG,27,HOU,2020,68,1594.0,596,113,27,148,175,49,10,50,129,211,501,0.4211576846307385,96,270,0.3555555555555555,115,231,0.4978354978354978,0.517,78,111,0.7027027027027027
Andre Roberson,roberan03,SF,28,OKC,2020,7,87.0,20,4,7,20,27,1,3,2,13,8,29,0.2758620689655172,3,14,0.2142857142857142,5,15,0.3333333333333333,0.328,1,2,0.5
Duncan Robinson,robindu01,SG,25,MIA,2020,73,2166.0,983,102,10,222,232,35,19,70,193,323,687,0.470160116448326,270,606,0.4455445544554455,53,81,0.654320987654321,0.667,67,72,0.9305555555555556
Glenn Robinson III,robingl02,SF,26,TOT,2020,62,1786.0,727,96,81,189,270,54,16,55,100,288,592,0.4864864864864865,77,197,0.3908629441624365,211,395,0.5341772151898734,0.552,74,86,0.8604651162790697
Jerome Robinson,robinje01,SG,22,TOT,2020,63,979.0,319,87,13,116,129,28,17,49,112,115,310,0.3709677419354839,49,153,0.3202614379084967,66,157,0.4203821656050955,0.45,40,57,0.7017543859649122
Justin Robinson,robinju01,PG,22,WAS,2020,9,49.0,13,7,1,4,5,0,1,3,2,5,12,0.4166666666666667,3,5,0.6,2,7,0.2857142857142857,0.542,0,0,0.0
Mitchell Robinson,robinmi01,C,21,NYK,2020,61,1412.0,590,36,186,242,428,52,119,37,194,253,341,0.7419354838709677,0,0,0.0,253,341,0.7419354838709677,0.742,84,148,0.5675675675675675
Isaiah Roby,robyis01,PF,21,OKC,2020,3,11.0,0,0,0,2,2,0,0,1,1,0,1,0.0,0,0,0.0,0,1,0.0,0.0,0,0,0.0
Rajon Rondo,rondora01,PG,33,LAL,2020,48,984.0,342,240,23,119,142,40,2,91,58,137,328,0.4176829268292683,41,125,0.328,96,203,0.4729064039408867,0.48,27,41,0.6585365853658537
Derrick Rose,rosede01,PG,31,DET,2020,50,1298.0,904,278,27,94,121,40,16,126,49,369,753,0.4900398406374502,45,147,0.3061224489795918,324,606,0.5346534653465347,0.52,121,139,0.8705035971223022
Terrence Ross,rosste01,SG,28,ORL,2020,69,1889.0,1016,82,13,209,222,77,24,70,109,341,846,0.4030732860520095,177,504,0.3511904761904761,164,342,0.47953216374269,0.508,157,184,0.8532608695652174
Terry Rozier,roziete01,PG,25,CHO,2020,63,2164.0,1134,259,50,226,276,61,10,141,126,398,941,0.4229543039319872,172,423,0.4066193853427896,226,518,0.4362934362934363,0.514,166,190,0.8736842105263158
Ricky Rubio,rubiori01,PG,29,PHO,2020,65,2016.0,847,570,46,258,304,94,11,173,167,287,692,0.4147398843930636,78,216,0.3611111111111111,209,476,0.4390756302521008,0.471,195,226,0.8628318584070797
D'Angelo Russell,russeda01,PG,23,TOT,2020,45,1452.0,1039,285,17,160,177,48,13,147,86,360,846,0.425531914893617,158,431,0.3665893271461717,202,415,0.4867469879518072,0.519,161,199,0.8090452261306532
Domantas Sabonis,sabondo01,PF,23,IND,2020,62,2159.0,1147,310,189,582,771,47,30,170,195,458,848,0.5400943396226415,17,67,0.2537313432835821,441,781,0.5646606914212549,0.55,214,296,0.722972972972973
Luka Šamanić,samanlu01,PF,20,SAS,2020,3,48.0,16,6,1,9,10,0,2,2,6,5,16,0.3125,3,8,0.375,2,8,0.25,0.406,3,4,0.75
JaKarr Sampson,sampsja02,PF,26,IND,2020,34,471.0,156,21,20,68,88,16,12,15,64,68,115,0.591304347826087,2,13,0.1538461538461538,66,102,0.6470588235294118,0.6,18,27,0.6666666666666666
Dario Šarić,saricda01,PF,25,PHO,2020,66,1632.0,704,123,100,306,406,37,16,88,156,256,538,0.4758364312267658,84,235,0.3574468085106383,172,303,0.5676567656765676,0.554,108,128,0.84375
Tomáš Satoranský,satorto01,SG,28,CHI,2020,65,1878.0,644,354,76,178,254,80,7,130,135,237,551,0.4301270417422868,64,199,0.321608040201005,173,352,0.4914772727272727,0.488,106,121,0.8760330578512396
Admiral Schofield,schofad01,PF,22,WAS,2020,33,368.0,99,15,7,40,47,8,4,7,50,35,92,0.3804347826086957,19,61,0.3114754098360656,16,31,0.5161290322580645,0.484,10,15,0.6666666666666666
Dennis Schröder,schrode01,PG,26,OKC,2020,65,1999.0,1229,262,19,217,236,45,14,166,146,453,965,0.4694300518134715,125,325,0.3846153846153846,328,640,0.5125,0.534,198,236,0.8389830508474576
Mike Scott,scottmi01,PF,31,PHI,2020,68,1207.0,408,56,65,183,248,21,5,26,96,149,350,0.4257142857142857,80,217,0.3686635944700461,69,133,0.518796992481203,0.54,30,37,0.8108108108108109
Thabo Sefolosha,sefolth01,PF,35,HOU,2020,41,436.0,92,25,21,72,93,24,12,15,43,37,91,0.4065934065934066,15,54,0.2777777777777778,22,37,0.5945945945945946,0.489,3,8,0.375
Collin Sexton,sextoco01,PG,21,CLE,2020,65,2143.0,1349,192,61,143,204,65,7,158,142,513,1086,0.4723756906077348,97,255,0.3803921568627451,416,831,0.5006016847172082,0.517,226,267,0.846441947565543
Landry Shamet,shamela01,SG,22,LAC,2020,53,1452.0,492,99,6,94,100,20,10,42,142,158,391,0.4040920716112532,111,296,0.375,47,95,0.4947368421052631,0.546,65,76,0.8552631578947368
Marial Shayok,shayoma01,SG,24,PHI,2020,4,28.0,11,1,1,6,7,0,1,3,4,3,12,0.25,2,6,0.3333333333333333,1,6,0.1666666666666666,0.333,3,4,0.75
Iman Shumpert,shumpim01,SF,29,BRK,2020,13,241.0,54,12,9,25,34,12,2,10,21,21,64,0.328125,8,33,0.2424242424242424,13,31,0.4193548387096774,0.391,4,7,0.5714285714285714
Pascal Siakam,siakapa01,PF,25,TOR,2020,60,2110.0,1371,207,64,375,439,61,53,148,170,500,1104,0.4528985507246377,131,365,0.3589041095890411,369,739,0.4993234100135318,0.512,240,303,0.7920792079207921
Chris Silva,silvach01,PF,23,MIA,2020,44,346.0,133,23,60,66,126,9,21,32,85,48,78,0.6153846153846154,0,3,0.0,48,75,0.64,0.615,37,55,0.6727272727272727
Ben Simmons,simmobe01,PG,23,PHI,2020,57,2017.0,937,455,113,331,444,119,33,200,186,375,647,0.5795981452859351,2,7,0.2857142857142857,373,640,0.5828125,0.581,185,298,0.6208053691275168
Anfernee Simons,simonan01,SG,20,POR,2020,70,1449.0,579,97,25,127,152,26,10,61,135,214,536,0.3992537313432835,75,226,0.331858407079646,139,310,0.4483870967741935,0.469,76,92,0.8260869565217391
Alen Smailagić,smailal01,C,19,GSW,2020,14,139.0,59,13,10,17,27,3,4,11,14,20,40,0.5,3,13,0.2307692307692307,17,27,0.6296296296296297,0.538,16,19,0.8421052631578947
Marcus Smart,smartma01,SG,25,BOS,2020,60,1919.0,776,291,42,183,225,101,29,103,162,256,682,0.375366568914956,137,395,0.3468354430379747,119,287,0.4146341463414634,0.476,127,152,0.8355263157894737
Dennis Smith Jr.,smithde03,PG,22,NYK,2020,34,537.0,187,98,21,57,78,28,8,58,65,72,211,0.3412322274881517,16,54,0.2962962962962963,56,157,0.3566878980891719,0.379,27,53,0.5094339622641509
Ish Smith,smithis01,PG,31,WAS,2020,68,1787.0,740,334,30,189,219,59,30,95,106,308,689,0.4470246734397677,62,169,0.3668639053254438,246,520,0.473076923076923,0.492,62,86,0.7209302325581395
J.R. Smith,smithjr01,SG,34,LAL,2020,6,79.0,17,3,0,5,5,1,0,4,5,7,22,0.3181818181818182,1,11,0.0909090909090909,6,11,0.5454545454545454,0.341,2,2,1.0
Zhaire Smith,smithzh01,SF,20,PHI,2020,7,32.0,8,2,0,2,2,3,0,2,4,3,11,0.2727272727272727,0,3,0.0,3,8,0.375,0.273,2,4,0.5
Tony Snell,snellto01,SF,28,DET,2020,59,1641.0,474,127,9,102,111,32,15,31,101,170,382,0.4450261780104712,102,254,0.4015748031496063,68,128,0.53125,0.579,32,32,1.0
Omari Spellman,spellom01,C,22,GSW,2020,49,886.0,370,47,77,142,219,33,24,54,63,127,295,0.4305084745762711,43,110,0.3909090909090909,84,185,0.4540540540540541,0.503,73,92,0.7934782608695652
Max Strus,strusma01,SF,23,CHI,2020,2,6.0,5,0,1,0,1,0,0,0,1,2,3,0.6666666666666666,0,1,0.0,2,2,1.0,0.667,1,1,1.0
Edmond Sumner,sumneed01,SG,24,IND,2020,31,447.0,152,55,11,35,46,15,9,22,44,61,142,0.4295774647887324,14,53,0.2641509433962264,47,89,0.5280898876404494,0.479,16,29,0.5517241379310345
Caleb Swanigan,swanica01,PF-C,22,TOT,2020,27,288.0,65,31,27,73,100,3,7,37,62,28,47,0.5957446808510638,0,2,0.0,28,45,0.6222222222222222,0.596,9,17,0.5294117647058824
Jayson Tatum,tatumja01,PF,21,BOS,2020,66,2265.0,1547,200,64,396,460,93,57,155,136,552,1226,0.4502446982055464,189,469,0.4029850746268656,363,757,0.4795244385733157,0.527,254,313,0.8115015974440895
Jeff Teague,teaguje01,PG,31,TOT,2020,59,1464.0,641,308,27,115,142,44,19,116,106,213,489,0.4355828220858895,43,117,0.3675213675213675,170,372,0.4569892473118279,0.48,172,197,0.8730964467005076
Garrett Temple,templga01,SG,33,BRK,2020,62,1730.0,641,156,29,189,218,49,29,62,108,222,587,0.3781942078364566,127,386,0.3290155440414508,95,201,0.472636815920398,0.486,70,87,0.8045977011494253
Daniel Theis,theisda01,C,27,BOS,2020,65,1566.0,601,111,140,286,426,37,84,54,219,241,426,0.5657276995305164,32,96,0.3333333333333333,209,330,0.6333333333333333,0.603,87,114,0.7631578947368421
Isaiah Thomas,thomais02,PG,30,WAS,2020,40,925.0,488,146,11,57,68,13,6,77,77,174,426,0.4084507042253521,78,189,0.4126984126984127,96,237,0.4050632911392405,0.5,62,76,0.8157894736842105
Khyri Thomas,thomakh01,SG,23,DET,2020,8,61.0,17,3,1,0,1,3,0,3,9,5,17,0.2941176470588235,5,14,0.3571428571428571,0,3,0.0,0.441,2,4,0.5
Lance Thomas,thomala01,PF,31,BRK,2020,7,98.0,24,6,2,11,13,0,0,6,11,8,23,0.3478260869565217,4,13,0.3076923076923077,4,10,0.4,0.435,4,4,1.0
Matt Thomas,thomama02,SG,25,TOR,2020,41,440.0,202,22,9,52,61,10,1,16,38,73,150,0.4866666666666667,47,99,0.4747474747474747,26,51,0.5098039215686274,0.643,9,12,0.75
Tristan Thompson,thomptr01,PF,28,CLE,2020,57,1721.0,684,120,226,351,577,33,50,103,124,288,562,0.5124555160142349,9,23,0.391304347826087,279,539,0.5176252319109462,0.52,99,161,0.6149068322981367
Sindarius Thornwell,thornsi01,SF,25,NOP,2020,2,35.0,16,4,0,4,4,1,1,2,2,6,11,0.5454545454545454,2,4,0.5,4,7,0.5714285714285714,0.636,2,4,0.5
Matisse Thybulle,thybuma01,SG,22,PHI,2020,65,1287.0,305,79,44,63,107,94,47,51,141,112,265,0.4226415094339623,56,157,0.3566878980891719,56,108,0.5185185185185185,0.528,25,41,0.6097560975609756
Anthony Tolliver,tollian01,PF,34,TOT,2020,55,872.0,200,42,34,120,154,19,11,34,74,65,182,0.3571428571428571,49,145,0.3379310344827586,16,37,0.4324324324324324,0.492,21,29,0.7241379310344828
Juan Toscano-Anderson,toscaju01,SG,26,GSW,2020,13,272.0,69,26,9,43,52,13,5,16,30,29,63,0.4603174603174603,8,23,0.3478260869565217,21,40,0.525,0.524,3,5,0.6
Karl-Anthony Towns,townska01,C,24,MIN,2020,35,1187.0,926,153,95,283,378,33,42,110,117,316,622,0.5080385852090032,114,277,0.4115523465703971,202,345,0.5855072463768116,0.6,180,226,0.7964601769911505
Gary Trent Jr.,trentga02,SF,21,POR,2020,61,1332.0,541,61,25,75,100,48,16,21,90,196,441,0.4444444444444444,112,268,0.417910447761194,84,173,0.4855491329479768,0.571,37,45,0.8222222222222222
Allonzo Trier,trieral01,SG,24,NYK,2020,24,291.0,155,28,6,23,29,3,4,22,29,51,106,0.4811320754716981,19,53,0.3584905660377358,32,53,0.6037735849056604,0.571,34,43,0.7906976744186046
P.J. Tucker,tuckepj01,PF,34,HOU,2020,72,2467.0,500,115,112,364,476,77,36,72,229,177,426,0.4154929577464789,107,299,0.3578595317725752,70,127,0.5511811023622047,0.541,39,48,0.8125
Rayjon Tucker,tuckera01,SG,22,UTA,2020,20,161.0,62,5,3,17,20,1,1,8,10,20,43,0.4651162790697674,3,17,0.1764705882352941,17,26,0.6538461538461539,0.5,19,23,0.8260869565217391
Evan Turner,turneev01,SG,31,ATL,2020,19,251.0,62,38,8,30,38,9,8,26,20,25,67,0.373134328358209,0,5,0.0,25,62,0.4032258064516129,0.373,12,14,0.8571428571428571
Myles Turner,turnemy01,C,23,IND,2020,62,1826.0,749,72,86,321,407,46,132,85,166,268,587,0.4565587734241908,86,250,0.344,182,337,0.5400593471810089,0.53,127,169,0.7514792899408284
Jarrod Uthoff,uthofja01,PF,26,TOT,2020,7,53.0,19,0,2,4,6,1,0,0,2,7,18,0.3888888888888889,3,9,0.3333333333333333,4,9,0.4444444444444444,0.472,2,2,1.0
Jonas Valančiūnas,valanjo01,C,27,MEM,2020,70,1845.0,1044,131,213,575,788,30,76,127,185,432,739,0.584573748308525,32,91,0.3516483516483517,400,648,0.6172839506172839,0.606,148,200,0.74
Denzel Valentine,valende01,SF,26,CHI,2020,36,488.0,246,43,9,65,74,26,6,26,51,97,237,0.4092827004219409,46,137,0.3357664233576642,51,100,0.51,0.506,6,8,0.75
Jarred Vanderbilt,vandeja01,PF,20,TOT,2020,11,46.0,12,2,3,6,9,3,1,7,6,5,8,0.625,0,1,0.0,5,7,0.7142857142857143,0.625,2,2,1.0
Fred VanVleet,vanvlfr01,SG,25,TOR,2020,54,1928.0,952,357,18,185,203,100,17,121,132,319,773,0.4126778783958603,146,374,0.3903743315508021,173,399,0.4335839598997493,0.507,168,198,0.8484848484848485
Gabe Vincent,vincega01,PG,23,MIA,2020,9,83.0,22,6,0,5,5,5,0,1,6,8,37,0.2162162162162162,6,27,0.2222222222222222,2,10,0.2,0.297,0,0,0.0
Noah Vonleh,vonleno01,C,24,TOT,2020,36,377.0,132,28,37,87,124,11,6,21,40,52,92,0.5652173913043478,3,15,0.2,49,77,0.6363636363636364,0.582,25,32,0.78125
Nikola Vučević,vucevni01,C,29,ORL,2020,62,1998.0,1215,222,140,533,673,54,47,88,135,493,1033,0.4772507260406582,98,289,0.3391003460207612,395,744,0.5309139784946236,0.525,131,167,0.7844311377245509
Dean Wade,wadede01,PF,23,CLE,2020,12,71.0,20,2,3,16,19,2,4,3,8,9,13,0.6923076923076923,2,4,0.5,7,9,0.7777777777777778,0.769,0,1,0.0
Moritz Wagner,wagnemo01,C,22,WAS,2020,45,835.0,393,56,56,163,219,28,19,66,152,145,266,0.5451127819548872,25,80,0.3125,120,186,0.6451612903225806,0.592,78,95,0.8210526315789474
Dion Waiters,waitedi01,SG,28,TOT,2020,10,207.0,111,20,2,22,24,4,6,16,21,41,99,0.4141414141414141,15,47,0.3191489361702128,26,52,0.5,0.49,14,17,0.8235294117647058
Kemba Walker,walkeke02,PG,29,BOS,2020,56,1742.0,1145,268,36,181,217,48,28,117,91,378,889,0.4251968503937008,180,473,0.3805496828752642,198,416,0.4759615384615384,0.526,209,242,0.8636363636363636
Lonnie Walker IV,walkelo01,SG,21,SAS,2020,61,988.0,389,68,23,116,139,32,14,44,78,152,357,0.4257703081232493,41,101,0.4059405940594059,111,256,0.43359375,0.483,44,61,0.7213114754098361
Tyrone Wallace,wallaty01,SG,25,ATL,2020,14,160.0,40,13,3,19,22,7,1,10,19,14,44,0.3181818181818182,1,15,0.0666666666666666,13,29,0.4482758620689655,0.33,11,17,0.6470588235294118
Derrick Walton,waltode01,PG,24,TOT,2020,26,248.0,53,27,2,14,16,7,0,5,21,18,39,0.4615384615384615,10,24,0.4166666666666667,8,15,0.5333333333333333,0.59,7,9,0.7777777777777778
Brad Wanamaker,wanambr01,PG,30,BOS,2020,71,1369.0,487,179,22,122,144,61,14,76,133,162,362,0.4475138121546961,37,102,0.3627450980392157,125,260,0.4807692307692308,0.499,126,136,0.9264705882352942
T.J. Warren,warretj01,SF,26,IND,2020,67,2202.0,1326,99,68,212,280,78,34,84,187,534,997,0.5356068204613842,91,226,0.4026548672566372,443,771,0.5745784695201037,0.581,167,204,0.8186274509803921
P.J. Washington,washipj01,PF,21,CHO,2020,58,1759.0,710,123,58,258,316,51,44,93,158,268,589,0.4550084889643463,86,230,0.3739130434782609,182,359,0.5069637883008357,0.528,88,136,0.6470588235294118
Yuta Watanabe,watanyu01,SF,25,MEM,2020,18,105.0,36,5,7,13,20,5,1,2,9,15,34,0.4411764705882353,3,8,0.375,12,26,0.4615384615384615,0.485,3,8,0.375
Tremont Waters,watertr01,PG,22,BOS,2020,11,119.0,40,16,0,12,12,10,2,15,13,14,49,0.2857142857142857,4,24,0.1666666666666666,10,25,0.4,0.327,8,8,1.0
Paul Watson,watsopa01,SF,25,TOT,2020,10,87.0,31,8,2,15,17,4,1,3,5,10,26,0.3846153846153846,4,12,0.3333333333333333,6,14,0.4285714285714285,0.462,7,9,0.7777777777777778
Quinndary Weatherspoon,weathqu01,SG,23,SAS,2020,11,78.0,12,11,1,6,7,3,1,5,8,5,17,0.2941176470588235,1,5,0.2,4,12,0.3333333333333333,0.324,1,2,0.5
Russell Westbrook,westbru01,PG,31,HOU,2020,57,2049.0,1553,401,100,351,451,93,20,255,200,604,1281,0.4715066354410617,55,213,0.2582159624413145,549,1068,0.5140449438202247,0.493,290,380,0.7631578947368421
Coby White,whiteco01,PG,19,CHI,2020,65,1674.0,859,175,28,202,230,49,6,109,117,312,792,0.3939393939393939,133,376,0.3537234042553192,179,416,0.4302884615384615,0.478,102,129,0.7906976744186046
Derrick White,whitede01,SG,25,SAS,2020,68,1677.0,765,241,35,188,223,44,59,89,152,253,552,0.4583333333333333,79,216,0.3657407407407407,174,336,0.5178571428571429,0.53,180,211,0.8530805687203792
Hassan Whiteside,whiteha01,C,30,POR,2020,67,2008.0,1040,78,258,647,905,26,196,120,196,436,702,0.6210826210826211,4,7,0.5714285714285714,432,695,0.6215827338129496,0.624,164,239,0.6861924686192469
Andrew Wiggins,wiggian01,SF,24,TOT,2020,54,1858.0,1175,198,66,208,274,45,53,132,127,437,978,0.4468302658486707,111,334,0.3323353293413174,326,644,0.5062111801242236,0.504,190,268,0.7089552238805971
Grant Williams,willigr01,PF,21,BOS,2020,69,1043.0,237,68,59,119,178,30,36,50,163,87,211,0.4123222748815165,24,96,0.25,63,115,0.5478260869565217,0.469,39,54,0.7222222222222222
Johnathan Williams,willijo04,PF,24,WAS,2020,15,180.0,45,8,24,40,64,1,8,5,16,19,34,0.5588235294117647,0,2,0.0,19,32,0.59375,0.559,7,13,0.5384615384615384
Kenrich Williams,willike04,PF,25,NOP,2020,39,832.0,136,57,51,135,186,27,21,22,88,51,147,0.3469387755102041,25,97,0.2577319587628865,26,50,0.52,0.432,9,26,0.3461538461538461
Lou Williams,willilo02,PG,33,LAC,2020,65,1864.0,1185,365,31,170,201,43,12,182,80,391,936,0.4177350427350427,111,315,0.3523809523809524,280,621,0.4508856682769726,0.477,292,339,0.8613569321533924
Marvin Williams,willima02,PF,33,TOT,2020,58,1129.0,343,60,30,153,183,36,30,33,103,119,267,0.445692883895131,56,156,0.358974358974359,63,111,0.5675675675675675,0.551,49,57,0.8596491228070176
Robert Williams,williro04,C,22,BOS,2020,29,388.0,150,27,40,88,128,22,35,21,51,64,88,0.7272727272727273,0,0,0.0,64,88,0.7272727272727273,0.727,22,34,0.6470588235294118
Nigel Williams-Goss,willini01,PG,25,UTA,2020,10,50.0,14,6,2,4,6,3,1,3,6,5,16,0.3125,2,7,0.2857142857142857,3,9,0.3333333333333333,0.375,2,2,1.0
Zion Williamson,willizi01,PF,19,NOP,2020,24,668.0,540,50,64,86,150,16,9,59,42,210,360,0.5833333333333334,6,14,0.4285714285714285,204,346,0.5895953757225434,0.592,114,178,0.6404494382022472
D.J. Wilson,wilsodj01,PF,23,MIL,2020,37,363.0,133,25,12,80,92,3,5,19,33,52,132,0.3939393939393939,18,73,0.2465753424657534,34,59,0.576271186440678,0.462,11,18,0.6111111111111112
Justise Winslow,winslju01,SG,23,MIA,2020,11,352.0,124,44,16,57,73,7,5,24,38,50,129,0.3875968992248062,6,27,0.2222222222222222,44,102,0.4313725490196078,0.411,18,27,0.6666666666666666
Christian Wood,woodch01,PF,24,DET,2020,62,1325.0,810,60,104,286,390,34,54,84,98,288,508,0.5669291338582677,54,140,0.3857142857142857,234,368,0.6358695652173914,0.62,180,242,0.743801652892562
Delon Wright,wrighde01,PG,27,DAL,2020,73,1570.0,504,244,70,210,280,85,22,73,93,190,411,0.462287104622871,47,127,0.3700787401574803,143,284,0.5035211267605634,0.519,77,100,0.77
Justin Wright-Foreman,wrighju02,PG,22,UTA,2020,4,45.0,19,7,0,5,5,2,0,3,5,7,20,0.35,2,10,0.2,5,10,0.5,0.4,3,4,0.75
Thaddeus Young,youngth01,PF,31,CHI,2020,64,1591.0,659,117,94,221,315,92,23,102,134,269,601,0.4475873544093178,79,222,0.3558558558558558,190,379,0.5013192612137203,0.513,42,72,0.5833333333333334
Trae Young,youngtr01,PG,21,ATL,2020,60,2120.0,1778,560,32,223,255,65,8,289,104,546,1249,0.4371497197758207,205,568,0.3609154929577465,341,681,0.5007342143906021,0.519,481,559,0.8604651162790697
Cody Zeller,zelleco01,C,27,CHO,2020,58,1341.0,642,88,160,251,411,40,25,75,140,251,479,0.524008350730689,18,75,0.24,233,404,0.5767326732673267,0.543,122,179,0.6815642458100558
Tyler Zeller,zellety01,C,30,SAS,2020,2,4.0,2,0,3,1,4,0,0,0,0,1,4,0.25,0,0,0.0,1,4,0.25,0.25,0,0,0.0
Ante Žižić,zizican01,C,23,CLE,2020,22,221.0,96,6,18,48,66,7,5,10,27,41,72,0.5694444444444444,0,0,0.0,41,72,0.5694444444444444,0.569,14,19,0.7368421052631579
Ivica Zubac,zubaciv01,C,22,LAC,2020,72,1326.0,596,82,197,346,543,16,66,61,168,236,385,0.612987012987013,0,2,0.0,236,383,0.6161879895561357,0.613,124,166,0.7469879518072289
Precious Achiuwa,achiupr01,PF,21,MIA,2021,61,737.0,304,29,73,135,208,20,28,43,91,124,228,0.543859649122807,0,1,0.0,124,227,0.5462555066079295,0.544,56,110,0.509090909090909
Jaylen Adams,adamsja01,PG,24,MIL,2021,7,18.0,2,2,0,3,3,0,0,0,1,1,8,0.125,0,2,0.0,1,6,0.1666666666666666,0.125,0,0,0.0
Steven Adams,adamsst01,C,27,NOP,2021,58,1605.0,438,111,213,301,514,54,38,78,113,189,308,0.6136363636363636,0,3,0.0,189,305,0.6196721311475409,0.614,60,135,0.4444444444444444
Bam Adebayo,adebaba01,C,23,MIA,2021,64,2143.0,1197,346,142,431,573,75,66,169,145,456,800,0.57,2,8,0.25,454,792,0.5732323232323232,0.571,283,354,0.7994350282485876
LaMarcus Aldridge,aldrila01,C,35,TOT,2021,26,674.0,352,49,19,99,118,11,29,27,47,140,296,0.4729729729729729,31,80,0.3875,109,216,0.5046296296296297,0.525,41,47,0.8723404255319149
Ty-Shon Alexander,alexaty01,SG,22,PHO,2021,15,47.0,9,6,2,8,10,0,1,3,2,3,12,0.25,2,9,0.2222222222222222,1,3,0.3333333333333333,0.333,1,2,0.5
Nickeil Alexander-Walker,alexani01,SG,22,NOP,2021,46,1007.0,508,102,13,131,144,47,22,69,88,192,458,0.4192139737991266,76,219,0.3470319634703196,116,239,0.4853556485355648,0.502,48,66,0.7272727272727273
Grayson Allen,allengr01,SG,25,MEM,2021,50,1259.0,532,108,19,141,160,46,8,48,71,173,414,0.4178743961352657,107,274,0.3905109489051095,66,140,0.4714285714285714,0.547,79,91,0.8681318681318682
Jarrett Allen,allenja01,C,22,TOT,2021,63,1864.0,806,106,196,435,631,32,90,100,96,298,482,0.6182572614107884,6,19,0.3157894736842105,292,463,0.6306695464362851,0.624,204,290,0.7034482758620689
Al-Farouq Aminu,aminual01,PF,30,TOT,2021,23,434.0,102,31,22,88,110,19,9,28,29,38,99,0.3838383838383838,8,37,0.2162162162162162,30,62,0.4838709677419355,0.424,18,22,0.8181818181818182
Kyle Anderson,anderky01,PF,27,MEM,2021,69,1887.0,854,250,52,344,396,84,57,86,120,308,658,0.4680851063829787,94,261,0.3601532567049808,214,397,0.5390428211586902,0.54,144,184,0.782608695652174
Giannis Antetokounmpo,antetgi01,PF,26,MIL,2021,61,2013.0,1717,357,97,574,671,72,73,207,168,626,1100,0.5690909090909091,67,221,0.3031674208144796,559,879,0.6359499431171786,0.6,398,581,0.685025817555938
Kostas Antetokounmpo,antetko01,PF,23,LAL,2021,15,56.0,12,1,4,15,19,2,4,11,8,3,10,0.3,0,0,0.0,3,10,0.3,0.3,6,13,0.4615384615384615
Thanasis Antetokounmpo,antetth01,SF,28,MIL,2021,57,551.0,166,46,54,70,124,22,10,43,74,67,137,0.4890510948905109,7,29,0.2413793103448276,60,108,0.5555555555555556,0.515,25,49,0.5102040816326531
Carmelo Anthony,anthoca01,PF,36,POR,2021,69,1690.0,924,104,32,182,214,46,38,61,144,327,777,0.4208494208494208,133,325,0.4092307692307692,194,452,0.4292035398230088,0.506,137,154,0.8896103896103896
Cole Anthony,anthoco01,PG,20,ORL,2021,47,1273.0,605,192,38,183,221,30,18,106,98,219,552,0.3967391304347826,58,172,0.3372093023255814,161,380,0.4236842105263158,0.449,109,131,0.8320610687022901
OG Anunoby,anunoog01,SF,23,TOR,2021,43,1433.0,682,94,54,183,237,66,32,75,114,249,519,0.4797687861271676,104,261,0.3984674329501915,145,258,0.562015503875969,0.58,80,102,0.7843137254901961
Ryan Arcidiacono,arcidry01,PG,26,CHI,2021,44,450.0,136,56,5,62,67,9,0,10,47,49,117,0.4188034188034188,25,67,0.373134328358209,24,50,0.48,0.526,13,20,0.65
Trevor Ariza,arizatr01,SF,35,MIA,2021,30,841.0,282,55,27,117,144,31,18,21,55,99,241,0.4107883817427386,50,143,0.3496503496503496,49,98,0.5,0.515,34,44,0.7727272727272727
D.J. Augustin,augusdj01,PG,33,TOT,2021,57,1129.0,438,188,20,74,94,28,1,65,56,135,343,0.3935860058309038,83,217,0.3824884792626728,52,126,0.4126984126984127,0.515,85,94,0.9042553191489362
Deni Avdija,avdijde01,SF,20,WAS,2021,54,1257.0,342,63,22,240,262,32,15,33,140,130,312,0.4166666666666667,53,168,0.3154761904761904,77,144,0.5347222222222222,0.502,29,45,0.6444444444444445
Deandre Ayton,aytonde01,C,22,PHO,2021,69,2115.0,997,99,228,499,727,41,81,103,196,430,687,0.6259097525473072,4,20,0.2,426,667,0.638680659670165,0.629,133,173,0.7687861271676301
Udoka Azubuike,azubuud01,C,21,UTA,2021,15,57.0,16,0,4,9,13,1,4,3,9,4,9,0.4444444444444444,0,0,0.0,4,9,0.4444444444444444,0.444,8,10,0.8
Dwayne Bacon,bacondw01,SG,25,ORL,2021,72,1853.0,788,93,31,193,224,45,5,46,103,292,726,0.4022038567493113,59,207,0.2850241545893719,233,519,0.4489402697495183,0.443,145,176,0.8238636363636364
Marvin Bagley III,baglema01,PF,21,SAC,2021,43,1112.0,608,43,106,212,318,21,21,59,100,247,490,0.5040816326530613,37,108,0.3425925925925926,210,382,0.5497382198952879,0.542,77,134,0.5746268656716418
LaMelo Ball,ballla01,PG,19,CHO,2021,51,1469.0,803,313,63,239,302,81,18,145,136,293,672,0.4360119047619047,92,261,0.3524904214559387,201,411,0.4890510948905109,0.504,125,165,0.7575757575757576
Lonzo Ball,balllo01,PG,23,NOP,2021,55,1747.0,802,316,33,230,263,82,31,123,103,290,700,0.4142857142857143,172,455,0.378021978021978,118,245,0.4816326530612245,0.537,50,64,0.78125
Mo Bamba,bambamo01,C,22,ORL,2021,46,725.0,367,35,76,189,265,14,58,36,87,142,301,0.4717607973421927,38,118,0.3220338983050847,104,183,0.5683060109289617,0.535,45,66,0.6818181818181818
Desmond Bane,banede01,SG,22,MEM,2021,68,1519.0,625,118,31,179,210,41,16,59,125,234,499,0.468937875751503,117,271,0.4317343173431734,117,228,0.5131578947368421,0.586,40,49,0.8163265306122449
Harrison Barnes,barneha02,PF,28,SAC,2021,58,2102.0,933,201,64,321,385,43,11,93,75,319,642,0.4968847352024922,100,256,0.390625,219,386,0.5673575129533679,0.575,195,235,0.8297872340425532
RJ Barrett,barrerj01,SG,20,NYK,2021,72,2511.0,1264,217,68,346,414,53,20,139,188,467,1060,0.440566037735849,124,309,0.401294498381877,343,751,0.4567243675099867,0.499,206,276,0.7463768115942029
Will Barton,bartowi01,SF,30,DEN,2021,56,1736.0,711,181,39,187,226,50,23,96,95,259,608,0.4259868421052631,98,257,0.3813229571984435,161,351,0.4586894586894587,0.507,95,121,0.7851239669421488
Keita Bates-Diop,bateske01,SF,25,SAS,2021,30,245.0,79,12,9,40,49,11,5,7,11,30,67,0.4477611940298507,5,17,0.2941176470588235,25,50,0.5,0.485,14,21,0.6666666666666666
Nicolas Batum,batumni01,SF,32,LAC,2021,67,1835.0,540,148,50,266,316,69,37,53,102,191,412,0.4635922330097087,110,272,0.4044117647058823,81,140,0.5785714285714286,0.597,48,58,0.8275862068965517
Aron Baynes,baynear01,C,34,TOR,2021,53,980.0,324,47,87,186,273,17,23,46,119,134,304,0.4407894736842105,27,103,0.2621359223300971,107,201,0.5323383084577115,0.485,29,41,0.7073170731707317
Kent Bazemore,bazemke01,SF,31,GSW,2021,67,1333.0,481,108,26,203,229,69,33,82,158,176,392,0.4489795918367347,75,184,0.4076086956521739,101,208,0.4855769230769231,0.545,54,78,0.6923076923076923
Darius Bazley,bazleda01,PF,20,OKC,2021,55,1714.0,754,99,51,345,396,29,25,122,60,273,690,0.3956521739130434,83,286,0.2902097902097902,190,404,0.4702970297029702,0.456,125,178,0.702247191011236
Bradley Beal,bealbr01,SG,27,WAS,2021,60,2147.0,1878,265,72,211,283,69,22,187,140,670,1382,0.4848046309696092,130,373,0.3485254691689008,540,1009,0.535183349851338,0.532,408,459,0.8888888888888888
Malik Beasley,beaslma01,SG,24,MIN,2021,37,1214.0,724,88,28,134,162,30,7,60,62,264,600,0.44,128,321,0.3987538940809969,136,279,0.4874551971326165,0.547,68,80,0.85
Jordan Bell,belljo01,C,26,TOT,2021,6,82.0,15,7,7,17,24,3,5,4,7,7,22,0.3181818181818182,0,2,0.0,7,20,0.35,0.318,1,2,0.5
DeAndre' Bembry,bembrde01,SF,26,TOR,2021,51,972.0,293,107,33,113,146,53,18,71,87,117,228,0.5131578947368421,14,53,0.2641509433962264,103,175,0.5885714285714285,0.544,45,66,0.6818181818181818
Dāvis Bertāns,bertada01,PF,28,WAS,2021,57,1464.0,655,49,18,150,168,33,13,33,136,193,478,0.403765690376569,169,428,0.3948598130841121,24,50,0.48,0.581,100,115,0.8695652173913043
Patrick Beverley,beverpa01,PG,32,LAC,2021,37,832.0,278,76,29,90,119,29,28,34,108,93,220,0.4227272727272727,56,141,0.3971631205673759,37,79,0.4683544303797468,0.55,36,45,0.8
Saddiq Bey,beysa01,SF,21,DET,2021,70,1909.0,857,95,43,275,318,52,14,60,110,279,691,0.4037626628075253,175,460,0.3804347826086957,104,231,0.4502164502164502,0.53,124,147,0.8435374149659864
Tyler Bey,beyty01,SF,22,DAL,2021,18,71.0,18,3,8,11,19,0,1,3,6,7,22,0.3181818181818182,1,4,0.25,6,18,0.3333333333333333,0.341,3,5,0.6
Khem Birch,birchkh01,C,28,TOT,2021,67,1529.0,482,89,174,213,387,48,50,44,113,189,380,0.4973684210526315,13,52,0.25,176,328,0.5365853658536586,0.514,91,129,0.7054263565891473
Goga Bitadze,bitadgo01,C,21,IND,2021,45,561.0,231,37,60,90,150,9,60,17,94,83,194,0.4278350515463917,20,79,0.2531645569620253,63,115,0.5478260869565217,0.479,45,61,0.7377049180327869
Bismack Biyombo,biyombi01,C,28,CHO,2021,66,1349.0,331,81,137,210,347,17,74,71,141,142,242,0.5867768595041323,0,1,0.0,142,241,0.5892116182572614,0.587,47,105,0.4476190476190476
Nemanja Bjelica,bjeline01,PF,32,TOT,2021,37,595.0,242,69,29,98,127,15,5,33,68,89,196,0.4540816326530612,27,85,0.3176470588235294,62,111,0.5585585585585585,0.523,37,51,0.7254901960784313
Eric Bledsoe,bledser01,SG,31,NOP,2021,71,2111.0,869,268,29,215,244,55,24,114,112,307,730,0.4205479452054794,121,355,0.3408450704225352,186,375,0.496,0.503,134,195,0.6871794871794872
Keljin Blevins,blevike01,SF,25,POR,2021,17,75.0,12,4,3,7,10,2,0,5,8,5,20,0.25,2,8,0.25,3,12,0.25,0.3,0,0,0.0
Bogdan Bogdanović,bogdabo01,SG,28,ATL,2021,44,1305.0,720,147,20,140,160,49,13,54,99,267,565,0.4725663716814159,146,333,0.4384384384384384,121,232,0.521551724137931,0.602,40,44,0.9090909090909092
Bojan Bogdanović,bogdabo02,SF,31,UTA,2021,72,2216.0,1225,136,40,241,281,45,4,128,115,406,925,0.4389189189189189,180,461,0.3904555314533622,226,464,0.4870689655172414,0.536,233,265,0.879245283018868
Bol Bol,bolbo01,PF,21,DEN,2021,32,160.0,69,7,0,24,24,3,10,13,14,25,58,0.4310344827586206,9,24,0.375,16,34,0.4705882352941176,0.509,10,15,0.6666666666666666
Marques Bolden,boldema01,C,22,CLE,2021,6,29.0,7,0,3,3,6,2,2,2,0,1,3,0.3333333333333333,0,0,0.0,1,3,0.3333333333333333,0.333,5,8,0.625
Jordan Bone,bonejo01,PG,23,ORL,2021,14,196.0,56,18,4,20,24,2,0,3,11,23,54,0.4259259259259259,10,32,0.3125,13,22,0.5909090909090909,0.519,0,0,0.0
Isaac Bonga,bongais01,SF,21,WAS,2021,40,432.0,78,23,18,48,66,11,9,22,63,30,81,0.3703703703703703,13,47,0.2765957446808511,17,34,0.5,0.451,5,8,0.625
Devin Booker,bookede01,SG,24,PHO,2021,67,2270.0,1712,289,34,247,281,53,16,207,181,623,1287,0.4840714840714841,126,371,0.3396226415094339,497,916,0.5425764192139738,0.533,340,392,0.8673469387755102
Chris Boucher,bouchch01,C,28,TOR,2021,60,1453.0,818,63,117,287,404,35,111,46,166,288,560,0.5142857142857142,90,235,0.3829787234042553,198,325,0.6092307692307692,0.595,152,193,0.7875647668393783
Brian Bowen,bowenbr02,SF,22,IND,2021,6,15.0,3,0,0,3,3,0,0,0,1,1,4,0.25,0,1,0.0,1,3,0.3333333333333333,0.25,1,1,1.0
Avery Bradley,bradlav01,SG,30,TOT,2021,27,602.0,173,46,8,49,57,21,3,28,55,64,171,0.3742690058479532,33,101,0.3267326732673267,31,70,0.4428571428571428,0.471,12,15,0.8
Tony Bradley,bradlto01,C,23,TOT,2021,42,684.0,300,37,85,154,239,15,30,33,61,131,197,0.6649746192893401,0,3,0.0,131,194,0.6752577319587629,0.665,38,55,0.6909090909090909
Jarrell Brantley,brantja01,PF,24,UTA,2021,28,138.0,64,15,9,18,27,7,2,8,17,25,52,0.4807692307692308,12,28,0.4285714285714285,13,24,0.5416666666666666,0.596,2,2,1.0
Ignas Brazdeikis,brazdig01,SF,22,TOT,2021,13,249.0,91,17,11,34,45,4,3,12,22,35,83,0.4216867469879518,11,28,0.3928571428571428,24,55,0.4363636363636363,0.488,10,14,0.7142857142857143
Mikal Bridges,bridgmi01,SF,24,PHO,2021,72,2348.0,970,152,76,233,309,76,63,57,116,363,669,0.5426008968609866,134,315,0.4253968253968254,229,354,0.6468926553672316,0.643,110,131,0.8396946564885496
Miles Bridges,bridgmi02,PF,22,CHO,2021,66,1932.0,840,147,81,316,397,44,52,106,143,313,622,0.5032154340836013,116,290,0.4,197,332,0.5933734939759037,0.596,98,113,0.8672566371681416
Amida Brimah,brimaam01,C,26,IND,2021,5,29.0,13,1,2,6,8,0,5,4,4,5,8,0.625,0,0,0.0,5,8,0.625,0.625,3,3,1.0
Oshae Brissett,brissos01,SF,22,IND,2021,21,519.0,229,18,29,86,115,19,20,10,32,73,151,0.4834437086092715,33,78,0.4230769230769231,40,73,0.547945205479452,0.593,50,65,0.7692307692307693
Malcolm Brogdon,brogdma01,PG,28,IND,2021,56,1930.0,1186,329,58,236,294,49,15,115,110,444,980,0.4530612244897959,145,374,0.3877005347593583,299,606,0.4933993399339934,0.527,153,177,0.864406779661017
Armoni Brooks,brookar01,SG,22,HOU,2021,20,520.0,223,30,10,58,68,12,5,22,34,78,192,0.40625,60,157,0.3821656050955414,18,35,0.5142857142857142,0.563,7,12,0.5833333333333334
Dillon Brooks,brookdi01,SF,25,MEM,2021,67,1997.0,1151,157,53,143,196,78,26,119,237,432,1031,0.4190106692531523,128,372,0.3440860215053763,304,659,0.4613050075872534,0.481,159,195,0.8153846153846154
Bruce Brown,brownbr01,PG,24,BRK,2021,65,1451.0,573,104,111,238,349,58,28,54,145,235,423,0.5555555555555556,17,59,0.288135593220339,218,364,0.5989010989010989,0.576,86,117,0.7350427350427351
Charlie Brown Jr.,brownch02,SG,23,OKC,2021,9,152.0,40,9,3,14,17,4,2,6,19,13,43,0.3023255813953488,5,21,0.238095238095238,8,22,0.3636363636363636,0.36,9,10,0.9
Jaylen Brown,brownja02,SG,24,BOS,2021,58,1999.0,1430,195,71,276,347,72,32,158,168,538,1111,0.4842484248424842,163,411,0.3965936739659367,375,700,0.5357142857142857,0.558,191,250,0.764
Moses Brown,brownmo01,C,21,OKC,2021,43,920.0,370,10,154,229,383,31,47,43,93,146,268,0.5447761194029851,0,0,0.0,146,268,0.5447761194029851,0.545,78,126,0.6190476190476191
Sterling Brown,brownst02,SG,25,HOU,2021,51,1229.0,416,72,38,186,224,38,12,41,97,150,335,0.4477611940298507,91,215,0.4232558139534884,59,120,0.4916666666666666,0.584,25,31,0.8064516129032258
Troy Brown Jr.,browntr01,SF,21,TOT,2021,34,524.0,161,29,20,85,105,10,6,21,49,62,144,0.4305555555555556,22,70,0.3142857142857143,40,74,0.5405405405405406,0.507,15,21,0.7142857142857143
Jalen Brunson,brunsja01,PG,24,DAL,2021,68,1697.0,857,239,27,204,231,35,1,80,109,328,627,0.5231259968102073,81,200,0.405,247,427,0.5784543325526932,0.588,120,151,0.7947019867549668
Elijah Bryant,bryanel01,SG,25,MIL,2021,1,32.0,16,3,2,4,6,0,1,4,4,6,13,0.4615384615384615,1,5,0.2,5,8,0.625,0.5,3,3,1.0
Thomas Bryant,bryanth01,C,23,WAS,2021,10,271.0,143,15,18,43,61,4,8,11,31,59,91,0.6483516483516484,9,21,0.4285714285714285,50,70,0.7142857142857143,0.698,16,24,0.6666666666666666
Reggie Bullock,bullore01,SF,29,NYK,2021,65,1949.0,709,99,16,207,223,52,11,45,146,248,561,0.4420677361853832,163,398,0.4095477386934673,85,163,0.5214723926380368,0.587,50,55,0.9090909090909092
Trey Burke,burketr01,PG,28,DAL,2021,62,911.0,411,81,10,44,54,36,7,33,64,151,353,0.4277620396600566,58,164,0.3536585365853658,93,189,0.492063492063492,0.51,51,57,0.8947368421052632
Alec Burks,burksal01,SG,29,NYK,2021,49,1255.0,623,107,21,206,227,31,14,49,102,210,500,0.42,102,246,0.4146341463414634,108,254,0.4251968503937008,0.522,101,118,0.8559322033898306
Jimmy Butler,butleji01,SF,31,MIA,2021,52,1745.0,1116,369,94,265,359,108,18,109,71,366,736,0.4972826086956521,25,102,0.2450980392156862,341,634,0.5378548895899053,0.514,359,416,0.8629807692307693
Bruno Caboclo,cabocbr01,PF,25,HOU,2021,6,36.0,17,1,3,11,14,0,2,4,6,8,17,0.4705882352941176,0,5,0.0,8,12,0.6666666666666666,0.471,1,2,0.5
Devontae Cacok,cacokde01,PF,24,LAL,2021,20,98.0,39,1,12,20,32,5,4,5,8,17,29,0.5862068965517241,0,0,0.0,17,29,0.5862068965517241,0.586,5,11,0.4545454545454545
Kentavious Caldwell-Pope,caldwke01,SG,27,LAL,2021,67,1902.0,653,127,27,152,179,62,26,66,114,218,506,0.4308300395256917,120,293,0.409556313993174,98,213,0.460093896713615,0.549,97,112,0.8660714285714286
Facundo Campazzo,campafa01,PG,29,DEN,2021,65,1425.0,396,232,22,112,134,79,14,73,132,120,315,0.3809523809523809,76,216,0.3518518518518518,44,99,0.4444444444444444,0.502,80,91,0.8791208791208791
Vlatko Čančar,cancavl01,PF,23,DEN,2021,41,281.0,85,14,11,39,50,11,2,14,18,33,72,0.4583333333333333,9,33,0.2727272727272727,24,39,0.6153846153846154,0.521,10,13,0.7692307692307693
Devin Cannady,cannade01,PG,24,ORL,2021,8,74.0,34,1,0,5,5,5,1,2,9,11,28,0.3928571428571428,6,16,0.375,5,12,0.4166666666666667,0.5,6,7,0.8571428571428571
Clint Capela,capelca01,C,26,ATL,2021,63,1898.0,956,49,297,606,903,44,129,73,145,413,695,0.5942446043165468,0,0,0.0,413,695,0.5942446043165468,0.594,130,227,0.5726872246696035
Vernon Carey Jr.,careyve01,C,19,CHO,2021,19,115.0,46,2,6,21,27,1,5,5,13,18,36,0.5,1,7,0.1428571428571428,17,29,0.5862068965517241,0.514,9,11,0.8181818181818182
Jevon Carter,carteje01,PG,25,PHO,2021,60,717.0,248,71,16,76,92,29,9,16,56,94,223,0.42152466367713,56,151,0.3708609271523179,38,72,0.5277777777777778,0.547,4,7,0.5714285714285714
Wendell Carter Jr.,cartewe01,C,21,TOT,2021,54,1375.0,606,104,132,311,443,35,42,78,146,230,457,0.5032822757111597,15,51,0.2941176470588235,215,406,0.5295566502463054,0.52,131,179,0.7318435754189944
Michael Carter-Williams,cartemi01,SG,29,ORL,2021,31,800.0,274,129,39,100,139,25,17,69,81,105,270,0.3888888888888889,15,61,0.2459016393442623,90,209,0.430622009569378,0.417,49,80,0.6125
Alex Caruso,carusal01,PG,26,LAL,2021,58,1216.0,370,160,31,139,170,64,15,76,108,133,305,0.4360655737704918,55,137,0.4014598540145985,78,168,0.4642857142857143,0.526,49,76,0.6447368421052632
Willie Cauley-Stein,caulewi01,C,27,DAL,2021,53,906.0,280,35,66,170,236,21,43,29,129,115,182,0.6318681318681318,1,11,0.0909090909090909,114,171,0.6666666666666666,0.635,49,78,0.6282051282051282
Chris Chiozza,chiozch01,PG,25,BRK,2021,22,232.0,88,65,3,21,24,7,6,16,19,31,88,0.3522727272727273,13,42,0.3095238095238095,18,46,0.391304347826087,0.426,13,17,0.7647058823529411
Marquese Chriss,chrisma01,PF,23,GSW,2021,2,27.0,13,2,3,10,13,0,2,2,3,5,14,0.3571428571428571,1,5,0.2,4,9,0.4444444444444444,0.393,2,4,0.5
Gary Clark,clarkga01,SF-PF,26,TOT,2021,39,654.0,119,31,33,82,115,13,7,17,35,40,132,0.303030303030303,31,108,0.287037037037037,9,24,0.375,0.42,8,10,0.8
Brandon Clarke,clarkbr01,PF,24,MEM,2021,59,1415.0,610,95,97,231,328,60,51,33,84,256,495,0.5171717171717172,20,77,0.2597402597402597,236,418,0.5645933014354066,0.537,78,113,0.6902654867256637
Jordan Clarkson,clarkjo01,SG,28,UTA,2021,68,1818.0,1251,168,47,227,274,61,10,115,110,457,1075,0.4251162790697674,208,599,0.347245409015025,249,476,0.523109243697479,0.522,129,144,0.8958333333333334
Nic Claxton,claxtni01,C,21,BRK,2021,32,594.0,212,28,43,123,166,23,40,18,68,90,145,0.6206896551724138,1,5,0.2,89,140,0.6357142857142857,0.624,31,64,0.484375
Amir Coffey,coffeam01,SG,23,LAC,2021,44,394.0,140,22,10,34,44,10,0,15,30,45,103,0.4368932038834951,23,56,0.4107142857142857,22,47,0.4680851063829787,0.549,27,38,0.7105263157894737
John Collins,collijo01,PF,23,ATL,2021,63,1848.0,1111,78,118,349,467,34,63,84,193,429,771,0.556420233463035,83,208,0.3990384615384615,346,563,0.6145648312611013,0.61,170,204,0.8333333333333334
Mike Conley,conlemi01,PG,33,UTA,2021,51,1498.0,827,305,36,141,177,70,9,99,98,284,640,0.44375,138,335,0.4119402985074626,146,305,0.4786885245901639,0.552,121,142,0.852112676056338
Pat Connaughton,connapa01,SG,28,MIL,2021,69,1575.0,468,81,63,269,332,49,23,33,99,168,387,0.4341085271317829,101,272,0.3713235294117647,67,115,0.5826086956521739,0.565,31,40,0.775
Quinn Cook,cookqu01,PG,27,TOT,2021,23,157.0,76,18,2,15,17,4,1,7,10,29,68,0.4264705882352941,11,26,0.4230769230769231,18,42,0.4285714285714285,0.507,7,8,0.875
Tyler Cook,cookty01,SF-PF,23,TOT,2021,32,438.0,156,17,28,67,95,8,2,21,35,69,103,0.6699029126213593,1,2,0.5,68,101,0.6732673267326733,0.675,17,35,0.4857142857142857
DeMarcus Cousins,couside01,C,30,TOT,2021,41,713.0,366,76,53,210,263,34,24,64,107,130,305,0.4262295081967213,47,135,0.3481481481481481,83,170,0.488235294117647,0.503,59,81,0.7283950617283951
Robert Covington,covinro01,PF,30,POR,2021,70,2243.0,593,117,61,405,466,101,84,64,195,204,509,0.4007858546168958,135,356,0.3792134831460674,69,153,0.4509803921568627,0.533,50,62,0.8064516129032258
Torrey Craig,craigto01,SF,30,TOT,2021,50,803.0,274,49,57,140,197,28,26,25,83,109,227,0.4801762114537445,39,106,0.3679245283018867,70,121,0.5785123966942148,0.566,17,22,0.7727272727272727
Jae Crowder,crowdja01,PF,30,PHO,2021,60,1648.0,603,127,32,250,282,48,27,55,125,199,492,0.4044715447154471,148,380,0.3894736842105263,51,112,0.4553571428571428,0.555,57,75,0.76
Jarrett Culver,culveja01,SG,21,MIN,2021,34,499.0,180,24,34,70,104,17,9,28,58,69,168,0.4107142857142857,13,53,0.2452830188679245,56,115,0.4869565217391304,0.449,29,48,0.6041666666666666
Seth Curry,curryse01,SG,30,PHI,2021,57,1638.0,711,155,10,126,136,44,8,65,96,258,552,0.4673913043478261,126,280,0.45,132,272,0.4852941176470588,0.582,69,77,0.8961038961038961
Stephen Curry,curryst01,PG,32,GSW,2021,63,2152.0,2015,363,29,316,345,77,8,213,119,658,1365,0.482051282051282,337,801,0.4207240948813982,321,564,0.5691489361702128,0.605,362,395,0.9164556962025316
Nate Darling,darlina01,SG,22,CHO,2021,7,26.0,9,1,1,0,1,0,1,1,1,2,7,0.2857142857142857,2,7,0.2857142857142857,0,0,0.0,0.429,3,3,1.0
Anthony Davis,davisan02,PF,27,LAL,2021,36,1162.0,786,110,62,224,286,45,59,74,60,301,613,0.4910277324632953,26,100,0.26,275,513,0.5360623781676414,0.512,158,214,0.7383177570093458
Ed Davis,davised01,C,31,MIN,2021,23,299.0,48,21,46,69,115,13,13,7,56,19,44,0.4318181818181818,0,0,0.0,19,44,0.4318181818181818,0.432,10,12,0.8333333333333334
Terence Davis,daviste02,SG,23,TOT,2021,61,1074.0,533,83,20,134,154,44,14,63,97,195,456,0.4276315789473684,98,267,0.3670411985018726,97,189,0.5132275132275133,0.535,45,55,0.8181818181818182
Gabriel Deck,deckga01,PF,25,OKC,2021,10,212.0,84,24,16,24,40,8,0,6,9,32,67,0.4776119402985074,2,15,0.1333333333333333,30,52,0.5769230769230769,0.493,18,22,0.8181818181818182
Dewayne Dedmon,dedmode01,C,31,MIA,2021,16,210.0,113,12,28,58,86,9,6,13,36,46,65,0.7076923076923077,1,5,0.2,45,60,0.75,0.715,20,27,0.7407407407407407
Matthew Dellavedova,dellama01,PG,30,CLE,2021,13,224.0,36,58,6,18,24,4,1,6,21,14,56,0.25,4,25,0.16,10,31,0.3225806451612903,0.286,4,4,1.0
DeMar DeRozan,derozde01,PF,31,SAS,2021,61,2056.0,1316,422,40,219,259,56,15,119,128,455,920,0.4945652173913043,19,74,0.2567567567567567,436,846,0.5153664302600472,0.505,387,440,0.8795454545454545
Mamadi Diakite,diakima01,PF,24,MIL,2021,14,141.0,44,8,8,26,34,7,6,3,16,16,40,0.4,1,8,0.125,15,32,0.46875,0.413,11,14,0.7857142857142857
Hamidou Diallo,diallha01,SG-SF,22,TOT,2021,52,1226.0,604,101,59,213,272,41,24,76,134,224,470,0.4765957446808511,28,82,0.3414634146341463,196,388,0.5051546391752577,0.506,128,200,0.64
Gorgui Dieng,dienggo01,C,31,TOT,2021,38,552.0,258,48,40,100,140,26,16,32,56,85,163,0.5214723926380368,30,70,0.4285714285714285,55,93,0.5913978494623656,0.613,58,67,0.8656716417910447
Spencer Dinwiddie,dinwisp01,SG,27,BRK,2021,3,64.0,20,9,0,13,13,2,1,5,4,6,16,0.375,2,7,0.2857142857142857,4,9,0.4444444444444444,0.438,6,6,1.0
Donte DiVincenzo,divindo01,SG,24,MIL,2021,66,1814.0,688,203,81,299,380,72,15,91,112,253,603,0.4195688225538971,131,346,0.3786127167630058,122,257,0.4747081712062256,0.528,51,71,0.7183098591549296
Luka Dončić,doncilu01,PG,21,DAL,2021,66,2262.0,1830,567,54,473,527,64,36,281,152,647,1351,0.4789045151739452,192,548,0.3503649635036496,455,803,0.5666251556662516,0.55,344,471,0.7303609341825902
Luguentz Dort,dortlu01,SG,21,OKC,2021,52,1543.0,729,88,38,151,189,45,19,79,134,247,639,0.3865414710485133,113,329,0.3434650455927052,134,310,0.432258064516129,0.475,122,164,0.7439024390243902
Damyean Dotson,dotsoda01,SG,26,CLE,2021,46,907.0,308,91,5,88,93,16,4,42,42,119,293,0.4061433447098976,46,159,0.2893081761006289,73,134,0.5447761194029851,0.485,24,36,0.6666666666666666
Devon Dotson,dotsode01,PG,21,CHI,2021,11,50.0,23,7,2,3,5,4,0,0,3,11,21,0.5238095238095238,1,7,0.1428571428571428,10,14,0.7142857142857143,0.548,0,0,0.0
Sekou Doumbouya,doumbse01,PF,20,DET,2021,56,869.0,285,47,39,104,143,24,9,44,94,107,282,0.3794326241134751,26,115,0.2260869565217391,81,167,0.4850299401197604,0.426,45,64,0.703125
PJ Dozier,doziepj01,SG,24,DEN,2021,50,1088.0,385,92,35,147,182,31,22,46,86,148,355,0.4169014084507042,47,149,0.3154362416107382,101,206,0.4902912621359223,0.483,42,66,0.6363636363636364
Goran Dragić,dragigo01,PG,34,MIA,2021,50,1337.0,672,219,25,144,169,33,8,118,113,240,555,0.4324324324324324,91,244,0.3729508196721312,149,311,0.4790996784565916,0.514,101,122,0.8278688524590164
Andre Drummond,drumman01,C,27,TOT,2021,46,1242.0,687,94,166,385,551,63,49,124,149,282,572,0.493006993006993,0,8,0.0,282,564,0.5,0.493,123,205,0.6
Jared Dudley,dudleja01,PF,35,LAL,2021,12,81.0,6,5,4,17,21,1,1,2,7,2,9,0.2222222222222222,2,6,0.3333333333333333,0,3,0.0,0.333,0,0,0.0
Kris Dunn,dunnkr01,PG,26,ATL,2021,4,45.0,5,2,0,6,6,2,2,3,10,1,12,0.0833333333333333,0,2,0.0,1,10,0.1,0.083,3,4,0.75
Kevin Durant,duranke01,PF,32,BRK,2021,35,1157.0,943,195,13,234,247,25,45,120,70,324,603,0.5373134328358209,85,189,0.4497354497354497,239,414,0.5772946859903382,0.608,210,238,0.8823529411764706
Anthony Edwards,edwaran01,SG,19,MIN,2021,72,2314.0,1392,211,59,277,336,82,36,160,129,505,1211,0.41701073492981,171,520,0.3288461538461538,334,691,0.4833574529667149,0.488,211,272,0.7757352941176471
Carsen Edwards,edwarca01,SG,22,BOS,2021,31,276.0,123,14,3,23,26,7,1,7,25,47,111,0.4234234234234234,18,63,0.2857142857142857,29,48,0.6041666666666666,0.505,11,13,0.8461538461538461
CJ Elleby,ellebcj01,SF,20,POR,2021,30,192.0,68,10,11,21,32,6,3,5,27,25,66,0.3787878787878788,7,34,0.2058823529411764,18,32,0.5625,0.432,11,15,0.7333333333333333
Henry Ellenson,ellenhe01,PF,24,TOR,2021,2,38.0,15,5,3,9,12,0,0,0,7,5,14,0.3571428571428571,2,9,0.2222222222222222,3,5,0.6,0.429,3,4,0.75
Wayne Ellington,ellinwa01,SG,33,DET,2021,46,1012.0,442,67,12,73,85,18,9,33,59,149,338,0.4408284023668639,116,275,0.4218181818181818,33,63,0.5238095238095238,0.612,28,35,0.8
Joel Embiid,embiijo01,C,26,PHI,2021,51,1585.0,1451,145,113,426,539,50,69,159,123,461,899,0.5127919911012235,58,154,0.3766233766233766,403,745,0.5409395973154363,0.545,471,548,0.8594890510948905
James Ennis III,ennisja01,SF,30,ORL,2021,41,986.0,345,62,43,123,166,32,7,36,84,115,243,0.4732510288065844,45,104,0.4326923076923077,70,139,0.5035971223021583,0.566,70,87,0.8045977011494253
Drew Eubanks,eubandr01,C,23,SAS,2021,54,755.0,311,42,74,167,241,18,49,45,88,116,205,0.5658536585365853,2,2,1.0,114,203,0.5615763546798029,0.571,77,106,0.7264150943396226
Dante Exum,exumda01,SG,25,CLE,2021,6,116.0,23,13,2,15,17,4,2,7,9,10,26,0.3846153846153846,2,11,0.1818181818181818,8,15,0.5333333333333333,0.423,1,2,0.5
Tacko Fall,fallta01,C,25,BOS,2021,19,136.0,47,3,16,36,52,1,20,6,22,21,29,0.7241379310344828,0,0,0.0,21,29,0.7241379310344828,0.724,5,15,0.3333333333333333
Derrick Favors,favorde01,C,29,UTA,2021,68,1039.0,369,44,138,238,376,32,68,36,143,155,243,0.6378600823045267,0,2,0.0,155,241,0.6431535269709544,0.638,59,80,0.7375
Cristiano Felício,feliccr01,C,28,CHI,2021,18,84.0,23,9,10,16,26,4,0,4,10,7,13,0.5384615384615384,0,2,0.0,7,11,0.6363636363636364,0.538,9,16,0.5625
Terrance Ferguson,fergute01,SG,22,PHI,2021,13,49.0,2,2,0,1,1,1,0,4,7,1,7,0.1428571428571428,0,5,0.0,1,2,0.5,0.143,0,0,0.0
Bruno Fernando,fernabr01,C,22,ATL,2021,33,226.0,51,10,16,62,78,4,3,21,23,18,44,0.4090909090909091,0,2,0.0,18,42,0.4285714285714285,0.409,15,22,0.6818181818181818
Yogi Ferrell,ferreyo01,PG,27,TOT,2021,10,136.0,56,22,5,14,19,7,3,3,11,20,57,0.3508771929824561,9,28,0.3214285714285714,11,29,0.3793103448275862,0.43,7,9,0.7777777777777778
Dorian Finney-Smith,finnedo01,PF,27,DAL,2021,60,1921.0,590,102,98,228,326,52,25,48,138,220,466,0.4721030042918455,119,302,0.3940397350993377,101,164,0.6158536585365854,0.6,31,41,0.7560975609756098
Malik Fitts,fittsma01,PF,23,LAC,2021,3,11.0,3,0,0,3,3,0,0,0,3,1,3,0.3333333333333333,1,2,0.5,0,1,0.0,0.5,0,0,0.0
Malachi Flynn,flynnma01,PG,22,TOR,2021,47,928.0,353,137,10,106,116,38,7,43,68,127,340,0.3735294117647059,54,168,0.3214285714285714,73,172,0.4244186046511627,0.453,45,56,0.8035714285714286
Bryn Forbes,forbebr01,SG,27,MIL,2021,70,1354.0,701,45,11,101,112,24,1,44,77,250,529,0.4725897920604915,154,341,0.4516129032258064,96,188,0.5106382978723404,0.618,47,61,0.7704918032786885
Trent Forrest,forretr01,PG,22,UTA,2021,30,302.0,88,45,11,33,44,9,4,21,22,32,71,0.4507042253521127,5,26,0.1923076923076923,27,45,0.6,0.486,19,19,1.0
Evan Fournier,fournev01,SF-SG,28,TOT,2021,42,1259.0,719,144,10,118,128,47,19,73,96,247,541,0.4565619223659889,117,283,0.4134275618374558,130,258,0.5038759689922481,0.565,108,137,0.7883211678832117
De'Aaron Fox,foxde01,PG,23,SAC,2021,58,2036.0,1461,417,33,170,203,87,27,174,170,529,1110,0.4765765765765766,103,320,0.321875,426,790,0.5392405063291139,0.523,300,417,0.7194244604316546
Robert Franks,frankro01,PF,24,ORL,2021,7,101.0,43,5,6,8,14,3,3,2,8,13,28,0.4642857142857143,5,15,0.3333333333333333,8,13,0.6153846153846154,0.554,12,13,0.9230769230769232
Tim Frazier,fraziti01,PG,30,MEM,2021,5,62.0,8,16,0,8,8,2,1,4,7,3,20,0.15,0,8,0.0,3,12,0.25,0.15,2,6,0.3333333333333333
Enes Freedom,kanteen01,C,28,POR,2021,72,1758.0,806,84,284,511,795,33,48,78,168,339,561,0.6042780748663101,1,4,0.25,338,557,0.6068222621184919,0.605,127,164,0.774390243902439
Markelle Fultz,fultzma01,PG,22,ORL,2021,8,215.0,103,43,5,20,25,8,2,18,18,41,104,0.3942307692307692,4,16,0.25,37,88,0.4204545454545454,0.413,17,19,0.8947368421052632
Wenyen Gabriel,gabriwe01,PF,23,NOP,2021,21,241.0,72,11,20,34,54,9,8,15,32,24,60,0.4,13,32,0.40625,11,28,0.3928571428571428,0.508,11,17,0.6470588235294118
Daniel Gafford,gaffoda01,PF-C,22,TOT,2021,54,791.0,380,29,94,137,231,26,75,41,98,154,225,0.6844444444444444,0,0,0.0,154,225,0.6844444444444444,0.684,72,108,0.6666666666666666
Danilo Gallinari,gallida01,PF,32,ATL,2021,51,1222.0,676,76,17,194,211,30,10,43,105,206,475,0.4336842105263158,103,254,0.405511811023622,103,221,0.4660633484162896,0.542,161,174,0.9252873563218392
Langston Galloway,gallola01,SG,29,PHO,2021,40,438.0,190,26,7,35,42,8,0,13,25,66,147,0.4489795918367347,36,85,0.4235294117647059,30,62,0.4838709677419355,0.571,22,23,0.9565217391304348
Darius Garland,garlada01,PG,21,CLE,2021,54,1790.0,941,329,23,106,129,66,6,164,110,362,802,0.4513715710723192,105,266,0.3947368421052631,257,536,0.4794776119402985,0.517,112,132,0.8484848484848485
Marc Gasol,gasolma01,C,36,LAL,2021,52,993.0,262,109,38,177,215,26,58,53,115,88,194,0.4536082474226804,50,122,0.4098360655737705,38,72,0.5277777777777778,0.582,36,50,0.72
Rudy Gay,gayru01,PF,34,SAS,2021,63,1358.0,716,88,42,261,303,45,40,65,115,264,628,0.4203821656050955,106,278,0.381294964028777,158,350,0.4514285714285714,0.505,82,102,0.803921568627451
Paul George,georgpa01,SF,30,LAC,2021,54,1821.0,1259,280,45,314,359,62,24,179,132,445,953,0.4669464847848898,171,416,0.4110576923076923,274,537,0.5102420856610801,0.557,198,228,0.868421052631579
Taj Gibson,gibsota01,C,35,NYK,2021,45,936.0,241,36,99,151,250,31,49,22,99,99,158,0.6265822784810127,3,15,0.2,96,143,0.6713286713286714,0.636,40,55,0.7272727272727273
Harry Giles,gilesha01,C,22,POR,2021,38,348.0,108,29,31,102,133,8,13,20,54,42,97,0.4329896907216495,8,23,0.3478260869565217,34,74,0.4594594594594595,0.474,16,27,0.5925925925925926
Shai Gilgeous-Alexander,gilgesh01,SG,22,OKC,2021,35,1180.0,830,207,19,147,166,27,23,106,70,287,565,0.5079646017699115,71,170,0.4176470588235294,216,395,0.5468354430379747,0.571,185,229,0.8078602620087336
Anthony Gill,gillan01,PF,28,WAS,2021,26,218.0,80,11,16,35,51,10,4,8,27,30,60,0.5,7,24,0.2916666666666667,23,36,0.6388888888888888,0.558,13,16,0.8125
Freddie Gillespie,gillefr01,PF,23,TOR,2021,20,392.0,111,9,42,55,97,13,20,12,43,44,84,0.5238095238095238,0,0,0.0,44,84,0.5238095238095238,0.524,23,33,0.696969696969697
Rudy Gobert,goberru01,C,28,UTA,2021,71,2187.0,1015,89,240,720,960,40,190,118,163,391,579,0.6753022452504318,0,4,0.0,391,575,0.68,0.675,233,374,0.6229946524064172
Brandon Goodwin,goodwbr01,PG,25,ATL,2021,47,620.0,228,95,8,61,69,17,0,36,41,84,223,0.3766816143497757,32,103,0.3106796116504854,52,120,0.4333333333333333,0.448,28,43,0.6511627906976745
Aaron Gordon,gordoaa01,PF,25,TOT,2021,50,1384.0,618,161,77,207,284,33,34,97,89,231,499,0.4629258517034068,59,176,0.3352272727272727,172,323,0.5325077399380805,0.522,97,149,0.6510067114093959
Eric Gordon,gordoer01,SG,32,HOU,2021,27,789.0,481,71,8,50,58,14,13,51,44,159,367,0.4332425068119891,69,210,0.3285714285714285,90,157,0.5732484076433121,0.527,94,114,0.8245614035087719
Devonte' Graham,grahade01,PG,25,CHO,2021,55,1659.0,816,295,22,126,148,48,6,84,77,252,669,0.3766816143497757,179,477,0.3752620545073375,73,192,0.3802083333333333,0.51,133,158,0.8417721518987342
Jerami Grant,grantje01,SF,26,DET,2021,54,1829.0,1205,152,35,215,250,35,58,109,125,400,932,0.4291845493562232,115,329,0.3495440729483283,285,603,0.472636815920398,0.491,290,343,0.8454810495626822
Danny Green,greenda02,SF,33,PHI,2021,69,1934.0,654,118,55,205,260,92,56,67,125,224,544,0.4117647058823529,175,432,0.4050925925925926,49,112,0.4375,0.573,31,40,0.775
Draymond Green,greendr01,PF,30,GSW,2021,63,1982.0,444,558,55,394,449,105,52,188,194,170,380,0.4473684210526316,34,126,0.2698412698412698,136,254,0.5354330708661418,0.492,70,88,0.7954545454545454
JaMychal Green,greenja01,PF,30,DEN,2021,58,1120.0,471,53,85,192,277,26,22,53,144,173,374,0.4625668449197861,79,198,0.398989898989899,94,176,0.5340909090909091,0.568,46,57,0.8070175438596491
Javonte Green,greenja02,SF-SG,27,TOT,2021,41,473.0,146,17,26,45,71,28,6,19,45,53,102,0.5196078431372549,10,30,0.3333333333333333,43,72,0.5972222222222222,0.569,30,40,0.75
Jeff Green,greenje02,C,34,BRK,2021,68,1835.0,750,108,34,229,263,36,27,54,122,261,530,0.4924528301886792,103,250,0.412,158,280,0.5642857142857143,0.59,125,161,0.7763975155279503
Josh Green,greenjo02,SG,20,DAL,2021,39,445.0,101,28,28,50,78,16,3,17,35,42,93,0.4516129032258064,4,25,0.16,38,68,0.5588235294117647,0.473,13,23,0.5652173913043478
Blake Griffin,griffbl01,PF,31,TOT,2021,46,1186.0,505,140,35,190,225,32,15,62,111,174,411,0.4233576642335766,70,205,0.3414634146341463,104,206,0.5048543689320388,0.509,87,117,0.7435897435897436
Kyle Guy,guyky01,PG,23,SAC,2021,31,235.0,87,32,5,30,35,6,0,11,20,29,88,0.3295454545454545,13,46,0.2826086956521739,16,42,0.3809523809523809,0.403,16,20,0.8
Rui Hachimura,hachiru01,PF,22,WAS,2021,57,1797.0,789,82,49,263,312,44,7,68,120,310,648,0.4783950617283951,45,137,0.3284671532846715,265,511,0.5185909980430529,0.513,124,161,0.7701863354037267
Ashton Hagans,haganas01,PG,21,MIN,2021,2,4.0,0,0,0,0,0,0,0,1,0,0,0,0.0,0,0,0.0,0,0,0.0,0.0,0,0,0.0
Tyrese Haliburton,halibty01,PG,20,SAC,2021,58,1746.0,753,309,39,134,173,77,28,92,83,292,619,0.4717285945072698,121,296,0.4087837837837837,171,323,0.5294117647058824,0.569,48,56,0.8571428571428571
Donta Hall,halldo01,PF,23,ORL,2021,13,179.0,73,11,24,38,62,5,10,8,18,25,35,0.7142857142857143,0,0,0.0,25,35,0.7142857142857143,0.714,23,34,0.6764705882352942
Josh Hall,halljo01,SF,20,OKC,2021,21,336.0,86,28,6,53,59,4,1,25,37,30,99,0.303030303030303,4,37,0.1081081081081081,26,62,0.4193548387096774,0.323,22,44,0.5
R.J. Hampton,hamptrj01,SG-PG,19,TOT,2021,51,888.0,354,87,29,150,179,21,10,53,61,136,313,0.4345047923322683,27,87,0.3103448275862069,109,226,0.4823008849557522,0.478,55,82,0.6707317073170732
Tim Hardaway Jr.,hardati02,SG,28,DAL,2021,70,1985.0,1163,126,20,209,229,31,11,64,111,407,911,0.446761800219539,207,529,0.391304347826087,200,382,0.5235602094240838,0.56,142,174,0.8160919540229885
James Harden,hardeja01,PG-SG,31,TOT,2021,44,1609.0,1083,475,35,313,348,53,33,177,99,342,734,0.4659400544959128,121,334,0.3622754491017964,221,400,0.5525,0.548,278,323,0.8606811145510835
Maurice Harkless,harklma01,PF-SF,27,TOT,2021,37,772.0,194,44,13,76,89,30,20,22,86,69,165,0.4181818181818181,23,84,0.2738095238095238,46,81,0.5679012345679012,0.488,33,43,0.7674418604651163
Jared Harper,harpeja01,PG,23,NYK,2021,8,16.0,3,1,0,2,2,0,0,3,1,0,4,0.0,0,1,0.0,0,3,0.0,0.0,3,4,0.75
Montrezl Harrell,harremo01,C,27,LAL,2021,69,1580.0,931,73,158,270,428,46,49,74,128,375,603,0.6218905472636815,0,10,0.0,375,593,0.6323777403035413,0.622,181,256,0.70703125
Gary Harris,harriga01,SG,26,TOT,2021,39,1080.0,388,78,21,58,79,28,11,37,71,138,345,0.4,48,141,0.3404255319148936,90,204,0.4411764705882353,0.47,64,78,0.8205128205128205
Jalen Harris,harrija01,SG,22,TOR,2021,13,172.0,96,17,3,15,18,8,0,14,15,36,72,0.5,17,36,0.4722222222222222,19,36,0.5277777777777778,0.618,7,9,0.7777777777777778
Joe Harris,harrijo01,SF,29,BRK,2021,69,2141.0,974,130,43,205,248,46,14,62,141,357,707,0.504950495049505,211,444,0.4752252252252252,146,263,0.5551330798479087,0.654,49,63,0.7777777777777778
Tobias Harris,harrito02,PF,28,PHI,2021,62,2014.0,1210,220,62,357,419,55,51,107,119,473,924,0.5119047619047619,82,208,0.3942307692307692,391,716,0.5460893854748603,0.556,182,204,0.8921568627450981
Shaquille Harrison,harrish01,SG,27,TOT,2021,34,333.0,73,25,7,41,48,17,5,11,33,26,78,0.3333333333333333,3,16,0.1875,23,62,0.3709677419354839,0.353,18,22,0.8181818181818182
Josh Hart,hartjo01,SF,25,NOP,2021,47,1349.0,434,109,53,324,377,38,12,49,111,151,344,0.438953488372093,63,193,0.3264248704663212,88,151,0.5827814569536424,0.531,69,89,0.7752808988764045
Isaiah Hartenstein,harteis01,C,22,TOT,2021,46,559.0,236,55,65,116,181,19,39,44,104,94,171,0.5497076023391813,2,6,0.3333333333333333,92,165,0.5575757575757576,0.556,46,71,0.647887323943662
Udonis Haslem,hasleud01,C,40,MIA,2021,1,3.0,4,0,0,1,1,0,0,0,0,2,2,1.0,0,0,0.0,2,2,1.0,1.0,0,0,0.0
Jaxson Hayes,hayesja02,C,20,NOP,2021,60,964.0,449,35,92,165,257,25,38,39,101,175,280,0.625,6,14,0.4285714285714285,169,266,0.6353383458646616,0.636,93,120,0.775
Killian Hayes,hayeski01,PG,19,DET,2021,26,670.0,176,138,6,63,69,27,10,83,57,71,201,0.3532338308457711,20,72,0.2777777777777778,51,129,0.3953488372093023,0.403,14,17,0.8235294117647058
Gordon Hayward,haywago01,SF,30,CHO,2021,44,1496.0,863,181,37,221,258,52,14,91,74,311,658,0.4726443768996961,85,205,0.4146341463414634,226,453,0.4988962472406181,0.537,156,185,0.8432432432432433
Juancho Hernangómez,hernaju01,PF,25,MIN,2021,52,900.0,375,35,45,160,205,19,7,27,52,130,299,0.4347826086956521,55,168,0.3273809523809524,75,131,0.5725190839694656,0.527,60,97,0.6185567010309279
Willy Hernangómez,hernawi01,C,26,NOP,2021,47,846.0,365,50,117,217,334,22,23,34,68,151,268,0.5634328358208955,1,10,0.1,150,258,0.5813953488372093,0.565,62,93,0.6666666666666666
Tyler Herro,herroty01,SG,21,MIA,2021,54,1635.0,815,184,25,243,268,35,17,101,71,307,699,0.4391988555078683,107,297,0.3602693602693603,200,402,0.4975124378109453,0.516,94,117,0.8034188034188035
Buddy Hield,hieldbu01,SG,28,SAC,2021,71,2433.0,1176,257,29,305,334,63,30,130,175,403,992,0.40625,282,721,0.391123439667129,121,271,0.4464944649446494,0.548,88,104,0.8461538461538461
George Hill,hillge01,PG,34,TOT,2021,30,672.0,261,73,16,45,61,23,5,31,31,95,197,0.482233502538071,31,80,0.3875,64,117,0.5470085470085471,0.561,40,50,0.8
Solomon Hill,hillso01,PF,29,ATL,2021,71,1513.0,317,75,42,172,214,50,11,42,116,107,298,0.3590604026845637,68,212,0.320754716981132,39,86,0.4534883720930232,0.473,35,46,0.7608695652173914
Nate Hinton,hintona01,SG,21,DAL,2021,21,93.0,41,8,1,8,9,7,2,5,8,15,42,0.3571428571428571,4,19,0.2105263157894736,11,23,0.4782608695652174,0.405,7,10,0.7
Jaylen Hoard,hoardja01,SF,21,OKC,2021,19,320.0,116,24,21,44,65,13,5,17,19,44,88,0.5,0,11,0.0,44,77,0.5714285714285714,0.5,28,41,0.6829268292682927
Aaron Holiday,holidaa01,PG,24,IND,2021,66,1176.0,475,123,15,74,89,46,13,66,94,170,436,0.3899082568807339,67,182,0.3681318681318681,103,254,0.405511811023622,0.467,68,83,0.8192771084337349
Jrue Holiday,holidjr01,PG,30,MIL,2021,59,1907.0,1046,357,73,195,268,96,37,127,98,414,823,0.503037667071689,111,283,0.392226148409894,303,540,0.5611111111111111,0.57,107,136,0.7867647058823529
Justin Holiday,holidju01,SG,31,IND,2021,72,2183.0,756,119,32,224,256,74,41,54,135,258,625,0.4128,173,453,0.3818984547461369,85,172,0.4941860465116279,0.551,67,85,0.788235294117647
Rondae Hollis-Jefferson,holliro01,PF,26,POR,2021,11,107.0,27,13,11,15,26,2,4,2,15,9,18,0.5,0,1,0.0,9,17,0.5294117647058824,0.5,9,16,0.5625
Richaun Holmes,holmeri01,C,27,SAC,2021,61,1782.0,869,101,144,360,504,39,96,75,213,366,575,0.6365217391304347,2,11,0.1818181818181818,364,564,0.6453900709219859,0.638,135,170,0.7941176470588235
Rodney Hood,hoodro01,SF,28,TOT,2021,55,942.0,246,53,23,80,103,24,7,36,74,94,260,0.3615384615384615,34,113,0.3008849557522124,60,147,0.4081632653061224,0.427,24,28,0.8571428571428571
Al Horford,horfoal01,C,34,OKC,2021,28,782.0,398,94,29,159,188,25,26,29,48,162,360,0.45,56,152,0.3684210526315789,106,208,0.5096153846153846,0.528,18,22,0.8181818181818182
Talen Horton-Tucker,hortota01,SG,20,LAL,2021,65,1304.0,585,181,25,144,169,63,21,105,127,224,489,0.4580777096114519,37,131,0.2824427480916031,187,358,0.5223463687150838,0.496,100,129,0.7751937984496124
Danuel House Jr.,houseda01,SF,27,HOU,2021,36,932.0,315,69,18,114,132,20,16,36,67,110,272,0.4044117647058823,54,156,0.3461538461538461,56,116,0.4827586206896552,0.504,41,63,0.6507936507936508
Dwight Howard,howardw01,C,35,PHI,2021,69,1196.0,482,61,190,390,580,30,62,112,200,178,303,0.5874587458745875,5,20,0.25,173,283,0.6113074204946997,0.596,121,210,0.5761904761904761
Markus Howard,howarma02,SG,21,DEN,2021,37,205.0,105,18,1,20,21,4,1,18,23,40,106,0.3773584905660377,18,65,0.2769230769230769,22,41,0.5365853658536586,0.462,7,9,0.7777777777777778
Kevin Huerter,huertke01,SG,22,ATL,2021,69,2126.0,822,241,38,193,231,82,18,79,165,316,731,0.4322845417236662,140,386,0.3626943005181347,176,345,0.5101449275362319,0.528,50,64,0.78125
Elijah Hughes,hugheel01,SF,22,UTA,2021,18,64.0,31,6,1,8,9,1,1,6,1,10,30,0.3333333333333333,8,23,0.3478260869565217,2,7,0.2857142857142857,0.467,3,4,0.75
De'Andre Hunter,huntede01,SF,23,ATL,2021,23,678.0,344,44,17,93,110,19,12,29,59,120,248,0.4838709677419355,31,95,0.3263157894736842,89,153,0.5816993464052288,0.546,73,85,0.8588235294117647
Chandler Hutchison,hutchch01,SF,24,TOT,2021,25,346.0,107,17,6,72,78,12,5,20,33,39,103,0.3786407766990291,8,22,0.3636363636363636,31,81,0.382716049382716,0.417,21,25,0.84
Serge Ibaka,ibakase01,C,31,LAC,2021,41,955.0,454,74,73,202,275,9,47,44,76,186,365,0.5095890410958904,39,115,0.3391304347826087,147,250,0.588,0.563,43,53,0.8113207547169812
Andre Iguodala,iguodan01,SF,37,MIA,2021,63,1339.0,275,142,38,183,221,57,35,67,90,95,248,0.3830645161290322,60,182,0.3296703296703296,35,66,0.5303030303030303,0.504,25,38,0.6578947368421053
Ersan İlyasova,ilyaser01,PF,33,UTA,2021,17,148.0,65,4,7,22,29,10,3,8,29,21,54,0.3888888888888889,18,41,0.4390243902439024,3,13,0.2307692307692307,0.556,5,5,1.0
Joe Ingles,inglejo01,SF,33,UTA,2021,67,1867.0,809,318,27,217,244,45,12,117,120,275,562,0.4893238434163701,183,406,0.4507389162561576,92,156,0.5897435897435898,0.652,76,90,0.8444444444444444
Brandon Ingram,ingrabr01,SF,23,NOP,2021,61,2093.0,1450,296,34,265,299,42,36,154,124,513,1101,0.4659400544959128,143,375,0.3813333333333333,370,726,0.509641873278237,0.531,281,320,0.878125
Kyrie Irving,irvinky01,PG,28,BRK,2021,54,1886.0,1451,324,52,205,257,76,37,130,140,549,1086,0.505524861878453,152,378,0.4021164021164021,397,708,0.5607344632768362,0.576,201,218,0.9220183486238532
Wes Iwundu,iwundwe01,SF,26,TOT,2021,41,539.0,99,18,15,75,90,15,4,19,49,34,102,0.3333333333333333,5,41,0.1219512195121951,29,61,0.4754098360655737,0.358,26,31,0.8387096774193549
Frank Jackson,jacksfr01,PG,22,DET,2021,40,738.0,390,36,15,71,86,15,1,34,53,134,293,0.4573378839590443,61,150,0.4066666666666667,73,143,0.5104895104895105,0.561,61,75,0.8133333333333334
Jaren Jackson Jr.,jacksja02,C,21,MEM,2021,11,258.0,158,12,17,45,62,12,18,15,42,53,125,0.424,17,60,0.2833333333333333,36,65,0.5538461538461539,0.492,35,42,0.8333333333333334
Josh Jackson,jacksjo02,SG,23,DET,2021,62,1560.0,828,143,57,197,254,53,47,142,178,296,707,0.4186704384724187,77,257,0.2996108949416342,219,450,0.4866666666666667,0.473,159,218,0.7293577981651376
Justin Jackson,jacksju01,SF,25,TOT,2021,34,577.0,245,52,16,61,77,15,2,32,32,89,221,0.4027149321266968,36,117,0.3076923076923077,53,104,0.5096153846153846,0.484,31,37,0.8378378378378378
Reggie Jackson,jacksre01,SG,30,LAC,2021,67,1544.0,715,205,24,168,192,41,7,74,127,263,585,0.4495726495726496,122,282,0.4326241134751773,141,303,0.4653465346534653,0.554,67,82,0.8170731707317073
Justin James,jamesju01,SF,24,SAC,2021,36,310.0,139,22,9,21,30,8,3,15,23,52,111,0.4684684684684684,14,38,0.3684210526315789,38,73,0.5205479452054794,0.532,21,36,0.5833333333333334
LeBron James,jamesle01,PG,36,LAL,2021,45,1504.0,1126,350,29,317,346,48,25,168,70,422,823,0.5127582017010935,104,285,0.3649122807017544,318,538,0.5910780669144982,0.576,178,255,0.6980392156862745
Mike James,jamesmi02,PG,30,BRK,2021,13,236.0,100,54,3,29,32,6,1,20,10,34,92,0.3695652173913043,11,31,0.3548387096774194,23,61,0.3770491803278688,0.429,21,27,0.7777777777777778
DaQuan Jeffries,jeffrda01,SG,23,TOT,2021,31,493.0,127,22,19,52,71,15,10,14,48,50,120,0.4166666666666667,20,67,0.2985074626865671,30,53,0.5660377358490566,0.5,7,8,0.875
Ty Jerome,jeromty01,SG,23,OKC,2021,33,788.0,353,120,10,81,91,20,6,47,61,128,287,0.445993031358885,71,168,0.4226190476190476,57,119,0.4789915966386555,0.57,26,34,0.7647058823529411
Isaiah Joe,joeis01,SG,21,PHI,2021,41,383.0,153,20,6,30,36,12,4,11,34,48,133,0.3609022556390977,39,106,0.3679245283018867,9,27,0.3333333333333333,0.508,18,24,0.75
Alize Johnson,johnsal02,PF,24,BRK,2021,18,189.0,94,14,27,63,90,5,5,9,16,40,68,0.5882352941176471,1,6,0.1666666666666666,39,62,0.6290322580645161,0.596,13,13,1.0
Cameron Johnson,johnsca02,PF,24,PHO,2021,60,1437.0,573,86,33,166,199,37,16,40,85,203,483,0.4202898550724637,117,335,0.3492537313432836,86,148,0.581081081081081,0.541,50,59,0.847457627118644
James Johnson,johnsja01,PF,33,TOT,2021,51,1043.0,368,98,32,145,177,42,42,55,120,146,327,0.4464831804281345,31,120,0.2583333333333333,115,207,0.5555555555555556,0.494,45,76,0.5921052631578947
Keldon Johnson,johnske04,SF,21,SAS,2021,69,1968.0,881,121,93,319,412,40,24,78,142,338,705,0.4794326241134752,60,181,0.3314917127071823,278,524,0.5305343511450382,0.522,145,196,0.7397959183673469
Stanley Johnson,johnsst04,PF,24,TOR,2021,61,1006.0,267,89,29,124,153,52,18,54,116,89,233,0.3819742489270386,45,137,0.3284671532846715,44,96,0.4583333333333333,0.479,44,55,0.8
Tyler Johnson,johnsty01,SG,28,BRK,2021,39,684.0,210,47,6,71,77,14,0,17,43,72,183,0.3934426229508196,48,132,0.3636363636363636,24,51,0.4705882352941176,0.525,18,21,0.8571428571428571
Nikola Jokić,jokicni01,C,25,DEN,2021,72,2488.0,1898,599,205,575,780,95,48,222,192,732,1293,0.5661252900232019,92,237,0.3881856540084388,640,1056,0.6060606060606061,0.602,342,394,0.868020304568528
Damian Jones,jonesda03,C,25,TOT,2021,39,547.0,183,29,36,85,121,11,29,26,77,70,103,0.6796116504854369,1,5,0.2,69,98,0.7040816326530612,0.684,42,58,0.7241379310344828
Derrick Jones Jr.,jonesde02,SF,23,POR,2021,58,1318.0,396,47,77,128,205,37,54,32,127,147,304,0.4835526315789473,43,136,0.3161764705882353,104,168,0.6190476190476191,0.554,59,91,0.6483516483516484
Mason Jones,jonesma05,SG,22,TOT,2021,32,334.0,168,42,7,48,55,7,1,29,24,52,123,0.4227642276422764,24,66,0.3636363636363636,28,57,0.4912280701754385,0.52,40,64,0.625
Tre Jones,jonestr01,PG,21,SAS,2021,37,269.0,94,39,8,13,21,8,0,13,13,37,78,0.4743589743589743,3,5,0.6,34,73,0.4657534246575342,0.494,17,19,0.8947368421052632
Tyus Jones,jonesty01,PG,24,MEM,2021,70,1222.0,442,259,21,119,140,64,6,48,31,178,413,0.4309927360774818,45,140,0.3214285714285714,133,273,0.4871794871794871,0.485,41,45,0.9111111111111112
DeAndre Jordan,jordade01,C,32,BRK,2021,57,1246.0,426,93,117,310,427,17,65,85,116,190,249,0.7630522088353414,0,1,0.0,190,248,0.7661290322580645,0.763,46,92,0.5
Cory Joseph,josepco01,PG,29,TOT,2021,63,1446.0,517,213,35,124,159,61,18,79,139,200,426,0.4694835680751174,45,132,0.3409090909090909,155,294,0.5272108843537415,0.522,72,88,0.8181818181818182
Mfiondu Kabengele,kabenmf01,PF,23,TOT,2021,39,280.0,95,17,12,48,60,8,13,15,36,33,89,0.3707865168539326,13,50,0.26,20,39,0.5128205128205128,0.444,16,20,0.8
Frank Kaminsky,kaminfr01,C,27,PHO,2021,47,715.0,310,79,36,152,188,14,17,22,70,121,257,0.4708171206225681,31,85,0.3647058823529411,90,172,0.5232558139534884,0.531,37,60,0.6166666666666667
Luke Kennard,kennalu01,SG,24,LAC,2021,63,1232.0,520,104,15,146,161,23,9,48,91,197,414,0.4758454106280193,100,224,0.4464285714285714,97,190,0.5105263157894737,0.597,26,31,0.8387096774193549
Louis King,kinglo02,SF,21,SAC,2021,6,85.0,44,9,5,13,18,7,3,4,9,17,34,0.5,4,11,0.3636363636363636,13,23,0.5652173913043478,0.559,6,6,1.0
Maxi Kleber,klebima01,PF,29,DAL,2021,50,1341.0,353,68,47,213,260,24,35,30,105,116,275,0.4218181818181818,87,212,0.410377358490566,29,63,0.4603174603174603,0.58,34,37,0.918918918918919
Nathan Knight,knighna01,PF,23,ATL,2021,33,279.0,124,8,27,45,72,9,10,15,22,37,100,0.37,6,33,0.1818181818181818,31,67,0.4626865671641791,0.4,44,55,0.8
Kevin Knox,knoxke01,SF,21,NYK,2021,42,464.0,163,19,10,51,61,12,6,17,37,56,143,0.3916083916083916,35,89,0.3932584269662921,21,54,0.3888888888888889,0.514,16,20,0.8
John Konchar,konchjo01,SG,24,MEM,2021,43,575.0,184,47,35,93,128,30,9,18,40,69,138,0.5,21,56,0.375,48,82,0.5853658536585366,0.576,25,30,0.8333333333333334
Furkan Korkmaz,korkmfu01,SG,23,PHI,2021,55,1062.0,501,82,17,96,113,49,9,46,64,170,424,0.4009433962264151,101,269,0.3754646840148699,69,155,0.4451612903225806,0.52,60,82,0.7317073170731707
Luke Kornet,kornelu01,C-PF,25,TOT,2021,31,348.0,106,24,14,53,67,4,32,7,20,44,101,0.4356435643564356,15,59,0.2542372881355932,29,42,0.6904761904761905,0.51,3,6,0.5
Rodions Kurucs,kurucro01,SF-PF,22,TOT,2021,21,125.0,31,10,5,18,23,9,4,13,16,11,32,0.34375,6,21,0.2857142857142857,5,11,0.4545454545454545,0.438,3,4,0.75
Kyle Kuzma,kuzmaky01,SF,25,LAL,2021,68,1954.0,874,127,108,309,417,35,41,113,121,335,757,0.4425363276089828,137,380,0.3605263157894737,198,377,0.5251989389920424,0.533,67,97,0.6907216494845361
Anthony Lamb,lamban01,SF,23,HOU,2021,24,415.0,133,23,27,43,70,6,5,19,34,46,118,0.3898305084745763,23,71,0.323943661971831,23,47,0.4893617021276595,0.487,18,21,0.8571428571428571
Jeremy Lamb,lambje01,SG,28,IND,2021,36,765.0,363,53,25,106,131,34,23,22,72,120,276,0.4347826086956521,52,128,0.40625,68,148,0.4594594594594595,0.529,71,75,0.9466666666666668
Romeo Langford,langfro01,SG,21,BOS,2021,18,283.0,56,13,12,23,35,6,5,10,24,21,59,0.3559322033898305,5,18,0.2777777777777778,16,41,0.3902439024390244,0.398,9,12,0.75
Zach LaVine,lavinza01,SG,25,CHI,2021,58,2034.0,1591,282,36,253,289,46,27,203,138,569,1123,0.5066785396260017,200,477,0.4192872117400419,369,646,0.5712074303405573,0.596,253,298,0.8489932885906041
Jake Layman,laymaja01,SF,26,MIN,2021,45,627.0,231,28,13,54,67,29,19,26,44,91,184,0.4945652173913043,23,78,0.2948717948717949,68,106,0.6415094339622641,0.557,26,37,0.7027027027027027
T.J. Leaf,leaftj01,PF,23,POR,2021,7,35.0,12,1,0,5,5,2,1,2,1,5,10,0.5,0,0,0.0,5,10,0.5,0.5,2,2,1.0
Jalen Lecque,lecquja01,PG,20,IND,2021,4,12.0,5,2,2,3,5,0,0,0,0,1,9,0.1111111111111111,0,1,0.0,1,8,0.125,0.111,3,3,1.0
Damion Lee,leeda03,SG,28,GSW,2021,57,1079.0,373,73,22,158,180,38,8,30,89,128,274,0.4671532846715328,77,194,0.3969072164948453,51,80,0.6375,0.608,40,44,0.9090909090909092
Saben Lee,leesa01,PG,21,DET,2021,48,781.0,267,174,20,77,97,32,13,55,76,99,210,0.4714285714285714,8,23,0.3478260869565217,91,187,0.4866310160427807,0.49,61,89,0.6853932584269663
Alex Len,lenal01,C,27,TOT,2021,64,979.0,423,49,78,182,260,20,64,55,127,171,278,0.6151079136690647,8,25,0.32,163,253,0.6442687747035574,0.629,73,116,0.6293103448275862
Kawhi Leonard,leonaka01,SF,29,LAC,2021,52,1773.0,1292,269,55,282,337,81,21,105,82,465,908,0.512114537444934,101,254,0.3976377952755905,364,654,0.5565749235474006,0.568,261,295,0.8847457627118644
Meyers Leonard,leoname01,C,28,MIA,2021,3,29.0,10,2,0,7,7,0,0,2,5,3,7,0.4285714285714285,3,7,0.4285714285714285,0,0,0.0,0.643,1,2,0.5
Caris LeVert,leverca01,SG,26,TOT,2021,47,1486.0,948,245,33,181,214,66,30,102,105,359,814,0.441031941031941,84,258,0.3255813953488372,275,556,0.4946043165467625,0.493,146,180,0.8111111111111111
Kira Lewis Jr.,lewiski01,PG,19,NOP,2021,54,904.0,343,124,12,59,71,38,10,34,88,130,337,0.3857566765578635,40,120,0.3333333333333333,90,217,0.4147465437788018,0.445,43,51,0.8431372549019608
Damian Lillard,lillada01,PG,30,POR,2021,67,2398.0,1928,505,32,251,283,62,17,203,102,602,1334,0.4512743628185907,275,704,0.390625,327,630,0.5190476190476191,0.554,449,484,0.9276859504132232
Nassir Little,littlna01,PF,20,POR,2021,48,640.0,220,23,32,96,128,5,13,18,51,78,167,0.467065868263473,28,80,0.35,50,87,0.5747126436781609,0.551,36,45,0.8
Kevon Looney,looneke01,C,24,GSW,2021,61,1161.0,251,119,117,205,322,21,22,37,136,108,197,0.5482233502538071,4,17,0.2352941176470588,104,180,0.5777777777777777,0.558,31,48,0.6458333333333334
Brook Lopez,lopezbr01,C,32,MIL,2021,70,1902.0,859,50,104,243,347,40,103,64,149,322,640,0.503125,95,281,0.3380782918149466,227,359,0.6323119777158774,0.577,120,142,0.8450704225352113
Robin Lopez,lopezro01,C,32,WAS,2021,71,1354.0,642,55,141,131,272,15,44,75,109,269,425,0.6329411764705882,5,18,0.2777777777777778,264,407,0.6486486486486487,0.639,99,137,0.7226277372262774
Didi Louzada,louzama01,SF,21,NOP,2021,3,56.0,8,3,1,2,3,2,0,3,5,3,13,0.2307692307692307,2,8,0.25,1,5,0.2,0.308,0,0,0.0
Kevin Love,loveke01,PF,32,CLE,2021,25,622.0,305,63,17,169,186,16,2,38,26,103,252,0.4087301587301587,57,156,0.3653846153846153,46,96,0.4791666666666667,0.522,42,51,0.8235294117647058
Kyle Lowry,lowryky01,PG,34,TOR,2021,46,1601.0,791,338,35,212,247,45,14,126,143,260,596,0.436241610738255,131,331,0.3957703927492447,129,265,0.4867924528301887,0.546,140,160,0.875
Timothé Luwawu-Cabarrot,luwawti01,SF,25,BRK,2021,58,1050.0,370,69,28,101,129,33,6,43,99,130,356,0.3651685393258427,75,239,0.3138075313807531,55,117,0.4700854700854701,0.471,35,43,0.813953488372093
Trey Lyles,lylestr01,PF,25,SAS,2021,23,358.0,115,14,9,77,86,6,1,6,13,43,90,0.4777777777777778,14,40,0.35,29,50,0.58,0.556,15,23,0.6521739130434783
Will Magnay,magnawi01,C,22,NOP,2021,1,3.0,0,0,0,0,0,0,0,1,1,0,1,0.0,0,1,0.0,0,0,0.0,0.0,0,0,0.0
Thon Maker,makerth01,C,23,CLE,2021,8,76.0,30,4,8,10,18,2,4,3,7,10,18,0.5555555555555556,0,2,0.0,10,16,0.625,0.556,10,11,0.9090909090909092
Théo Maledon,maledth01,PG,19,OKC,2021,65,1778.0,658,227,25,186,211,56,11,141,126,226,614,0.3680781758957654,105,313,0.3354632587859425,121,301,0.4019933554817276,0.454,101,135,0.7481481481481481
Karim Mané,maneka01,PG,20,ORL,2021,10,88.0,11,4,1,13,14,0,2,3,10,3,13,0.2307692307692307,1,2,0.5,2,11,0.1818181818181818,0.269,4,5,0.8
Terance Mann,mannte01,SG,24,LAC,2021,67,1263.0,472,104,56,186,242,29,13,40,126,178,350,0.5085714285714286,38,91,0.4175824175824176,140,259,0.5405405405405406,0.563,78,94,0.8297872340425532
Nico Mannion,mannini01,PG,19,GSW,2021,30,364.0,123,70,6,40,46,16,1,31,29,39,114,0.3421052631578947,22,60,0.3666666666666666,17,54,0.3148148148148148,0.439,23,28,0.8214285714285714
Boban Marjanović,marjabo01,C,32,DAL,2021,33,271.0,156,10,47,81,128,2,6,12,29,62,122,0.5081967213114754,1,8,0.125,61,114,0.5350877192982456,0.512,31,38,0.8157894736842105
Lauri Markkanen,markkla01,PF,23,CHI,2021,51,1317.0,695,45,35,233,268,26,15,52,75,250,521,0.4798464491362764,119,296,0.402027027027027,131,225,0.5822222222222222,0.594,76,92,0.8260869565217391
Naji Marshall,marshna01,SF,23,NOP,2021,32,700.0,246,88,15,133,148,26,10,38,58,82,209,0.3923444976076555,29,83,0.3493975903614458,53,126,0.4206349206349206,0.462,53,75,0.7066666666666667
Caleb Martin,martica02,SF,25,CHO,2021,53,818.0,264,67,31,110,141,37,12,33,62,96,256,0.375,31,125,0.248,65,131,0.4961832061068702,0.436,41,64,0.640625
Cody Martin,martico01,SF,25,CHO,2021,52,849.0,207,86,52,109,161,37,12,40,52,83,188,0.4414893617021276,16,58,0.2758620689655172,67,130,0.5153846153846153,0.484,25,43,0.5813953488372093
Jeremiah Martin,martije02,PG,24,CLE,2021,9,75.0,22,4,2,5,7,5,2,6,1,9,33,0.2727272727272727,3,12,0.25,6,21,0.2857142857142857,0.318,1,5,0.2
Kelan Martin,martike03,SF,25,IND,2021,35,322.0,157,17,18,60,78,10,10,16,35,62,138,0.4492753623188406,24,60,0.4,38,78,0.4871794871794871,0.536,9,10,0.9
Kenyon Martin Jr.,martike04,SF,20,HOU,2021,45,1068.0,419,48,73,169,242,30,41,38,89,162,318,0.5094339622641509,35,96,0.3645833333333333,127,222,0.5720720720720721,0.564,60,84,0.7142857142857143
Frank Mason III,masonfr01,PG,26,ORL,2021,4,79.0,25,12,3,9,12,0,0,5,7,9,24,0.375,2,5,0.4,7,19,0.3684210526315789,0.417,5,7,0.7142857142857143
Garrison Mathews,mathega01,SG,24,WAS,2021,64,1038.0,354,26,16,71,87,29,7,10,106,97,237,0.4092827004219409,76,198,0.3838383838383838,21,39,0.5384615384615384,0.57,84,95,0.8842105263157894
Dakota Mathias,mathida01,SG,25,PHI,2021,8,123.0,48,13,1,6,7,1,3,1,7,19,48,0.3958333333333333,8,26,0.3076923076923077,11,22,0.5,0.479,2,6,0.3333333333333333
Wesley Matthews,matthwe02,SG,34,LAL,2021,58,1130.0,279,54,20,73,93,38,17,26,80,89,252,0.3531746031746032,66,197,0.3350253807106599,23,55,0.4181818181818181,0.484,35,41,0.8536585365853658
Tyrese Maxey,maxeyty01,SG,20,PHI,2021,61,935.0,488,120,11,93,104,26,13,41,79,198,429,0.4615384615384615,31,103,0.3009708737864077,167,326,0.5122699386503068,0.498,61,70,0.8714285714285714
Skylar Mays,mayssk01,SG,23,ATL,2021,33,269.0,124,30,10,25,35,14,2,9,15,44,98,0.4489795918367347,14,40,0.35,30,58,0.5172413793103449,0.52,22,25,0.88
Patrick McCaw,mccawpa01,SF,25,TOR,2021,5,33.0,5,4,1,2,3,2,0,0,6,1,1,1.0,0,0,0.0,1,1,1.0,1.0,3,3,1.0
CJ McCollum,mccolcj01,SG,29,POR,2021,47,1600.0,1087,223,30,155,185,44,21,65,87,405,884,0.4581447963800905,169,420,0.4023809523809524,236,464,0.5086206896551724,0.554,108,133,0.8120300751879699
T.J. McConnell,mccontj01,PG,28,IND,2021,69,1796.0,596,456,55,201,256,128,23,135,113,274,490,0.5591836734693878,15,48,0.3125,259,442,0.5859728506787331,0.574,33,48,0.6875
Jaden McDaniels,mcdanja02,PF,20,MIN,2021,63,1511.0,427,71,52,180,232,35,60,47,172,164,367,0.4468664850136239,72,198,0.3636363636363636,92,169,0.5443786982248521,0.545,27,45,0.6
Jalen McDaniels,mcdanja01,SF,23,CHO,2021,47,904.0,346,53,45,124,169,28,19,45,95,133,284,0.4683098591549295,35,105,0.3333333333333333,98,179,0.547486033519553,0.53,45,64,0.703125
Doug McDermott,mcderdo01,PF,29,IND,2021,66,1619.0,899,85,60,161,221,20,6,53,117,354,665,0.5323308270676692,111,286,0.3881118881118881,243,379,0.6411609498680739,0.616,80,98,0.8163265306122449
Sean McDermott,mcderse01,SF,24,MEM,2021,18,158.0,39,4,6,13,19,2,3,4,8,13,33,0.3939393939393939,5,22,0.2272727272727272,8,11,0.7272727272727273,0.47,8,8,1.0
JaVale McGee,mcgeeja01,C,33,TOT,2021,46,678.0,337,39,77,162,239,19,54,60,121,144,282,0.5106382978723404,5,24,0.2083333333333333,139,258,0.5387596899224806,0.52,44,67,0.6567164179104478
Rodney McGruder,mcgruro01,SG,29,DET,2021,16,194.0,91,16,8,14,22,8,1,7,12,37,70,0.5285714285714286,11,24,0.4583333333333333,26,46,0.5652173913043478,0.607,6,8,0.75
Alfonzo McKinnie,mckinal01,SF,28,LAL,2021,39,258.0,122,6,22,32,54,7,0,5,26,48,93,0.5161290322580645,16,39,0.4102564102564102,32,54,0.5925925925925926,0.602,10,18,0.5555555555555556
Jordan McLaughlin,mclaujo01,PG,24,MIN,2021,51,938.0,256,193,21,87,108,51,6,51,44,100,242,0.4132231404958678,33,92,0.358695652173913,67,150,0.4466666666666666,0.481,23,30,0.7666666666666667
Ben McLemore,mclembe01,SG,27,TOT,2021,53,905.0,406,39,15,85,100,23,9,42,88,135,365,0.3698630136986301,97,280,0.3464285714285714,38,85,0.4470588235294118,0.503,39,53,0.7358490566037735
Nicolò Melli,mellini01,PF,30,TOT,2021,45,566.0,134,44,29,93,122,14,3,12,58,46,141,0.3262411347517731,23,85,0.2705882352941176,23,56,0.4107142857142857,0.408,19,25,0.76
De'Anthony Melton,meltode01,PG,22,MEM,2021,52,1045.0,472,132,30,131,161,60,31,66,85,172,393,0.4376590330788804,87,211,0.4123222748815165,85,182,0.467032967032967,0.548,41,51,0.803921568627451
Sam Merrill,merrisa01,SG,24,MIL,2021,30,233.0,89,21,6,24,30,8,1,10,17,32,72,0.4444444444444444,21,47,0.4468085106382978,11,25,0.44,0.59,4,4,1.0
Chimezie Metu,metuch01,C,23,SAC,2021,36,488.0,226,28,31,81,112,14,18,29,59,91,179,0.5083798882681564,13,37,0.3513513513513513,78,142,0.5492957746478874,0.545,31,43,0.7209302325581395
Khris Middleton,middlkh01,SF,29,MIL,2021,68,2269.0,1385,370,54,352,406,74,9,178,160,511,1074,0.4757914338919926,151,365,0.4136986301369863,360,709,0.5077574047954866,0.546,212,236,0.8983050847457628
Darius Miller,milleda01,SF,30,OKC,2021,18,197.0,73,21,2,22,24,13,5,8,13,22,48,0.4583333333333333,17,42,0.4047619047619047,5,6,0.8333333333333334,0.635,12,12,1.0
Patty Mills,millspa02,PG,32,SAS,2021,68,1685.0,736,162,18,98,116,42,3,66,81,252,611,0.4124386252045826,161,429,0.3752913752913753,91,182,0.5,0.544,71,78,0.9102564102564102
Paul Millsap,millspa01,PF,35,DEN,2021,56,1162.0,502,98,76,186,262,51,36,51,111,191,401,0.4763092269326683,49,143,0.3426573426573426,142,258,0.5503875968992248,0.537,71,98,0.7244897959183674
Shake Milton,miltosh01,SG,24,PHI,2021,63,1461.0,817,193,33,115,148,39,18,103,130,300,667,0.4497751124437781,71,203,0.3497536945812808,229,464,0.4935344827586206,0.503,146,176,0.8295454545454546
Donovan Mitchell,mitchdo01,PG,24,UTA,2021,53,1771.0,1401,277,50,185,235,52,15,147,117,478,1091,0.4381301558203483,178,461,0.386117136659436,300,630,0.4761904761904761,0.52,267,316,0.8449367088607594
Adam Mokoka,mokokad01,SG,22,CHI,2021,14,56.0,15,5,1,4,5,2,1,5,5,7,19,0.3684210526315789,1,10,0.1,6,9,0.6666666666666666,0.395,0,1,0.0
Malik Monk,monkma01,SG,22,CHO,2021,42,878.0,490,87,14,87,101,19,4,55,47,173,399,0.4335839598997493,85,212,0.4009433962264151,88,187,0.4705882352941176,0.54,59,72,0.8194444444444444
E'Twaun Moore,mooreet01,SG,31,PHO,2021,27,389.0,133,40,14,31,45,15,5,23,32,55,121,0.4545454545454545,11,35,0.3142857142857143,44,86,0.5116279069767442,0.5,12,14,0.8571428571428571
Ja Morant,moranja01,PG,21,MEM,2021,63,2053.0,1204,465,59,193,252,57,13,203,87,430,957,0.4493207941483803,73,241,0.3029045643153527,357,716,0.4986033519553072,0.487,271,372,0.728494623655914
Juwan Morgan,morgaju01,PF,23,UTA,2021,29,147.0,35,9,9,19,28,4,1,4,21,14,30,0.4666666666666667,4,13,0.3076923076923077,10,17,0.5882352941176471,0.533,3,7,0.4285714285714285
Marcus Morris,morrima03,PF,31,LAC,2021,57,1502.0,765,58,35,199,234,34,15,57,117,276,584,0.4726027397260274,140,296,0.4729729729729729,136,288,0.4722222222222222,0.592,73,89,0.8202247191011236
Markieff Morris,morrima02,PF,31,LAL,2021,61,1200.0,407,73,48,218,266,22,19,54,105,153,378,0.4047619047619047,65,209,0.3110047846889952,88,169,0.5207100591715976,0.491,36,50,0.72
Monte Morris,morrimo01,PG,25,DEN,2021,47,1196.0,481,150,11,85,96,34,13,34,48,186,387,0.4806201550387597,51,134,0.3805970149253731,135,253,0.5335968379446641,0.547,58,73,0.7945205479452054
Mychal Mulder,muldemy01,PG,26,GSW,2021,60,766.0,337,26,8,52,60,12,12,16,56,119,265,0.4490566037735849,85,214,0.397196261682243,34,51,0.6666666666666666,0.609,14,22,0.6363636363636364
Dejounte Murray,murrade01,PG,24,SAS,2021,67,2139.0,1051,363,58,415,473,101,7,117,135,441,974,0.4527720739219713,63,199,0.3165829145728643,378,775,0.4877419354838709,0.485,106,134,0.7910447761194029
Jamal Murray,murraja01,PG,23,DEN,2021,48,1704.0,1018,231,37,157,194,64,13,108,95,378,792,0.4772727272727273,129,316,0.4082278481012658,249,476,0.523109243697479,0.559,133,153,0.869281045751634
Mike Muscala,muscami01,C,29,OKC,2021,35,645.0,339,28,19,113,132,8,11,21,54,119,267,0.445692883895131,68,184,0.3695652173913043,51,83,0.6144578313253012,0.573,33,36,0.9166666666666666
Svi Mykhailiuk,mykhasv01,SF-SG,23,TOT,2021,66,1324.0,559,110,24,139,163,51,12,88,63,208,506,0.4110671936758893,105,314,0.3343949044585987,103,192,0.5364583333333334,0.515,38,50,0.76
Abdel Nader,naderab01,SF,27,PHO,2021,24,355.0,160,19,7,55,62,10,9,19,34,57,116,0.4913793103448275,18,43,0.4186046511627907,39,73,0.5342465753424658,0.569,28,37,0.7567567567567568
Larry Nance Jr.,nancela02,PF,28,CLE,2021,35,1091.0,327,107,54,181,235,61,17,55,72,128,272,0.4705882352941176,41,114,0.3596491228070175,87,158,0.5506329113924051,0.546,30,49,0.6122448979591837
Aaron Nesmith,nesmiaa01,SF,21,BOS,2021,46,669.0,218,23,28,99,127,15,9,23,87,78,178,0.4382022471910112,40,108,0.3703703703703703,38,70,0.5428571428571428,0.551,22,28,0.7857142857142857
Raul Neto,netora01,PG,28,WAS,2021,64,1403.0,557,146,28,128,156,73,6,53,109,209,447,0.4675615212527964,64,164,0.3902439024390244,145,283,0.5123674911660777,0.539,75,85,0.8823529411764706
Georges Niang,niangge01,PF,27,UTA,2021,72,1154.0,500,59,28,148,176,25,8,51,116,177,405,0.437037037037037,124,292,0.4246575342465753,53,113,0.4690265486725664,0.59,22,23,0.9565217391304348
Zeke Nnaji,nnajize01,PF,20,DEN,2021,42,397.0,136,10,14,51,65,8,4,7,29,50,104,0.4807692307692308,24,59,0.4067796610169492,26,45,0.5777777777777777,0.596,12,15,0.8
Nerlens Noel,noelne01,C,26,NYK,2021,64,1547.0,324,46,142,266,408,70,141,65,176,137,223,0.6143497757847534,0,3,0.0,137,220,0.6227272727272727,0.614,50,70,0.7142857142857143
Jaylen Nowell,nowelja01,SG,21,MIN,2021,42,759.0,379,62,19,76,95,22,12,28,72,142,335,0.4238805970149253,50,150,0.3333333333333333,92,185,0.4972972972972973,0.499,45,55,0.8181818181818182
Frank Ntilikina,ntilila01,PG,22,NYK,2021,33,322.0,89,19,6,25,31,18,4,11,45,29,79,0.3670886075949367,23,48,0.4791666666666667,6,31,0.1935483870967742,0.513,8,18,0.4444444444444444
Kendrick Nunn,nunnke01,PG,25,MIA,2021,56,1650.0,816,148,21,158,179,52,14,80,108,319,658,0.4848024316109423,122,320,0.38125,197,338,0.5828402366863905,0.578,56,60,0.9333333333333332
James Nunnally,nunnaja01,SF,30,NOP,2021,9,48.0,15,3,2,7,9,0,0,2,1,5,13,0.3846153846153846,4,12,0.3333333333333333,1,1,1.0,0.538,1,2,0.5
Jusuf Nurkić,nurkiju01,C,26,POR,2021,37,880.0,424,125,86,246,332,38,39,73,103,171,333,0.5135135135135135,12,30,0.4,159,303,0.5247524752475248,0.532,70,113,0.6194690265486725
David Nwaba,nwabada01,SF,28,HOU,2021,30,679.0,276,31,40,78,118,30,21,17,60,106,218,0.4862385321100917,17,63,0.2698412698412698,89,155,0.5741935483870968,0.525,47,68,0.6911764705882353
Jordan Nwora,nworajo01,SF,22,MIL,2021,30,274.0,171,7,9,51,60,16,7,24,22,62,135,0.4592592592592592,28,62,0.4516129032258064,34,73,0.4657534246575342,0.563,19,25,0.76
Royce O'Neale,onealro01,SF,27,UTA,2021,71,2241.0,496,181,88,397,485,57,32,83,182,175,394,0.4441624365482233,107,278,0.3848920863309352,68,116,0.5862068965517241,0.58,39,46,0.8478260869565217
Semi Ojeleye,ojelese01,PF,26,BOS,2021,56,950.0,260,37,31,116,147,17,0,21,56,89,221,0.4027149321266968,58,158,0.3670886075949367,31,63,0.492063492063492,0.534,24,32,0.75
Jahlil Okafor,okafoja01,C,25,DET,2021,27,347.0,145,13,23,43,66,6,5,21,39,63,102,0.6176470588235294,2,9,0.2222222222222222,61,93,0.6559139784946236,0.627,17,24,0.7083333333333334
Chuma Okeke,okekech01,PF,22,ORL,2021,45,1133.0,349,101,42,139,181,48,22,38,48,135,324,0.4166666666666667,49,141,0.3475177304964539,86,183,0.4699453551912568,0.492,30,40,0.75
Josh Okogie,okogijo01,SG,22,MIN,2021,59,1197.0,316,63,63,93,156,54,28,43,123,102,254,0.4015748031496063,29,108,0.2685185185185185,73,146,0.5,0.459,83,108,0.7685185185185185
Onyeka Okongwu,okongon01,C,20,ATL,2021,50,601.0,228,18,62,101,163,23,33,29,100,96,149,0.6442953020134228,0,3,0.0,96,146,0.6575342465753424,0.644,36,57,0.631578947368421
Isaac Okoro,okorois01,SG,20,CLE,2021,67,2173.0,646,128,68,138,206,62,24,86,185,235,559,0.4203935599284436,62,214,0.2897196261682243,173,345,0.5014492753623189,0.476,114,157,0.7261146496815286
KZ Okpala,okpalkz01,PF,21,MIA,2021,37,447.0,92,19,21,47,68,10,11,15,59,36,96,0.375,12,50,0.24,24,46,0.5217391304347826,0.438,8,15,0.5333333333333333
Victor Oladipo,oladivi01,SG,28,TOT,2021,33,1080.0,652,151,12,148,160,46,14,83,81,235,576,0.4079861111111111,78,239,0.3263598326359833,157,337,0.4658753709198813,0.476,104,138,0.7536231884057971
Cameron Oliver,oliveca01,SF,24,HOU,2021,4,87.0,43,5,5,16,21,2,4,3,11,19,33,0.5757575757575758,4,13,0.3076923076923077,15,20,0.75,0.636,1,4,0.25
Kelly Olynyk,olynyke01,C-PF,29,TOT,2021,70,1997.0,945,203,87,402,489,79,42,126,207,337,697,0.4835007173601148,126,368,0.3423913043478261,211,329,0.6413373860182371,0.574,145,175,0.8285714285714286
Miye Oni,onimi01,SG,23,UTA,2021,54,519.0,105,28,23,61,84,11,8,16,61,35,99,0.3535353535353535,30,88,0.3409090909090909,5,11,0.4545454545454545,0.505,5,6,0.8333333333333334
Cedi Osman,osmande01,SF,25,CLE,2021,59,1510.0,613,174,38,163,201,53,9,80,119,219,586,0.3737201365187713,99,324,0.3055555555555556,120,262,0.4580152671755725,0.458,76,95,0.8
Daniel Oturu,oturuda01,C,21,LAC,2021,30,161.0,54,10,21,27,48,4,7,9,24,22,52,0.4230769230769231,1,5,0.2,21,47,0.4468085106382978,0.433,9,12,0.75
Kelly Oubre Jr.,oubreke01,SF,25,GSW,2021,55,1687.0,849,73,82,247,329,57,42,70,121,318,724,0.4392265193370165,90,285,0.3157894736842105,228,439,0.5193621867881549,0.501,123,177,0.6949152542372882
Jabari Parker,parkeja01,PF,25,TOT,2021,13,165.0,72,11,10,32,42,1,5,10,13,30,55,0.5454545454545454,2,11,0.1818181818181818,28,44,0.6363636363636364,0.564,10,13,0.7692307692307693
Eric Paschall,pascher01,PF,24,GSW,2021,40,695.0,381,51,28,100,128,12,7,43,68,148,298,0.4966442953020134,18,54,0.3333333333333333,130,244,0.5327868852459017,0.527,67,94,0.7127659574468085
Anžejs Pasečņiks,pasecan01,C,25,WAS,2021,1,6.0,0,1,1,0,1,0,0,5,2,0,1,0.0,0,1,0.0,0,0,0.0,0.0,0,0,0.0
Patrick Patterson,pattepa01,PF,31,LAC,2021,38,582.0,197,29,19,56,75,14,8,11,45,72,165,0.4363636363636363,40,112,0.3571428571428571,32,53,0.6037735849056604,0.558,13,17,0.7647058823529411
Justin Patton,pattoju01,C,23,HOU,2021,13,247.0,70,14,14,35,49,12,14,4,34,29,70,0.4142857142857143,9,34,0.2647058823529412,20,36,0.5555555555555556,0.479,3,4,0.75
Chris Paul,paulch01,PG,35,PHO,2021,70,2199.0,1149,622,25,287,312,99,19,156,166,439,879,0.4994311717861205,102,258,0.3953488372093023,337,621,0.5426731078904992,0.557,169,181,0.9337016574585636
Cameron Payne,payneca01,PG,26,PHO,2021,60,1079.0,505,217,16,128,144,36,16,60,97,191,395,0.4835443037974684,73,166,0.4397590361445783,118,229,0.5152838427947598,0.576,50,56,0.8928571428571429
Elfrid Payton,paytoel01,PG,26,NYK,2021,63,1484.0,639,203,64,152,216,47,9,103,116,269,622,0.432475884244373,28,98,0.2857142857142857,241,524,0.4599236641221374,0.455,73,107,0.6822429906542056
Gary Payton II,paytoga02,PG,28,GSW,2021,10,40.0,25,1,2,9,11,6,1,1,8,10,13,0.7692307692307693,2,4,0.5,8,9,0.8888888888888888,0.846,3,4,0.75
Norvel Pelle,pelleno01,C,27,TOT,2021,13,84.0,20,2,6,13,19,1,9,3,14,8,15,0.5333333333333333,0,0,0.0,8,15,0.5333333333333333,0.533,4,6,0.6666666666666666
Reggie Perry,perryre01,PF,20,BRK,2021,26,211.0,78,14,27,46,73,6,6,15,40,32,78,0.4102564102564102,4,21,0.1904761904761904,28,57,0.4912280701754385,0.436,10,13,0.7692307692307693
Theo Pinson,pinsoth01,SG,25,NYK,2021,17,34.0,2,1,0,5,5,0,0,1,4,1,9,0.1111111111111111,0,8,0.0,1,1,1.0,0.111,0,0,0.0
Mason Plumlee,plumlma01,C,30,DET,2021,56,1499.0,581,202,145,374,519,43,50,105,186,234,381,0.6141732283464567,0,7,0.0,234,374,0.6256684491978609,0.614,113,169,0.6686390532544378
Jakob Poeltl,poeltja01,C,25,SAS,2021,69,1845.0,593,134,219,328,547,47,123,83,172,265,430,0.6162790697674418,0,0,0.0,265,430,0.6162790697674418,0.616,63,124,0.5080645161290323
Vincent Poirier,poirivi01,C,27,PHI,2021,10,39.0,8,2,6,8,14,0,3,4,8,3,12,0.25,0,1,0.0,3,11,0.2727272727272727,0.25,2,6,0.3333333333333333
Aleksej Pokusevski,pokusal01,PF,19,OKC,2021,45,1090.0,367,97,30,182,212,20,42,99,58,139,408,0.3406862745098039,58,207,0.2801932367149758,81,201,0.4029850746268656,0.412,31,42,0.7380952380952381
Jordan Poole,poolejo01,SG,21,GSW,2021,51,988.0,612,99,15,77,92,26,9,51,86,205,474,0.4324894514767932,97,276,0.3514492753623188,108,198,0.5454545454545454,0.535,105,119,0.8823529411764706
Jontay Porter,portejo01,PF,21,MEM,2021,11,54.0,22,1,4,10,14,3,1,7,12,8,15,0.5333333333333333,3,8,0.375,5,7,0.7142857142857143,0.633,3,5,0.6
Kevin Porter Jr.,porteke02,SG,20,HOU,2021,26,835.0,431,164,20,79,99,19,8,91,61,156,367,0.4250681198910082,50,161,0.3105590062111801,106,206,0.5145631067961165,0.493,69,94,0.7340425531914894
Michael Porter Jr.,portemi01,SF,22,DEN,2021,61,1912.0,1162,70,91,354,445,40,54,77,126,443,817,0.5422276621787026,170,382,0.4450261780104712,273,435,0.6275862068965518,0.646,106,134,0.7910447761194029
Otto Porter Jr.,porteot01,SF-PF,27,TOT,2021,28,606.0,271,55,28,124,152,16,4,25,41,98,227,0.4317180616740088,39,104,0.375,59,123,0.4796747967479675,0.518,36,42,0.8571428571428571
Bobby Portis,portibo01,C,25,MIL,2021,66,1372.0,754,71,124,342,466,52,26,56,115,313,598,0.5234113712374582,74,157,0.4713375796178344,239,441,0.5419501133786848,0.585,54,73,0.7397260273972602
Kristaps Porziņģis,porzikr01,C,25,DAL,2021,43,1327.0,865,68,82,299,381,20,58,51,115,325,683,0.4758418740849194,97,258,0.375968992248062,228,425,0.5364705882352941,0.547,118,138,0.855072463768116
Dwight Powell,poweldw01,C,29,DAL,2021,58,966.0,342,63,80,154,234,36,30,40,135,120,194,0.6185567010309279,5,21,0.238095238095238,115,173,0.6647398843930635,0.631,97,124,0.782258064516129
Norman Powell,powelno01,SG-SF,27,TOT,2021,69,2205.0,1283,129,42,173,215,82,18,119,160,438,918,0.477124183006536,171,416,0.4110576923076923,267,502,0.5318725099601593,0.57,236,271,0.8708487084870848
Taurean Prince,princta02,PF,26,TOT,2021,41,905.0,389,76,19,123,142,28,23,47,75,131,327,0.400611620795107,62,155,0.4,69,172,0.4011627906976744,0.495,65,76,0.8552631578947368
Payton Pritchard,pritcpa01,SG,23,BOS,2021,66,1268.0,510,120,33,125,158,37,9,53,104,184,418,0.4401913875598086,102,248,0.4112903225806452,82,170,0.4823529411764706,0.562,40,45,0.8888888888888888
Immanuel Quickley,quickim01,PG,21,NYK,2021,64,1243.0,731,127,25,112,137,30,12,58,114,229,580,0.3948275862068965,118,303,0.3894389438943894,111,277,0.4007220216606498,0.497,155,174,0.8908045977011494
Jahmi'us Ramsey,ramseja01,SG,19,SAC,2021,13,94.0,40,6,2,8,10,4,1,3,8,15,38,0.3947368421052631,5,19,0.2631578947368421,10,19,0.5263157894736842,0.461,5,5,1.0
Chasson Randle,randlch01,PG,27,ORL,2021,41,837.0,266,74,7,75,82,22,5,46,64,92,237,0.3881856540084388,44,130,0.3384615384615385,48,107,0.4485981308411215,0.481,38,48,0.7916666666666666
Julius Randle,randlju01,PF,26,NYK,2021,71,2667.0,1712,427,84,639,723,64,18,241,225,602,1321,0.4557153671461014,160,389,0.4113110539845758,442,932,0.4742489270386266,0.516,348,429,0.8111888111888111
Cam Reddish,reddica01,SF,21,ATL,2021,26,750.0,292,35,22,82,104,33,9,34,68,96,263,0.3650190114068441,33,126,0.2619047619047619,63,137,0.4598540145985401,0.428,67,82,0.8170731707317073
J.J. Redick,redicjj01,SG,36,TOT,2021,44,723.0,327,51,4,60,64,11,3,36,50,106,267,0.3970037453183521,66,178,0.3707865168539326,40,89,0.449438202247191,0.521,49,52,0.9423076923076924
Paul Reed,reedpa01,PF,21,PHI,2021,26,177.0,88,12,30,31,61,10,13,12,29,42,78,0.5384615384615384,0,6,0.0,42,72,0.5833333333333334,0.538,4,8,0.5
Naz Reid,reidna01,C,21,MIN,2021,70,1347.0,784,72,82,240,322,34,76,69,179,304,581,0.5232358003442341,61,174,0.3505747126436782,243,407,0.597051597051597,0.576,115,166,0.6927710843373494
Cameron Reynolds,reynoca01,SF,25,TOT,2021,5,40.0,15,2,2,3,5,0,0,0,2,6,18,0.3333333333333333,3,12,0.25,3,6,0.5,0.417,0,0,0.0
Nick Richards,richani01,PF,23,CHO,2021,18,63.0,15,2,4,7,11,0,0,3,7,4,9,0.4444444444444444,0,1,0.0,4,8,0.5,0.444,7,11,0.6363636363636364
Josh Richardson,richajo01,SG,27,DAL,2021,59,1790.0,715,153,51,144,195,61,24,79,130,264,618,0.4271844660194174,88,267,0.3295880149812734,176,351,0.5014245014245015,0.498,99,108,0.9166666666666666
Grant Riller,rillegr01,PG,23,CHO,2021,7,27.0,18,3,0,1,1,1,0,1,0,8,12,0.6666666666666666,2,4,0.5,6,8,0.75,0.75,0,0,0.0
Austin Rivers,riverau01,SG,28,TOT,2021,36,845.0,285,81,8,74,82,30,2,36,64,104,245,0.4244897959183673,55,149,0.3691275167785235,49,96,0.5104166666666666,0.537,22,31,0.7096774193548387
Andre Roberson,roberan03,SG,29,BRK,2021,5,63.0,6,4,7,8,15,3,1,2,4,2,14,0.1428571428571428,1,8,0.125,1,6,0.1666666666666666,0.179,1,2,0.5
Duncan Robinson,robindu01,SF,26,MIA,2021,72,2262.0,942,127,7,243,250,43,20,81,181,315,717,0.4393305439330544,250,613,0.4078303425774878,65,104,0.625,0.614,62,75,0.8266666666666667
Glenn Robinson III,robingl02,SF,27,SAC,2021,23,369.0,121,20,11,34,45,4,3,11,23,42,99,0.4242424242424242,16,44,0.3636363636363636,26,55,0.4727272727272727,0.505,21,23,0.9130434782608696
Jerome Robinson,robinje01,SG,23,WAS,2021,17,305.0,83,25,4,34,38,12,6,19,31,28,95,0.2947368421052631,11,42,0.2619047619047619,17,53,0.320754716981132,0.353,16,20,0.8
Justin Robinson,robinju01,PG,23,OKC,2021,9,88.0,21,9,1,6,7,3,0,2,10,7,21,0.3333333333333333,4,14,0.2857142857142857,3,7,0.4285714285714285,0.429,3,5,0.6
Mitchell Robinson,robinmi01,C,22,NYK,2021,31,853.0,256,17,113,139,252,35,45,26,86,115,176,0.6534090909090909,0,0,0.0,115,176,0.6534090909090909,0.653,26,53,0.490566037735849
Isaiah Roby,robyis01,PF,22,OKC,2021,61,1425.0,533,107,89,252,341,52,37,113,162,207,429,0.4825174825174825,32,109,0.2935779816513761,175,320,0.546875,0.52,87,117,0.7435897435897436
Rajon Rondo,rondora01,PG,34,TOT,2021,45,770.0,242,199,18,92,110,37,4,79,53,95,215,0.4418604651162791,36,89,0.4044943820224719,59,126,0.4682539682539682,0.526,16,17,0.9411764705882352
Derrick Rose,rosede01,PG,32,TOT,2021,50,1279.0,734,209,20,110,130,49,19,78,56,287,611,0.469721767594108,50,129,0.3875968992248062,237,482,0.491701244813278,0.511,110,127,0.8661417322834646
Terrence Ross,rosste01,SG,29,ORL,2021,46,1347.0,717,108,15,143,158,47,21,74,88,254,616,0.4123376623376623,89,264,0.3371212121212121,165,352,0.46875,0.485,120,138,0.8695652173913043
Terry Rozier,roziete01,SG,26,CHO,2021,69,2383.0,1407,293,47,255,302,87,26,128,119,510,1134,0.4497354497354497,222,571,0.3887915936952714,288,563,0.5115452930728241,0.548,165,202,0.8168316831683168
Ricky Rubio,rubiori01,PG,30,MIN,2021,68,1772.0,582,433,28,195,223,98,4,111,139,193,498,0.3875502008032128,66,214,0.308411214953271,127,284,0.4471830985915493,0.454,130,150,0.8666666666666667
D'Angelo Russell,russeda01,PG,24,MIN,2021,42,1196.0,796,244,16,95,111,45,18,112,68,281,652,0.4309815950920245,120,310,0.3870967741935484,161,342,0.4707602339181286,0.523,114,149,0.7651006711409396
Domantas Sabonis,sabondo01,PF,24,IND,2021,62,2231.0,1260,415,150,592,742,76,33,213,203,484,904,0.5353982300884956,52,162,0.3209876543209876,432,742,0.5822102425876011,0.564,240,328,0.7317073170731707
Luka Šamanić,samanlu01,PF,21,SAS,2021,33,308.0,122,15,16,52,68,8,8,20,43,47,105,0.4476190476190476,12,43,0.2790697674418604,35,62,0.5645161290322581,0.505,16,29,0.5517241379310345
JaKarr Sampson,sampsja02,PF,27,IND,2021,29,316.0,134,4,27,50,77,2,14,15,52,56,113,0.495575221238938,3,15,0.2,53,98,0.5408163265306123,0.509,19,29,0.6551724137931034
Dario Šarić,saricda01,C,26,PHO,2021,50,871.0,437,65,46,144,190,30,4,57,95,153,342,0.4473684210526316,47,135,0.3481481481481481,106,207,0.5120772946859904,0.516,84,99,0.8484848484848485
Tomáš Satoranský,satorto01,SG,29,CHI,2021,58,1307.0,447,271,30,112,142,40,14,96,89,169,329,0.513677811550152,42,118,0.3559322033898305,127,211,0.6018957345971564,0.578,67,79,0.8481012658227848
Dennis Schröder,schrode01,SG,27,LAL,2021,61,1956.0,941,351,30,181,211,70,13,163,159,332,760,0.4368421052631579,71,212,0.3349056603773584,261,548,0.4762773722627737,0.484,206,243,0.8477366255144033
Mike Scott,scottmi01,PF,32,PHI,2021,51,852.0,213,40,11,109,120,24,14,19,72,76,211,0.3601895734597156,53,155,0.3419354838709677,23,56,0.4107142857142857,0.486,8,12,0.6666666666666666
Jay Scrubb,scrubja01,SG,20,LAC,2021,4,84.0,35,1,2,12,14,4,0,7,5,14,36,0.3888888888888889,2,9,0.2222222222222222,12,27,0.4444444444444444,0.417,5,5,1.0
Collin Sexton,sextoco01,SG,22,CLE,2021,60,2115.0,1460,262,58,129,187,62,10,167,157,525,1105,0.4751131221719457,98,264,0.3712121212121212,427,841,0.5077288941736029,0.519,312,383,0.814621409921671
Landry Shamet,shamela01,SG,23,BRK,2021,61,1403.0,567,99,11,101,112,31,10,48,93,186,456,0.4078947368421052,129,333,0.3873873873873873,57,123,0.4634146341463415,0.549,66,78,0.8461538461538461
Iman Shumpert,shumpim01,SG,30,BRK,2021,2,11.0,2,0,1,0,1,1,0,1,0,1,4,0.25,0,3,0.0,1,1,1.0,0.25,0,0,0.0
Pascal Siakam,siakapa01,PF,26,TOR,2021,56,2006.0,1196,250,95,310,405,64,37,130,174,437,961,0.4547346514047867,73,246,0.2967479674796748,364,715,0.509090909090909,0.493,249,301,0.8272425249169435
Chris Silva,silvach01,PF,24,TOT,2021,15,92.0,32,6,7,20,27,1,6,10,24,10,16,0.625,1,1,1.0,9,15,0.6,0.656,11,15,0.7333333333333333
Ben Simmons,simmobe01,PG,24,PHI,2021,58,1877.0,829,401,93,324,417,93,35,173,171,325,583,0.5574614065180102,3,10,0.3,322,573,0.5619546247818499,0.56,176,287,0.6132404181184669
Anfernee Simons,simonan01,SG,21,POR,2021,64,1104.0,502,89,14,126,140,18,8,43,96,168,401,0.4189526184538653,120,282,0.425531914893617,48,119,0.4033613445378151,0.569,46,57,0.8070175438596491
Deividas Sirvydis,sirvyde01,SG,20,DET,2021,20,133.0,41,5,0,29,29,2,0,5,9,14,40,0.35,10,28,0.3571428571428571,4,12,0.3333333333333333,0.475,3,6,0.5
Alen Smailagić,smailal01,PF,20,GSW,2021,15,84.0,28,4,6,10,16,3,5,5,11,11,27,0.4074074074074074,4,10,0.4,7,17,0.4117647058823529,0.481,2,6,0.3333333333333333
Marcus Smart,smartma01,PG,26,BOS,2021,48,1581.0,627,273,36,131,167,72,23,96,126,203,510,0.3980392156862745,93,282,0.3297872340425531,110,228,0.4824561403508772,0.489,128,162,0.7901234567901234
Dennis Smith Jr.,smithde03,PG,23,TOT,2021,23,420.0,154,77,12,43,55,23,14,26,37,58,145,0.4,19,58,0.3275862068965517,39,87,0.4482758620689655,0.466,19,26,0.7307692307692307
Ish Smith,smithis01,PG,32,WAS,2021,44,924.0,295,172,22,128,150,32,13,41,62,129,297,0.4343434343434343,18,49,0.3673469387755102,111,248,0.4475806451612903,0.465,19,33,0.5757575757575758
Jalen Smith,smithja04,PF,20,PHO,2021,27,156.0,53,4,7,30,37,1,5,7,16,22,50,0.44,4,17,0.2352941176470588,18,33,0.5454545454545454,0.48,5,7,0.7142857142857143
Tony Snell,snellto01,SG,29,ATL,2021,47,992.0,249,59,18,94,112,13,11,21,75,88,171,0.5146198830409356,62,109,0.5688073394495413,26,62,0.4193548387096774,0.696,11,11,1.0
Ray Spalding,spaldra01,C,23,HOU,2021,2,19.0,4,0,2,2,4,0,2,3,3,2,4,0.5,0,1,0.0,2,3,0.6666666666666666,0.5,0,2,0.0
Cassius Stanley,stanlca01,SG,21,IND,2021,24,93.0,36,1,8,12,20,1,2,1,14,13,43,0.3023255813953488,3,13,0.2307692307692307,10,30,0.3333333333333333,0.337,7,9,0.7777777777777778
Lamar Stevens,stevela01,PF,23,CLE,2021,40,499.0,165,25,24,72,96,17,13,23,53,62,136,0.4558823529411764,4,25,0.16,58,111,0.5225225225225225,0.471,37,51,0.7254901960784313
Isaiah Stewart,stewais01,C,19,DET,2021,68,1455.0,537,59,159,294,453,39,86,67,184,226,409,0.5525672371638142,21,63,0.3333333333333333,205,346,0.5924855491329479,0.578,64,92,0.6956521739130435
Max Strus,strusma01,SF,24,MIA,2021,39,507.0,236,24,5,36,41,11,2,8,43,85,187,0.4545454545454545,50,148,0.3378378378378378,35,39,0.8974358974358975,0.588,16,24,0.6666666666666666
Edmond Sumner,sumneed01,SG,25,IND,2021,53,861.0,399,49,18,76,94,33,10,51,88,148,282,0.524822695035461,35,88,0.3977272727272727,113,194,0.5824742268041238,0.587,68,83,0.8192771084337349
Jae'Sean Tate,tateja01,SF,25,HOU,2021,70,2043.0,794,178,132,242,374,85,36,98,222,316,625,0.5056,60,195,0.3076923076923077,256,430,0.5953488372093023,0.554,102,147,0.6938775510204082
Jayson Tatum,tatumja01,SF,22,BOS,2021,64,2290.0,1692,276,50,422,472,75,31,171,122,605,1318,0.4590288315629742,187,485,0.3855670103092783,418,833,0.5018007202881153,0.53,295,340,0.8676470588235294
Jeff Teague,teaguje01,PG,32,TOT,2021,55,950.0,371,132,15,73,88,34,12,64,56,123,284,0.4330985915492957,36,82,0.4390243902439024,87,202,0.4306930693069307,0.496,89,105,0.8476190476190476
Garrett Temple,templga01,SG,34,CHI,2021,56,1528.0,423,124,29,131,160,43,30,58,126,158,381,0.4146981627296588,67,200,0.335,91,181,0.5027624309392266,0.503,40,50,0.8
Tyrell Terry,terryty01,PG,20,DAL,2021,11,56.0,11,6,0,6,6,5,0,2,2,5,16,0.3125,0,7,0.0,5,9,0.5555555555555556,0.313,1,3,0.3333333333333333
Daniel Theis,theisda01,C,28,TOT,2021,65,1601.0,627,108,93,263,356,41,57,66,167,252,466,0.5407725321888412,49,152,0.3223684210526316,203,314,0.6464968152866242,0.593,74,110,0.6727272727272727
Brodric Thomas,thomabr01,SG,24,TOT,2021,32,399.0,125,30,8,45,53,15,10,22,40,39,108,0.3611111111111111,16,59,0.2711864406779661,23,49,0.4693877551020408,0.435,31,46,0.6739130434782609
Isaiah Thomas,thomais02,PG,31,NOP,2021,3,48.0,23,5,1,3,4,1,0,6,3,9,27,0.3333333333333333,3,12,0.25,6,15,0.4,0.389,2,2,1.0
Khyri Thomas,thomakh01,SG,24,HOU,2021,5,153.0,82,25,7,11,18,9,6,6,8,32,66,0.4848484848484848,9,27,0.3333333333333333,23,39,0.5897435897435898,0.553,9,9,1.0
Matt Thomas,thomama02,SG,26,TOT,2021,45,326.0,139,19,7,37,44,4,0,14,18,50,127,0.3937007874015748,27,80,0.3375,23,47,0.4893617021276595,0.5,12,14,0.8571428571428571
Tristan Thompson,thomptr01,PF,29,BOS,2021,54,1287.0,409,67,169,270,439,24,33,62,119,169,326,0.5184049079754601,0,3,0.0,169,323,0.5232198142414861,0.518,71,120,0.5916666666666667
Sindarius Thornwell,thornsi01,SG,26,TOT,2021,21,217.0,41,21,3,15,18,13,2,7,15,15,46,0.3260869565217391,7,23,0.3043478260869565,8,23,0.3478260869565217,0.402,4,8,0.5
Matisse Thybulle,thybuma01,SG,23,PHI,2021,65,1298.0,255,63,30,94,124,105,71,32,127,102,243,0.419753086419753,43,143,0.3006993006993007,59,100,0.59,0.508,8,18,0.4444444444444444
Killian Tillie,tilliki02,C,22,MEM,2021,18,182.0,57,8,6,18,24,5,8,2,20,19,57,0.3333333333333333,10,33,0.303030303030303,9,24,0.375,0.421,9,11,0.8181818181818182
Xavier Tillman Sr.,tillmxa01,PF,22,MEM,2021,59,1085.0,390,75,74,182,256,44,33,45,116,167,299,0.5585284280936454,22,65,0.3384615384615385,145,234,0.6196581196581197,0.595,34,53,0.6415094339622641
Anthony Tolliver,tollian01,PF,35,PHI,2021,11,99.0,17,2,3,7,10,3,2,3,7,4,17,0.2352941176470588,4,14,0.2857142857142857,0,3,0.0,0.353,5,6,0.8333333333333334
Obi Toppin,toppiob01,PF,22,NYK,2021,62,683.0,253,29,26,112,138,17,15,23,55,104,209,0.4976076555023923,26,85,0.3058823529411765,78,124,0.6290322580645161,0.56,19,26,0.7307692307692307
Juan Toscano-Anderson,toscaju01,SG,27,GSW,2021,53,1107.0,301,150,29,205,234,41,26,61,111,121,209,0.5789473684210527,37,92,0.4021739130434782,84,117,0.717948717948718,0.667,22,31,0.7096774193548387
Axel Toupane,toupaax01,SF,28,MIL,2021,8,61.0,14,4,0,6,6,2,3,0,6,4,11,0.3636363636363636,1,2,0.5,3,9,0.3333333333333333,0.409,5,7,0.7142857142857143
Karl-Anthony Towns,townska01,C,25,MIN,2021,50,1689.0,1239,225,133,396,529,39,57,160,186,425,875,0.4857142857142857,122,315,0.3873015873015873,303,560,0.5410714285714285,0.555,267,311,0.8585209003215434
Gary Trent Jr.,trentga02,SG,22,TOT,2021,58,1802.0,888,80,27,125,152,56,10,43,92,320,785,0.4076433121019108,165,429,0.3846153846153846,155,356,0.4353932584269663,0.513,83,106,0.7830188679245284
P.J. Tucker,tuckepj01,PF,35,TOT,2021,52,1356.0,193,61,51,153,204,39,20,40,125,66,177,0.3728813559322034,40,119,0.3361344537815126,26,58,0.4482758620689655,0.486,21,28,0.75
Rayjon Tucker,tuckera01,PG,23,PHI,2021,14,68.0,34,6,1,10,11,2,0,4,8,9,18,0.5,2,7,0.2857142857142857,7,11,0.6363636363636364,0.556,14,19,0.7368421052631579
Myles Turner,turnemy01,C,24,IND,2021,47,1455.0,592,48,63,243,306,40,159,67,165,206,432,0.4768518518518518,69,206,0.3349514563106796,137,226,0.6061946902654868,0.557,111,142,0.7816901408450704
Jonas Valančiūnas,valanjo01,C,28,MEM,2021,62,1755.0,1058,112,253,523,776,35,57,100,179,440,743,0.5921938088829072,21,57,0.3684210526315789,419,686,0.6107871720116618,0.606,157,203,0.7733990147783252
Denzel Valentine,valende01,SG,27,CHI,2021,62,1036.0,406,105,24,173,197,30,7,42,70,155,416,0.3725961538461538,80,242,0.3305785123966942,75,174,0.4310344827586206,0.469,16,17,0.9411764705882352
Jarred Vanderbilt,vandeja01,PF,21,MIN,2021,64,1139.0,344,76,118,250,368,64,46,53,123,143,236,0.6059322033898306,1,5,0.2,142,231,0.6147186147186147,0.608,57,102,0.5588235294117647
Fred VanVleet,vanvlfr01,SG,26,TOR,2021,52,1899.0,1019,328,32,188,220,87,37,95,119,338,870,0.3885057471264367,174,476,0.3655462184873949,164,394,0.416243654822335,0.489,169,191,0.8848167539267016
Anderson Varejão,varejan01,C,38,CLE,2021,5,36.0,13,3,7,13,20,0,2,1,3,4,16,0.25,0,1,0.0,4,15,0.2666666666666666,0.25,5,9,0.5555555555555556
Devin Vassell,vassede01,SF,20,SAS,2021,62,1056.0,341,56,24,150,174,43,18,22,88,123,303,0.4059405940594059,52,150,0.3466666666666667,71,153,0.4640522875816993,0.492,43,51,0.8431372549019608
Gabe Vincent,vincega01,PG,24,MIA,2021,50,655.0,242,67,10,46,56,21,2,34,79,88,233,0.3776824034334764,46,149,0.3087248322147651,42,84,0.5,0.476,20,23,0.8695652173913043
Noah Vonleh,vonleno01,PF,25,BRK,2021,4,11.0,0,1,0,1,1,0,0,2,2,0,3,0.0,0,2,0.0,0,1,0.0,0.0,0,0,0.0
Nikola Vučević,vucevni01,C,30,TOT,2021,70,2348.0,1639,269,146,671,817,65,48,126,137,666,1396,0.4770773638968481,176,440,0.4,490,956,0.5125523012552301,0.54,131,156,0.8397435897435898
Dean Wade,wadede01,PF,24,CLE,2021,63,1212.0,376,74,38,177,215,35,21,30,78,134,311,0.4308681672025723,78,213,0.3661971830985915,56,98,0.5714285714285714,0.556,30,39,0.7692307692307693
Moritz Wagner,wagnemo01,C,23,TOT,2021,45,722.0,310,50,27,119,146,26,18,43,108,104,229,0.4541484716157205,31,91,0.3406593406593406,73,138,0.5289855072463768,0.522,71,87,0.8160919540229885
Kemba Walker,walkeke02,PG,30,BOS,2021,43,1369.0,829,212,16,154,170,48,12,88,61,284,676,0.4201183431952662,127,353,0.3597733711048159,157,323,0.4860681114551083,0.514,134,149,0.8993288590604027
Lonnie Walker IV,walkelo01,SG,22,SAS,2021,60,1522.0,669,101,14,141,155,29,15,65,101,256,609,0.4203612479474548,100,282,0.3546099290780142,156,327,0.4770642201834862,0.502,57,70,0.8142857142857143
John Wall,walljo01,PG,30,HOU,2021,40,1288.0,823,275,17,112,129,42,31,141,46,293,726,0.4035812672176309,79,249,0.3172690763052209,214,477,0.4486373165618448,0.458,158,211,0.7488151658767772
Brad Wanamaker,wanambr01,PG,31,TOT,2021,61,1053.0,336,174,18,87,105,43,11,71,94,115,299,0.3846153846153846,16,85,0.188235294117647,99,214,0.4626168224299065,0.411,90,101,0.8910891089108911
T.J. Warren,warretj01,SF,27,IND,2021,4,117.0,62,5,2,12,14,2,0,4,16,27,51,0.5294117647058824,0,7,0.0,27,44,0.6136363636363636,0.529,8,10,0.8
P.J. Washington,washipj01,PF,22,CHO,2021,64,1954.0,824,161,93,325,418,69,79,128,171,302,686,0.4402332361516035,112,290,0.3862068965517241,190,396,0.4797979797979798,0.522,108,145,0.7448275862068966
Yuta Watanabe,watanyu01,SF,26,TOR,2021,50,723.0,218,40,36,123,159,26,19,19,57,79,180,0.4388888888888889,36,90,0.4,43,90,0.4777777777777778,0.539,24,29,0.8275862068965517
Tremont Waters,watertr01,PG,23,BOS,2021,26,238.0,99,62,5,16,21,15,1,27,17,34,84,0.4047619047619047,15,38,0.3947368421052631,19,46,0.4130434782608695,0.494,16,17,0.9411764705882352
Paul Watson,watsopa01,SF,26,TOR,2021,27,297.0,111,17,4,41,45,6,3,9,36,38,82,0.4634146341463415,30,64,0.46875,8,18,0.4444444444444444,0.646,5,8,0.625
Quinndary Weatherspoon,weathqu01,SG,24,SAS,2021,20,121.0,46,8,3,8,11,8,2,10,18,16,35,0.4571428571428571,1,6,0.1666666666666666,15,29,0.5172413793103449,0.471,13,16,0.8125
Russell Westbrook,westbru01,PG,32,WAS,2021,65,2369.0,1445,763,109,641,750,89,23,312,190,544,1238,0.4394184168012924,86,273,0.315018315018315,458,965,0.4746113989637305,0.474,271,413,0.6561743341404358
Coby White,whiteco01,PG,20,CHI,2021,69,2156.0,1041,328,28,256,284,38,15,156,179,375,902,0.4157427937915743,163,454,0.3590308370044053,212,448,0.4732142857142857,0.506,128,142,0.9014084507042254
Derrick White,whitede01,SG,26,SAS,2021,36,1064.0,553,127,13,94,107,26,36,45,91,186,453,0.4105960264900662,84,243,0.345679012345679,102,210,0.4857142857142857,0.503,97,114,0.8508771929824561
Hassan Whiteside,whiteha01,C,31,SAC,2021,36,546.0,293,20,61,154,215,9,46,40,73,126,224,0.5625,0,1,0.0,126,223,0.5650224215246636,0.563,41,79,0.5189873417721519
Greg Whittington,whittgr01,PF,27,DEN,2021,4,12.0,0,0,0,0,0,0,0,0,0,0,3,0.0,0,2,0.0,0,1,0.0,0.0,0,0,0.0
Andrew Wiggins,wiggian01,PF,25,GSW,2021,71,2364.0,1320,167,82,265,347,67,70,126,159,505,1058,0.4773156899810964,140,368,0.3804347826086957,365,690,0.5289855072463768,0.543,170,238,0.7142857142857143
Grant Williams,willigr01,PF,22,BOS,2021,63,1138.0,294,64,48,130,178,32,24,56,161,108,247,0.437246963562753,48,129,0.3720930232558139,60,118,0.5084745762711864,0.534,30,51,0.5882352941176471
Kenrich Williams,willike04,PF,26,OKC,2021,66,1426.0,526,152,84,189,273,55,17,76,143,219,411,0.5328467153284672,52,117,0.4444444444444444,167,294,0.5680272108843537,0.596,36,63,0.5714285714285714
Lou Williams,willilo02,PG,34,TOT,2021,66,1423.0,749,225,21,117,138,47,6,108,62,265,646,0.4102167182662539,69,173,0.3988439306358382,196,473,0.4143763213530655,0.464,150,173,0.8670520231213873
Patrick Williams,willipa01,PF,19,CHI,2021,71,1983.0,655,99,66,261,327,64,46,98,126,255,528,0.4829545454545454,54,138,0.391304347826087,201,390,0.5153846153846153,0.534,91,125,0.728
Robert Williams,williro04,C,23,BOS,2021,52,985.0,417,94,133,225,358,43,91,52,105,186,258,0.7209302325581395,0,2,0.0,186,256,0.7265625,0.721,45,73,0.6164383561643836
Zion Williamson,willizi01,PF,20,NOP,2021,61,2026.0,1647,226,167,274,441,57,39,167,135,634,1037,0.6113789778206364,10,34,0.2941176470588235,624,1003,0.6221335992023929,0.616,369,529,0.6975425330812854
D.J. Wilson,wilsodj01,PF,24,TOT,2021,35,433.0,183,23,20,92,112,11,16,22,44,68,168,0.4047619047619047,30,87,0.3448275862068966,38,81,0.4691358024691358,0.494,17,25,0.68
Dylan Windler,windldy01,SF,24,CLE,2021,31,513.0,161,33,20,87,107,19,12,32,37,57,130,0.4384615384615384,26,77,0.3376623376623376,31,53,0.5849056603773585,0.538,21,27,0.7777777777777778
Justise Winslow,winslju01,SF,24,MEM,2021,26,507.0,178,50,18,100,118,15,12,37,47,74,210,0.3523809523809524,10,54,0.1851851851851851,64,156,0.4102564102564102,0.376,20,35,0.5714285714285714
Cassius Winston,winstca01,PG,22,WAS,2021,22,98.0,41,12,0,9,9,2,1,5,8,14,33,0.4242424242424242,8,17,0.4705882352941176,6,16,0.375,0.545,5,6,0.8333333333333334
James Wiseman,wisemja01,C,19,GSW,2021,39,836.0,448,26,55,171,226,11,36,60,121,191,368,0.5190217391304348,12,38,0.3157894736842105,179,330,0.5424242424242425,0.535,54,86,0.627906976744186
Christian Wood,woodch01,C,25,HOU,2021,41,1326.0,860,71,76,319,395,34,48,80,88,329,640,0.5140625,77,206,0.3737864077669903,252,434,0.5806451612903226,0.574,125,198,0.6313131313131313
Robert Woodard II,woodaro01,SF,21,SAC,2021,13,45.0,20,2,4,12,16,0,3,1,4,8,20,0.4,1,6,0.1666666666666666,7,14,0.5,0.425,3,8,0.375
Delon Wright,wrighde01,SG-PG,28,TOT,2021,63,1748.0,645,278,65,204,269,101,30,83,75,240,518,0.4633204633204633,64,172,0.3720930232558139,176,346,0.5086705202312138,0.525,101,126,0.8015873015873016
Thaddeus Young,youngth01,PF,32,CHI,2021,68,1652.0,823,291,168,255,423,74,40,137,152,370,662,0.5589123867069486,12,45,0.2666666666666666,358,617,0.580226904376013,0.568,71,113,0.6283185840707964
Trae Young,youngtr01,PG,22,ATL,2021,63,2125.0,1594,594,38,207,245,53,12,261,111,487,1112,0.4379496402877698,136,397,0.3425692695214106,351,715,0.4909090909090909,0.499,484,546,0.8864468864468864
Cody Zeller,zelleco01,C,28,CHO,2021,48,1005.0,451,86,119,209,328,27,17,51,121,181,324,0.558641975308642,4,28,0.1428571428571428,177,296,0.597972972972973,0.565,85,119,0.7142857142857143
Ivica Zubac,zubaciv01,C,23,LAC,2021,72,1609.0,650,90,189,330,519,24,62,81,187,257,394,0.6522842639593909,1,4,0.25,256,390,0.6564102564102564,0.654,135,171,0.7894736842105263
